srcIP,srcPort,dstIP,dstPort,numPackets,numBytes,streamID,maybe_TotalPackets,maybe_PercentFiltered,numPacketsSent,numBytesSent,numPacketsRecv,numBytesRecv,relStartTimestampInSec,duration,bpsSent,bpsRecv
"96.43.146.176",443,"172.16.133.82",61228,113,86644,0,0,0,67,59114,46,27530,0.000322,280.18483200000003,1687,786
"96.43.146.176",443,"172.16.133.82",60073,102,75723,1,0,0,55,39148,47,36575,0.005263,293.89687,1065,995
"172.16.133.103",63406,"216.115.222.200",443,6,366,2,0,0,4,246,2,120,0.006739,0.154404,12745,6217
"172.16.133.43",57700,"172.16.139.250",5440,8,890,3,0,0,8,890,0,0,0.008991,0.004461,"",""
"172.16.133.53",49292,"172.16.139.250",5500,20,1740,4,0,0,20,1740,0,0,0.010924,299.794143,46,0
"157.56.242.198",443,"172.16.133.57",60589,253,149574,5,0,0,127,66335,126,83239,0.01111,125.439016,4230,5308
"172.16.133.114",55270,"67.217.65.49",443,187,15158,6,0,0,120,9282,67,5876,0.011356,121.109776,613,388
"172.16.133.114",55272,"67.217.64.49",443,187,15158,7,0,0,120,9282,67,5876,0.01345,121.10072899999999,613,388
"172.16.133.114",55273,"67.217.66.49",443,187,15158,8,0,0,120,9282,67,5876,0.013451,121.098426,613,388
"172.16.133.13",52976,"172.16.139.250",5440,10,1022,9,0,0,10,1022,0,0,0.013994,0.015441,529499,0
"172.16.133.82",61238,"96.43.146.50",443,53,27844,10,0,0,28,17281,25,10563,0.01486,280.508418,492,301
"172.16.133.82",61240,"96.43.146.50",443,13,780,11,0,0,7,420,6,360,0.014861,270.141358,12,10
"172.16.133.82",61236,"96.43.146.50",443,13,780,12,0,0,7,420,6,360,0.016841,270.063884,12,10
"172.16.133.82",61239,"96.43.146.50",443,13,780,13,0,0,7,420,6,360,0.017845,270.05197699999997,12,10
"172.16.133.82",61237,"96.43.146.50",443,13,780,14,0,0,7,420,6,360,0.017847,270.154705,12,10
"96.43.146.22",443,"172.16.133.109",49451,266,233524,15,0,0,166,217152,100,16372,0.018029,11.941135,145481,10968
"96.43.146.50",443,"172.16.133.82",61247,77,51434,16,0,0,41,27470,36,23964,0.019494,280.584695,783,683
"64.74.80.244",443,"172.16.133.85",51696,309,24876,17,0,0,103,9342,206,15534,0.020024,198.553684,376,625
"216.219.115.183",443,"172.16.133.85",51700,309,24876,18,0,0,103,9342,206,15534,0.021003,198.553554,376,625
"172.16.133.49",54982,"67.217.65.65",443,459,37044,19,0,0,306,23121,153,13923,0.025978,298.220694,620,373
"172.16.133.49",54984,"67.217.64.65",443,461,37201,20,0,0,307,23187,154,14014,0.026039,298.22968,621,375
"172.16.133.49",54985,"67.217.66.65",443,461,37201,21,0,0,307,23187,154,14014,0.026095,298.217566,622,375
"172.16.133.78",58865,"24.44.106.119",18131,532,75948,22,0,0,254,17621,278,58327,0.032049,299.532752,470,1557
"172.16.133.78",62209,"128.119.195.145",38677,367,46443,23,0,0,177,12413,190,34030,0.03205,297.244584,334,915
"172.16.133.113",55582,"172.16.139.250",5462,4,240,24,0,0,4,240,0,0,0.035792,0.0010530000000000053,"",""
"172.16.133.113",56684,"172.16.139.250",5500,500,43964,25,0,0,500,43964,0,0,0.03679,299.763338,1173,0
"172.16.133.82",61249,"96.43.146.176",443,452,380355,26,0,0,156,52073,296,328282,0.053409,299.40695700000003,1391,8771
"172.16.133.75",58186,"157.56.241.150",443,103,21610,27,0,0,57,18850,46,2760,0.059112,245.243254,614,90
"172.16.133.99",51685,"216.115.216.44",443,192,15401,28,0,0,128,9608,64,5793,0.060372,125.726187,611,368
"172.16.133.99",51686,"216.219.115.17",443,190,15244,29,0,0,127,9542,63,5702,0.060374,125.725927,607,362
"172.16.133.99",51683,"64.74.80.15",443,190,15244,30,0,0,127,9542,63,5702,0.060375,125.724338,607,362
"172.16.133.99",51687,"216.115.217.144",443,190,15244,31,0,0,127,9542,63,5702,0.06141,125.725409,607,362
"172.16.133.36",65067,"216.115.219.126",443,6,378,32,0,0,4,258,2,120,0.06227,0.5427559999999999,3802,1768
"172.16.133.20",62286,"172.16.139.250",5440,12,1142,33,0,0,12,1142,0,0,0.062582,0.014782000000000003,618048,0
"172.16.133.103",63407,"66.151.158.187",443,7,426,34,0,0,4,246,3,180,0.063778,0.239379,8221,6015
"172.16.133.103",63408,"216.219.112.250",443,6,366,35,0,0,4,246,2,120,0.065661,0.26159699999999997,7523,3669
"172.16.133.76",60548,"5.79.25.106",443,427,32907,36,0,0,264,17859,163,15048,0.06686,297.726087,479,404
"172.16.133.60",62038,"67.217.64.49",443,706,450864,37,0,0,269,22098,437,428766,0.071942,296.36183900000003,596,11574
"172.16.133.37",49741,"96.43.146.48",443,27,8409,38,0,0,16,5344,11,3065,0.073584,240.347771,177,102
"172.16.133.82",61246,"96.43.146.50",443,13,780,39,0,0,7,420,6,360,0.077899,270.149219,12,10
"172.16.133.99",55867,"96.43.146.176",443,86,53830,40,0,0,41,22483,45,31347,0.080366,260.684876,689,961
"172.16.133.53",53643,"67.217.64.49",443,651,447760,41,0,0,213,18928,438,428832,0.081997,299.523794,505,11453
"216.115.216.31",443,"172.16.133.85",51699,309,24876,42,0,0,103,9342,206,15534,0.085388,198.489976,376,626
"216.115.217.225",443,"172.16.133.85",51701,309,24876,43,0,0,103,9342,206,15534,0.085994,198.491187,376,626
"172.16.133.82",61245,"96.43.146.50",443,13,780,44,0,0,7,420,6,360,0.086886,270.136566,12,10
"172.16.133.82",61242,"96.43.146.50",443,13,780,45,0,0,7,420,6,360,0.086888,270.072696,12,10
"172.16.133.82",61243,"96.43.146.50",443,13,780,46,0,0,7,420,6,360,0.087869,270.140036,12,10
"172.16.133.82",61244,"96.43.146.50",443,13,780,47,0,0,7,420,6,360,0.087871,270.140206,12,10
"98.138.19.88",80,"172.16.133.132",44296,6,1006,48,0,0,4,874,2,132,0.091257,0.07874699999999998,88790,13410
"172.16.133.78",58631,"157.56.241.150",443,47,14575,49,0,0,17,1020,30,13555,0.09209,299.30472000000003,27,362
"157.56.241.150",443,"172.16.133.75",58187,85,27435,50,0,0,54,25533,31,1902,0.093029,285.211085,716,53
"172.16.133.28",65271,"172.16.139.250",5440,10,1022,51,0,0,10,1022,0,0,0.095941,0.005540000000000003,1475812,0
"172.16.133.109",49453,"96.43.146.22",443,62,31092,52,0,0,35,17237,27,13855,0.09857,11.86225,11624,9343
"172.16.133.78",54905,"66.31.24.112",32450,159,12513,53,0,0,78,5600,81,6913,0.112067,277.075228,161,199
"172.16.133.132",54613,"216.185.152.111",80,88,31200,54,0,0,56,13890,32,17310,0.113427,31.428691999999998,3535,4406
"172.16.133.99",55981,"172.16.139.250",5440,10,1022,55,0,0,10,1022,0,0,0.120195,0.014748000000000011,554380,0
"172.16.131.10",8080,"172.16.133.237",4358,156,56074,56,0,0,86,8508,70,47566,0.121751,270.348892,251,1407
"172.16.131.10",8080,"172.16.133.235",2691,10,1401,57,0,0,5,378,5,1023,0.122735,6.303498,479,1298
"172.16.133.132",38625,"98.139.134.187",80,15,8483,58,0,0,8,942,7,7541,0.127207,0.15413000000000002,48893,391409
"96.43.146.50",443,"172.16.133.82",61241,50,26292,59,0,0,26,10642,24,15650,0.130641,287.21198499999997,296,435
"172.16.133.87",60115,"172.16.139.250",5440,10,1022,60,0,0,10,1022,0,0,0.141755,0.006979000000000013,1171514,0
"172.16.133.18",49879,"157.56.238.6",443,59,25260,61,0,0,28,11256,31,14004,0.151234,247.62717700000002,363,452
"172.16.133.118",57961,"68.64.28.20",443,110,8336,62,0,0,55,4261,55,4075,0.156762,292.455992,116,111
"172.16.133.26",53038,"67.217.65.99",443,459,37044,63,0,0,306,23121,153,13923,0.158599,299.817815,616,371
"172.16.133.116",53121,"172.16.139.250",5440,10,1022,64,0,0,10,1022,0,0,0.159288,0.006748999999999977,1211438,0
"172.16.133.35",49909,"172.16.139.250",5440,12,1142,65,0,0,12,1142,0,0,0.162908,0.024187000000000014,377723,0
"172.16.133.26",53041,"67.217.66.99",443,459,37044,66,0,0,306,23121,153,13923,0.164585,299.811708,616,371
"172.16.133.26",53040,"67.217.64.99",443,459,37044,67,0,0,306,23121,153,13923,0.166573,299.80995399999995,616,371
"172.16.133.116",53122,"172.16.139.250",5440,10,1022,68,0,0,10,1022,0,0,0.167155,0.005482000000000015,1491426,0
"24.63.143.150",10943,"172.16.133.25",59904,93,6863,69,0,0,48,3840,45,3023,0.168032,298.28365,102,81
"172.16.133.233",22,"172.16.128.233",55208,228,35388,70,0,0,148,29696,80,5692,0.171167,13.536660999999999,17549,3363
"172.16.133.116",53123,"172.16.139.250",5440,10,1022,71,0,0,10,1022,0,0,0.173473,0.007107000000000002,1150415,0
"172.16.133.82",61235,"64.56.203.22",443,13,780,72,0,0,7,420,6,360,0.177876,270.415213,12,10
"172.16.133.84",58729,"172.16.139.250",5440,10,1022,73,0,0,10,1022,0,0,0.181031,0.014629000000000003,558889,0
"172.16.133.207",55649,"67.217.66.54",443,459,37044,74,0,0,306,23121,153,13923,0.191088,299.786037,617,371
"172.16.133.207",55648,"67.217.64.54",443,459,37044,75,0,0,306,23121,153,13923,0.192048,299.78641700000003,616,371
"172.16.133.207",55646,"67.217.65.54",443,459,37044,76,0,0,306,23121,153,13923,0.19205,299.78631,616,371
"157.56.232.214",443,"172.16.133.121",53746,13,1149,77,0,0,7,789,6,360,0.194952,245.734195,25,11
"157.56.242.198",443,"172.16.133.57",60587,18,6543,78,0,0,9,4220,9,2323,0.196276,61.319462,550,303
"172.16.133.132",54620,"216.185.152.111",80,81,33538,79,0,0,53,13216,28,20322,0.205184,25.218868,4192,6446
"172.16.133.103",63409,"202.173.24.200",443,6,366,80,0,0,4,246,2,120,0.205814,0.474926,4143,2021
"172.16.133.121",53745,"157.56.232.214",443,28,2358,81,0,0,14,1518,14,840,0.206576,271.404474,44,24
"172.16.133.82",61234,"64.56.203.22",443,26,19642,82,0,0,11,5271,15,14371,0.216866,12.856731,3279,8942
"172.16.133.82",60717,"216.115.208.199",443,59,4408,83,0,0,30,2234,29,2174,0.216868,168.062763,106,103
"172.16.133.28",49284,"5.79.25.105",443,443,33822,84,0,0,275,18628,168,15194,0.219012,297.25323599999996,501,408
"172.16.133.35",64162,"172.16.139.250",5462,794,49708,85,0,0,794,49708,0,0,0.22873,298.36642,1332,0
"172.16.133.46",58048,"172.16.139.250",5462,796,49828,86,0,0,796,49828,0,0,0.22989,298.359869,1336,0
"172.16.133.35",63962,"172.16.139.250",5500,2836,1684068,87,0,0,2836,1684068,0,0,0.231844,298.571988,45123,0
"172.16.133.207",49562,"172.16.139.250",5462,794,49708,88,0,0,794,49708,0,0,0.232624,298.35765200000003,1332,0
"172.16.133.46",57824,"172.16.139.250",5500,2784,1677104,89,0,0,2784,1677104,0,0,0.233309,298.56913099999997,44937,0
"24.63.70.49",28159,"172.16.133.25",59820,95,6942,90,0,0,50,4005,45,2937,0.234208,297.70147499999996,107,78
"172.16.133.37",49273,"172.16.139.250",5462,816,51028,91,0,0,816,51028,0,0,0.235106,298.36653600000005,1368,0
"172.16.133.207",49560,"172.16.139.250",5500,2664,1669904,92,0,0,2664,1669904,0,0,0.235367,298.363309,44775,0
"172.16.133.132",50395,"76.13.6.174",80,9,1929,93,0,0,5,717,4,1212,0.236315,0.11392600000000003,50348,85107
"172.16.133.67",49855,"172.16.139.250",5462,834,52108,94,0,0,834,52108,0,0,0.237316,298.36474999999996,1397,0
"172.16.133.37",49272,"172.16.139.250",5500,2718,1698836,95,0,0,2718,1698836,0,0,0.237604,298.36993700000005,45549,0
"172.16.133.68",49279,"172.16.139.250",5462,828,51792,96,0,0,828,51792,0,0,0.240369,298.361844,1388,0
"172.16.133.67",49854,"172.16.139.250",5500,2782,1720428,97,0,0,2782,1720428,0,0,0.240694,298.365794,46129,0
"172.16.133.11",49284,"172.16.139.250",5462,796,49828,99,0,0,796,49828,0,0,0.245472,298.35864499999997,1336,0
"172.16.133.68",49278,"172.16.139.250",5500,2794,1750356,100,0,0,2794,1750356,0,0,0.245927,298.362905,46932,0
"172.16.133.11",49283,"172.16.139.250",5500,2656,1669604,101,0,0,2656,1669604,0,0,0.251906,298.356162,44768,0
"172.16.133.42",57835,"172.16.139.250",5462,866,54380,102,0,0,866,54380,0,0,0.253625,298.357724,1458,0
"172.16.133.49",55704,"172.16.139.250",5440,10,1022,103,0,0,10,1022,0,0,0.260152,0.01549600000000001,527620,0
"184.96.221.120",64510,"172.16.133.78",58899,82,6717,104,0,0,43,3673,39,3044,0.261365,115.96280300000001,253,209
"173.49.112.206",61315,"172.16.133.25",60121,157,11616,105,0,0,80,6646,77,4970,0.275429,296.156518,179,134
"172.16.133.42",57833,"172.16.139.250",5500,4926,1889680,106,0,0,4926,1889680,0,0,0.275944,298.549275,50636,0
"172.16.133.95",56882,"172.16.139.250",5440,12,1142,107,0,0,12,1142,0,0,0.29438,0.016122000000000025,566679,0
"172.16.133.132",54610,"98.139.161.29",80,9,1428,108,0,0,5,715,4,713,0.296278,0.11227200000000004,50947,50805
"172.16.133.132",44300,"98.138.19.88",80,10,1681,109,0,0,5,733,5,948,0.312246,0.18621099999999996,31491,40727
"172.16.133.63",53725,"107.22.18.198",443,201,106864,110,0,0,127,81288,74,25576,0.319388,90.087594,7218,2271
"172.16.133.24",57634,"23.20.10.203",443,2,120,111,0,0,1,60,1,60,0.319638,0.030028,15985,15985
"172.16.133.24",57632,"23.20.10.203",443,2,120,112,0,0,1,60,1,60,0.319891,0.03514200000000001,13658,13658
"172.16.133.24",57633,"23.20.10.203",443,134,69208,113,0,0,84,52442,50,16766,0.320483,75.593974,5549,1774
"172.16.133.92",57606,"172.16.139.250",5440,12,1142,114,0,0,12,1142,0,0,0.323566,0.012826000000000004,712303,0
"172.16.133.92",57607,"216.219.115.250",443,6,366,115,0,0,4,246,2,120,0.3241,0.05001899999999998,39345,19192
"172.16.133.43",57403,"173.194.43.59",80,2,120,116,0,0,1,60,1,60,0.324716,0.025289000000000006,18980,18980
"172.16.133.43",57406,"173.194.43.59",80,2,120,117,0,0,1,60,1,60,0.324722,0.025399000000000005,18898,18898
"216.219.115.160",443,"172.16.133.57",59181,234,28178,118,0,0,116,13623,118,14555,0.324919,297.261649,366,391
"172.16.133.92",57608,"67.217.66.244",443,6,366,119,0,0,4,246,2,120,0.328106,0.05840899999999999,33693,16435
"67.217.64.49",443,"172.16.133.114",55269,731,458586,120,0,0,300,24869,431,433717,0.3338,298.795002,665,11612
"172.16.133.132",52323,"98.139.240.23",80,9,1654,121,0,0,5,1036,4,618,0.338782,0.117975,70252,41907
"172.16.133.57",59183,"216.219.115.183",443,234,28178,122,0,0,118,14555,116,13623,0.340883,297.246518,391,366
"172.16.133.26",53072,"107.20.103.220",443,148,80447,123,0,0,94,61766,54,18681,0.340982,66.092839,7476,2261
"172.16.133.29",60816,"172.16.139.250",5440,10,1022,124,0,0,10,1022,0,0,0.341535,0.005462000000000022,1496887,0
"172.16.133.114",55271,"67.217.64.54",443,240,27887,125,0,0,112,13400,128,14487,0.347447,298.783198,358,387
"172.16.133.44",64673,"172.16.139.250",5440,10,1022,126,0,0,10,1022,0,0,0.34814,0.005460999999999994,1497161,0
"172.16.133.45",61287,"96.43.146.176",443,17,1037,127,0,0,8,480,9,557,0.357736,255.61247300000002,15,17
"157.56.237.150",443,"172.16.133.29",49318,12,1034,128,0,0,6,674,6,360,0.361598,261.765266,20,11
"157.56.236.102",443,"172.16.133.23",61949,10,863,129,0,0,5,563,5,300,0.362633,240.62444100000002,18,9
"172.16.133.92",57609,"68.64.30.250",443,6,366,130,0,0,4,246,2,120,0.368134,0.10543599999999997,18665,9105
"172.16.133.92",57610,"68.64.13.250",443,6,366,131,0,0,4,246,2,120,0.374009,0.12067800000000001,16307,7955
"172.16.133.36",64948,"208.85.40.50",80,2,1732,132,0,0,1,866,1,866,0.374067,0.000254000000000032,"",""
"172.16.133.207",55872,"172.16.139.250",5440,12,1142,133,0,0,12,1142,0,0,0.374322,0.015058000000000016,606720,0
"172.16.133.36",65068,"208.85.40.20",80,6,1565,134,0,0,4,1076,2,489,0.37541,0.18200399999999994,47295,21494
"172.16.133.28",63799,"96.43.146.22",443,46,18737,135,0,0,25,15221,21,3516,0.375891,279.034064,436,100
"172.16.133.83",57021,"172.16.139.250",5440,10,1022,136,0,0,10,1022,0,0,0.38044,0.004933999999999994,"",""
"157.56.236.102",443,"172.16.133.43",62631,26,4388,137,0,0,15,3722,11,666,0.397929,240.950349,123,22
"172.16.133.93",60597,"172.16.139.250",5440,12,1142,138,0,0,12,1142,0,0,0.398893,0.005236000000000018,1744843,0
"172.16.133.45",61190,"173.70.53.92",41433,4,240,139,0,0,2,120,2,120,0.400258,0.03106199999999998,30905,30905
"172.16.133.45",61200,"24.125.152.21",51398,4,240,140,0,0,2,120,2,120,0.400314,0.044003000000000014,21816,21816
"172.16.133.93",54574,"96.43.146.22",443,42,19080,141,0,0,24,16188,18,2892,0.405989,289.786081,446,79
"172.16.133.75",58053,"96.43.146.176",443,27,8683,142,0,0,16,5618,11,3065,0.40726,240.35672599999998,186,102
"172.16.133.11",55079,"172.16.139.250",5440,12,1142,143,0,0,12,1142,0,0,0.414634,0.006491999999999998,1407270,0
"172.16.133.55",57517,"172.16.139.250",5440,10,1022,144,0,0,10,1022,0,0,0.419556,0.005792999999999993,1411358,0
"216.115.208.199",443,"172.16.133.36",64909,170,31745,145,0,0,87,14165,83,17580,0.422683,288.622565,392,487
"172.16.133.39",62817,"216.115.216.44",443,194,15583,146,0,0,129,9699,65,5884,0.423675,125.338186,619,375
"172.16.133.39",62818,"216.219.115.17",443,194,15583,147,0,0,129,9699,65,5884,0.423951,125.343752,619,375
"172.16.133.39",62821,"216.115.217.144",443,194,15583,148,0,0,129,9699,65,5884,0.424229,125.34385300000001,619,375
"172.16.133.39",62815,"64.74.80.15",443,194,15583,149,0,0,129,9699,65,5884,0.424478,125.336792,619,375
"172.16.133.163",1184,"157.56.240.102",443,1431,182280,150,0,0,721,139668,710,42612,0.427959,278.136858,4017,1225
"172.16.133.73",60503,"172.16.139.250",5440,10,1022,151,0,0,10,1022,0,0,0.443913,0.005888000000000004,1388586,0
"172.16.133.53",54037,"172.16.139.250",5440,10,1022,152,0,0,10,1022,0,0,0.444719,0.011280000000000012,724822,0
"172.16.133.21",53111,"172.16.139.250",5440,10,1022,153,0,0,10,1022,0,0,0.448779,0.012360000000000038,661488,0
"172.16.133.30",62549,"172.16.139.250",5440,12,1142,154,0,0,12,1142,0,0,0.451477,0.015497999999999956,589495,0
"172.16.133.37",55511,"96.43.146.176",443,114,83248,155,0,0,55,43163,59,40085,0.452304,257.71443,1339,1244
"172.16.133.37",60537,"96.43.146.48",443,44,22003,156,0,0,20,8856,24,13147,0.460443,278.166481,254,378
"173.194.75.99",443,"172.16.133.25",62995,6,450,157,0,0,4,330,2,120,0.467279,0.04111500000000001,64210,23349
"172.16.133.34",50377,"172.16.139.250",5440,12,1142,158,0,0,12,1142,0,0,0.467488,0.005381999999999998,1697510,0
"172.16.133.47",56534,"67.217.65.65",443,458,37003,159,0,0,307,23262,151,13741,0.469215,298.229154,624,368
"172.16.133.47",56536,"67.217.64.65",443,458,37003,160,0,0,307,23262,151,13741,0.469217,298.229151,624,368
"172.16.133.47",56537,"67.217.66.65",443,458,37003,161,0,0,307,23262,151,13741,0.469302,298.229068,624,368
"157.56.240.102",443,"172.16.133.163",1185,1022,401945,162,0,0,653,379799,369,22146,0.469461,277.143826,10963,639
"172.16.133.25",63342,"172.16.139.250",5440,10,1022,163,0,0,10,1022,0,0,0.469619,0.007247999999999977,1128035,0
"174.129.20.55",443,"172.16.133.110",45907,15,5974,164,0,0,7,5458,8,516,0.469936,2.400058,18192,1719
"172.16.133.97",59308,"172.16.139.250",5440,10,1022,165,0,0,10,1022,0,0,0.479127,0.005511999999999961,1483309,0
"172.16.128.169",8014,"172.16.133.128",64958,5,446,166,0,0,3,326,2,120,0.480088,0.10075799999999996,25883,9527
"172.16.128.169",8014,"172.16.133.92",57225,5,446,167,0,0,3,326,2,120,0.480397,0.128164,20348,7490
"172.16.128.169",8014,"172.16.133.33",57361,5,446,168,0,0,3,326,2,120,0.480492,0.10045300000000007,25962,9556
"172.16.128.169",8014,"172.16.133.93",60076,4,386,169,0,0,3,326,1,60,0.482452,0.09939299999999995,26239,4829
"172.16.128.169",8014,"172.16.133.11",54680,5,446,170,0,0,3,326,2,120,0.482544,0.10645300000000002,24499,9018
"172.16.128.169",8014,"172.16.133.83",56650,5,446,171,0,0,3,326,2,120,0.482832,0.09911700000000007,26312,9685
"172.16.128.169",8014,"172.16.133.68",60280,5,446,172,0,0,3,326,2,120,0.483004,0.09904199999999996,26332,9692
"172.16.128.169",8014,"172.16.133.235",2682,5,446,173,0,0,3,326,2,120,0.483237,0.15160600000000002,17202,6332
"172.16.128.169",8014,"172.16.133.20",61857,5,446,174,0,0,3,326,2,120,0.483495,0.09945599999999999,26222,9652
"172.16.128.169",8014,"172.16.133.28",64786,5,446,175,0,0,3,326,2,120,0.483718,0.099333,26255,9664
"172.16.128.169",8014,"172.16.133.72",52205,5,446,176,0,0,3,326,2,120,0.483904,0.10891300000000004,23945,8814
"172.16.128.169",8014,"172.16.133.34",50008,5,446,177,0,0,3,326,2,120,0.484082,0.09910299999999994,26316,9686
"172.16.128.169",8014,"172.16.133.95",56519,5,446,178,0,0,3,326,2,120,0.484277,0.09901500000000002,26339,9695
"172.16.128.169",8014,"172.16.133.60",62028,5,446,179,0,0,3,326,2,120,0.484587,0.09880500000000003,26395,9716
"172.16.128.169",8014,"172.16.133.49",55355,5,446,180,0,0,3,326,2,120,0.484812,0.10408799999999996,25055,9222
"172.16.128.169",8014,"172.16.133.43",57325,5,446,181,0,0,3,326,2,120,0.485154,0.10402699999999998,25070,9228
"172.16.128.169",8014,"172.16.133.37",60126,5,446,182,0,0,3,326,2,120,0.48545,0.10363899999999998,25164,9262
"172.16.128.169",8014,"172.16.133.76",62340,5,446,183,0,0,3,326,2,120,0.485692,0.11316999999999999,23044,8482
"172.16.128.169",8014,"172.16.133.53",53649,5,446,184,0,0,3,326,2,120,0.485792,0.106819,24415,8987
"172.16.128.169",8014,"172.16.133.25",62890,5,446,185,0,0,3,326,2,120,0.486033,0.10732999999999998,24298,8944
"172.16.128.169",8014,"172.16.133.46",64483,5,446,186,0,0,3,326,2,120,0.486198,0.103074,25302,9313
"172.16.128.169",8014,"172.16.133.88",51194,5,446,187,0,0,3,326,2,120,0.486521,0.10619600000000007,24558,9039
"172.16.128.169",8014,"172.16.133.103",63350,5,446,188,0,0,3,326,2,120,0.486804,0.10619699999999999,24558,9039
"172.16.128.169",8014,"172.16.133.12",59108,5,446,189,0,0,3,326,2,120,0.487092,0.10581499999999994,24646,9072
"172.16.128.169",8014,"172.16.133.75",50413,5,446,190,0,0,3,326,2,120,0.487268,0.105825,24644,9071
"172.16.128.169",8014,"172.16.133.66",53308,5,446,191,0,0,3,326,2,120,0.488747,0.10443399999999997,24972,9192
"172.16.128.169",8014,"172.16.133.87",59659,5,446,192,0,0,3,326,2,120,0.489013,0.10425800000000002,25014,9207
"172.16.133.132",38630,"98.139.134.187",80,15,8483,193,0,0,8,942,7,7541,0.497614,0.14032999999999995,53701,429900
"172.16.133.60",62042,"67.217.66.49",443,453,36573,194,0,0,303,22923,150,13650,0.50609,298.237298,614,366
"172.16.133.60",62039,"67.217.65.49",443,453,36573,195,0,0,303,22923,150,13650,0.506091,298.23729499999996,614,366
"172.16.133.60",62041,"67.217.64.49",443,453,36573,196,0,0,303,22923,150,13650,0.506092,298.23825999999997,614,366
"172.16.133.68",56917,"205.203.132.1",80,93,39087,197,0,0,56,30986,37,8101,0.51515,290.07561599999997,854,223
"208.92.54.5",80,"172.16.133.56",56237,3380,2705837,198,0,0,2042,2623071,1338,82766,0.527023,299.209657,70133,2212
"172.16.133.53",53992,"173.194.43.7",443,16,1080,199,0,0,7,420,9,660,0.527996,195.016352,17,27
"172.16.133.82",61250,"64.56.203.22",443,15,4098,200,0,0,8,2939,7,1159,0.542029,12.531741,1876,739
"172.16.133.82",61251,"64.56.203.22",443,22,9849,201,0,0,12,3516,10,6333,0.542085,15.319535,1836,3307
"172.16.133.82",61252,"64.56.203.22",443,15,3955,202,0,0,8,2933,7,1022,0.542193,12.532353,1872,652
"96.43.146.176",443,"172.16.133.50",50638,218,158831,203,0,0,129,131924,89,26907,0.542885,281.583038,3748,764
"172.16.133.36",64956,"67.217.64.99",443,493,44620,204,0,0,321,27402,172,17218,0.543088,298.022817,735,462
"172.16.133.36",64958,"67.217.66.99",443,495,44801,205,0,0,322,27505,173,17296,0.543515,298.020041,738,464
"172.16.133.36",64954,"67.217.65.99",443,495,44801,206,0,0,322,27505,173,17296,0.543516,298.021934,738,464
"172.16.133.24",55774,"172.16.139.250",5500,122,52264,207,0,0,122,52264,0,0,0.545016,285.77290800000003,1463,0
"172.16.133.82",61253,"216.137.33.209",443,20,7696,208,0,0,9,926,11,6770,0.546893,35.236647000000005,210,1537
"172.16.133.82",61254,"216.137.33.209",443,19,7386,209,0,0,9,920,10,6466,0.546895,35.236110000000004,208,1468
"172.16.133.82",61255,"216.137.33.209",443,19,7636,210,0,0,8,866,11,6770,0.547028,35.235877,196,1537
"172.16.133.82",61256,"216.137.33.209",443,19,7386,211,0,0,9,920,10,6466,0.547156,35.235661,208,1468
"172.16.133.82",61257,"216.137.33.209",443,19,7636,212,0,0,8,866,11,6770,0.547262,35.235887,196,1537
"172.16.133.82",61258,"74.125.226.222",443,62,19639,213,0,0,33,16821,29,2818,0.549147,280.723882,479,80
"172.16.133.41",52362,"173.194.75.103",443,57,14827,214,0,0,27,9167,30,5660,0.549266,277.309429,264,163
"172.16.133.33",57817,"172.16.139.250",5440,12,1142,215,0,0,12,1142,0,0,0.555637,0.025474999999999914,358626,0
"172.16.133.24",56083,"172.16.139.250",5462,46,2760,216,0,0,46,2760,0,0,0.5631,273.740339,80,0
"132.245.1.150",443,"172.16.133.85",60808,160,92168,217,0,0,109,89102,51,3066,0.566049,243.080951,2932,100
"172.16.133.85",60806,"132.245.1.150",443,139,27825,218,0,0,71,23745,68,4080,0.567271,280.86413699999997,676,116
"172.16.133.85",51683,"216.115.208.199",443,190,52956,219,0,0,90,28179,100,24777,0.579121,295.619437,762,670
"172.16.133.68",60656,"172.16.139.250",5440,12,1142,220,0,0,12,1142,0,0,0.584739,0.01651199999999997,553294,0
"172.16.133.12",59648,"172.16.139.250",5440,10,1022,221,0,0,10,1022,0,0,0.598092,0.014524000000000092,562930,0
"157.56.245.198",443,"172.16.133.207",49659,138,37681,222,0,0,90,34795,48,2886,0.606161,293.419336,948,78
"172.16.133.63",53814,"172.16.139.250",5440,10,1022,223,0,0,10,1022,0,0,0.607421,0.009174000000000015,891214,0
"172.16.133.207",49658,"157.56.245.198",443,395,259190,224,0,0,224,248930,171,10260,0.607645,293.210366,6791,279
"172.16.133.66",53787,"172.16.139.250",5440,10,1022,225,0,0,10,1022,0,0,0.624045,0.038000000000000034,215157,0
"172.16.139.250",3389,"172.16.128.15",57460,635,47200,226,0,0,323,28178,312,19022,0.63281,298.811643,754,509
"172.16.133.45",61092,"173.194.68.125",5222,16,1623,227,0,0,8,1076,8,547,0.633719,286.44688,30,15
"172.16.133.82",61259,"172.16.139.250",5440,10,1022,228,0,0,10,1022,0,0,0.636978,0.02962100000000001,276020,0
"172.16.133.24",56569,"96.43.146.48",443,90,67763,229,0,0,48,38468,42,29295,0.640205,275.353133,1117,851
"172.16.133.24",56568,"96.43.146.48",443,193,161859,230,0,0,86,64540,107,97319,0.641327,274.929528,1878,2831
"172.16.133.24",56570,"96.43.146.48",443,115,91765,231,0,0,58,50212,57,41553,0.64255,274.87755100000004,1461,1209
"172.16.133.24",57115,"96.43.146.176",443,332,279723,232,0,0,154,141861,178,137862,0.643648,275.059698,4125,4009
"172.16.133.24",56567,"96.43.146.48",443,200,153491,233,0,0,93,79870,107,73621,0.645795,146.26000000000002,4368,4026
"172.16.133.24",57212,"96.43.146.176",443,542,462715,234,0,0,221,164254,321,298461,0.647124,275.12623199999996,4776,8678
"157.56.234.118",443,"172.16.133.37",59833,111,49505,235,0,0,76,47405,35,2100,0.650979,287.845389,1317,58
"172.16.133.132",50400,"76.13.6.174",80,9,1929,236,0,0,5,717,4,1212,0.654294,0.121305,47285,79930
"172.16.133.92",55696,"216.219.115.163",443,457,36862,237,0,0,304,22939,153,13923,0.654738,298.21772799999997,615,373
"172.16.133.92",55697,"216.115.217.201",443,457,36862,238,0,0,304,22939,153,13923,0.65482,298.22262600000005,615,373
"172.16.133.92",55693,"64.74.80.188",443,457,36862,239,0,0,304,22939,153,13923,0.65487,298.221616,615,373
"172.16.133.92",55695,"216.115.216.101",443,457,36862,240,0,0,304,22939,153,13923,0.654931,298.22251600000004,615,373
"172.16.133.37",60538,"172.16.139.250",5440,10,1022,241,0,0,10,1022,0,0,0.655465,0.01689700000000005,483872,0
"172.16.133.37",59832,"157.56.234.118",443,117,17788,242,0,0,59,14308,58,3480,0.656485,283.572089,403,98
"172.16.128.233",55207,"172.16.133.233",22,4,240,243,0,0,2,120,2,120,0.661317,0.2063649999999999,4651,4651
"172.16.133.29",60708,"23.0.49.244",80,8,492,244,0,0,4,240,4,252,0.66182,50.453802,38,39
"172.16.133.34",52661,"172.16.139.250",5500,150,56384,245,0,0,150,56384,0,0,0.664398,294.969874,1529,0
"172.16.133.29",60711,"23.0.49.244",80,6,366,246,0,0,3,180,3,186,0.681848,30.439978,47,48
"172.16.133.37",60539,"96.43.146.48",443,84,56725,247,0,0,40,28686,44,28039,0.681974,271.84383499999996,844,825
"172.16.133.53",53651,"67.217.94.254",443,110,8321,248,0,0,55,4230,55,4091,0.685118,290.189232,116,112
"172.16.133.29",60328,"23.33.81.244",80,72,36084,249,0,0,31,8022,41,28062,0.686806,269.253979,238,833
"172.16.133.12",57542,"96.43.146.176",443,25,8055,250,0,0,15,5010,10,3045,0.707796,240.357968,166,101
"172.16.133.60",62037,"216.115.208.199",443,149,27082,251,0,0,69,13405,80,13677,0.709426,298.66297,359,366
"172.16.133.37",60540,"96.43.146.48",443,36,15697,252,0,0,19,8522,17,7175,0.710806,270.638016,251,212
"172.16.133.37",60541,"96.43.146.48",443,59,32033,253,0,0,29,16623,30,15410,0.714887,272.49906000000004,488,452
"172.16.133.132",54615,"98.139.161.29",80,9,1428,254,0,0,5,715,4,713,0.724316,0.125892,45435,45308
"172.16.133.116",57461,"96.43.146.22",443,5,317,255,0,0,2,120,3,197,0.72814,0.066438,14449,23721
"172.16.133.132",44305,"98.138.19.88",80,10,1681,256,0,0,5,733,5,948,0.740143,0.18846799999999997,31114,40240
"172.16.133.29",60108,"23.33.81.244",80,139,83654,257,0,0,56,16178,83,67476,0.741853,272.51207600000004,474,1980
"157.56.240.102",443,"172.16.133.95",49359,1832,298723,258,0,0,1217,261823,615,36900,0.743398,240.26845699999998,8717,1228
"172.16.133.63",49370,"157.56.232.214",443,32,3828,259,0,0,16,2868,16,960,0.755443,270.332718,84,28
"202.68.93.36",443,"172.16.133.20",62259,5,331,260,0,0,3,211,2,120,0.757318,3.736671,451,256
"68.64.28.20",443,"172.16.133.26",53042,152,12179,261,0,0,76,6329,76,5850,0.758639,281.674327,179,166
"172.16.133.116",56985,"96.43.146.48",443,4,257,262,0,0,2,120,2,137,0.760374,0.05558700000000005,17270,19716
"172.16.133.132",52328,"98.139.240.23",80,9,1654,263,0,0,5,1036,4,618,0.763775,0.13112999999999997,63204,37703
"172.16.133.23",55024,"67.217.66.244",443,6,366,264,0,0,4,246,2,120,0.776757,0.062383999999999995,31546,15388
"172.16.133.23",55025,"216.219.115.250",443,6,366,265,0,0,4,246,2,120,0.781597,0.059301999999999966,33186,16188
"96.43.146.178",443,"172.16.133.45",61259,35,21031,266,0,0,21,15502,14,5529,0.795407,257.094052,482,172
"130.64.83.164",64216,"172.16.133.78",58905,195,15818,267,0,0,98,8835,97,6983,0.802865,298.75397,236,186
"172.16.133.29",60710,"23.0.49.244",80,89,48484,268,0,0,38,10115,51,38369,0.806816,269.31129799999997,300,1139
"172.16.133.78",59016,"172.16.139.250",5440,12,1142,269,0,0,12,1142,0,0,0.806817,0.0064509999999999845,1416214,0
"68.64.28.20",443,"172.16.133.36",64957,178,13647,270,0,0,89,6664,89,6983,0.810184,295.99998800000003,180,188
"172.16.133.29",60709,"23.0.49.244",80,84,46950,271,0,0,37,10482,47,36468,0.810762,269.11859599999997,311,1084
"172.16.133.23",55026,"68.64.30.250",443,6,366,272,0,0,4,246,2,120,0.812709,0.09934799999999999,19809,9663
"172.16.133.23",55027,"68.64.13.250",443,6,366,273,0,0,4,246,2,120,0.814579,0.10725799999999996,18348,8950
"172.16.133.63",64439,"74.125.226.195",443,185,137814,274,0,0,63,25035,122,112779,0.818315,293.956342,681,3069
"172.16.133.126",57827,"72.52.5.192",80,275,102291,275,0,0,152,46452,123,55839,0.832924,297.863712,1247,1499
"172.16.133.35",64163,"172.16.139.250",5500,4,348,276,0,0,4,348,0,0,0.838525,0.1967970000000001,14146,0
"172.16.133.73",59940,"23.32.176.63",443,139,72265,277,0,0,62,33019,77,39246,0.847974,284.84599099999997,927,1102
"172.16.133.67",55894,"172.16.139.250",5440,10,1022,278,0,0,10,1022,0,0,0.861131,0.005777000000000032,1415267,0
"172.16.133.42",57002,"172.16.139.250",5440,12,1142,279,0,0,12,1142,0,0,0.876189,0.009947999999999957,918375,0
"172.16.128.169",8014,"172.16.133.119",49271,5,446,280,0,0,3,326,2,120,0.883801,2.454059,1062,391
"172.16.128.169",8014,"172.16.133.10",10188,5,446,281,0,0,3,326,2,120,0.883802,2.6398,987,363
"172.16.133.56",61341,"172.16.139.250",5440,12,1142,282,0,0,12,1142,0,0,0.884902,0.006035000000000013,1513835,0
"23.20.10.203",443,"172.16.133.24",57631,5,331,283,0,0,3,211,2,120,0.887131,0.982886,1717,976
"172.16.133.63",49366,"172.16.139.250",5500,20,1740,284,0,0,20,1740,0,0,0.907335,240.195094,57,0
"64.56.203.22",443,"172.16.133.24",57609,4,240,285,0,0,2,120,2,120,0.91797,5.0644279999999995,189,189
"172.16.133.132",38635,"98.139.134.187",80,15,8483,286,0,0,8,942,7,7541,0.922033,0.14137699999999997,53304,426717
"172.16.133.67",51316,"216.115.216.44",443,203,16352,287,0,0,136,10286,67,6066,0.927077,124.835087,659,388
"172.16.133.67",51317,"216.219.115.17",443,201,16195,288,0,0,135,10220,66,5975,0.927078,124.83508400000001,654,382
"172.16.133.67",51318,"216.115.217.144",443,201,16195,289,0,0,135,10220,66,5975,0.927079,124.83594099999999,654,382
"172.16.133.67",51313,"64.74.80.15",443,201,16195,290,0,0,135,10220,66,5975,0.927156,124.83500500000001,654,382
"172.16.133.75",50875,"172.16.139.250",5440,10,1022,291,0,0,10,1022,0,0,0.938826,0.019920999999999967,410421,0
"172.16.133.41",52656,"172.16.139.250",5440,10,1022,292,0,0,10,1022,0,0,0.939436,0.014629000000000003,558889,0
"172.16.133.21",53015,"173.194.43.46",443,15,1014,293,0,0,7,420,8,594,0.939873,149.991781,22,31
"96.43.146.22",443,"172.16.133.53",53841,40,18857,294,0,0,17,2831,23,16026,0.947087,279.750393,80,458
"172.16.133.85",52185,"172.16.139.250",5440,12,1142,295,0,0,12,1142,0,0,0.95653,0.014842000000000022,615550,0
"157.56.241.150",443,"172.16.133.58",53926,76,44868,296,0,0,49,43248,27,1620,0.957831,240.302316,1439,53
"172.16.133.41",52657,"81.17.254.12",80,10,636,297,0,0,6,378,4,258,0.987014,19.119535000000003,158,107
"172.16.133.41",52658,"81.17.254.12",80,10,636,298,0,0,6,378,4,258,0.987336,19.114961,158,107
"172.16.133.116",52395,"96.43.146.48",443,1790,1510163,299,0,0,778,666243,1012,843920,0.990329,278.138415,19162,24273
"172.16.133.25",63141,"96.43.146.176",443,92,65164,300,0,0,38,14745,54,50419,0.997713,284.56961900000005,414,1417
"172.16.133.47",56533,"67.217.64.65",443,248,30474,301,0,0,119,13232,129,17242,1.000055,297.516275,355,463
"172.16.133.47",56535,"67.217.64.64",443,224,25415,302,0,0,108,12572,116,12843,1.000055,295.991639,339,347
"173.194.43.54",443,"172.16.133.66",53271,10,783,303,0,0,5,462,5,321,1.003751,53.844246,68,47
"70.99.54.203",28061,"172.16.133.78",58887,1323,1163548,304,0,0,839,1131579,484,31969,1.005809,298.224001,30355,857
"172.16.133.43",57701,"172.16.139.250",5440,12,1142,305,0,0,12,1142,0,0,1.011396,0.006213999999999942,1470228,0
"108.28.150.190",22350,"172.16.133.25",59887,226,16966,306,0,0,115,9922,111,7044,1.011451,297.47126,266,189
"64.56.203.22",443,"172.16.133.24",57656,4,240,307,0,0,2,120,2,120,1.013924,4.968475,193,193
"172.16.133.56",60846,"67.217.64.54",443,231,26047,308,0,0,114,13033,117,13014,1.023489,298.49965000000003,349,348
"172.16.133.56",60849,"67.217.64.49",443,221,25213,309,0,0,106,12541,115,12672,1.023542,294.392927,340,344
"172.16.133.13",52977,"172.16.139.250",5440,10,1022,310,0,0,10,1022,0,0,1.029186,0.015349999999999975,532638,0
"67.228.168.221",80,"172.16.133.48",59660,16,962,311,0,0,10,600,6,362,1.029642,25.352971,189,114
"172.16.133.132",50405,"76.13.6.174",80,9,1929,312,0,0,5,717,4,1212,1.029644,0.14536799999999994,39458,66699
"172.16.133.132",54620,"98.139.161.29",80,9,1428,313,0,0,5,715,4,713,1.034651,0.150188,38085,37979
"172.16.133.12",62872,"173.194.76.125",5222,14,907,314,0,0,7,420,7,487,1.051272,257.284716,13,15
"23.21.122.20",5222,"172.16.133.48",49219,43,8563,315,0,0,26,7388,17,1175,1.059281,269.680461,219,34
"23.21.122.20",5222,"172.16.133.54",64195,67,10363,316,0,0,33,7872,34,2491,1.060265,292.821737,215,68
"107.22.199.132",443,"172.16.133.24",56804,189,76070,317,0,0,95,19906,94,56164,1.062818,291.51206,546,1541
"54.235.187.196",443,"172.16.133.49",53682,161,87031,318,0,0,69,15585,92,71446,1.062967,281.699005,442,2029
"23.23.126.165",5222,"172.16.133.114",63437,74,11970,319,0,0,38,9420,36,2550,1.065296,291.15157,258,70
"23.21.62.199",5222,"172.16.133.71",52729,71,12043,320,0,0,37,9270,34,2773,1.066589,295.10216499999996,251,75
"23.21.62.199",5222,"172.16.133.39",49282,75,12214,321,0,0,37,9556,38,2658,1.0675729999999999,297.51364800000005,256,71
"23.21.62.199",5222,"172.16.133.63",49228,102,29420,322,0,0,53,26006,49,3414,1.068655,294.349015,706,92
"23.21.62.199",5222,"172.16.133.163",1121,63,10248,323,0,0,32,8072,31,2176,1.068878,276.709764,233,62
"23.21.62.199",5222,"172.16.133.18",49357,72,12577,324,0,0,36,9602,36,2975,1.069028,276.53571,277,86
"204.236.224.158",5222,"172.16.133.82",54098,78,12706,325,0,0,38,9928,40,2778,1.0698509999999999,286.66955199999995,277,77
"204.236.224.158",5222,"172.16.133.120",49224,64,10308,326,0,0,32,8072,32,2236,1.069982,277.046244,233,64
"204.236.224.158",5222,"172.16.133.36",63693,74,15783,327,0,0,37,13230,37,2553,1.071047,276.50938299999996,382,73
"204.236.224.158",5222,"172.16.133.76",57695,74,12054,328,0,0,37,9312,37,2742,1.071178,281.88817700000004,264,77
"54.235.187.196",443,"172.16.133.26",53149,210,101648,329,0,0,120,26420,90,75228,1.072859,297.610643,710,2022
"172.16.133.29",60773,"54.243.68.206",80,3,180,330,0,0,2,120,1,60,1.074931,0.07035099999999983,13645,6822
"172.16.133.29",60774,"54.243.68.206",80,3,180,331,0,0,2,120,1,60,1.075015,0.07220399999999993,13295,6647
"172.16.133.29",60786,"208.47.254.83",80,3,180,332,0,0,2,120,1,60,1.075067,0.07021199999999994,13672,6836
"172.16.133.29",60776,"23.15.129.231",80,4,240,333,0,0,2,120,2,120,1.075119,0.07288400000000017,13171,13171
"172.16.133.29",60775,"23.15.129.231",80,3,180,334,0,0,2,120,1,60,1.075169,0.07104299999999997,13512,6756
"172.16.133.29",60777,"23.15.129.231",80,3,180,335,0,0,2,120,1,60,1.075169,0.07098300000000002,13524,6762
"172.16.133.29",60779,"23.15.129.231",80,4,240,336,0,0,2,120,2,120,1.075268,0.0728390000000001,13179,13179
"172.16.133.29",60778,"23.15.129.231",80,3,180,337,0,0,2,120,1,60,1.075269,0.07101200000000008,13518,6759
"172.16.133.29",60783,"23.0.52.46",80,3,180,338,0,0,2,120,1,60,1.075349,0.07080599999999992,13558,6779
"172.16.133.29",60784,"23.0.52.46",80,3,180,339,0,0,2,120,1,60,1.075401,0.07176699999999991,13376,6688
"172.16.133.29",60785,"23.0.52.46",80,3,180,340,0,0,2,120,1,60,1.075403,0.07081199999999988,13557,6778
"172.16.133.29",60788,"64.94.107.46",80,4,240,341,0,0,2,120,2,120,1.075451,0.08155299999999999,11771,11771
"172.16.133.29",60787,"64.94.107.46",80,4,240,342,0,0,2,120,2,120,1.07553,0.08152799999999982,11775,11775
"172.16.133.29",60790,"173.194.43.57",80,3,180,343,0,0,2,120,1,60,1.075584,0.08432099999999987,11385,5692
"172.16.133.29",60789,"173.194.43.57",80,4,240,344,0,0,2,120,2,120,1.075634,0.08512699999999995,11277,11277
"172.16.133.29",60780,"50.17.220.219",80,3,180,345,0,0,2,120,1,60,1.075685,0.08855600000000008,10840,5420
"172.16.133.29",60781,"50.17.220.219",80,3,180,346,0,0,2,120,1,60,1.075686,0.09014000000000011,10650,5325
"172.16.133.29",60782,"206.33.41.253",80,2,120,347,0,0,1,60,1,60,1.075779,0.08668600000000004,5537,5537
"172.16.133.29",60792,"206.33.41.253",80,4,240,348,0,0,2,120,2,120,1.075829,0.08748900000000015,10972,10972
"172.16.133.29",60791,"206.33.41.253",80,3,180,349,0,0,2,120,1,60,1.075831,0.08739699999999995,10984,5492
"172.16.133.29",60793,"206.33.41.253",80,3,180,350,0,0,2,120,1,60,1.075899,0.08742099999999997,10981,5490
"172.16.133.29",60794,"206.33.41.253",80,3,180,351,0,0,2,120,1,60,1.075953,0.08645900000000006,11103,5551
"172.16.133.29",60797,"64.94.107.11",80,4,240,352,0,0,2,120,2,120,1.076025,0.08388200000000001,11444,11444
"172.16.133.29",60796,"64.94.107.11",80,4,240,353,0,0,2,120,2,120,1.076076,0.08389099999999994,11443,11443
"172.16.133.29",60800,"138.108.7.20",80,3,180,354,0,0,2,120,1,60,1.076141,0.15686599999999995,6119,3059
"172.16.133.29",60798,"138.108.7.20",80,3,180,355,0,0,2,120,1,60,1.076191,0.15430300000000008,6221,3110
"172.16.133.29",60805,"173.194.43.45",80,3,180,356,0,0,2,120,1,60,1.076243,0.08359699999999992,11483,5741
"172.16.133.29",60804,"173.194.43.45",80,3,180,357,0,0,2,120,1,60,1.076294,0.08453999999999984,11355,5677
"172.16.133.29",60802,"216.52.242.80",80,3,180,358,0,0,2,120,1,60,1.076295,0.15578500000000006,6162,3081
"172.16.133.29",60801,"216.52.242.80",80,3,180,359,0,0,2,120,1,60,1.076343,0.15666099999999994,6127,3063
"172.16.133.29",60803,"216.52.242.80",80,3,180,360,0,0,2,120,1,60,1.076419,0.15744099999999994,6097,3048
"172.16.133.20",62287,"172.16.139.250",5440,12,1142,361,0,0,12,1142,0,0,1.076915,0.014433999999999836,632949,0
"172.16.133.84",58698,"64.90.204.229",443,2,120,362,0,0,1,60,1,60,1.083231,0.1376949999999999,3485,3485
"172.16.133.132",44310,"98.138.19.88",80,10,1681,363,0,0,5,733,5,948,1.106403,0.22002900000000003,26651,34468
"172.16.133.28",65272,"172.16.139.250",5440,12,1142,364,0,0,12,1142,0,0,1.108926,0.0062189999999999745,1469046,0
"172.16.133.50",50678,"96.43.146.22",443,8,2782,366,0,0,4,2525,4,257,1.129423,0.06969099999999995,289850,29501
"172.16.133.99",55982,"172.16.139.250",5440,10,1022,367,0,0,10,1022,0,0,1.13429,0.016350000000000087,500061,0
"172.16.133.57",59182,"64.74.80.185",443,457,41434,368,0,0,304,25762,153,15672,1.140899,298.031774,691,420
"172.16.133.57",59184,"216.115.216.98",443,457,41434,369,0,0,304,25762,153,15672,1.1409,298.019458,691,420
"172.16.133.57",59186,"216.219.115.160",443,457,41434,370,0,0,304,25762,153,15672,1.140902,298.033536,691,420
"172.16.133.57",59187,"216.115.217.198",443,457,41434,371,0,0,304,25762,153,15672,1.140903,298.033536,691,420
"172.16.133.114",55076,"216.137.33.161",80,60,20700,372,0,0,40,11820,20,8880,1.142946,285.690856,330,248
"98.209.196.102",34603,"172.16.133.78",58806,185,15421,373,0,0,91,8653,94,6768,1.145281,297.325568,232,182
"172.16.133.118",57944,"216.115.217.201",443,217,24767,374,0,0,103,12266,114,12501,1.145494,298.38651600000003,328,335
"172.16.133.118",57946,"216.115.217.210",443,219,25004,375,0,0,104,12332,115,12672,1.146153,298.38541899999996,330,339
"68.33.218.83",45301,"172.16.133.78",49608,172,31164,376,0,0,88,24998,84,6166,1.148645,273.87203900000003,730,180
"172.16.133.87",60116,"172.16.139.250",5440,12,1142,377,0,0,12,1142,0,0,1.156467,0.006402000000000019,1427054,0
"67.228.168.221",80,"172.16.133.126",57660,93,5592,378,0,0,59,3546,34,2046,1.1565699999999999,291.53484000000003,97,56
"172.16.133.132",52333,"98.139.240.23",80,9,1654,379,0,0,5,1036,4,618,1.159776,0.1042050000000001,79535,47444
"216.115.208.199",443,"172.16.133.35",49522,17,1237,380,0,0,8,604,9,633,1.165719,37.165443999999994,130,136
"172.16.133.35",49910,"172.16.139.250",5440,12,1142,381,0,0,12,1142,0,0,1.169711,0.014448000000000016,632336,0
"172.16.133.116",53124,"172.16.139.250",5440,10,1022,382,0,0,10,1022,0,0,1.173867,0.006836999999999982,1195846,0
"96.242.17.13",60086,"172.16.133.78",59001,223,18889,383,0,0,117,11280,106,7609,1.180117,286.81906200000003,314,212
"172.16.133.116",53125,"172.16.139.250",5440,12,1142,384,0,0,12,1142,0,0,1.181683,0.006440000000000001,1418633,0
"172.16.133.116",53126,"172.16.139.250",5440,12,1142,385,0,0,12,1142,0,0,1.1890830000000001,0.0062189999999999745,1469046,0
"172.16.133.84",58730,"172.16.139.250",5440,10,1022,386,0,0,10,1022,0,0,1.1953,0.005663999999999891,1443502,0
"172.16.133.110",45711,"74.125.226.222",443,6,1564,387,0,0,4,1031,2,533,1.216431,1.6495860000000002,5000,2584
"172.16.133.57",59178,"216.115.208.199",443,551,164564,388,0,0,267,102150,284,62414,1.222091,289.37507000000005,2824,1725
"173.194.76.125",5222,"172.16.133.21",57524,10,973,389,0,0,5,613,5,360,1.224455,247.08341199999998,19,11
"172.16.133.78",58383,"63.73.131.68",80,6,360,390,0,0,3,180,3,180,1.228069,33.851808000000005,42,42
"172.16.133.45",61077,"157.56.234.118",443,10,775,391,0,0,5,475,5,300,1.244924,240.061375,15,9
"172.16.133.56",49600,"172.16.139.250",5500,258,134956,392,0,0,258,134956,0,0,1.252045,240.19455599999998,4494,0
"132.245.2.22",443,"172.16.133.66",53705,29,4450,393,0,0,16,3664,13,786,1.254377,257.65024400000004,113,24
"172.16.133.49",55705,"172.16.139.250",5440,10,1022,394,0,0,10,1022,0,0,1.273797,0.014817999999999998,551761,0
"67.228.168.221",80,"172.16.133.126",57848,90,5406,395,0,0,59,3540,31,1866,1.282839,291.4242,97,51
"107.22.210.163",5222,"172.16.133.118",56698,74,12374,396,0,0,37,9832,37,2542,1.2956940000000001,284.15007299999996,276,71
"96.43.146.22",443,"172.16.133.55",57079,58,32928,397,0,0,24,5178,34,27750,1.296502,298.58795100000003,138,743
"172.16.133.95",56883,"172.16.139.250",5440,12,1142,398,0,0,12,1142,0,0,1.3095430000000001,0.005976999999999899,1528526,0
"216.219.115.183",443,"172.16.133.85",51695,187,25495,399,0,0,101,14936,86,10559,1.32458,196.902382,606,429
"172.16.133.132",38640,"98.139.134.187",80,15,8483,400,0,0,8,942,7,7541,1.324941,0.18368399999999996,41026,328433
"216.219.115.183",443,"172.16.133.37",60482,184,24860,401,0,0,98,14836,86,10024,1.325752,196.884699,602,407
"67.217.64.100",443,"172.16.133.26",53039,244,27201,402,0,0,123,13374,121,13827,1.327486,298.19762,358,370
"67.217.64.100",443,"172.16.133.36",64955,253,30582,403,0,0,125,14862,128,15720,1.327617,298.47745100000003,398,421
"216.219.115.160",443,"172.16.133.85",51697,152,17134,404,0,0,80,8812,72,8322,1.328648,196.89732,358,338
"69.132.122.65",49560,"172.16.133.90",51477,129,10068,405,0,0,72,5988,57,4080,1.328865,298.575374,160,109
"216.219.115.160",443,"172.16.133.37",60484,151,16979,406,0,0,79,8752,72,8227,1.329049,196.880583,355,334
"172.16.133.66",58182,"74.125.226.214",443,441,178649,407,0,0,187,100323,254,78326,1.336417,286.874296,2797,2184
"172.16.133.92",57611,"172.16.139.250",5440,10,1022,408,0,0,10,1022,0,0,1.337108,0.005696000000000145,1435393,0
"67.217.64.54",443,"172.16.133.53",53645,217,24761,409,0,0,114,12501,103,12260,1.337269,298.268253,335,328
"67.217.64.54",443,"172.16.133.60",62040,217,24688,410,0,0,113,12552,104,12136,1.337482,295.096431,340,329
"172.16.133.56",60851,"67.217.66.54",443,460,37110,411,0,0,306,23096,154,14014,1.33841,298.224746,619,375
"172.16.133.56",60847,"67.217.65.54",443,466,37470,412,0,0,306,23096,160,14374,1.338412,298.224743,619,385
"172.16.133.56",60850,"67.217.64.54",443,466,37470,413,0,0,306,23096,160,14374,1.3384610000000001,298.228694,619,385
"184.73.255.87",5222,"172.16.133.57",59155,66,11244,414,0,0,33,8696,33,2548,1.340852,285.375379,243,71
"67.217.64.97",443,"172.16.133.56",60854,114,8623,415,0,0,57,4273,57,4350,1.34235,293.097753,116,118
"172.16.133.120",52113,"96.43.146.164",443,276,213353,416,0,0,111,36446,165,176907,1.35439,270.380481,1078,5234
"172.16.133.37",60245,"96.43.146.22",443,9,557,417,0,0,4,240,5,317,1.355134,76.912228,24,32
"172.16.133.29",60817,"172.16.139.250",5440,10,1022,418,0,0,10,1022,0,0,1.355805,0.009694000000000091,843408,0
"172.16.133.44",64674,"172.16.139.250",5440,10,1022,419,0,0,10,1022,0,0,1.362384,0.009881999999999946,827362,0
"172.16.133.118",58125,"216.115.217.201",443,458,36953,420,0,0,305,23030,153,13923,1.3710149999999999,298.352783,617,373
"67.69.196.212",1935,"172.16.133.93",60584,9,830,421,0,0,5,590,4,240,1.371765,42.513983999999994,111,45
"172.16.133.118",58122,"64.74.80.188",443,458,36953,422,0,0,305,23030,153,13923,1.378059,298.322046,617,373
"172.16.133.118",58123,"216.115.216.101",443,457,36862,423,0,0,304,22939,153,13923,1.378064,298.344825,615,373
"172.16.133.118",58124,"216.219.115.163",443,458,36953,424,0,0,305,23030,153,13923,1.378064,298.34177,617,373
"172.16.133.207",55873,"172.16.139.250",5440,12,1142,425,0,0,12,1142,0,0,1.387016,0.005168999999999979,1767459,0
"172.16.133.83",57022,"172.16.139.250",5440,10,1022,426,0,0,10,1022,0,0,1.395444,0.005009999999999959,1631936,0
"157.56.234.118",443,"172.16.133.53",59079,134,53891,427,0,0,91,51311,43,2580,1.398963,240.423139,1707,85
"172.16.133.93",60598,"172.16.139.250",5440,12,1142,428,0,0,12,1142,0,0,1.413348,0.006475999999999926,1410747,0
"172.16.133.11",55080,"172.16.139.250",5440,10,1022,429,0,0,10,1022,0,0,1.428518,0.005716999999999972,1430120,0
"172.16.133.55",57518,"172.16.139.250",5440,10,1022,430,0,0,10,1022,0,0,1.434349,0.005641999999999925,1449131,0
"169.233.51.66",46939,"172.16.133.78",58880,3536,3449988,431,0,0,2349,3369948,1187,80040,1.437468,296.921297,90797,2156
"172.16.133.73",60504,"172.16.139.250",5440,10,1022,432,0,0,10,1022,0,0,1.45753,0.005727999999999955,1427374,0
"172.16.133.36",65069,"68.64.24.250",443,6,378,433,0,0,4,258,2,120,1.4576,0.09447499999999986,21847,10161
"172.16.133.53",54038,"172.16.139.250",5440,10,1022,434,0,0,10,1022,0,0,1.459893,0.016079999999999872,508457,0
"172.16.133.21",53112,"172.16.139.250",5440,10,1022,435,0,0,10,1022,0,0,1.461932,0.006032000000000037,1355437,0
"172.16.133.30",62550,"172.16.139.250",5440,10,1022,436,0,0,10,1022,0,0,1.465948,0.0060949999999999616,1341427,0
"172.16.133.25",63343,"172.16.139.250",5440,12,1142,437,0,0,12,1142,0,0,1.475854,0.015911999999999926,574157,0
"172.16.133.132",50410,"76.13.6.174",80,9,1927,438,0,0,5,717,4,1210,1.48018,0.10075199999999995,56931,96077
"172.16.133.34",50378,"172.16.139.250",5440,12,1142,439,0,0,12,1142,0,0,1.4826679999999999,0.0052080000000001014,1754224,0
"172.16.133.132",54625,"98.139.161.29",80,9,1428,440,0,0,5,715,4,713,1.487107,0.10939600000000005,52287,52140
"172.16.133.132",44315,"98.138.19.88",80,10,1681,441,0,0,5,733,5,948,1.49309,0.1786810000000001,32818,42444
"172.16.133.97",59309,"172.16.139.250",5440,10,1022,442,0,0,10,1022,0,0,1.49363,0.005708999999999964,1432124,0
"157.55.130.158",40031,"172.16.133.45",61060,45,3882,443,0,0,26,1688,19,2194,1.496906,298.47425799999996,45,58
"129.64.197.158",57824,"172.16.133.25",59900,280,21015,444,0,0,144,12381,136,8634,1.5136910000000001,298.008015,332,231
"184.73.235.12",5222,"172.16.133.96",52662,87,16873,445,0,0,45,13646,42,3227,1.513966,279.99856900000003,389,92
"184.73.235.12",5222,"172.16.133.87",65355,72,12398,446,0,0,36,9922,36,2476,1.514081,278.825012,284,71
"204.232.250.57",443,"172.16.133.24",57665,4,240,447,0,0,2,120,2,120,1.546047,4.379889,219,219
"96.43.146.22",443,"172.16.133.40",64710,40,18402,448,0,0,17,2832,23,15570,1.548622,281.54112,80,442
"172.16.133.20",62288,"216.219.115.250",443,6,366,449,0,0,4,246,2,120,1.560222,0.050289999999999946,39133,19089
"172.16.133.20",60694,"96.43.146.22",443,47,22832,450,0,0,27,19101,20,3731,1.569779,289.55893100000003,527,103
"172.16.133.33",57818,"172.16.139.250",5440,12,1142,451,0,0,12,1142,0,0,1.569866,0.005754999999999955,1587489,0
"172.16.133.132",52338,"98.139.240.23",80,9,1654,452,0,0,5,1036,4,618,1.572569,0.12182000000000004,68034,40584
"172.16.133.20",62289,"67.217.66.244",443,6,366,453,0,0,4,246,2,120,1.5732270000000002,0.06575799999999976,29927,14598
"172.16.133.109",49454,"96.43.146.22",443,17,3992,454,0,0,10,1090,7,2902,1.577399,10.38621,839,2235
"172.16.133.109",49455,"96.43.146.22",443,17,3992,455,0,0,10,1090,7,2902,1.5775869999999999,10.382535,839,2236
"172.16.133.68",60658,"172.16.139.250",5440,10,1022,456,0,0,10,1022,0,0,1.6000079999999999,0.015829000000000093,516520,0
"172.16.133.20",62290,"68.64.30.250",443,6,366,457,0,0,4,246,2,120,1.6031360000000001,0.101626,19365,9446
"172.16.133.12",59649,"172.16.139.250",5440,12,1142,458,0,0,12,1142,0,0,1.613222,0.007476000000000038,1222043,0
"172.16.133.63",53815,"172.16.139.250",5440,12,1142,459,0,0,12,1142,0,0,1.620223,0.015622000000000025,584816,0
"172.16.133.76",62352,"74.125.226.201",443,15,1014,460,0,0,7,420,8,594,1.622123,149.98283600000002,22,31
"172.16.133.57",60586,"157.56.242.198",443,110,84963,461,0,0,52,43355,58,41608,1.6230470000000001,123.82708,2801,2688
"172.16.133.20",62291,"68.64.13.250",443,6,366,462,0,0,4,246,2,120,1.62316,0.12094000000000005,16272,7937
"157.56.232.214",443,"172.16.133.63",49368,10,775,463,0,0,5,475,5,300,1.628526,240.00293000000002,15,9
"172.16.133.66",53788,"172.16.139.250",5440,12,1142,464,0,0,12,1142,0,0,1.637768,0.01580400000000015,578081,0
"172.16.133.82",61260,"172.16.139.250",5440,12,1142,465,0,0,12,1142,0,0,1.649744,0.007775999999999783,1174897,0
"172.16.133.37",60542,"172.16.139.250",5440,12,1142,466,0,0,12,1142,0,0,1.66439,0.006564999999999932,1391622,0
"172.16.133.36",65071,"216.219.118.244",443,6,378,467,0,0,4,258,2,120,1.671395,0.1973069999999999,10460,4865
"172.16.133.36",65070,"78.108.118.250",443,6,378,468,0,0,4,258,2,120,1.6719119999999998,0.19637400000000005,10510,4888
"172.16.133.37",60485,"216.115.216.31",443,301,24229,469,0,0,201,15160,100,9069,1.678247,197.214646,614,367
"172.16.133.37",60487,"216.219.115.183",443,300,24138,470,0,0,200,15069,100,9069,1.678248,197.20794800000002,611,367
"172.16.133.37",60488,"216.115.217.225",443,300,24138,471,0,0,200,15069,100,9069,1.6782979999999998,197.216308,611,367
"172.16.133.37",60483,"64.74.80.244",443,300,24138,472,0,0,200,15069,100,9069,1.6783510000000001,197.206981,611,367
"172.16.133.50",50683,"64.56.203.22",443,16,3947,473,0,0,9,2788,7,1159,1.6820330000000001,14.70898,1516,630
"172.16.133.53",53648,"67.217.66.49",443,453,36548,474,0,0,302,22807,151,13741,1.682118,298.242725,611,368
"172.16.133.53",53644,"67.217.65.49",443,453,36548,475,0,0,302,22807,151,13741,1.68218,298.242662,611,368
"172.16.133.53",53647,"67.217.64.49",443,453,36548,476,0,0,302,22807,151,13741,1.682233,298.242607,611,368
"172.16.133.50",50684,"64.56.203.22",443,39,23294,477,0,0,19,7831,20,15463,1.682341,14.708773999999998,4259,8410
"172.16.133.50",50685,"96.43.146.50",443,53,24172,478,0,0,28,14491,25,9681,1.6832150000000001,280.441242,413,276
"172.16.133.41",52378,"23.60.230.152",80,15,936,479,0,0,8,480,7,456,1.697805,258.324014,14,14
"172.16.133.41",52377,"23.60.230.152",80,15,936,480,0,0,8,480,7,456,1.727783,258.314161,14,14
"172.16.133.132",38645,"98.139.134.187",80,15,8483,481,0,0,8,942,7,7541,1.734506,0.14721299999999982,51191,409800
"172.16.133.33",57580,"216.52.242.80",80,19,7688,482,0,0,12,5070,7,2618,1.7596690000000001,294.736213,137,71
"199.94.91.63",12192,"172.16.133.78",58867,45,3333,483,0,0,24,2001,21,1332,1.763476,47.675379,335,223
"172.16.133.82",61261,"204.232.250.57",443,19,8173,484,0,0,10,3851,9,4322,1.778181,14.023176,2196,2465
"172.16.133.41",52423,"74.125.226.77",80,14,870,485,0,0,7,420,7,450,1.778767,198.237522,16,18
"38.124.22.82",36043,"172.16.133.78",58886,653,474438,486,0,0,418,458048,235,16390,1.790762,297.689043,12309,440
"172.16.133.68",59408,"96.43.146.176",443,15,917,487,0,0,7,420,8,497,1.810879,215.021553,15,18
"172.16.133.47",56541,"96.43.146.48",443,20,3576,488,0,0,11,2582,9,994,1.8126280000000001,118.49135299999999,174,67
"172.16.133.78",59017,"172.16.139.250",5440,12,1142,489,0,0,12,1142,0,0,1.824357,0.0064030000000001586,1426831,0
"68.49.25.49",55165,"172.16.133.25",62051,142,10557,490,0,0,74,6008,68,4549,1.832139,288.975339,166,125
"172.16.133.68",60558,"96.43.146.48",443,15,917,491,0,0,7,420,8,497,1.841888,214.990546,15,18
"172.16.133.68",60557,"96.43.146.48",443,53,30604,492,0,0,26,16958,27,13646,1.845854,274.65575900000005,493,397
"71.234.178.21",33052,"172.16.133.78",55438,206,49858,493,0,0,109,42710,97,7148,1.850519,285.668996,1196,200
"172.16.133.132",50415,"76.13.6.174",80,9,1929,494,0,0,5,717,4,1212,1.8538000000000001,0.09648900000000005,59447,100488
"172.16.133.132",54630,"98.139.161.29",80,9,1428,495,0,0,5,715,4,713,1.85961,0.10598399999999986,53970,53819
"172.16.133.67",55895,"172.16.139.250",5440,10,1022,496,0,0,10,1022,0,0,1.874585,0.014904999999999946,548540,0
"172.16.133.42",57003,"172.16.139.250",5440,12,1142,497,0,0,12,1142,0,0,1.889196,0.026773999999999853,341226,0
"172.16.133.56",61342,"172.16.139.250",5440,10,1022,498,0,0,10,1022,0,0,1.898111,0.005095999999999989,1604395,0
"172.16.133.50",50686,"96.43.146.48",443,57,27243,499,0,0,29,10909,28,16334,1.9013360000000001,285.53457499999996,305,457
"172.16.133.50",50687,"96.43.146.48",443,19,1531,500,0,0,10,862,9,669,1.901987,270.468284,25,19
"172.16.133.36",64517,"54.243.254.190",443,843,412157,501,0,0,424,331512,419,80645,1.907213,298.075264,8897,2164
"172.16.133.44",50452,"96.43.146.48",443,26,8075,502,0,0,15,5010,11,3065,1.9234909999999998,240.36102599999998,166,102
"172.16.133.132",44320,"98.138.19.88",80,10,1681,503,0,0,5,733,5,948,1.930676,0.18420900000000007,31833,41170
"173.194.43.38",443,"172.16.133.163",3472,7,510,504,0,0,4,330,3,180,1.932803,0.022080999999999795,119559,65214
"172.16.133.78",58444,"63.116.244.160",80,11,684,505,0,0,6,360,5,324,1.9380899999999999,173.13178100000002,16,14
"172.16.133.132",52343,"98.139.240.23",80,9,1653,506,0,0,5,1035,4,618,1.9400680000000001,0.1004649999999998,82416,49211
"216.115.101.178",80,"172.16.133.39",64160,4,240,507,0,0,2,120,2,120,1.940372,3.7344540000000004,257,257
"72.80.185.137",13135,"172.16.133.78",54982,243,52393,508,0,0,134,44688,109,7705,1.9517470000000001,296.658895,1205,207
"172.16.133.75",50876,"172.16.139.250",5440,10,1022,509,0,0,10,1022,0,0,1.953392,0.005542999999999854,1475013,0
"172.16.133.41",52659,"172.16.139.250",5440,10,1022,510,0,0,10,1022,0,0,1.9536090000000002,0.01593,513245,0
"172.16.133.50",50688,"96.43.146.22",443,25,9596,511,0,0,14,7994,11,1602,1.9665569999999999,38.582029,1657,332
"172.16.133.50",50689,"96.43.146.22",443,31,12839,512,0,0,18,10862,13,1977,1.96688,52.451874999999994,1656,301
"172.16.133.50",50690,"96.43.146.22",443,18,1477,513,0,0,10,868,8,609,1.9671880000000002,270.402834,25,18
"172.16.133.85",52186,"172.16.139.250",5440,10,1022,514,0,0,10,1022,0,0,1.972243,0.005382999999999916,1518855,0
"172.16.133.83",51419,"172.16.139.250",5500,530,310632,515,0,0,530,310632,0,0,2.001933,284.640837,8730,0
"172.16.133.12",63225,"172.16.139.250",5500,866,467512,516,0,0,866,467512,0,0,2.002629,287.67945299999997,13000,0
"172.16.133.83",51533,"172.16.139.250",5462,176,10924,517,0,0,176,10924,0,0,2.004663,292.304368,298,0
"172.16.133.12",63226,"172.16.139.250",5462,316,19268,518,0,0,316,19268,0,0,2.005081,272.29362,566,0
"172.16.133.53",53776,"96.43.146.22",443,9,557,519,0,0,4,240,5,317,2.025021,79.822776,24,31
"172.16.133.53",53775,"96.43.146.22",443,9,557,520,0,0,4,240,5,317,2.029015,79.817858,24,31
"172.16.133.53",53772,"96.43.146.22",443,9,557,521,0,0,4,240,5,317,2.029017,79.81877800000001,24,31
"172.16.133.53",53773,"96.43.146.22",443,9,557,522,0,0,4,240,5,317,2.032046,79.81569900000001,24,31
"172.16.133.53",53774,"96.43.146.22",443,9,557,523,0,0,4,240,5,317,2.032049,79.815808,24,31
"172.16.133.43",57702,"172.16.139.250",5440,10,1022,524,0,0,10,1022,0,0,2.035179,0.05475399999999997,149322,0
"172.16.133.13",52978,"172.16.139.250",5440,10,1022,525,0,0,10,1022,0,0,2.042718,0.0473650000000001,172616,0
"172.16.133.53",53777,"96.43.146.22",443,9,557,526,0,0,4,240,5,317,2.068054,79.778751,24,31
"172.16.133.12",51752,"172.16.139.250",5500,66,29436,527,0,0,66,29436,0,0,2.072935,251.462285,936,0
"69.9.238.98",56159,"172.16.133.121",54742,64,4713,528,0,0,34,2839,30,1874,2.08128,133.967812,169,111
"172.16.133.53",53779,"96.43.146.22",443,9,557,529,0,0,4,240,5,317,2.085007,79.760868,24,31
"172.16.133.53",53780,"96.43.146.22",443,9,557,530,0,0,4,240,5,317,2.088057,79.75776499999999,24,31
"172.16.133.53",53778,"96.43.146.22",443,9,557,531,0,0,4,240,5,317,2.088058,79.757868,24,31
"172.16.133.20",62292,"172.16.139.250",5440,12,1142,532,0,0,12,1142,0,0,2.09189,0.006680000000000241,1367664,0
"172.16.133.12",53371,"96.43.146.176",443,806,672643,533,0,0,345,253934,461,418709,2.094986,290.280122,6998,11539
"172.16.133.12",53368,"96.43.146.176",443,561,476621,534,0,0,229,175320,332,301301,2.098966,288.22110499999997,4866,8363
"172.16.133.132",38650,"98.139.134.187",80,15,8483,535,0,0,8,942,7,7541,2.100748,0.1849390000000004,40748,326204
"172.16.133.103",63410,"216.115.222.200",443,6,366,536,0,0,4,246,2,120,2.101963,0.13331500000000007,14762,7200
"71.252.224.198",44248,"172.16.133.25",60425,334,25260,537,0,0,171,14924,163,10336,2.104173,294.916453,404,280
"172.16.133.42",56923,"96.43.146.22",443,55,27300,538,0,0,31,23503,24,3797,2.107071,285.052458,659,106
"172.16.133.41",52424,"74.125.226.26",80,14,870,539,0,0,7,420,7,450,2.108777,197.908427,16,18
"173.194.43.54",443,"172.16.133.29",59842,117,34830,540,0,0,60,8043,57,26787,2.113403,278.046074,231,770
"172.16.133.28",65273,"172.16.139.250",5440,10,1022,541,0,0,10,1022,0,0,2.122783,0.015565000000000051,525281,0
"172.16.133.78",62336,"193.182.8.55",4070,409,405101,542,0,0,111,9501,298,395600,2.134472,280.96397099999996,270,11264
"172.16.133.99",55983,"172.16.139.250",5440,10,1022,543,0,0,10,1022,0,0,2.148917,0.005066000000000237,1613896,0
"172.16.133.78",58388,"216.246.75.64",80,5,306,544,0,0,3,180,2,126,2.150133,32.937045000000005,43,30
"172.16.133.67",64620,"216.115.208.199",443,230,72996,545,0,0,104,40528,126,32468,2.154333,287.596272,1127,903
"172.16.133.78",58391,"216.246.75.64",80,5,306,546,0,0,3,180,2,126,2.160122,32.927901999999996,43,30
"172.16.133.78",58392,"216.246.75.64",80,5,306,547,0,0,3,180,2,126,2.160124,32.938328,43,30
"172.16.133.87",60117,"172.16.139.250",5440,12,1142,548,0,0,12,1142,0,0,2.170619,0.006407999999999969,1425717,0
"172.16.133.116",53127,"172.16.139.250",5440,12,1142,549,0,0,12,1142,0,0,2.188424,0.005273000000000305,1732600,0
"172.16.133.116",53128,"172.16.139.250",5440,10,1022,550,0,0,10,1022,0,0,2.194524,0.005924999999999958,1379915,0
"172.16.133.35",49911,"172.16.139.250",5440,12,1142,551,0,0,12,1142,0,0,2.195707,0.05848299999999984,156216,0
"187.59.124.8",15849,"172.16.133.78",55130,121,10315,552,0,0,59,5592,62,4723,2.200709,297.529116,150,126
"172.16.133.116",53129,"172.16.139.250",5440,10,1022,553,0,0,10,1022,0,0,2.201036,0.005471000000000004,1494425,0
"172.16.133.84",58731,"172.16.139.250",5440,12,1142,554,0,0,12,1142,0,0,2.209183,0.006168000000000173,1481193,0
"172.16.133.78",59014,"192.168.2.10",8014,2,128,555,0,0,2,128,0,0,2.210071,5.996168999999999,170,0
"172.16.133.103",63411,"66.151.158.187",443,6,366,556,0,0,4,246,2,120,2.212857,0.19033899999999981,10339,5043
"172.16.133.57",60590,"96.43.146.48",443,34,13584,557,0,0,19,1882,15,11702,2.217294,0.2908750000000002,51761,321842
"172.16.133.103",63412,"216.219.112.250",443,6,366,558,0,0,4,246,2,120,2.219787,0.22419399999999978,8778,4282
"172.16.133.57",59175,"184.73.181.74",8080,1437,549278,559,0,0,733,499574,704,49704,2.233286,272.397413,14671,1459
"172.16.133.33",53878,"96.43.146.176",443,9,557,560,0,0,4,240,5,317,2.23468,74.887592,25,33
"172.16.133.44",64675,"216.52.242.80",80,115,104986,561,0,0,41,15301,74,89685,2.242262,275.766366,443,2601
"172.16.133.132",50420,"76.13.6.174",80,10,1994,562,0,0,5,717,5,1277,2.249545,0.19121900000000025,29997,53425
"172.16.133.48",60316,"96.43.146.22",443,18,4085,563,0,0,10,3171,8,914,2.2572229999999998,24.006995,1056,304
"172.16.133.49",55706,"172.16.139.250",5440,10,1022,564,0,0,10,1022,0,0,2.287831,0.005703999999999709,1433380,0
"172.16.133.132",54635,"98.139.161.29",80,9,1428,565,0,0,5,715,4,713,2.311319,0.12358799999999981,46282,46153
"216.219.115.17",443,"172.16.133.99",51681,119,15276,566,0,0,64,8991,55,6285,2.318574,123.122426,584,408
"216.219.115.17",443,"172.16.133.67",51312,120,16070,567,0,0,66,9302,54,6768,2.319313,123.126722,604,439
"216.219.115.17",443,"172.16.133.39",62814,133,18011,568,0,0,70,9014,63,8997,2.31944,123.121701,585,584
"172.16.133.95",56884,"172.16.139.250",5440,10,1022,569,0,0,10,1022,0,0,2.322493,0.005557000000000034,1471297,0
"216.219.115.54",443,"172.16.133.39",62816,108,12990,570,0,0,56,6645,52,6345,2.322654,123.159679,431,412
"216.219.115.54",443,"172.16.133.67",51314,104,11825,571,0,0,55,6123,49,5702,2.323786,123.158823,397,370
"67.217.64.65",443,"172.16.133.49",54981,245,30273,572,0,0,128,16497,117,13776,2.324074,296.04367,445,372
"216.219.115.54",443,"172.16.133.99",51684,103,11765,573,0,0,55,6123,48,5642,2.324237,123.11703200000001,397,366
"67.217.64.49",443,"172.16.133.207",55647,218,24821,574,0,0,114,12501,104,12320,2.326959,294.47704200000004,339,334
"172.16.133.132",44325,"98.138.19.88",80,10,1681,575,0,0,5,733,5,948,2.327925,0.1933919999999998,30321,39215
"67.217.64.99",443,"172.16.133.36",64953,17862,16269753,576,0,0,6119,427600,11743,15842153,2.329068,297.652463,11492,425789
"67.217.64.99",443,"172.16.133.26",53037,16054,15278367,577,0,0,11549,14997326,4505,281041,2.329252,297.641629,403097,7553
"67.217.64.64",443,"172.16.133.49",54983,225,25475,578,0,0,116,12843,109,12632,2.332412,296.035255,347,341
"172.16.133.39",64173,"74.122.143.12",80,46,26313,579,0,0,21,16224,25,10089,2.336518,257.86251899999996,503,313
"172.16.133.92",57612,"216.219.115.250",443,6,366,580,0,0,4,246,2,120,2.350004,0.0591339999999998,33280,16234
"172.16.133.92",57613,"172.16.139.250",5440,10,1022,581,0,0,10,1022,0,0,2.350187,0.015193000000000012,538142,0
"172.16.133.36",65072,"216.115.219.126",443,6,378,582,0,0,4,258,2,120,2.353876,0.4862829999999998,4244,1974
"172.16.133.92",57614,"67.217.66.244",443,6,366,583,0,0,4,246,2,120,2.353937,0.06583399999999973,29893,14582
"172.16.133.67",51811,"23.33.47.100",443,2896,3301216,584,0,0,679,74313,2217,3226903,2.356957,297.588671,1997,86748
"172.16.133.50",50691,"216.137.33.57",443,21,7756,585,0,0,10,986,11,6770,2.35962,33.900938000000004,232,1597
"172.16.133.50",50692,"216.137.33.57",443,19,7386,586,0,0,9,920,10,6466,2.359932,33.90178,217,1525
"172.16.133.50",50693,"216.137.33.57",443,19,7386,587,0,0,9,920,10,6466,2.360222,33.90532,217,1525
"172.16.133.29",60818,"172.16.139.250",5440,10,1022,588,0,0,10,1022,0,0,2.36939,0.006062000000000012,1348729,0
"172.16.133.44",64676,"172.16.139.250",5440,12,1142,589,0,0,12,1142,0,0,2.37596,0.01539899999999994,593285,0
"172.16.133.207",55874,"172.16.139.250",5440,10,1022,590,0,0,10,1022,0,0,2.401096,0.004990999999999968,"",""
"172.16.133.83",57023,"172.16.139.250",5440,12,1142,591,0,0,12,1142,0,0,2.409649,0.005041999999999991,1811979,0
"204.232.200.90",80,"172.16.133.63",53748,4,240,592,0,0,2,120,2,120,2.412016,5.364788000000001,178,178
"172.16.133.132",52348,"98.139.240.23",80,9,1654,593,0,0,5,1036,4,618,2.422999,0.11113700000000026,74574,44485
"172.16.133.92",57615,"68.64.30.250",443,6,366,594,0,0,4,246,2,120,2.42324,0.10472999999999999,18791,9166
"172.16.133.73",60505,"72.21.195.34",443,30,10475,595,0,0,14,1805,16,8670,2.42357,270.462652,53,256
"172.16.133.93",60599,"172.16.139.250",5440,12,1142,596,0,0,12,1142,0,0,2.427023,0.014667999999999903,622852,0
"216.115.208.199",443,"172.16.133.49",54972,155,34694,597,0,0,85,18468,70,16226,2.433926,291.266252,507,445
"172.16.133.92",57616,"68.64.13.250",443,6,366,598,0,0,4,246,2,120,2.434143,0.11492799999999992,17123,8353
"172.16.133.11",55081,"172.16.139.250",5440,10,1022,599,0,0,10,1022,0,0,2.442481,0.005724000000000284,1428371,0
"172.16.133.103",63413,"202.173.24.200",443,6,366,600,0,0,4,246,2,120,2.443003,0.48338199999999976,4071,1986
"172.16.133.55",57519,"172.16.139.250",5440,10,1022,601,0,0,10,1022,0,0,2.446579,0.005657000000000245,1445289,0
"172.16.133.73",60506,"172.16.139.250",5440,10,1022,602,0,0,10,1022,0,0,2.471631,0.005989000000000022,1365169,0
"172.16.133.53",54039,"172.16.139.250",5440,12,1142,603,0,0,12,1142,0,0,2.474177,0.016145999999999994,565836,0
"172.16.133.21",53113,"172.16.139.250",5440,10,1022,604,0,0,10,1022,0,0,2.475847,0.017850000000000144,458039,0
"172.16.133.30",62551,"172.16.139.250",5440,10,1022,605,0,0,10,1022,0,0,2.479021,0.00548599999999988,1490339,0
"172.16.133.25",63344,"172.16.139.250",5440,10,1022,606,0,0,10,1022,0,0,2.488358,0.009193999999999924,889275,0
"172.16.133.34",50379,"172.16.139.250",5440,10,1022,607,0,0,10,1022,0,0,2.49643,0.006018000000000079,1358590,0
"172.16.133.97",59310,"172.16.139.250",5440,10,1022,608,0,0,10,1022,0,0,2.507127,0.00550000000000006,1486545,0
"172.16.133.93",49509,"96.43.146.48",443,27,8175,609,0,0,15,5010,12,3165,2.520539,240.375349,166,105
"172.16.133.66",49747,"172.16.139.250",5500,20,1740,610,0,0,20,1740,0,0,2.537133,240.196252,57,0
"172.16.133.39",64202,"23.46.17.231",80,13,810,611,0,0,7,420,6,390,2.538456,215.356641,15,14
"172.16.133.39",64201,"23.46.17.231",80,13,810,612,0,0,7,420,6,390,2.539403,215.35599100000002,15,14
"157.56.237.150",443,"172.16.133.30",56975,135,32097,613,0,0,87,29217,48,2880,2.541548,240.269454,972,95
"172.16.133.132",38655,"98.139.134.187",80,15,8483,614,0,0,8,942,7,7541,2.559328,0.16207200000000022,46497,372229
"172.16.133.78",58398,"23.67.242.42",80,5,306,615,0,0,3,180,2,126,2.570153,32.494881,44,31
"172.16.133.33",57819,"172.16.139.250",5440,10,1022,616,0,0,10,1022,0,0,2.583754,0.011798999999999893,692940,0
"172.16.133.20",55134,"173.194.68.125",5222,25,2383,617,0,0,13,1632,12,751,2.591986,270.039542,48,22
"172.16.133.68",60659,"172.16.139.250",5440,12,1142,618,0,0,12,1142,0,0,2.612792,0.015749000000000457,580100,0
"172.16.133.67",55896,"68.64.13.250",443,6,366,619,0,0,4,246,2,120,2.623601,0.10839100000000013,18156,8856
"172.16.133.67",55897,"68.64.30.250",443,6,366,620,0,0,4,246,2,120,2.623708,0.10083900000000012,19516,9520
"172.16.133.67",55898,"67.217.66.244",443,6,366,621,0,0,4,246,2,120,2.624696,0.06726999999999972,29255,14270
"172.16.133.67",55899,"216.219.115.250",443,6,366,622,0,0,4,246,2,120,2.624698,0.06631799999999988,29675,14475
"172.16.133.12",59650,"172.16.139.250",5440,12,1142,623,0,0,12,1142,0,0,2.626253,0.006659999999999666,1371771,0
"172.16.133.63",53816,"172.16.139.250",5440,10,1022,624,0,0,10,1022,0,0,2.634638,0.01547300000000007,528404,0
"76.29.54.243",10009,"172.16.133.78",49259,153,12314,625,0,0,77,6767,76,5547,2.6364330000000002,271.652892,199,163
"172.16.133.78",58385,"184.50.240.134",80,5,306,626,0,0,3,180,2,126,2.648145,32.416887,44,31
"172.16.133.66",53789,"172.16.139.250",5440,12,1142,627,0,0,12,1142,0,0,2.651915,0.0062269999999999825,1467159,0
"172.16.133.82",61262,"172.16.139.250",5440,12,1142,628,0,0,12,1142,0,0,2.664135,0.022944999999999993,398169,0
"172.16.133.37",60543,"172.16.139.250",5440,10,1022,629,0,0,10,1022,0,0,2.678234,0.016141000000000183,506536,0
"172.16.133.132",50425,"76.13.6.174",80,9,1928,630,0,0,5,717,4,1211,2.6792059999999998,0.0984860000000003,58241,98369
"172.16.133.24",55751,"173.194.43.40",443,111,43359,631,0,0,56,29663,55,13696,2.6881690000000003,282.782813,839,387
"172.16.133.41",52150,"173.194.43.59",443,15,1014,632,0,0,7,420,8,594,2.6978109999999997,195.022436,17,24
"172.16.133.44",64677,"208.111.161.254",80,110,97820,633,0,0,40,4444,70,93376,2.702906,37.710213,942,19809
"172.16.133.44",64678,"208.111.161.254",80,135,122604,634,0,0,50,5321,85,117283,2.703137,37.709051,1128,24881
"70.42.13.101",443,"172.16.133.109",53893,3,180,635,0,0,2,120,1,60,2.722403,0.024955000000000283,38469,19234
"172.16.133.37",55425,"172.16.139.250",5500,10,1708,636,0,0,10,1708,0,0,2.7297029999999998,0.22143900000000016,61705,0
"172.16.133.207",55645,"67.217.64.54",443,230,25892,637,0,0,113,12878,117,13014,2.7310090000000002,296.79270099999997,347,350
"172.16.133.78",58419,"208.71.123.129",443,5,300,638,0,0,3,180,2,120,2.748152,36.667247,39,26
"172.16.133.78",58418,"208.71.123.129",443,5,300,639,0,0,3,180,2,120,2.748153,36.665724999999995,39,26
"172.16.133.78",58427,"206.188.4.9",443,5,300,640,0,0,3,180,2,120,2.751096,36.658851000000006,39,26
"172.16.133.78",58428,"206.188.4.9",443,5,300,641,0,0,3,180,2,120,2.751098,36.658848,39,26
"172.16.133.63",60815,"157.56.232.214",443,10,775,642,0,0,5,475,5,300,2.755543,240.02132,15,9
"172.16.133.132",54640,"98.139.161.29",80,9,1428,643,0,0,5,715,4,713,2.7648960000000002,0.11538399999999971,49573,49434
"172.16.133.42",57946,"172.16.139.250",5447,10,1390,644,0,0,10,1390,0,0,2.770264,240.07102700000002,46,0
"172.16.133.132",44330,"98.138.19.88",80,10,1681,645,0,0,5,733,5,948,2.781768,0.17742099999999983,33051,42745
"172.16.133.132",52353,"98.139.240.23",80,9,1654,646,0,0,5,1036,4,618,2.791185,0.10843300000000022,76434,45594
"193.182.8.75",4070,"172.16.133.121",54656,50,13835,647,0,0,27,12264,23,1571,2.792747,289.75942799999996,338,43
"172.16.133.78",49385,"172.16.139.250",5500,46,16652,648,0,0,46,16652,0,0,2.812842,253.01102300000002,526,0
"172.16.133.23",55028,"67.217.66.244",443,6,366,649,0,0,4,246,2,120,2.814815,0.06093000000000037,32299,15755
"172.16.133.23",55029,"216.219.115.250",443,6,366,650,0,0,4,246,2,120,2.817642,0.04961099999999963,39668,19350
"172.16.133.78",58452,"63.116.244.145",80,11,684,651,0,0,6,360,5,324,2.818088,172.248355,16,15
"172.16.133.78",58453,"63.116.244.145",80,11,684,652,0,0,6,360,5,324,2.8180899999999998,172.249935,16,15
"172.16.133.78",49780,"172.16.139.250",5462,30,1800,653,0,0,30,1800,0,0,2.830062,281.475496,51,0
"172.16.133.78",59018,"172.16.139.250",5440,10,1022,654,0,0,10,1022,0,0,2.83629,0.10010600000000025,81673,0
"172.16.133.78",58456,"63.116.244.145",80,11,684,655,0,0,6,360,5,324,2.838059,172.23001900000003,16,15
"172.16.133.78",58455,"63.116.244.145",80,11,684,656,0,0,6,360,5,324,2.8380609999999997,172.23089399999998,16,15
"172.16.133.78",58454,"63.116.244.145",80,11,684,657,0,0,6,360,5,324,2.838063,172.23089,16,15
"172.16.133.78",58451,"63.116.244.145",80,11,684,658,0,0,6,360,5,324,2.848055,172.22002600000002,16,15
"172.16.133.23",55031,"68.64.30.250",443,6,366,659,0,0,4,246,2,120,2.8688190000000002,0.08967099999999961,21946,10705
"172.16.133.23",55030,"68.64.13.250",443,6,366,660,0,0,4,246,2,120,2.86882,0.10839500000000024,18155,8856
"138.108.7.20",80,"172.16.133.29",60799,1,60,661,0,0,1,60,0,0,2.883784,0,"",""
"172.16.133.67",55900,"172.16.139.250",5440,10,1022,662,0,0,10,1022,0,0,2.8885870000000002,0.06433899999999992,127076,0
"216.115.208.199",443,"172.16.133.93",54031,107,10398,663,0,0,54,5485,53,4913,2.901354,294.835832,148,133
"172.16.133.42",57004,"172.16.139.250",5440,12,1142,664,0,0,12,1142,0,0,2.904611,0.05789199999999983,157811,0
"172.16.133.78",49789,"172.16.139.250",5447,12,1510,665,0,0,12,1510,0,0,2.906838,239.981765,50,0
"172.16.133.56",61343,"172.16.139.250",5440,10,1022,666,0,0,10,1022,0,0,2.912368,0.04820700000000011,169601,0
"172.16.133.36",64862,"132.245.2.22",443,56,26021,667,0,0,25,12962,31,13059,2.925644,32.380993000000004,3202,3226
"172.16.133.132",38660,"98.139.134.187",80,15,8483,668,0,0,8,942,7,7541,2.942112,0.16883400000000037,44635,357321
"172.16.133.71",57510,"132.245.2.22",443,173,72270,669,0,0,88,42339,85,29931,2.94597,182.301384,1857,1313
"172.16.133.24",57403,"96.43.146.48",443,2,120,670,0,0,1,60,1,60,2.949212,8.699999999972619e-05,"",""
"172.16.133.24",57666,"96.43.146.48",443,17,3898,671,0,0,10,2427,7,1471,2.949882,47.552332,408,247
"67.217.64.97",443,"172.16.133.207",55651,113,8563,672,0,0,56,4182,57,4381,2.966865,292.192674,114,119
"172.16.133.41",52660,"172.16.139.250",5440,10,1022,673,0,0,10,1022,0,0,2.967647,0.00587900000000019,1390712,0
"172.16.133.75",50877,"172.16.139.250",5440,10,1022,674,0,0,10,1022,0,0,2.967908,0.009234999999999882,885327,0
"172.16.133.85",52187,"172.16.139.250",5440,10,1022,675,0,0,10,1022,0,0,2.984786,0.015730000000000022,519771,0
"172.16.133.126",61083,"157.56.244.214",443,44,12825,676,0,0,23,11565,21,1260,2.996632,296.251748,312,34
"172.16.133.47",56543,"72.21.195.34",80,18,6164,677,0,0,10,2940,8,3224,3.002658,17.323299,1357,1488
"172.16.133.47",56544,"72.21.195.34",80,26,7814,678,0,0,13,3718,13,4096,3.002659,215.315811,138,152
"96.43.146.22",443,"172.16.133.45",60451,40,19026,679,0,0,17,2832,23,16194,3.005678,279.839217,80,462
"172.16.139.250",1606,"64.74.103.175",80,30,2420,680,0,0,20,1510,10,910,3.01363,270.62693,44,26
"172.16.133.41",65162,"157.56.236.102",443,32,3812,681,0,0,16,2852,16,960,3.013999,270.078668,84,28
"24.210.53.247",51741,"172.16.133.78",58921,84,6414,682,0,0,43,3406,41,3008,3.023105,142.398436,191,168
"172.16.133.47",56545,"184.72.255.145",80,67,40522,683,0,0,34,11705,33,28817,3.029525,81.027243,1155,2845
"172.16.133.47",56546,"184.72.255.145",80,55,28554,684,0,0,27,7842,28,20712,3.029526,18.146408,3457,9131
"172.16.133.43",57703,"172.16.139.250",5440,10,1022,685,0,0,10,1022,0,0,3.039589,0.022965000000000124,356020,0
"207.38.140.238",26845,"172.16.133.25",60406,132,9768,686,0,0,70,5872,62,3896,3.040416,185.965342,252,167
"172.16.133.99",55387,"96.43.146.22",443,5,317,687,0,0,2,120,3,197,3.043583,0.0400879999999999,23947,39313
"172.16.133.13",52979,"172.16.139.250",5440,12,1142,688,0,0,12,1142,0,0,3.056638,0.0111340000000002,820549,0
"172.16.133.25",49275,"172.16.139.250",5462,188,11280,689,0,0,188,11280,0,0,3.0566969999999998,271.24138400000004,332,0
"172.16.133.28",49244,"172.16.139.250",5462,222,13540,690,0,0,222,13540,0,0,3.056895,291.353943,371,0
"172.16.133.66",50006,"172.16.139.250",5462,20,1200,691,0,0,20,1200,0,0,3.058093,271.240931,35,0
"172.16.133.87",65485,"172.16.139.250",5462,20,1200,692,0,0,20,1200,0,0,3.058755,271.244194,35,0
"172.16.133.21",51652,"172.16.139.250",5462,94,5640,693,0,0,94,5640,0,0,3.058924,295.597086,152,0
"172.16.133.23",56742,"172.16.139.250",5462,136,8292,694,0,0,136,8292,0,0,3.059312,271.240317,244,0
"172.16.133.163",1322,"172.16.139.250",5462,20,1200,695,0,0,20,1200,0,0,3.060112,271.240496,35,0
"172.16.133.128",55234,"172.16.139.250",5462,48,2924,696,0,0,48,2924,0,0,3.060254,271.241213,86,0
"172.16.133.34",62944,"172.16.139.250",5462,56,3448,697,0,0,56,3448,0,0,3.060345,292.564228,94,0
"172.16.133.45",61042,"172.16.139.250",5462,86,5248,698,0,0,86,5248,0,0,3.060805,271.239919,154,0
"172.16.133.13",54236,"172.16.139.250",5462,20,1200,699,0,0,20,1200,0,0,3.060978,271.239748,35,0
"172.16.133.60",55334,"172.16.139.250",5462,20,1200,700,0,0,20,1200,0,0,3.061039,271.239797,35,0
"172.16.133.84",49333,"172.16.139.250",5462,20,1200,701,0,0,20,1200,0,0,3.06118,271.246868,35,0
"172.16.133.116",58990,"172.16.139.250",5462,106,6472,702,0,0,106,6472,0,0,3.061181,271.24845200000004,190,0
"68.9.194.237",54094,"172.16.133.78",56478,237,51951,703,0,0,125,43934,112,8017,3.06125,292.440423,1201,219
"172.16.133.132",50430,"76.13.6.174",80,9,1926,704,0,0,5,717,4,1209,3.064088,0.11095100000000002,51698,87173
"172.16.133.132",54645,"98.139.161.29",80,9,1428,705,0,0,5,715,4,713,3.069722,0.17636399999999997,32432,32342
"172.16.133.20",62293,"172.16.139.250",5440,12,1142,706,0,0,12,1142,0,0,3.105617,0.0050360000000000404,1814138,0
"172.16.133.15",53995,"157.56.240.102",443,53,7077,707,0,0,27,5517,26,1560,3.107986,269.91271800000004,163,46
"172.16.133.39",64203,"23.67.242.64",80,8,492,708,0,0,4,240,4,252,3.109559,72.705957,26,27
"172.16.133.73",60219,"173.194.43.30",443,34,4313,709,0,0,14,2661,20,1652,3.112095,282.481318,75,46
"216.115.208.199",443,"172.16.133.37",60405,176,46644,710,0,0,96,21598,80,25046,3.114996,294.19615999999996,587,681
"172.16.133.63",53330,"108.168.241.135",80,240,99215,711,0,0,156,84700,84,14515,3.132625,295.30222299999997,2294,393
"172.16.133.28",65274,"172.16.139.250",5440,10,1022,712,0,0,10,1022,0,0,3.136832,0.015511000000000053,527109,0
"172.16.133.132",44335,"98.138.19.88",80,10,1681,713,0,0,5,733,5,948,3.137056,0.26821800000000007,21862,28275
"172.16.133.73",60507,"174.129.16.74",443,19,3532,714,0,0,10,1762,9,1770,3.150778,9.308065,1514,1521
"172.16.133.132",52358,"98.139.240.23",80,9,1653,715,0,0,5,1035,4,618,3.159591,0.21557100000000018,38409,22934
"172.16.133.99",55984,"172.16.139.250",5440,10,1022,716,0,0,10,1022,0,0,3.162643,0.014768000000000114,553629,0
"172.16.133.95",49348,"172.16.139.250",5447,10,1400,717,0,0,10,1400,0,0,3.178123,240.008493,46,0
"172.16.133.87",60118,"172.16.139.250",5440,10,1022,718,0,0,10,1022,0,0,3.1837239999999998,0.005554000000000059,1472092,0
"172.16.133.35",49912,"172.16.139.250",5440,12,1142,719,0,0,12,1142,0,0,3.198402,0.022967999999999655,397770,0
"172.16.133.92",55692,"216.115.217.201",443,218,24849,720,0,0,103,12177,115,12672,3.199556,296.16838600000005,328,342
"172.16.133.92",55694,"216.115.217.210",443,217,24789,721,0,0,102,12117,115,12672,3.199658,296.171843,327,342
"172.16.133.116",53130,"172.16.139.250",5440,10,1022,722,0,0,10,1022,0,0,3.201511,0.019411999999999985,421182,0
"172.16.133.116",53131,"172.16.139.250",5440,10,1022,723,0,0,10,1022,0,0,3.221859,0.014935000000000365,547438,0
"172.16.133.84",58732,"172.16.139.250",5440,10,1022,724,0,0,10,1022,0,0,3.223194,0.006098000000000159,1340767,0
"172.16.133.116",53132,"172.16.139.250",5440,10,1022,725,0,0,10,1022,0,0,3.237899,0.014963999999999977,546377,0
"199.16.156.8",80,"172.16.133.207",55844,4,240,726,0,0,2,120,2,120,3.246219,1.7658060000000004,543,543
"96.43.146.22",443,"172.16.133.54",64237,30,17196,727,0,0,12,2532,18,14664,3.246398,279.794634,72,419
"173.194.68.189",443,"172.16.133.25",49412,133,35875,728,0,0,74,6927,59,28948,3.255875,285.157509,194,812
"172.16.133.49",55707,"172.16.139.250",5440,10,1022,729,0,0,10,1022,0,0,3.30099,0.0061709999999997045,1324906,0
"172.16.133.93",60405,"216.137.33.157",80,8,492,730,0,0,4,240,4,252,3.303125,84.221491,22,23
"172.16.133.92",55717,"68.64.28.20",443,114,8669,731,0,0,58,4503,56,4166,3.320858,290.23643000000004,124,114
"172.16.133.41",52427,"74.125.226.89",80,15,3298,732,0,0,8,2442,7,856,3.322749,174.43253900000002,111,39
"68.49.1.159",44534,"172.16.133.78",55436,133,13850,733,0,0,67,7043,66,6807,3.336251,290.708477,193,187
"172.16.133.95",56885,"172.16.139.250",5440,10,1022,734,0,0,10,1022,0,0,3.3365270000000002,0.01570799999999961,520499,0
"74.205.17.67",80,"172.16.133.93",60581,4,240,735,0,0,2,120,2,120,3.337283,4.280015,224,224
"74.205.17.67",80,"172.16.133.93",60582,4,240,736,0,0,2,120,2,120,3.3373530000000002,4.279942999999999,224,224
"157.56.237.150",443,"172.16.133.30",59917,12,990,737,0,0,6,630,6,360,3.33954,278.753877,18,10
"172.16.133.92",57617,"172.16.139.250",5440,10,1022,738,0,0,10,1022,0,0,3.365188,0.016086000000000045,508268,0
"172.16.133.73",60508,"23.13.208.81",443,20,4442,739,0,0,10,1618,10,2824,3.377641,59.074371000000006,219,382
"172.16.133.29",60819,"172.16.139.250",5440,10,1022,740,0,0,10,1022,0,0,3.382683,0.005376000000000047,1520833,0
"172.16.133.44",64679,"172.16.139.250",5440,10,1022,741,0,0,10,1022,0,0,3.390123,0.005408000000000079,1511834,0
"172.16.133.132",38665,"98.139.134.187",80,15,8483,742,0,0,8,942,7,7541,3.3927680000000002,0.14127199999999984,53343,427034
"172.16.133.78",50685,"198.82.107.217",44419,141,11830,743,0,0,70,5266,71,6564,3.394271,286.623303,146,183
"172.16.133.78",49709,"68.198.245.116",26725,204,33306,744,0,0,95,6966,109,26340,3.394272,292.337478,190,720
"172.16.133.78",55611,"96.3.161.187",44369,104,8886,745,0,0,55,4244,49,4642,3.394329,279.85410399999995,121,132
"172.16.133.78",56344,"96.243.227.77",12365,266,54625,746,0,0,128,8857,138,45768,3.394384,285.709189,248,1281
"172.16.133.78",49613,"71.231.31.96",46619,192,32885,747,0,0,93,6718,99,26167,3.3943849999999998,276.394967,194,757
"172.16.133.78",57678,"198.82.205.114",23618,190,15703,748,0,0,95,6885,95,8818,3.394496,296.464352,185,237
"172.16.133.78",55437,"173.61.73.122",11648,348,60691,749,0,0,163,11366,185,49325,3.394552,295.08626200000003,308,1337
"172.16.133.78",50616,"108.32.188.171",15218,88,6641,750,0,0,49,3843,39,2798,3.394606,270.944428,113,82
"172.16.133.78",60699,"98.216.191.85",44774,163,46381,751,0,0,77,5758,86,40623,3.394608,294.554593,156,1103
"172.16.133.78",64765,"108.13.146.190",21031,166,30962,752,0,0,80,6159,86,24803,3.394659,293.03947700000003,168,677
"172.16.133.78",55590,"65.19.76.135",27186,182,65081,753,0,0,98,57598,84,7483,3.394719,270.846948,1701,221
"172.16.133.78",58234,"165.124.181.58",40169,248,52683,754,0,0,116,8082,132,44601,3.394773,296.29206600000003,218,1204
"172.16.133.78",51583,"71.56.69.159",64277,125,26305,755,0,0,61,4594,64,21711,3.394827,270.94965399999995,135,641
"172.16.133.78",54271,"50.149.21.29",56409,226,18082,756,0,0,110,7593,116,10489,3.394828,294.391933,206,285
"172.16.133.78",54670,"209.6.55.79",64921,152,29145,757,0,0,70,5198,82,23947,3.394885,270.694698,153,707
"172.16.133.78",56347,"24.238.106.59",35983,51,3642,758,0,0,25,1892,26,1750,3.394936,142.98542799999998,105,97
"172.16.133.78",58249,"35.24.119.169",55765,168,46824,759,0,0,76,5730,92,41094,3.394937,296.164876,154,1110
"172.16.133.78",53947,"173.22.42.240",55220,45,3267,760,0,0,23,1772,22,1495,3.394991,143.021534,99,83
"172.16.133.78",59040,"76.92.112.222",34755,110,9034,761,0,0,57,4408,53,4626,3.395048,277.44335500000005,127,133
"172.16.133.78",58840,"74.101.38.221",12868,265,20290,762,0,0,131,8815,134,11475,3.395255,203.552501,346,450
"172.16.133.78",58922,"67.171.115.41",16349,138,11365,763,0,0,68,5067,70,6298,3.395264,295.575585,137,170
"172.16.133.78",58842,"97.104.102.121",38017,59,5397,764,0,0,35,3573,24,1824,3.395305,269.316009,106,54
"172.16.133.78",58852,"69.120.250.50",11642,214,17360,765,0,0,103,7477,111,9883,3.395406,290.85863600000005,205,271
"172.16.133.78",58862,"71.126.171.148",23164,147,45051,766,0,0,72,5573,75,39478,3.395407,295.083386,151,1070
"172.16.133.78",58971,"173.59.1.130",47111,184,15110,767,0,0,88,6520,96,8590,3.395464,296.16040399999997,176,232
"172.16.133.207",55875,"172.16.139.250",5440,12,1142,768,0,0,12,1142,0,0,3.415228,0.016817000000000082,543259,0
"172.16.128.169",8014,"172.16.133.81",59022,3,618,769,0,0,3,618,0,0,3.42191,53.0073,93,0
"172.16.133.83",57024,"172.16.139.250",5440,12,1142,770,0,0,12,1142,0,0,3.422542,0.004882000000000275,"",""
"172.16.133.93",60600,"172.16.139.250",5440,10,1022,771,0,0,10,1022,0,0,3.439916,0.014889999999999848,549093,0
"172.16.133.11",55082,"172.16.139.250",5440,10,1022,772,0,0,10,1022,0,0,3.456941,0.005539000000000183,1476078,0
"172.16.133.55",57520,"172.16.139.250",5440,12,1142,773,0,0,12,1142,0,0,3.460774,0.007144000000000261,1278835,0
"172.16.133.78",59019,"172.16.139.250",5440,10,1022,774,0,0,10,1022,0,0,3.4613329999999998,0.018022000000000205,453667,0
"97.89.18.110",59737,"172.16.133.25",63052,147,11385,775,0,0,77,6860,70,4525,3.482194,219.273424,250,165
"172.16.133.73",60509,"172.16.139.250",5440,10,1022,776,0,0,10,1022,0,0,3.484575,0.005587999999999926,1463135,0
"172.16.133.53",54040,"172.16.139.250",5440,10,1022,777,0,0,10,1022,0,0,3.4869339999999998,0.0071910000000001695,1136976,0
"172.16.133.21",53114,"172.16.139.250",5440,12,1142,778,0,0,12,1142,0,0,3.491029,0.008391999999999733,1088655,0
"172.16.133.30",62552,"172.16.139.250",5440,10,1022,779,0,0,10,1022,0,0,3.494059,0.011038000000000103,740713,0
"172.16.133.78",58985,"96.43.146.176",443,59,41372,780,0,0,25,13622,34,27750,3.496808,282.642223,385,785
"172.16.133.25",63345,"172.16.139.250",5440,10,1022,781,0,0,10,1022,0,0,3.502771,0.00618300000000005,1322335,0
"172.16.133.78",55648,"96.43.146.48",443,2,120,782,0,0,1,60,1,60,3.503951,0.00010400000000032605,"",""
"172.16.133.110",45712,"74.125.226.222",443,7,478,783,0,0,4,272,3,206,3.504644,0.04387400000000019,49596,37562
"172.16.133.78",59020,"96.43.146.48",443,16,3907,784,0,0,9,2285,7,1622,3.504762,0.679395,26906,19099
"172.16.133.73",60221,"173.194.43.57",443,37,3470,785,0,0,17,1726,20,1744,3.5096600000000002,282.457947,48,49
"96.43.146.178",443,"172.16.133.45",61310,173,134885,786,0,0,100,86712,73,48173,3.510138,254.144624,2729,1516
"172.16.133.132",50435,"76.13.6.174",80,9,1928,787,0,0,5,717,4,1211,3.5103429999999998,0.10068400000000022,56970,96221
"172.16.133.34",50380,"172.16.139.250",5440,10,1022,788,0,0,10,1022,0,0,3.510844,0.005085999999999924,1607550,0
"172.16.133.73",60510,"64.208.138.118",443,26,13722,789,0,0,12,5777,14,7945,3.511521,18.942974,2439,3355
"172.16.133.78",58986,"96.43.146.176",443,277,254782,790,0,0,89,20783,188,233999,3.518815,282.923584,587,6616
"172.16.133.97",59311,"172.16.139.250",5440,10,1022,791,0,0,10,1022,0,0,3.521228,0.005514999999999937,1482502,0
"172.16.133.85",64606,"96.43.146.22",443,40,19115,792,0,0,23,16134,17,2981,3.534846,260.254595,495,91
"172.16.133.50",50694,"74.125.226.228",443,33,3872,793,0,0,18,2298,15,1574,3.540948,240.15204699999998,76,52
"172.16.133.110",45915,"174.129.20.55",443,6,412,794,0,0,4,272,2,140,3.550606,0.0565629999999997,38470,19800
"172.16.133.73",60223,"74.125.226.217",443,37,3613,795,0,0,17,1930,20,1683,3.550741,282.48670599999997,54,47
"172.16.133.41",52661,"199.102.234.31",80,39,30462,796,0,0,14,2720,25,27742,3.553014,0.34872000000000014,62399,636430
"172.16.133.41",52662,"199.102.234.31",80,17,7649,797,0,0,8,2461,9,5188,3.553173,0.9967709999999999,19751,41638
"172.16.133.132",54650,"98.139.161.29",80,9,1428,798,0,0,5,715,4,713,3.569108,0.11663900000000016,49040,48903
"172.16.133.37",60544,"74.125.226.224",443,36,6369,799,0,0,18,2161,18,4208,3.571074,240.12181199999998,71,140
"172.16.133.39",64205,"68.142.253.40",80,15,900,800,0,0,8,480,7,420,3.582472,225.212549,17,14
"172.16.133.20",62294,"216.219.115.250",443,6,366,801,0,0,4,246,2,120,3.58725,0.04909600000000003,40084,19553
"172.16.133.132",44340,"98.138.19.88",80,10,1681,802,0,0,5,733,5,948,3.587865,0.20521900000000004,28574,36955
"172.16.133.33",57820,"172.16.139.250",5440,12,1142,803,0,0,12,1142,0,0,3.597587,0.016606000000000343,550162,0
"172.16.133.132",52363,"98.139.240.23",80,9,1653,804,0,0,5,1035,4,618,3.599489,0.10874099999999975,76144,45465
"172.16.133.41",52445,"207.171.14.112",80,15,900,805,0,0,8,480,7,420,3.6068249999999997,256.470864,14,13
"172.16.133.20",62295,"67.217.66.244",443,6,366,806,0,0,4,246,2,120,3.610313,0.04978199999999999,39532,19284
"172.16.133.68",60660,"172.16.139.250",5440,10,1022,807,0,0,10,1022,0,0,3.6266819999999997,0.005781000000000258,1414288,0
"172.16.133.12",59651,"172.16.139.250",5440,12,1142,808,0,0,12,1142,0,0,3.641089,0.006521000000000221,1401012,0
"172.16.133.11",54697,"209.34.90.75",443,11,728,809,0,0,3,180,8,548,3.641612,43.573716999999995,33,100
"172.16.133.50",50695,"74.125.226.222",443,46,9521,810,0,0,24,7441,22,2080,3.643477,293.137101,203,56
"172.16.133.63",53817,"172.16.139.250",5440,10,1022,811,0,0,10,1022,0,0,3.6482229999999998,0.005469000000000168,1494971,0
"172.16.133.20",62296,"68.64.30.250",443,6,366,812,0,0,4,246,2,120,3.662299,0.09093600000000013,21641,10556
"172.16.133.66",53790,"172.16.139.250",5440,10,1022,813,0,0,10,1022,0,0,3.66593,0.005602000000000107,1459478,0
"172.16.133.99",63680,"216.115.208.199",443,210,64946,814,0,0,98,37825,112,27121,3.666892,295.840831,1022,733
"172.16.133.78",59021,"96.43.146.178",443,51,26541,815,0,0,23,9398,28,17143,3.671212,270.7996,277,506
"172.16.133.78",59022,"96.43.146.178",443,34,13612,816,0,0,17,4713,17,8899,3.6715299999999997,270.690177,139,263
"172.16.133.82",61263,"172.16.139.250",5440,12,1142,817,0,0,12,1142,0,0,3.6780239999999997,0.006993000000000471,1306449,0
"172.16.133.37",60499,"23.13.211.100",443,2703,3192297,818,0,0,576,87594,2127,3104703,3.683098,286.78233500000005,2443,86607
"172.16.133.41",52450,"67.69.174.24",80,25,6616,819,0,0,12,4174,13,2442,3.6868309999999997,263.985422,126,74
"172.16.133.20",62297,"68.64.13.250",443,6,366,820,0,0,4,246,2,120,3.692309,0.11208500000000043,17558,8564
"172.16.133.37",60545,"172.16.139.250",5440,10,1022,821,0,0,10,1022,0,0,3.693466,0.00696399999999997,1174037,0
"157.56.236.102",443,"172.16.133.42",55084,40,10632,822,0,0,24,9666,16,966,3.702854,241.29996,320,32
"172.16.133.118",58205,"180.153.30.250",443,6,366,823,0,0,4,246,2,120,3.719159,0.701565,2805,1368
"96.43.146.178",443,"172.16.133.45",61288,160,119524,824,0,0,91,73342,69,46182,3.719967,260.048996,2256,1420
"172.16.133.50",50696,"64.56.203.22",443,18,3881,825,0,0,10,2799,8,1082,3.723488,62.626063,357,138
"75.126.109.194",80,"172.16.133.48",60096,44,2644,826,0,0,28,1680,16,964,3.732469,117.194654,114,65
"172.16.133.103",63204,"96.43.146.48",443,24,6042,827,0,0,13,4766,11,1276,3.73253,270.783934,140,37
"172.16.133.41",52439,"54.243.70.224",80,6,366,828,0,0,3,180,3,186,3.736795,16.271152,88,91
"68.64.28.20",443,"172.16.133.37",60490,90,6877,829,0,0,45,3526,45,3351,3.744516,200.632176,140,133
"172.16.133.50",50697,"204.232.250.57",443,16,4523,830,0,0,9,3543,7,980,3.752709,12.581358999999999,2252,623
"172.16.133.30",49245,"172.16.139.250",5500,168,82496,831,0,0,168,82496,0,0,3.756406,240.200649,2747,0
"172.16.133.41",52376,"23.60.230.152",80,15,936,832,0,0,8,480,7,456,3.787794,256.235725,14,14
"172.16.133.132",38670,"98.139.134.187",80,15,8483,833,0,0,8,942,7,7541,3.79638,0.14871100000000004,50675,405672
"172.16.133.16",59316,"208.85.40.20",80,6,360,834,0,0,3,180,3,180,3.800214,29.709456999999997,48,48
"172.16.133.92",49464,"96.43.146.22",443,35,15707,835,0,0,20,13280,15,2427,3.817399,285.660486,371,67
"172.16.133.78",58445,"63.116.244.160",80,7,432,836,0,0,4,240,3,192,3.838134,81.260028,23,18
"172.16.133.112",51577,"174.129.24.14",8080,655,303444,837,0,0,332,279834,323,23610,3.844868,273.934783,8172,689
"172.16.133.41",52462,"67.69.196.153",80,15,2499,838,0,0,8,1740,7,759,3.84499,270.444504,51,22
"172.16.133.78",59023,"172.16.139.250",5440,12,1142,839,0,0,12,1142,0,0,3.84908,0.006329000000000029,1443513,0
"172.16.133.78",59024,"96.43.146.178",443,33,10860,840,0,0,15,4327,18,6533,3.865576,272.189743,127,192
"172.16.133.76",61548,"96.43.146.48",443,25,8402,841,0,0,15,7186,10,1216,3.87464,270.596909,212,35
"172.16.133.78",58440,"63.116.244.160",80,6,366,842,0,0,4,240,2,126,3.88815,81.210069,23,12
"172.16.133.78",58441,"63.116.244.160",80,6,366,843,0,0,4,240,2,126,3.888152,81.21012999999999,23,12
"172.16.133.67",55901,"172.16.139.250",5440,10,1022,844,0,0,10,1022,0,0,3.903015,0.005380999999999858,1519420,0
"172.16.133.78",58529,"205.188.201.137",80,6,360,845,0,0,4,240,2,120,3.906159,81.193046,23,11
"172.16.133.93",49242,"172.16.139.250",5500,20,1740,846,0,0,20,1740,0,0,3.908277,240.195974,57,0
"172.16.133.41",52663,"23.15.129.86",80,106,78055,847,0,0,46,8437,60,69618,3.912111,126.40345,533,4406
"172.16.133.41",52664,"23.15.129.86",80,557,624889,848,0,0,141,18870,416,606019,3.91223,166.103688,908,29187
"172.16.133.41",52665,"23.15.129.86",80,227,238290,849,0,0,65,7384,162,230906,3.912337,136.09607599999998,434,13573
"172.16.133.41",52666,"23.15.129.86",80,70,52285,850,0,0,30,5204,40,47081,3.912429,126.410245,329,2979
"172.16.133.41",52667,"23.15.129.86",80,40,22322,851,0,0,19,4088,21,18234,3.9125199999999998,106.102655,308,1374
"172.16.133.41",52668,"23.15.129.86",80,124,114329,852,0,0,42,7407,82,106922,3.912611,136.095931,435,6285
"172.16.133.132",50440,"76.13.6.174",80,9,1927,853,0,0,5,717,4,1210,3.916195,0.1235590000000002,46423,78343
"172.16.133.132",54655,"98.139.161.29",80,9,1428,854,0,0,5,715,4,713,3.921906,0.12469200000000047,45873,45744
"172.16.128.169",3601,"172.16.139.250",135,17,1741,855,0,0,10,961,7,780,3.922056,143.61822,53,43
"172.16.133.42",57005,"172.16.139.250",5440,12,1142,856,0,0,12,1142,0,0,3.923886,0.012173000000000211,750513,0
"172.16.133.56",61344,"172.16.139.250",5440,12,1142,857,0,0,12,1142,0,0,3.9250030000000002,0.005105999999999611,1789267,0
"172.16.133.42",54610,"216.115.208.199",443,71,5314,858,0,0,36,2687,35,2627,3.928276,195.06015299999999,110,107
"172.16.133.13",52118,"96.43.146.22",443,35,15746,859,0,0,20,13320,15,2426,3.976071,255.55420800000002,416,75
"172.16.133.120",49166,"50.16.211.32",8080,60,16460,860,0,0,25,12840,35,3620,3.977702,294.62730799999997,348,98
"172.16.133.75",50878,"172.16.139.250",5440,10,1022,861,0,0,10,1022,0,0,3.980513,0.005600999999999967,1459739,0
"172.16.133.41",52669,"172.16.139.250",5440,12,1142,862,0,0,12,1142,0,0,3.981484,0.015978000000000048,571786,0
"172.16.133.132",44345,"98.138.19.88",80,10,1681,863,0,0,5,733,5,948,3.992701,0.18779000000000012,31226,40385
"172.16.133.78",59025,"96.43.146.178",443,19,1542,864,0,0,10,873,9,669,3.995927,270.463938,25,19
"172.16.133.85",52188,"172.16.139.250",5440,10,1022,865,0,0,10,1022,0,0,3.998831,0.01546999999999965,528506,0
"172.16.133.83",51135,"216.115.208.199",443,95,7126,866,0,0,48,3593,47,3533,4.000238,277.02892799999995,103,102
"172.16.133.163",3513,"74.125.226.207",80,3,180,867,0,0,2,120,1,60,4.004242,0.026380000000000514,36391,18195
"172.16.133.163",3512,"74.125.226.207",80,3,180,868,0,0,2,120,1,60,4.004331,0.026637000000000022,36040,18020
"172.16.133.163",3511,"74.125.226.207",80,3,180,869,0,0,2,120,1,60,4.004389,0.026642999999999972,36031,18015
"96.43.146.22",443,"172.16.133.67",49205,43,22060,870,0,0,18,2892,25,19168,4.006443,280.30027,82,547
"172.16.133.45",61299,"173.194.75.106",443,25,2735,871,0,0,12,1461,13,1274,4.028215,240.11176600000002,48,42
"172.16.133.132",52368,"98.139.240.23",80,9,1654,872,0,0,5,1036,4,618,4.02967,0.10901899999999998,76023,45349
"172.16.133.41",52453,"23.60.228.46",80,15,936,873,0,0,8,480,7,456,4.030729,255.990229,15,14
"172.16.133.113",55583,"172.16.139.250",135,8,492,874,0,0,8,492,0,0,4.038288,0.0030860000000005883,"",""
"172.16.133.113",55584,"172.16.139.250",5462,10,696,875,0,0,10,696,0,0,4.042399,0.5046360000000005,11033,0
"172.16.133.43",57704,"172.16.139.250",5440,10,1022,876,0,0,10,1022,0,0,4.054523,0.015697000000000294,520863,0
"172.16.133.114",55214,"96.43.146.22",443,31,19171,877,0,0,18,16652,13,2519,4.069598,242.93473899999998,548,82
"172.16.133.13",52980,"172.16.139.250",5440,10,1022,878,0,0,10,1022,0,0,4.07092,0.00570999999999966,1431873,0
"157.56.237.150",443,"172.16.133.83",63466,88,21138,879,0,0,56,19218,32,1920,4.081454,240.24059699999998,639,63
"172.16.133.45",61303,"67.152.103.227",80,12,10183,880,0,0,2,120,10,10063,4.092624,120.532942,7,667
"172.16.133.45",61311,"67.152.103.227",80,91,88104,881,0,0,27,2031,64,86073,4.099739,22.048251,736,31230
"172.16.133.20",62298,"172.16.139.250",5440,12,1142,882,0,0,12,1142,0,0,4.119542,0.004990999999999524,"",""
"172.16.133.28",65275,"172.16.139.250",5440,12,1142,883,0,0,12,1142,0,0,4.15079,0.015375999999999834,594172,0
"23.20.26.196",443,"172.16.133.24",57652,5,331,884,0,0,3,211,2,120,4.157438,1.768917,954,542
"172.16.133.41",52454,"67.69.174.113",80,15,936,885,0,0,8,480,7,456,4.157769,255.86491700000002,15,14
"172.16.133.99",55985,"172.16.139.250",5440,12,1142,886,0,0,12,1142,0,0,4.176718,0.014664999999999928,622979,0
"68.64.28.20",443,"172.16.133.85",51704,85,6562,887,0,0,43,3375,42,3187,4.183979,193.923978,139,131
"172.16.133.103",63414,"216.115.222.200",443,6,366,888,0,0,4,246,2,120,4.18398,0.09069600000000033,21698,10584
"172.16.133.132",38675,"98.139.134.187",80,15,8483,889,0,0,8,942,7,7541,4.187318,0.19511699999999976,38622,309188
"172.16.133.22",53973,"184.72.243.110",80,9,882,890,0,0,5,494,4,388,4.190711,0.08315200000000011,47527,37329
"172.16.133.87",60119,"172.16.139.250",5440,10,1022,891,0,0,10,1022,0,0,4.198766,0.005488999999999855,1489524,0
"172.16.133.93",60419,"23.21.114.119",80,6,366,892,0,0,3,180,3,186,4.19918,23.321013,61,63
"172.16.133.35",49913,"172.16.139.250",5440,12,1142,893,0,0,12,1142,0,0,4.213813,0.009513000000000105,960370,0
"172.16.133.42",57006,"198.145.13.24",80,10,1469,894,0,0,5,769,5,700,4.214148,0.2963849999999999,20756,18894
"172.16.133.42",57007,"198.145.13.24",80,10,1470,895,0,0,5,770,5,700,4.215561,0.3976369999999996,15491,14083
"172.16.133.42",57008,"198.145.13.24",80,10,1469,896,0,0,5,769,5,700,4.215563,0.3891859999999996,15807,14389
"172.16.133.116",53133,"172.16.139.250",5440,10,1022,897,0,0,10,1022,0,0,4.216462,0.008716999999999864,937937,0
"172.16.133.116",53134,"172.16.139.250",5440,10,1022,898,0,0,10,1022,0,0,4.226128,0.0054109999999996106,1510996,0
"172.16.133.56",56507,"67.69.174.18",80,20,3244,899,0,0,10,1508,10,1736,4.228112,264.954551,45,52
"172.16.133.116",53135,"172.16.139.250",5440,10,1022,900,0,0,10,1022,0,0,4.232488,0.005606000000000222,1458437,0
"172.16.133.84",58733,"172.16.139.250",5440,10,1022,901,0,0,10,1022,0,0,4.237089,0.0055949999999995725,1461304,0
"157.56.52.24",40040,"172.16.133.82",54100,62,5776,902,0,0,34,3132,28,2644,4.248403,292.341964,85,72
"172.16.133.39",49310,"132.245.1.150",443,390,53230,903,0,0,197,41644,193,11586,4.273864,277.185419,1201,334
"172.16.133.35",57118,"74.125.226.86",443,110,34528,904,0,0,53,26616,57,7912,4.29128,294.077493,724,215
"172.16.133.132",50445,"76.13.6.174",80,9,1928,905,0,0,5,717,4,1211,4.294259,0.18642599999999998,30768,51967
"172.16.133.103",63415,"66.151.158.187",443,6,366,906,0,0,4,246,2,120,4.311069,0.19202600000000025,10248,4999
"172.16.133.99",51689,"216.115.209.97",443,55,4138,907,0,0,27,2054,28,2084,4.314606,120.394932,136,138
"172.16.133.57",60187,"184.73.197.44",443,384,211071,908,0,0,179,93546,205,117525,4.315467,294.643277,2539,3190
"172.16.133.49",55708,"172.16.139.250",5440,12,1142,909,0,0,12,1142,0,0,4.316094,0.006454000000000626,1415556,0
"172.16.133.78",58528,"173.194.43.57",80,6,366,910,0,0,3,180,3,186,4.338141,20.726677,69,71
"172.16.133.103",63416,"216.219.112.250",443,6,366,911,0,0,4,246,2,120,4.340979,0.280284,7021,3425
"172.16.133.41",52670,"199.102.234.31",80,14,5820,912,0,0,6,2339,8,3481,4.345492,0.7187200000000002,26035,38746
"172.16.133.95",56886,"172.16.139.250",5440,10,1022,913,0,0,10,1022,0,0,4.350434,0.0061949999999999505,1319774,0
"172.16.133.41",52671,"199.102.234.31",80,12,4162,914,0,0,6,2422,6,1740,4.35315,0.15575199999999967,124402,89372
"172.16.133.39",64198,"63.116.244.80",80,14,870,915,0,0,8,480,6,390,4.354565,224.330408,17,13
"172.16.133.39",64199,"63.116.244.80",80,14,870,916,0,0,8,480,6,390,4.355487,224.33436999999998,17,13
"172.16.133.132",54660,"98.139.161.29",80,9,1428,917,0,0,5,715,4,713,4.357594,0.16134800000000027,35451,35352
"172.16.133.39",64197,"63.116.244.80",80,14,870,918,0,0,8,480,6,390,4.364519,224.320137,17,13
"172.16.133.39",64200,"63.116.244.80",80,14,870,919,0,0,8,480,6,390,4.364712,224.321589,17,13
"172.16.133.132",44350,"98.138.19.88",80,10,1681,920,0,0,5,733,5,948,4.375042,0.21643200000000018,27093,35041
"172.16.133.92",57618,"172.16.139.250",5440,10,1022,921,0,0,10,1022,0,0,4.379012,0.015428999999999249,529911,0
"172.16.133.92",57619,"216.219.115.250",443,6,366,922,0,0,4,246,2,120,4.380291,0.08424399999999999,23360,11395
"172.16.133.41",52672,"199.102.234.31",80,14,4742,923,0,0,7,2542,7,2200,4.38085,0.12375800000000048,164320,142213
"67.217.94.254",443,"172.16.133.60",62043,111,8412,924,0,0,55,4091,56,4321,4.384902,292.964294,111,117
"157.56.244.214",443,"172.16.133.76",60749,567,453222,925,0,0,376,441762,191,11460,4.385173,240.20191,14713,381
"172.16.133.92",57620,"67.217.66.244",443,6,366,926,0,0,4,246,2,120,4.388098,0.08385100000000012,23470,11448
"172.16.133.39",64211,"63.116.244.80",80,14,870,927,0,0,8,480,6,390,4.394513,224.29156400000002,17,13
"96.43.146.22",443,"172.16.133.13",52626,44,22608,928,0,0,18,2890,26,19718,4.396598,280.819131,82,561
"172.16.133.29",60820,"172.16.139.250",5440,10,1022,929,0,0,10,1022,0,0,4.397679,0.005435000000000301,1504323,0
"172.16.133.93",60414,"74.125.226.206",443,16,1080,930,0,0,7,420,9,660,4.399152,194.945882,17,27
"172.16.133.44",64680,"172.16.139.250",5440,10,1022,931,0,0,10,1022,0,0,4.404575,0.005441999999999503,1502388,0
"172.16.133.92",50016,"157.56.240.102",443,141,95274,932,0,0,80,91614,61,3660,4.420964,226.104149,3241,129
"172.16.133.93",60428,"74.125.226.207",443,16,1080,933,0,0,7,420,9,660,4.423084,195.072655,17,27
"172.16.133.207",55876,"172.16.139.250",5440,12,1142,934,0,0,12,1142,0,0,4.429038,0.017583999999999378,519563,0
"172.16.133.41",52592,"74.125.226.67",80,44,21960,935,0,0,27,16846,17,5114,4.436645,289.827173,464,141
"172.16.133.83",57025,"172.16.139.250",5440,12,1142,936,0,0,12,1142,0,0,4.437494,0.0047920000000001295,"",""
"172.16.133.93",60440,"173.194.43.62",80,14,870,937,0,0,7,420,7,450,4.439133,203.071008,16,17
"172.16.133.30",56973,"157.56.237.150",443,409,247560,938,0,0,231,236880,178,10680,4.442464,270.084924,7016,316
"172.16.133.93",60438,"74.125.226.207",443,17,1140,939,0,0,8,480,9,660,4.443078,196.496422,19,26
"172.16.133.93",60417,"208.71.125.69",80,9,540,940,0,0,8,480,1,60,4.443079,263.071841,14,1
"172.16.133.41",52673,"23.62.105.87",80,148,133247,941,0,0,53,19262,95,113985,4.444556,255.329087,603,3571
"172.16.133.41",52674,"23.62.105.87",80,271,285733,942,0,0,75,18148,196,267585,4.444735,272.270716,533,7862
"172.16.133.41",52675,"23.62.105.87",80,250,254351,943,0,0,75,22766,175,231585,4.444859,289.837194,628,6392
"172.16.133.41",52676,"23.62.105.87",80,173,163728,944,0,0,59,19613,114,144115,4.444979,255.32757900000001,614,4515
"172.16.133.41",52677,"23.62.105.87",80,108,87665,945,0,0,42,18110,66,69555,4.445107,272.293387,532,2043
"172.16.133.41",52678,"23.62.105.87",80,204,191238,946,0,0,70,20284,134,170954,4.445255,225.584171,719,6062
"172.16.133.93",60418,"208.71.125.69",80,9,540,947,0,0,8,480,1,60,4.44812,263.066515,14,1
"172.16.133.93",60601,"172.16.139.250",5440,12,1142,948,0,0,12,1142,0,0,4.454989,0.014859999999999651,614804,0
"173.194.76.125",5222,"172.16.133.39",62037,14,1279,949,0,0,7,451,7,828,4.455401,288.28526700000003,12,22
"172.16.133.93",60442,"63.116.244.83",80,15,936,950,0,0,8,480,7,456,4.45812,263.053023,14,13
"172.16.133.132",52373,"98.139.240.23",80,9,1654,951,0,0,5,1036,4,618,4.462151,0.11416099999999929,72599,43307
"172.16.133.78",58777,"216.52.242.80",80,30,14508,952,0,0,18,8959,12,5549,4.464168,287.58067900000003,249,154
"172.16.133.97",62767,"96.43.146.176",443,24,5852,953,0,0,13,4576,11,1276,4.46446,270.75428800000003,135,37
"172.16.133.11",55083,"172.16.139.250",5440,10,1022,954,0,0,10,1022,0,0,4.470737,0.005646000000000484,1448104,0
"172.16.133.55",57521,"172.16.139.250",5440,10,1022,955,0,0,10,1022,0,0,4.474795,0.006349999999999412,1287559,0
"172.16.133.92",57621,"68.64.30.250",443,6,366,956,0,0,4,246,2,120,4.47714,0.09394599999999986,20948,10218
"157.56.232.214",443,"172.16.133.63",49371,30,13072,957,0,0,19,12412,11,660,4.484687,265.794992,373,19
"172.16.133.92",57622,"68.64.13.250",443,6,366,958,0,0,4,246,2,120,4.492162,0.11801399999999962,16675,8134
"172.16.133.73",60511,"172.16.139.250",5440,10,1022,959,0,0,10,1022,0,0,4.499789,0.016697000000000628,489668,0
"172.16.133.53",54041,"172.16.139.250",5440,10,1022,960,0,0,10,1022,0,0,4.501954,0.00559000000000065,1462611,0
"172.16.133.21",53115,"172.16.139.250",5440,10,1022,961,0,0,10,1022,0,0,4.504887,0.016182999999999836,505221,0
"172.16.133.30",62553,"172.16.139.250",5440,10,1022,962,0,0,10,1022,0,0,4.50687,0.005631000000000164,1451962,0
"172.16.133.44",64681,"216.52.242.80",80,74,53802,963,0,0,32,19455,42,34347,4.511177,65.496907,2376,4195
"172.16.133.21",51497,"172.16.139.250",5500,328,172496,964,0,0,328,172496,0,0,4.514038,294.14998799999995,4691,0
"172.16.133.44",64682,"173.194.43.59",80,42,17593,965,0,0,22,10254,20,7339,4.514682,274.266775,299,214
"172.16.133.25",63346,"172.16.139.250",5440,12,1142,966,0,0,12,1142,0,0,4.516484,0.00835700000000017,1093215,0
"172.16.133.96",59608,"74.125.226.245",443,92,27222,967,0,0,48,13952,44,13270,4.519837,290.572256,384,365
"172.16.133.34",50381,"172.16.139.250",5440,10,1022,968,0,0,10,1022,0,0,4.524621,0.0050360000000004845,1623510,0
"172.16.133.41",52679,"67.69.174.115",80,6,372,969,0,0,4,246,2,126,4.534764,15.499093000000002,126,65
"172.16.133.41",52680,"67.69.174.115",80,6,372,970,0,0,4,246,2,126,4.534899,15.497311,126,65
"172.16.133.97",59312,"172.16.139.250",5440,10,1022,971,0,0,10,1022,0,0,4.535448,0.01610900000000015,507542,0
"172.16.133.41",52681,"23.61.18.110",443,13,1206,972,0,0,6,632,7,574,4.5355039999999995,27.422874,184,167
"172.16.133.41",52682,"23.61.18.110",443,13,1206,973,0,0,6,632,7,574,4.535665,27.422497,184,167
"172.16.133.23",51054,"172.16.139.250",5447,14,1960,974,0,0,14,1960,0,0,4.537904,267.595378,58,0
"172.16.133.49",54413,"96.43.146.22",443,41,19134,975,0,0,24,16302,17,2832,4.5379059999999996,290.293657,449,78
"216.115.208.199",443,"172.16.133.207",55639,165,39845,976,0,0,91,17429,74,22416,4.540478,289.066141,482,620
"64.208.138.118",443,"172.16.133.24",57647,5,331,977,0,0,3,211,2,120,4.547814,1.3707289999999999,1231,700
"66.92.149.253",60113,"172.16.133.25",62291,176,13192,978,0,0,90,7654,86,5538,4.549388,293.998186,208,150
"172.16.133.78",58724,"173.194.43.59",80,30,7653,979,0,0,16,4830,14,2823,4.561139,280.49110299999995,137,80
"172.16.133.63",53201,"96.43.146.176",443,62,38540,980,0,0,29,19764,33,18776,4.565458,291.124203,543,515
"172.16.133.63",53204,"96.43.146.176",443,28,12409,981,0,0,13,6005,15,6404,4.575415,266.86304099999995,180,191
"172.16.133.41",52464,"64.12.152.13",80,15,900,982,0,0,8,480,7,420,4.580749,255.424975,15,13
"172.16.133.37",56299,"96.43.146.48",443,2,120,983,0,0,1,60,1,60,4.600098,9.899999999962716e-05,"",""
"172.16.133.37",60546,"96.43.146.48",443,25,8742,984,0,0,13,2812,12,5930,4.600675,181.303468,124,261
"172.16.133.33",57821,"172.16.139.250",5440,10,1022,985,0,0,10,1022,0,0,4.610644,0.005666000000000615,1442993,0
"172.16.133.48",49284,"157.56.245.198",443,54,11795,986,0,0,28,10235,26,1560,4.624857,113.117104,723,110
"74.125.226.246",443,"172.16.133.72",50683,57,16856,987,0,0,29,4507,28,12349,4.6259820000000005,280.327516,128,352
"172.16.133.93",60448,"75.101.129.242",80,6,366,988,0,0,3,180,3,186,4.629123,22.89127,62,65
"172.16.133.93",60449,"184.73.184.196",80,6,366,989,0,0,3,180,3,186,4.634119,22.886175,62,65
"172.16.133.93",60436,"173.194.43.59",80,16,990,990,0,0,8,480,8,510,4.634121,202.876188,18,20
"172.16.133.132",38680,"98.139.134.187",80,15,8483,991,0,0,8,942,7,7541,4.635839,0.1697329999999999,44399,355428
"172.16.133.68",60661,"172.16.139.250",5440,10,1022,992,0,0,10,1022,0,0,4.640932,0.015862999999999516,515413,0
"172.16.133.44",64683,"206.33.41.253",80,55,30259,993,0,0,22,4089,33,26170,4.646069,15.768491000000001,2074,13277
"172.16.133.12",59652,"172.16.139.250",5440,10,1022,994,0,0,10,1022,0,0,4.65561,0.00571900000000003,1429620,0
"172.16.133.63",53818,"172.16.139.250",5440,12,1142,995,0,0,12,1142,0,0,4.662188,0.01546499999999984,590753,0
"172.16.133.114",54033,"193.182.8.51",80,23,1474,996,0,0,14,865,9,609,4.662248,256.009547,27,19
"172.16.133.67",55902,"216.219.115.250",443,6,366,997,0,0,4,246,2,120,4.662652,0.03621000000000052,54349,26512
"172.16.133.67",55903,"67.217.66.244",443,6,366,998,0,0,4,246,2,120,4.663386,0.0731320000000002,26910,13126
"157.56.245.198",443,"172.16.133.48",49285,33,11277,999,0,0,21,10557,12,720,4.670298,113.072182,746,50
"172.16.133.67",55904,"68.64.13.250",443,6,366,1000,0,0,4,246,2,120,4.674525,0.1121799999999995,17543,8557
"172.16.133.66",53791,"172.16.139.250",5440,10,1022,1001,0,0,10,1022,0,0,4.679741,0.015260999999999747,535744,0
"172.16.133.67",55905,"68.64.30.250",443,6,366,1002,0,0,4,246,2,120,4.682537,0.1017020000000004,19350,9439
"172.16.133.103",63417,"202.173.24.200",443,6,366,1003,0,0,4,246,2,120,4.689023,0.4970180000000006,3959,1931
"172.16.133.82",61264,"172.16.139.250",5440,10,1022,1004,0,0,10,1022,0,0,4.691923,0.007245000000000168,1128502,0
"172.16.133.37",60547,"172.16.139.250",5440,10,1022,1005,0,0,10,1022,0,0,4.708523,0.0055960000000006005,1461043,0
"67.217.94.254",443,"172.16.133.114",55276,133,10104,1006,0,0,68,5088,65,5016,4.721729,292.865533,138,137
"172.16.133.46",52015,"174.129.141.188",80,20,1364,1007,0,0,10,666,10,698,4.722105,285.141066,18,19
"172.16.133.44",64684,"23.62.196.163",80,38,20780,1008,0,0,17,1457,21,19323,4.723524,270.530276,43,571
"172.16.133.93",60487,"63.116.244.153",80,15,936,1009,0,0,8,480,7,456,4.747146,262.76343,14,13
"172.16.133.84",49476,"96.43.146.48",443,26,8035,1010,0,0,15,5010,11,3025,4.752536,240.341857,166,100
"172.16.133.93",60491,"63.116.244.130",80,15,936,1011,0,0,8,480,7,456,4.754147,262.756124,14,13
"172.16.133.93",60492,"63.116.244.130",80,15,936,1012,0,0,8,480,7,456,4.754149,262.756708,14,13
"172.16.133.41",52474,"207.171.14.219",80,15,900,1013,0,0,8,480,7,420,4.773777,255.302163,15,13
"172.16.133.93",60494,"63.116.244.130",80,15,936,1014,0,0,8,480,7,456,4.777126,262.733053,14,13
"172.16.133.20",62299,"173.194.75.104",443,574,307281,1015,0,0,218,50865,356,256416,4.777953,255.51404699999998,1592,8028
"172.16.133.93",60420,"63.116.244.153",80,15,936,1016,0,0,8,480,7,456,4.778138,262.733004,14,13
"172.16.133.132",50450,"76.13.6.174",80,9,1927,1017,0,0,5,717,4,1210,4.778714,0.09450000000000003,60698,102433
"172.16.133.93",60493,"63.116.244.130",80,15,936,1018,0,0,8,480,7,456,4.77914,262.731718,14,13
"172.16.133.78",56986,"74.125.226.77",80,23,5291,1019,0,0,12,2556,11,2735,4.781185,280.293301,72,78
"172.16.133.37",59428,"96.43.146.22",443,40,18630,1020,0,0,23,15648,17,2982,4.781235,266.33772500000003,470,89
"172.16.133.132",54665,"98.139.161.29",80,9,1428,1021,0,0,5,715,4,713,4.784521,0.10756700000000041,53176,53027
"172.16.133.93",60490,"107.20.217.22",80,6,366,1022,0,0,3,180,3,186,4.788149,32.731773000000004,43,45
"172.16.133.93",60489,"23.67.243.81",80,14,870,1023,0,0,7,420,7,450,4.794103,192.716836,17,18
"157.56.245.198",443,"172.16.133.116",54534,10,863,1024,0,0,5,563,5,300,4.795695,214.550766,20,11
"172.16.133.78",57250,"173.194.43.45",80,37,18381,1025,0,0,17,5238,20,13143,4.828194,280.22562,149,375
"172.16.133.23",55032,"216.219.115.250",443,6,366,1026,0,0,4,246,2,120,4.8487670000000005,0.04843899999999923,40628,19818
"172.16.133.93",60430,"173.194.43.45",80,14,870,1027,0,0,7,420,7,450,4.854137,202.654396,16,17
"172.16.133.78",59026,"172.16.139.250",5440,10,1022,1028,0,0,10,1022,0,0,4.862281,0.015681999999999974,521362,0
"172.16.133.23",55033,"67.217.66.244",443,6,366,1029,0,0,4,246,2,120,4.862802,0.05785299999999971,34017,16593
"172.16.133.93",60484,"23.67.242.83",80,8,492,1030,0,0,4,240,4,252,4.86915,82.65042799999999,23,24
"172.16.133.93",60488,"173.194.74.155",80,14,870,1031,0,0,7,420,7,450,4.877114,202.64560799999998,16,17
"172.16.133.132",44355,"98.138.19.88",80,10,1681,1032,0,0,5,733,5,948,4.882391,0.18668999999999958,31410,40623
"172.16.133.132",52378,"98.139.240.23",80,9,1654,1033,0,0,5,1036,4,618,4.891329,0.10861199999999993,76308,45519
"172.16.133.207",55228,"209.46.23.85",80,92,49058,1034,0,0,62,39368,30,9690,4.898411,290.56012,1083,266
"172.16.133.78",58762,"23.33.81.244",80,15,936,1035,0,0,8,480,7,456,4.904209,260.15616400000005,14,14
"172.16.133.23",55034,"68.64.30.250",443,6,366,1036,0,0,4,246,2,120,4.913716,0.09627199999999991,20442,9971
"172.16.133.67",55906,"172.16.139.250",5440,10,1022,1037,0,0,10,1022,0,0,4.916628,0.005355999999999916,1526512,0
"172.16.133.23",55035,"68.64.13.250",443,6,366,1038,0,0,4,246,2,120,4.924662,0.137861,14275,6963
"172.16.133.56",61345,"173.194.43.32",443,64,18014,1039,0,0,33,11898,31,6116,4.933204,282.130072,337,173
"172.16.133.42",57009,"172.16.139.250",5440,12,1142,1040,0,0,12,1142,0,0,4.935615,0.00928199999999979,984270,0
"172.16.133.56",61346,"172.16.139.250",5440,8,902,1041,0,0,8,902,0,0,4.939574,0.007904999999999163,912839,0
"172.16.133.78",58759,"208.47.254.83",80,18,4110,1042,0,0,10,2892,8,1218,4.945208,110.114664,210,88
"203.214.65.251",25090,"172.16.133.25",49538,76,5357,1043,0,0,39,2898,37,2459,4.956583,290.753028,79,67
"172.16.133.93",60429,"173.194.43.45",80,14,870,1044,0,0,7,420,7,450,4.978146,202.53058199999998,16,17
"172.16.133.75",50879,"172.16.139.250",5440,12,1142,1045,0,0,12,1142,0,0,4.994212,0.006445000000000256,1417532,0
"172.16.133.41",52683,"172.16.139.250",5440,10,1022,1046,0,0,10,1022,0,0,4.995624,0.01468399999999992,556796,0
"172.16.133.85",52189,"172.16.139.250",5440,12,1142,1047,0,0,12,1142,0,0,5.0131,0.006467999999999918,1412492,0
"172.16.133.24",57667,"216.115.217.254",443,6,366,1048,0,0,4,246,2,120,5.013324,0.057006000000000334,34522,16840
"172.16.133.24",57668,"202.173.27.250",443,6,366,1049,0,0,4,246,2,120,5.013326,0.5643349999999998,3487,1701
"172.16.133.24",57669,"216.219.120.244",443,6,366,1050,0,0,4,246,2,120,5.014806,0.17832899999999974,11035,5383
"172.16.133.24",57670,"216.115.220.254",443,6,366,1051,0,0,4,246,2,120,5.015214,0.4657499999999999,4225,2061
"172.16.133.41",52684,"74.125.226.67",80,6,372,1052,0,0,4,246,2,126,5.026646,15.003973000000002,131,67
"172.16.133.93",60415,"173.194.43.57",80,14,870,1053,0,0,7,420,7,450,5.028171,202.48121300000003,16,17
"172.16.133.41",52458,"74.125.226.91",80,62,28457,1054,0,0,30,17858,32,10599,5.028737,291.992526,489,290
"172.16.133.41",52408,"31.13.74.7",443,48,11221,1055,0,0,21,5487,27,5734,5.033697,229.238064,191,200
"172.16.133.132",38685,"98.139.134.187",80,15,8483,1056,0,0,8,942,7,7541,5.047503,0.1489850000000006,50582,404926
"172.16.133.93",60501,"23.23.86.35",80,6,366,1057,0,0,3,180,3,186,5.049136,22.47095,64,66
"157.56.234.118",443,"172.16.133.45",61066,10,863,1058,0,0,5,563,5,300,5.049317,218.221645,20,10
"172.16.133.93",60502,"173.194.43.57",80,14,870,1059,0,0,7,420,7,450,5.058168,202.45105800000002,16,17
"172.16.133.43",57705,"172.16.139.250",5440,10,1022,1060,0,0,10,1022,0,0,5.068368,0.014707999999999721,555887,0
"172.16.133.13",52981,"172.16.139.250",5440,10,1022,1061,0,0,10,1022,0,0,5.085175,0.005665000000000475,1443248,0
"172.16.133.63",53694,"96.43.146.48",443,112,86087,1062,0,0,38,14577,74,71510,5.095474,266.183041,438,2149
"173.194.76.125",443,"172.16.133.93",64074,13,841,1063,0,0,6,421,7,420,5.110823,270.170727,12,12
"172.16.133.37",50361,"209.107.209.50",80,2486,2863998,1064,0,0,613,57867,1873,2806131,5.117954,292.63250800000003,1581,76714
"172.16.133.40",65404,"74.125.226.213",443,117,45079,1065,0,0,60,37604,57,7475,5.121745,289.44686800000005,1039,206
"157.56.240.102",443,"172.16.133.15",53996,33,8174,1066,0,0,21,7454,12,720,5.149268,270.444776,220,21
"172.16.133.41",52487,"67.69.196.59",80,15,936,1067,0,0,8,480,7,456,5.160804,264.85900100000003,14,13
"172.16.133.132",50455,"76.13.6.174",80,9,1926,1068,0,0,5,717,4,1209,5.163898,0.10574100000000008,54245,91468
"172.16.133.28",65276,"172.16.139.250",5440,12,1142,1069,0,0,12,1142,0,0,5.165446,0.00617399999999968,1479753,0
"172.16.133.44",64685,"206.33.41.253",80,43,29456,1070,0,0,17,3054,26,26402,5.166881,15.248667999999999,1602,13851
"172.16.133.44",64686,"206.33.41.253",80,39,25190,1071,0,0,16,2337,23,22853,5.167468,15.247974,1226,11990
"172.16.133.132",54670,"98.139.161.29",80,9,1428,1072,0,0,5,715,4,713,5.16945,0.12133599999999944,47141,47009
"172.16.133.20",62300,"172.16.139.250",5440,12,1142,1073,0,0,12,1142,0,0,5.183527,0.005621000000000542,1625333,0
"172.16.133.99",55986,"172.16.139.250",5440,12,1142,1074,0,0,12,1142,0,0,5.190873,0.014314999999999856,638211,0
"172.16.133.44",64687,"206.33.41.253",80,31,17725,1075,0,0,13,2159,18,15566,5.212314,15.202128000000002,1136,8191
"172.16.133.44",64688,"206.33.41.253",80,39,16516,1076,0,0,18,3406,21,13110,5.212911,15.202326000000001,1792,6898
"172.16.133.87",60121,"172.16.139.250",5440,10,1022,1077,0,0,10,1022,0,0,5.21306,0.015222000000000513,537117,0
"172.16.133.116",53136,"172.16.139.250",5440,10,1022,1078,0,0,10,1022,0,0,5.228182,0.005770000000000053,1416984,0
"172.16.133.35",49914,"172.16.139.250",5440,12,1142,1079,0,0,12,1142,0,0,5.232844,0.05195599999999967,175841,0
"172.16.133.44",64689,"206.33.41.253",80,26,12726,1080,0,0,12,2117,14,10609,5.234893,15.179357,1115,5591
"172.16.133.116",53137,"172.16.139.250",5440,10,1022,1081,0,0,10,1022,0,0,5.234943,0.005487999999999715,1489795,0
"172.16.133.116",53138,"172.16.139.250",5440,10,1022,1082,0,0,10,1022,0,0,5.24145,0.014434999999999754,566401,0
"172.16.133.84",58734,"172.16.139.250",5440,12,1142,1083,0,0,12,1142,0,0,5.251233,0.00959399999999988,952261,0
"172.16.133.21",54015,"157.56.238.6",443,20,1590,1084,0,0,10,990,10,600,5.271144,270.082396,29,17
"172.16.133.132",44360,"98.138.19.88",80,10,1681,1085,0,0,5,733,5,948,5.278917,0.2119730000000004,27663,35778
"172.16.133.132",52383,"98.139.240.23",80,9,1654,1086,0,0,5,1036,4,618,5.288016,0.16012000000000004,51761,30876
"172.16.133.44",64690,"23.45.65.19",80,36,9254,1087,0,0,20,6812,16,2442,5.288245,265.143515,205,73
"172.16.133.44",64691,"23.0.49.244",80,6,372,1088,0,0,4,246,2,126,5.294161,15.124621000000001,130,66
"172.16.133.44",64692,"23.0.49.244",80,6,372,1089,0,0,4,246,2,126,5.29431,15.123522000000001,130,66
"172.16.133.44",64693,"23.0.49.244",80,6,372,1090,0,0,4,246,2,126,5.297811,15.120969000000002,130,66
"172.16.133.44",64694,"23.0.49.244",80,6,372,1091,0,0,4,246,2,126,5.29795,15.120830999999999,130,66
"172.16.133.78",58394,"23.33.85.239",80,7,432,1092,0,0,4,240,3,192,5.311725,79.786495,24,19
"172.16.133.49",55709,"172.16.139.250",5440,10,1022,1093,0,0,10,1022,0,0,5.328942,0.015588000000000157,524506,0
"172.16.133.63",53687,"96.43.146.22",443,33,13774,1094,0,0,18,11759,15,2015,5.332491,243.025708,387,66
"96.43.146.22",443,"172.16.133.39",62244,34,15001,1095,0,0,15,2276,19,12725,5.346838,200.981669,90,506
"172.16.133.78",58395,"74.121.134.156",80,4,240,1096,0,0,3,180,1,60,5.354208,39.762748,36,12
"172.16.133.95",56887,"172.16.139.250",5440,10,1022,1097,0,0,10,1022,0,0,5.364477,0.005531999999999648,1477946,0
"172.16.133.92",57623,"172.16.139.250",5440,10,1022,1098,0,0,10,1022,0,0,5.393207,0.0058469999999992694,1398323,0
"172.16.133.41",52484,"67.69.196.139",80,15,936,1099,0,0,8,480,7,456,5.394797,264.629652,14,13
"172.16.133.41",52498,"54.243.32.162",80,6,360,1100,0,0,3,180,3,180,5.394799,24.621012,58,58
"172.16.133.25",49274,"172.16.139.250",5500,640,366712,1101,0,0,640,366712,0,0,5.404845,240.202461,12213,0
"172.16.133.29",60821,"172.16.139.250",5440,10,1022,1102,0,0,10,1022,0,0,5.412045,0.005395000000000039,1515477,0
"172.16.133.44",64695,"172.16.139.250",5440,10,1022,1103,0,0,10,1022,0,0,5.417099,0.005525999999999698,1479551,0
"172.16.133.41",52485,"173.203.215.84",443,7,457,1104,0,0,3,180,4,277,5.440759,26.553966,54,83
"172.16.133.207",55877,"172.16.139.250",5440,12,1142,1105,0,0,12,1142,0,0,5.44367,0.016994000000000398,537601,0
"172.16.133.11",55084,"157.56.244.214",443,27,16615,1106,0,0,10,2445,17,14170,5.449737,15.545221000000002,1258,7292
"172.16.133.83",57026,"172.16.139.250",5440,12,1142,1107,0,0,12,1142,0,0,5.451538,0.004998999999999754,"",""
"172.16.133.53",52266,"96.43.146.22",443,50,30308,1108,0,0,30,26055,20,4253,5.4658999999999995,260.57095000000004,799,130
"172.16.133.93",60602,"172.16.139.250",5440,12,1142,1109,0,0,12,1142,0,0,5.468278,0.014518999999999949,629244,0
"172.16.133.83",53558,"216.52.242.80",80,3,180,1110,0,0,2,120,1,60,5.471045,0.0938699999999999,10226,5113
"172.16.133.132",38690,"98.139.134.187",80,15,8483,1111,0,0,8,942,7,7541,5.475262,0.14478800000000014,52048,416664
"119.47.118.78",80,"172.16.133.20",62273,6,372,1112,0,0,2,126,4,246,5.475316,1.489941,676,1320
"172.16.133.11",55085,"172.16.139.250",5440,10,1022,1113,0,0,10,1022,0,0,5.484499,0.015043000000000362,543508,0
"172.16.133.55",57522,"172.16.139.250",5440,10,1022,1114,0,0,10,1022,0,0,5.488823,0.01612300000000033,507101,0
"172.16.133.41",52490,"54.240.160.242",80,8,492,1115,0,0,4,240,4,252,5.492803,84.51704600000001,22,23
"172.16.133.87",59963,"96.43.146.22",443,15,917,1116,0,0,7,420,8,497,5.507834,210.458289,15,18
"172.16.133.87",59825,"96.43.146.22",443,21,11327,1117,0,0,12,10177,9,1150,5.508924,23.945498,3400,384
"172.16.133.73",60512,"172.16.139.250",5440,12,1142,1118,0,0,12,1142,0,0,5.513104,0.03261599999999998,280107,0
"172.16.133.121",56442,"96.43.146.22",443,17,1037,1119,0,0,8,480,9,557,5.514444,257.69999099999995,14,17
"172.16.133.53",54042,"172.16.139.250",5440,10,1022,1120,0,0,10,1022,0,0,5.515051,0.005691999999999808,1436401,0
"172.16.133.21",53116,"172.16.139.250",5440,10,1022,1121,0,0,10,1022,0,0,5.517859,0.02459600000000073,332411,0
"172.16.133.30",62554,"172.16.139.250",5440,10,1022,1122,0,0,10,1022,0,0,5.520988,0.012654999999999639,646068,0
"172.16.133.54",64313,"65.54.81.228",80,10,2431,1123,0,0,6,861,4,1570,5.522142,5.06064,1361,2481
"172.16.133.25",63347,"172.16.139.250",5440,12,1142,1124,0,0,12,1142,0,0,5.531204,0.02133800000000008,428156,0
"172.16.133.34",50382,"172.16.139.250",5440,10,1022,1125,0,0,10,1022,0,0,5.537657,0.010888999999999704,750849,0
"172.16.133.93",60504,"64.236.116.3",80,15,900,1126,0,0,8,480,7,420,5.540185,261.974738,14,12
"172.16.133.87",59964,"96.43.146.22",443,15,917,1127,0,0,7,420,8,497,5.5458549999999995,210.420388,15,18
"172.16.133.97",59313,"172.16.139.250",5440,10,1022,1128,0,0,10,1022,0,0,5.549165,0.007066999999999268,1156926,0
"172.16.133.92",50180,"216.115.208.199",443,130,24407,1129,0,0,58,11334,72,13073,5.550191,289.55005,313,361
"172.16.133.128",64593,"173.194.43.60",80,22,5217,1130,0,0,11,3018,11,2199,5.550343,288.023756,83,61
"157.56.234.118",443,"172.16.133.53",49607,10,775,1131,0,0,5,475,5,300,5.552123,240.112107,15,9
"172.16.133.87",59965,"96.43.146.22",443,15,917,1132,0,0,7,420,8,497,5.55284,210.41334899999998,15,18
"172.16.133.41",52685,"74.125.226.91",80,52,19787,1133,0,0,26,14278,26,5509,5.570251,288.73010400000004,395,152
"172.16.133.41",52686,"74.125.226.91",80,6,372,1134,0,0,4,246,2,126,5.570625,14.450510999999999,136,69
"172.16.133.41",52459,"74.125.226.60",80,21,3362,1135,0,0,11,1419,10,1943,5.592319,244.431556,46,63
"172.16.133.132",50460,"76.13.6.174",80,9,1928,1136,0,0,5,717,4,1211,5.593758,0.10203099999999932,56218,94951
"172.16.133.121",53744,"157.56.234.118",443,30,3005,1137,0,0,15,2105,15,900,5.598445,273.006877,61,26
"172.16.133.132",54675,"98.139.161.29",80,9,1428,1138,0,0,5,715,4,713,5.598732,0.12319899999999961,46428,46299
"172.16.133.121",56471,"96.43.146.22",443,17,1037,1139,0,0,8,480,9,557,5.601398,257.612685,14,17
"172.16.133.121",56472,"96.43.146.22",443,17,1037,1140,0,0,8,480,9,557,5.6044,257.61021,14,17
"172.16.133.68",60556,"96.43.146.48",443,35,18309,1141,0,0,18,10385,17,7924,5.6059909999999995,252.04836200000003,329,251
"172.16.133.121",56474,"96.43.146.22",443,17,1037,1142,0,0,8,480,9,557,5.614307,257.598854,14,17
"172.16.133.20",62301,"216.219.115.250",443,6,366,1143,0,0,4,246,2,120,5.616111,0.06475600000000004,30391,14824
"172.16.133.121",56473,"96.43.146.22",443,17,1037,1144,0,0,8,480,9,557,5.621367,257.592582,14,17
"172.16.133.121",56475,"96.43.146.22",443,17,1037,1145,0,0,8,480,9,557,5.621368,257.593661,14,17
"172.16.133.45",61262,"96.43.146.176",443,30,15862,1146,0,0,13,6586,17,9276,5.621895,252.09551900000002,209,294
"172.16.133.33",57822,"172.16.139.250",5440,10,1022,1147,0,0,10,1022,0,0,5.624717,0.015867000000000075,515283,0
"172.16.133.20",62302,"67.217.66.244",443,6,366,1148,0,0,4,246,2,120,5.636144,0.07422400000000007,26514,12933
"172.16.133.116",52508,"216.52.242.80",80,6,360,1149,0,0,5,300,1,60,5.639256,126.581532,18,3
"172.16.133.68",60663,"172.16.139.250",5440,12,1142,1150,0,0,12,1142,0,0,5.655147,0.005980999999999348,1527503,0
"172.16.133.126",50878,"72.21.207.18",80,24,3912,1151,0,0,16,1800,8,2112,5.659027,284.247367,50,59
"172.16.133.12",59653,"172.16.139.250",5440,10,1022,1152,0,0,10,1022,0,0,5.668327,0.005463999999999913,1496339,0
"172.16.133.63",53819,"172.16.139.250",5440,10,1022,1153,0,0,10,1022,0,0,5.676587,0.006700000000000372,1220298,0
"172.16.133.128",64961,"23.67.242.73",80,9,558,1154,0,0,5,300,4,258,5.680306,119.996646,20,17
"172.16.133.128",64964,"23.67.242.73",80,9,558,1155,0,0,5,300,4,258,5.681334,119.99468100000001,20,17
"172.16.133.132",44365,"98.138.19.88",80,10,1681,1156,0,0,5,733,5,948,5.68383,0.4709479999999999,12451,16103
"172.16.133.29",60321,"216.52.242.80",80,703,550532,1157,0,0,259,113494,444,437038,5.686651,291.58732200000003,3113,11990
"172.16.133.128",64962,"23.67.242.73",80,27,10708,1158,0,0,12,3282,15,7426,5.690326,254.56884399999998,103,233
"172.16.133.41",52403,"23.60.245.109",80,15,936,1159,0,0,8,480,7,456,5.690845,264.32654599999995,14,13
"172.16.133.118",58200,"74.125.226.233",443,17,1140,1160,0,0,8,480,9,660,5.693927,195.005126,19,27
"172.16.133.66",53792,"172.16.139.250",5440,12,1142,1161,0,0,12,1142,0,0,5.694334,0.006400000000000183,1427499,0
"172.16.133.132",52388,"98.139.240.23",80,9,1654,1162,0,0,5,1036,4,618,5.694672,0.1351659999999999,61317,36577
"172.16.133.42",56856,"208.89.13.133",80,80,34772,1163,0,0,40,19516,40,15256,5.698657,280.14009799999997,557,435
"172.16.133.82",61265,"172.16.139.250",5440,10,1022,1164,0,0,10,1022,0,0,5.707107,0.005554000000000059,1472092,0
"172.16.133.20",62303,"68.64.30.250",443,6,366,1165,0,0,4,246,2,120,5.710089,0.09783700000000017,20115,9812
"172.16.133.128",64963,"23.67.242.73",80,35,16551,1166,0,0,15,5155,20,11396,5.711319,254.595689,161,358
"96.43.146.22",443,"172.16.133.56",60876,10,3308,1167,0,0,5,619,5,2689,5.711634,29.972813,165,717
"172.16.133.35",49475,"23.33.81.244",80,5,306,1168,0,0,3,180,2,126,5.712128,33.132239,43,30
"172.16.133.37",60548,"172.16.139.250",5440,10,1022,1169,0,0,10,1022,0,0,5.720701,0.015595000000000248,524270,0
"172.16.133.41",52404,"23.60.245.109",80,15,936,1170,0,0,8,480,7,456,5.720816,264.29567,14,13
"172.16.133.121",56477,"96.43.146.22",443,20,4474,1171,0,0,11,3628,9,846,5.721317,288.053284,100,23
"172.16.133.95",56851,"199.59.148.247",80,2,120,1172,0,0,1,60,1,60,5.7355789999999995,0.09733700000000045,4931,4931
"172.16.133.42",55080,"157.56.236.102",443,46,6669,1173,0,0,23,5289,23,1380,5.736518,270.28659,156,40
"172.16.133.114",64372,"157.56.242.198",443,403,48547,1174,0,0,202,36487,201,12060,5.745254,284.203996,1027,339
"172.16.133.20",62304,"68.64.13.250",443,6,366,1175,0,0,4,246,2,120,5.753167,0.10770400000000002,18272,8913
"199.47.218.150",80,"172.16.133.87",65361,18,3252,1176,0,0,12,1758,6,1494,5.76338,278.027976,50,42
"172.16.133.35",49509,"23.33.84.46",80,5,306,1177,0,0,3,180,2,126,5.76344,33.080928,43,30
"157.56.238.6",443,"172.16.133.34",62902,87,13295,1178,0,0,55,11369,32,1926,5.773683,284.505602,319,54
"172.16.133.41",52504,"74.125.226.92",80,14,870,1179,0,0,7,420,7,450,5.773785,204.25064,16,17
"172.16.133.41",52495,"23.60.245.109",80,15,936,1180,0,0,8,480,7,456,5.783801,264.235926,14,13
"172.16.133.41",52687,"199.102.234.31",80,18,9807,1181,0,0,8,2611,10,7196,5.816785,0.5136719999999997,40664,112071
"172.16.133.67",55907,"173.194.43.0",443,531,535901,1182,0,0,156,15618,375,520283,5.818965,242.695899,514,17150
"172.16.133.67",55908,"173.194.43.0",443,16,4201,1183,0,0,9,1024,7,3177,5.819271,8.242163000000001,993,3083
"172.16.133.41",52688,"199.102.234.31",80,11,3947,1184,0,0,6,2611,5,1336,5.837984,0.1575950000000006,132542,67819
"172.16.133.41",52689,"199.102.234.31",80,11,3021,1185,0,0,6,2488,5,533,5.839383,0.16608,119845,25674
"172.16.133.128",64932,"96.43.146.176",443,17,3912,1186,0,0,9,3118,8,794,5.840325,270.180266,92,23
"172.16.133.66",53376,"96.43.146.22",443,42,18449,1187,0,0,24,15558,18,2891,5.849089,289.790437,429,79
"96.43.146.22",443,"172.16.133.97",58793,42,18721,1188,0,0,18,3193,24,15528,5.84936,286.29814,89,433
"172.16.133.41",52690,"74.125.226.60",80,124,120511,1189,0,0,35,4553,89,115958,5.869651,284.151742,128,3264
"172.16.133.78",59027,"172.16.139.250",5440,12,1142,1190,0,0,12,1142,0,0,5.875838,0.01594500000000032,572969,0
"172.16.133.24",57517,"173.194.74.95",443,3,180,1191,0,0,2,120,1,60,5.884387,0.04547399999999957,21110,10555
"172.16.133.24",57637,"107.21.174.95",443,2,120,1192,0,0,1,60,1,60,5.884691,0.04333100000000023,11077,11077
"172.16.133.24",57636,"107.21.174.95",443,2,120,1193,0,0,1,60,1,60,5.8849,0.043254000000000126,11097,11097
"172.16.133.24",57638,"107.21.174.95",443,2,120,1194,0,0,1,60,1,60,5.885093,0.042607999999999535,11265,11265
"172.16.133.24",57635,"107.21.174.95",443,2,120,1195,0,0,1,60,1,60,5.885285,0.042964000000000446,11172,11172
"172.16.133.24",57639,"23.22.135.102",443,2,120,1196,0,0,1,60,1,60,5.885476,0.04026900000000033,11919,11919
"172.16.133.24",57641,"23.22.135.102",443,2,120,1197,0,0,1,60,1,60,5.885663,0.040013000000000076,11996,11996
"172.16.133.24",57640,"23.22.135.102",443,2,120,1198,0,0,1,60,1,60,5.885851,0.04041400000000017,11877,11877
"172.16.133.24",57642,"204.232.201.76",443,2,120,1199,0,0,1,60,1,60,5.886786,0.07548600000000061,6358,6358
"172.16.133.24",57643,"204.232.201.76",443,2,120,1200,0,0,1,60,1,60,5.886976,0.07541900000000012,6364,6364
"172.16.133.67",55909,"172.16.139.250",5440,10,1022,1201,0,0,10,1022,0,0,5.931023,0.005768999999999913,1417230,0
"172.16.133.42",57010,"172.16.139.250",5440,12,1142,1202,0,0,12,1142,0,0,5.949692,0.0347230000000005,263110,0
"172.16.133.56",61347,"172.16.139.250",5440,10,1022,1203,0,0,10,1022,0,0,5.953623,0.004874000000000045,"",""
"173.194.43.21",443,"172.16.133.45",54683,305,101705,1204,0,0,176,25802,129,75903,5.970881,293.041589,704,2072
"172.16.133.85",51708,"96.43.146.176",443,51,27913,1205,0,0,25,13509,26,14404,5.996975,270.50940599999996,399,425
"172.16.133.132",38695,"98.139.134.187",80,16,8557,1206,0,0,9,1016,7,7541,6.005752,3.1296100000000004,2597,19276
"172.16.133.75",50880,"172.16.139.250",5440,12,1142,1207,0,0,12,1142,0,0,6.008051,0.015203999999999773,600894,0
"172.16.133.41",52691,"172.16.139.250",5440,12,1142,1208,0,0,12,1142,0,0,6.010457,0.006526000000000032,1399938,0
"172.16.133.85",52190,"172.16.139.250",5440,10,1022,1209,0,0,10,1022,0,0,6.02654,0.005359000000000336,1525657,0
"172.16.133.20",62257,"202.68.93.36",80,3,180,1210,0,0,2,120,1,60,6.044903,0.9190290000000001,1044,522
"172.16.133.20",62271,"119.47.118.78",80,3,180,1211,0,0,2,120,1,60,6.045026,0.7258949999999995,1322,661
"172.16.133.44",64696,"208.111.161.254",80,9,558,1212,0,0,5,312,4,246,6.061431,14.356501000000002,173,137
"172.16.133.44",64697,"173.194.43.58",443,14,3552,1213,0,0,8,967,6,2585,6.066955,2.0744299999999996,3729,9969
"172.16.133.118",58206,"180.153.30.250",443,6,366,1214,0,0,4,246,2,120,6.074163,0.7614129999999992,2584,1260
"172.16.133.43",57706,"172.16.139.250",5440,10,1022,1215,0,0,10,1022,0,0,6.082488,0.005413000000000778,1510437,0
"172.16.133.13",52982,"172.16.139.250",5440,10,1022,1216,0,0,10,1022,0,0,6.098003,0.005365999999999538,1523667,0
"172.16.133.87",59808,"96.43.146.22",443,11,677,1217,0,0,5,300,6,377,6.098919,119.86805000000001,20,25
"172.16.133.93",60466,"216.52.92.45",80,16,960,1218,0,0,8,480,8,480,6.100195,261.407956,14,14
"172.16.133.35",49512,"23.33.84.46",80,5,306,1219,0,0,3,180,2,126,6.100748,32.742217999999994,43,30
"172.16.133.118",58201,"173.194.43.36",443,17,1140,1220,0,0,8,480,9,660,6.103365,194.991748,19,27
"172.16.133.116",52415,"173.194.43.60",80,75,38416,1221,0,0,37,21967,38,16449,6.111274,286.80262500000003,612,458
"172.16.133.84",58478,"96.43.146.22",443,18,3723,1222,0,0,10,2955,8,768,6.130295,254.819812,92,24
"172.16.133.87",59809,"96.43.146.22",443,11,677,1223,0,0,5,300,6,377,6.132896,129.839039,18,23
"172.16.133.20",62305,"172.16.139.250",5440,12,1142,1224,0,0,12,1142,0,0,6.146922,0.004989000000000132,"",""
"172.16.133.128",64840,"208.44.23.50",80,28,7470,1225,0,0,15,5922,13,1548,6.1513349999999996,288.332219,164,42
"172.16.133.35",49514,"23.46.17.231",80,5,306,1226,0,0,3,180,2,126,6.164834,32.679531000000004,44,30
"172.16.133.44",64698,"173.194.43.58",80,21,3434,1227,0,0,11,1651,10,1783,6.177967,244.228161,54,58
"172.16.133.28",65277,"172.16.139.250",5440,10,1022,1228,0,0,10,1022,0,0,6.178897,0.006264999999999965,1305027,0
"172.16.133.114",54314,"96.43.146.22",443,46,28700,1229,0,0,27,24658,19,4042,6.184694,251.5966,784,128
"172.16.133.99",55987,"172.16.139.250",5440,10,1022,1230,0,0,10,1022,0,0,6.203504,0.005338000000000065,1531659,0
"172.16.133.87",60122,"172.16.139.250",5440,12,1142,1231,0,0,12,1142,0,0,6.225626,0.006380000000000052,1431974,0
"68.64.28.20",443,"172.16.133.49",54994,115,8730,1232,0,0,57,4289,58,4441,6.232005,293.307107,116,121
"172.16.133.103",63418,"216.115.222.200",443,6,366,1233,0,0,4,246,2,120,6.234024,0.09831099999999982,20018,9764
"172.16.133.35",49915,"172.16.139.250",5440,12,1142,1234,0,0,12,1142,0,0,6.242774,0.07406800000000047,123346,0
"172.16.133.116",53139,"172.16.139.250",5440,12,1142,1235,0,0,12,1142,0,0,6.243499,0.005895999999999901,1549525,0
"172.16.133.116",53140,"172.16.139.250",5440,12,1142,1236,0,0,12,1142,0,0,6.250629,0.005800999999999945,1574900,0
"172.16.133.132",44368,"98.138.19.88",80,10,1681,1237,0,0,5,733,5,948,6.255636,0.24501699999999982,23933,30952
"172.16.133.116",53141,"172.16.139.250",5440,10,1022,1238,0,0,10,1022,0,0,6.257497,0.005298999999999943,1542932,0
"172.16.133.84",58735,"172.16.139.250",5440,10,1022,1239,0,0,10,1022,0,0,6.265102,0.005396000000000178,1515196,0
"173.194.43.9",443,"172.16.133.115",53568,6,450,1240,0,0,4,330,2,120,6.273067,0.018832999999999878,140179,50974
"172.16.133.44",64699,"173.194.43.57",80,21,3116,1241,0,0,11,1998,10,1118,6.286107,244.11993700000002,65,36
"208.47.254.81",80,"172.16.133.63",53735,4,240,1242,0,0,2,120,2,120,6.315697,1.4127169999999998,679,679
"172.16.133.20",53634,"173.194.68.125",5222,14,907,1243,0,0,7,420,7,487,6.315827,253.15640099999996,13,15
"172.16.133.116",52436,"216.52.242.80",80,570,423140,1244,0,0,230,107401,340,315739,6.32427,293.645467,2926,8601
"172.16.133.116",52521,"216.52.242.80",80,123,98033,1245,0,0,50,29364,73,68669,6.327269,286.843597,818,1915
"172.16.133.41",52518,"74.125.226.28",80,14,870,1246,0,0,7,420,7,450,6.333849,203.691751,16,17
"172.16.133.49",55710,"172.16.139.250",5440,10,1022,1247,0,0,10,1022,0,0,6.344067,0.005514999999999937,1482502,0
"172.16.133.78",58436,"23.33.47.196",80,7,432,1248,0,0,4,240,3,192,6.371176,78.72703999999999,24,19
"172.16.133.78",58432,"69.25.24.24",80,22,9674,1249,0,0,11,5934,11,3740,6.371232,256.834029,184,116
"172.16.133.78",58435,"23.33.83.167",80,7,432,1250,0,0,4,240,3,192,6.371233,78.726928,24,19
"172.16.133.78",58429,"173.194.43.58",80,6,366,1251,0,0,3,180,3,186,6.371234,18.693379999999998,77,79
"172.16.133.95",56888,"172.16.139.250",5440,12,1142,1252,0,0,12,1142,0,0,6.378552,0.005609999999999893,1628520,0
"172.16.133.103",63419,"66.151.158.187",443,6,366,1253,0,0,4,246,2,120,6.398137,0.21394800000000025,9198,4487
"172.16.133.41",52692,"199.102.234.31",80,15,6511,1254,0,0,7,2562,8,3949,6.398942,0.15689200000000003,130637,201361
"172.16.133.92",57624,"172.16.139.250",5440,10,1022,1255,0,0,10,1022,0,0,6.407412,0.015057999999999794,542967,0
"172.16.133.29",60822,"172.16.139.250",5440,10,1022,1256,0,0,10,1022,0,0,6.425864,0.005447000000000202,1501009,0
"172.16.133.132",38697,"98.139.134.187",80,15,8483,1257,0,0,8,942,7,7541,6.430451,0.22027200000000047,34212,273879
"172.16.133.44",64700,"172.16.139.250",5440,12,1142,1258,0,0,12,1142,0,0,6.432347,0.01621499999999987,563428,0
"172.16.133.235",2692,"172.16.131.10",8080,19,3213,1259,0,0,10,1627,9,1586,6.442037,18.982966,685,668
"172.16.133.207",55878,"172.16.139.250",5440,12,1142,1260,0,0,12,1142,0,0,6.457352,0.0050200000000000244,1819920,0
"172.16.133.78",58434,"23.67.242.41",80,7,432,1261,0,0,4,240,3,192,6.45822,78.64093,24,19
"172.16.133.83",57027,"172.16.139.250",5440,12,1142,1262,0,0,12,1142,0,0,6.465806,0.004793000000000269,"",""
"172.16.133.93",60603,"172.16.139.250",5440,10,1022,1263,0,0,10,1022,0,0,6.482363,0.0145369999999998,562426,0
"172.16.133.83",57028,"172.16.128.169",8014,15,7260,1264,0,0,9,4368,6,2892,6.488473,2.8675520000000008,12186,8068
"172.16.133.93",60604,"172.16.128.169",8014,10,4598,1265,0,0,5,1898,5,2700,6.488894,2.177773,6972,9918
"172.16.133.49",55711,"172.16.128.169",8014,12,5434,1266,0,0,6,2674,6,2760,6.491121,2.442634,8757,9039
"172.16.133.87",60123,"172.16.128.169",8014,10,4598,1267,0,0,5,1898,5,2700,6.496585,2.1708300000000005,6994,9950
"172.16.133.11",55086,"172.16.139.250",5440,10,1022,1268,0,0,10,1022,0,0,6.498977,0.006281999999999677,1301496,0
"172.16.133.55",57523,"172.16.139.250",5440,12,1142,1269,0,0,12,1142,0,0,6.502727,0.009596999999999412,951964,0
"172.16.133.12",59654,"172.16.128.169",8014,10,4630,1270,0,0,5,1930,5,2700,6.504159,2.1628550000000004,7138,9986
"172.16.133.37",60549,"172.16.128.169",8014,15,7502,1271,0,0,9,4610,6,2892,6.507326,2.949312,12504,7844
"172.16.133.67",49857,"172.16.139.250",5447,10,1400,1272,0,0,10,1400,0,0,6.507519,233.911504,47,0
"172.16.133.53",54043,"172.16.128.169",8014,10,4630,1273,0,0,5,1930,5,2700,6.507596,2.159152999999999,7150,10003
"172.16.133.66",53793,"172.16.128.169",8014,10,4598,1274,0,0,5,1898,5,2700,6.509664,2.157661,7037,10010
"172.16.133.11",55087,"172.16.128.169",8014,10,4638,1275,0,0,5,1938,5,2700,6.510663,2.1562449999999993,7190,10017
"172.16.133.43",63444,"157.56.236.102",443,10,775,1276,0,0,5,475,5,300,6.512867,240.083567,15,9
"172.16.133.103",63420,"216.219.112.250",443,6,366,1277,0,0,4,246,2,120,6.519094,0.22196999999999978,8866,4324
"172.16.133.128",65024,"172.16.128.169",8014,12,5414,1278,0,0,6,2654,6,2760,6.519221,2.4235480000000003,8760,9110
"172.16.133.73",60513,"172.16.139.250",5440,12,1142,1279,0,0,12,1142,0,0,6.528168,0.01362000000000041,670778,0
"172.16.133.53",54044,"172.16.139.250",5440,10,1022,1280,0,0,10,1022,0,0,6.528978,0.016040999999999528,509693,0
"172.16.133.21",53117,"172.16.139.250",5440,10,1022,1281,0,0,10,1022,0,0,6.531804,0.017071999999999754,478912,0
"172.16.133.43",57707,"172.16.128.169",8014,10,4630,1282,0,0,5,1930,5,2700,6.532255,2.1349609999999997,7231,10117
"172.16.133.41",52693,"74.125.226.77",80,6,372,1283,0,0,4,246,2,126,6.53425,13.492128000000001,145,74
"172.16.133.30",62555,"172.16.139.250",5440,10,1022,1284,0,0,10,1022,0,0,6.534332,0.022336000000000134,366045,0
"172.16.133.41",52694,"74.125.226.77",80,6,372,1285,0,0,4,246,2,126,6.534706,13.490829999999999,145,74
"172.16.133.41",52695,"68.67.159.147",80,30,17978,1286,0,0,15,11612,15,6366,6.535397,13.475455,6893,3779
"172.16.133.41",52696,"68.67.159.147",80,21,11234,1287,0,0,10,5866,11,5368,6.535601,13.472142999999999,3483,3187
"172.16.133.41",52697,"68.67.159.147",80,7,432,1288,0,0,4,246,3,186,6.535697,13.471008000000001,146,110
"172.16.133.41",52698,"74.125.226.26",80,6,372,1289,0,0,4,246,2,126,6.536517,13.492512999999999,145,74
"172.16.133.41",52699,"74.125.226.26",80,6,372,1290,0,0,4,246,2,126,6.537282,13.490903,145,74
"172.16.133.25",63348,"172.16.139.250",5440,12,1142,1291,0,0,12,1142,0,0,6.544866,0.008049000000000639,1135047,0
"172.16.133.66",53371,"96.43.146.178",443,7,437,1292,0,0,3,180,4,257,6.5480979999999995,38.007181,37,54
"172.16.133.34",50383,"172.16.139.250",5440,12,1142,1293,0,0,12,1142,0,0,6.552684,0.008223000000000091,1111030,0
"172.16.133.66",53373,"96.43.146.178",443,7,437,1294,0,0,3,180,4,257,6.559077,37.995067,37,54
"172.16.133.66",53372,"96.43.146.178",443,7,437,1295,0,0,3,180,4,257,6.559079,37.997204,37,54
"172.16.133.97",59314,"172.16.139.250",5440,12,1142,1296,0,0,12,1142,0,0,6.56346,0.016649000000000136,548741,0
"172.16.133.78",58393,"216.246.75.64",80,12,744,1297,0,0,6,360,6,384,6.58124,168.54003,17,18
"172.16.133.96",53329,"23.21.74.238",80,11,1537,1298,0,0,6,1004,5,533,6.582187,0.2316250000000002,34676,18409
"172.16.133.132",50467,"76.13.6.174",80,9,1928,1299,0,0,5,717,4,1211,6.598531,0.09209899999999926,62280,105191
"172.16.133.114",55243,"199.7.52.72",80,3,180,1300,0,0,2,120,1,60,6.601049,0.10158000000000023,9450,4725
"172.16.133.132",44371,"98.138.19.88",80,10,1681,1301,0,0,5,733,5,948,6.607168,0.20764100000000063,28241,36524
"172.16.133.41",52700,"74.119.118.94",80,11,4989,1302,0,0,6,4540,5,449,6.6244,14.307005000000002,2538,251
"172.16.133.41",52701,"74.119.118.94",80,11,5119,1303,0,0,6,4490,5,629,6.6245709999999995,11.587809,3099,434
"172.16.133.41",52702,"74.119.118.94",80,4,252,1304,0,0,2,126,2,126,6.625046,11.562977,87,87
"172.16.133.41",52703,"74.119.118.84",80,16,9625,1305,0,0,8,4769,8,4856,6.628921,14.245816,2678,2726
"172.16.133.66",53374,"96.43.146.178",443,7,437,1306,0,0,3,180,4,257,6.634113,37.921168,37,54
"172.16.133.41",52704,"208.71.123.86",80,6,366,1307,0,0,4,246,2,120,6.638298,13.377317000000001,147,71
"172.16.133.41",52705,"208.71.123.86",80,6,366,1308,0,0,4,246,2,120,6.638466,13.377146999999997,147,71
"172.16.133.33",57823,"172.16.139.250",5440,12,1142,1309,0,0,12,1142,0,0,6.638575,0.01500900000000005,608701,0
"172.16.133.41",52706,"208.71.123.86",80,6,366,1310,0,0,4,246,2,120,6.638729,13.376064000000001,147,71
"172.16.133.41",52707,"23.67.243.65",80,16,4973,1311,0,0,9,3500,7,1473,6.638979,73.37313999999999,381,160
"172.16.133.41",52708,"23.67.243.65",80,6,372,1312,0,0,4,246,2,126,6.6392240000000005,13.371816,147,75
"172.16.133.41",52709,"23.67.243.65",80,6,372,1313,0,0,4,246,2,126,6.639636,13.371405,147,75
"172.16.133.41",52710,"208.81.234.106",80,6,366,1314,0,0,4,246,2,120,6.6422419999999995,13.438659000000001,146,71
"172.16.133.41",52711,"208.81.234.106",80,6,366,1315,0,0,4,246,2,120,6.6424199999999995,13.440107,146,71
"172.16.133.41",52712,"208.81.234.106",80,6,366,1316,0,0,4,246,2,120,6.64276,13.434492000000002,146,71
"172.16.133.41",52713,"91.103.138.13",80,8,486,1317,0,0,4,246,4,240,6.642972,13.445440999999999,146,142
"172.16.133.41",52714,"91.103.138.13",80,8,486,1318,0,0,4,246,4,240,6.643147,13.446107000000001,146,142
"172.16.133.41",52715,"91.103.138.13",80,8,486,1319,0,0,4,246,4,240,6.6432970000000005,13.449223,146,142
"172.16.133.20",60177,"173.194.43.38",443,393,254082,1320,0,0,166,57244,227,196838,6.644563,258.82421899999997,1769,6084
"172.16.133.41",52716,"64.94.2.224",80,10,1552,1321,0,0,5,885,5,667,6.648345,0.9005830000000001,7861,5925
"172.16.133.41",52717,"64.94.2.224",80,6,372,1322,0,0,4,246,2,126,6.648498,13.376213,147,75
"172.16.133.41",52718,"64.94.2.224",80,6,372,1323,0,0,4,246,2,126,6.648632,13.375258000000002,147,75
"172.16.133.68",60664,"172.16.139.250",5440,10,1022,1324,0,0,10,1022,0,0,6.668735,0.020691000000000237,395147,0
"172.16.133.132",54683,"98.139.161.29",80,9,1428,1325,0,0,5,715,4,713,6.675542,0.1212390000000001,47179,47047
"172.16.133.67",55910,"216.219.115.250",443,6,366,1326,0,0,4,246,2,120,6.681534,0.060845999999999734,32343,15777
"172.16.133.12",59655,"172.16.139.250",5440,12,1142,1327,0,0,12,1142,0,0,6.683198,0.010095999999999883,904912,0
"172.16.133.63",53820,"172.16.139.250",5440,10,1022,1328,0,0,10,1022,0,0,6.690083,0.008098000000000383,1009632,0
"172.16.133.78",58630,"157.56.241.150",443,67,9622,1329,0,0,34,7642,33,1980,6.690921,292.49445099999997,209,54
"172.16.133.67",55911,"67.217.66.244",443,6,366,1330,0,0,4,246,2,120,6.699522,0.06130600000000008,32101,15659
"172.16.133.132",52395,"98.139.240.23",80,9,1654,1331,0,0,5,1036,4,618,6.702072,0.14495900000000006,57174,34106
"172.16.133.66",53794,"172.16.139.250",5440,12,1142,1332,0,0,12,1142,0,0,6.706887,0.015501000000000431,589381,0
"172.16.133.82",61266,"172.16.139.250",5440,12,1142,1333,0,0,12,1142,0,0,6.720104,0.005838999999999928,1564651,0
"172.16.133.67",55912,"68.64.13.250",443,6,366,1334,0,0,4,246,2,120,6.7345690000000005,0.1356149999999996,14511,7078
"172.16.133.37",60550,"172.16.139.250",5440,10,1022,1335,0,0,10,1022,0,0,6.736946,0.015513000000000332,527041,0
"172.16.133.67",55913,"68.64.30.250",443,6,366,1336,0,0,4,246,2,120,6.7415,0.11870399999999925,16579,8087
"172.16.133.66",53353,"96.43.146.48",443,7,437,1337,0,0,3,180,4,257,6.749091,37.808248,38,54
"172.16.133.66",51597,"96.43.146.176",443,7,437,1338,0,0,3,180,4,257,6.754091,37.80213,38,54
"172.16.133.66",53355,"96.43.146.48",443,7,437,1339,0,0,3,180,4,257,6.754092,37.801101,38,54
"172.16.133.25",62945,"216.52.242.80",80,4,240,1340,0,0,3,180,1,60,6.764819,31.119239000000004,46,15
"172.16.133.41",52719,"199.102.234.31",80,9,2231,1341,0,0,5,632,4,1599,6.771002,0.1249589999999996,40461,102369
"68.64.28.20",443,"172.16.133.47",56538,113,8579,1342,0,0,56,4198,57,4381,6.776626,292.945047,114,119
"172.16.133.92",57625,"172.16.128.169",8014,15,6113,1343,0,0,8,3161,7,2952,6.78627,3.678421,6874,6420
"172.16.133.66",53356,"96.43.146.48",443,7,437,1344,0,0,3,180,4,257,6.789084,37.768305999999995,38,54
"172.16.133.29",60766,"208.111.160.6",80,45,44643,1345,0,0,12,3901,33,40742,6.8161819999999995,54.288244,574,6003
"172.16.133.29",60768,"208.111.160.6",80,34,31683,1346,0,0,9,2366,25,29317,6.836958,34.263856,552,6844
"216.115.208.199",443,"172.16.133.47",56532,132,24558,1347,0,0,73,13164,59,11394,6.836958,282.884588,372,322
"172.16.133.29",60770,"208.111.160.6",80,47,37370,1348,0,0,19,3040,28,34330,6.837301,34.263251999999994,709,8015
"172.16.133.29",60769,"208.111.160.6",80,22,19260,1349,0,0,7,1559,15,17701,6.837498,34.262929,364,4132
"172.16.133.132",38702,"98.139.134.187",80,15,8483,1350,0,0,8,942,7,7541,6.857121,0.16001300000000018,47096,377019
"172.16.133.44",64701,"138.108.6.20",80,8,1961,1351,0,0,4,1303,4,658,6.865146,11.076459,941,475
"172.16.133.44",64702,"64.94.107.55",80,8,1317,1352,0,0,5,845,3,472,6.865681,0.07486999999999977,90289,50434
"172.16.133.67",51828,"23.66.230.80",80,2449,2855619,1353,0,0,576,48022,1873,2807597,6.867545,292.418026,1313,76810
"172.16.133.23",55037,"216.219.115.250",443,6,366,1354,0,0,4,246,2,120,6.877836,0.06348399999999987,30999,15121
"172.16.133.41",52469,"23.60.228.46",80,13,804,1355,0,0,7,420,6,384,6.8778369999999995,193.14038,17,15
"172.16.133.41",52471,"54.243.68.206",80,6,366,1356,0,0,3,180,3,186,6.877887,23.138025,62,64
"50.136.53.54",23604,"172.16.133.25",59742,208,15173,1357,0,0,105,8744,103,6429,6.880553,288.394093,242,178
"172.16.133.78",59028,"172.16.139.250",5440,12,1142,1358,0,0,12,1142,0,0,6.890517,0.0065309999999998425,1398866,0
"129.10.139.136",60873,"172.16.133.25",59780,189,14195,1359,0,0,98,8352,91,5843,6.892558,292.42118999999997,228,159
"172.16.133.23",55038,"67.217.66.244",443,6,366,1360,0,0,4,246,2,120,6.89673,0.0683959999999999,28773,14035
"172.16.133.44",64703,"64.94.107.14",80,8,1924,1361,0,0,5,1461,3,463,6.92587,0.08784700000000001,133049,42164
"107.20.161.243",443,"172.16.133.48",60314,5,331,1362,0,0,3,211,2,120,6.933249,0.40753799999999973,4141,2355
"172.16.133.103",63421,"202.173.24.200",443,7,426,1363,0,0,5,306,2,120,6.94303,1.192333999999999,2053,805
"174.65.136.31",11315,"172.16.133.25",60577,55,3792,1364,0,0,29,1993,26,1799,6.943581,286.300989,55,50
"172.16.133.67",55914,"172.16.139.250",5440,10,1022,1365,0,0,10,1022,0,0,6.944799,0.020186999999999955,405013,0
"172.16.133.28",49251,"157.56.234.118",443,23,1860,1366,0,0,12,1200,11,660,6.94517,270.05882299999996,35,19
"96.43.146.22",443,"172.16.133.26",52964,40,19062,1367,0,0,17,2832,23,16230,6.946257,279.862819,80,463
"172.16.133.113",55586,"63.147.189.115",80,16,7272,1368,0,0,8,2338,8,4934,6.951689,0.816452,22908,48345
"172.16.133.113",55585,"63.147.189.115",80,17,6418,1369,0,0,8,1418,9,5000,6.953123,25.27957,448,1582
"172.16.133.72",52215,"172.16.128.169",8014,16,7102,1370,0,0,9,4150,7,2952,6.954804,2.910317,11407,8114
"172.16.133.23",55039,"68.64.30.250",443,8,486,1371,0,0,5,306,3,180,6.965765,3.1187010000000006,784,461
"172.16.133.56",61348,"172.16.139.250",5440,12,1142,1372,0,0,12,1142,0,0,6.966852,0.004710999999999466,"",""
"172.16.133.42",57011,"172.16.139.250",5440,12,1142,1373,0,0,12,1142,0,0,6.966967,0.01021599999999978,894283,0
"172.16.133.67",51321,"216.115.209.97",443,56,4293,1374,0,0,28,2130,28,2163,6.967234,118.475185,143,146
"172.16.133.132",50472,"76.13.6.174",80,10,1995,1375,0,0,6,783,4,1212,6.984565,0.35522900000000046,17633,27295
"172.16.133.23",55040,"68.64.13.250",443,7,426,1376,0,0,5,306,2,120,6.985759,0.4282110000000001,5716,2241
"172.16.133.25",62957,"23.33.81.244",80,5,306,1377,0,0,3,180,2,126,6.991789,30.861546,46,32
"172.16.131.10",443,"172.16.133.234",52485,630,182716,1378,0,0,310,50600,320,132116,7.013911,291.484385,1388,3626
"172.16.133.75",50881,"172.16.139.250",5440,10,1022,1379,0,0,10,1022,0,0,7.022392,0.019859000000000293,411702,0
"172.16.133.41",52509,"54.243.70.224",443,8,517,1380,0,0,4,240,4,277,7.023806,24.918028,77,88
"172.16.133.41",52720,"172.16.139.250",5440,10,1022,1381,0,0,10,1022,0,0,7.023925,0.005021999999999416,1628036,0
"172.16.133.132",54687,"98.139.161.29",80,11,1937,1382,0,0,7,1224,4,713,7.0408,0.929595,10533,6136
"172.16.133.85",52191,"172.16.139.250",5440,10,1022,1383,0,0,10,1022,0,0,7.041561,0.018665000000000376,438039,0
"172.16.133.24",57671,"216.115.217.254",443,7,426,1384,0,0,5,306,2,120,7.047559,0.5694180000000006,4299,1685
"216.115.208.199",443,"172.16.133.118",56739,131,24436,1385,0,0,71,13013,60,11423,7.050193,288.723727,360,316
"172.16.133.132",44377,"98.138.19.88",80,11,1755,1386,0,0,6,807,5,948,7.058966,3.233817,1996,2345
"172.16.133.66",53354,"96.43.146.48",443,6,377,1387,0,0,3,180,3,197,7.07414,37.486934,38,42
"172.16.133.10",10190,"172.16.128.169",8014,11,4736,1388,0,0,6,2036,5,2700,7.085861,5.086650999999999,3202,4246
"172.16.133.119",49272,"172.16.128.169",8014,13,5544,1389,0,0,7,2784,6,2760,7.094755,5.37596,4142,4107
"172.16.133.41",52562,"54.243.70.224",443,8,548,1390,0,0,4,246,4,302,7.094807,24.847414,79,97
"172.16.133.43",57708,"172.16.139.250",5440,12,1142,1391,0,0,12,1142,0,0,7.09645,0.008537999999999712,1070039,0
"172.16.133.132",52400,"98.139.240.23",80,10,1728,1392,0,0,6,1110,4,618,7.096725,3.131946,2835,1578
"172.16.133.24",57672,"216.219.120.244",443,7,432,1393,0,0,5,312,2,120,7.100566,3.17518,786,302
"172.16.133.66",53694,"208.47.254.81",80,3,180,1394,0,0,2,120,1,60,7.105168,0.3254210000000004,2950,1475
"172.16.133.13",52983,"172.16.139.250",5440,10,1022,1395,0,0,10,1022,0,0,7.113069,0.0054109999999996106,1510996,0
"172.16.133.39",64172,"216.137.33.49",80,5,300,1396,0,0,3,180,2,120,7.128502,38.620898000000004,37,24
"172.16.133.39",64213,"216.137.33.49",80,5,300,1397,0,0,3,180,2,120,7.138419,38.611915,37,24
"172.16.133.20",62306,"172.16.139.250",5440,12,1142,1398,0,0,12,1142,0,0,7.160798,0.010148000000000046,900275,0
"172.16.133.28",65278,"172.16.139.250",5440,12,1142,1399,0,0,12,1142,0,0,7.194047,0.006685999999999304,1366437,0
"172.16.133.82",61052,"173.194.43.33",443,10,702,1400,0,0,4,240,6,462,7.209135,59.92863299999999,32,61
"207.237.194.246",17693,"172.16.133.25",58099,54,3830,1401,0,0,29,2093,25,1737,7.209677,285.939835,58,48
"172.16.133.99",55988,"172.16.139.250",5440,12,1142,1402,0,0,12,1142,0,0,7.217736,0.014546999999999422,628033,0
"65.31.30.198",23196,"172.16.133.25",62993,194,15645,1403,0,0,100,9415,94,6230,7.223004,262.716327,286,189
"172.16.133.116",52530,"216.52.242.80",443,21,8827,1404,0,0,10,2998,11,5829,7.233291,259.245561,92,179
"172.16.133.99",52170,"157.56.240.102",443,10,775,1405,0,0,5,475,5,300,7.239788,240.022085,15,9
"172.16.133.87",60124,"172.16.139.250",5440,10,1022,1406,0,0,10,1022,0,0,7.240012,0.0054059999999998,1512393,0
"172.16.133.115",53731,"173.194.43.38",80,10,618,1407,0,0,5,300,5,318,7.244854,108.217064,22,23
"172.16.133.24",57673,"216.115.220.254",443,7,426,1408,0,0,4,246,3,180,7.25355,0.5945400000000003,3310,2422
"172.16.133.115",53730,"173.194.43.38",80,10,618,1409,0,0,5,300,5,318,7.254857,108.20719199999999,22,23
"172.16.133.116",53142,"172.16.139.250",5440,10,1022,1410,0,0,10,1022,0,0,7.25667,0.004796000000000689,"",""
"172.16.133.115",53732,"173.194.43.38",80,10,618,1411,0,0,5,300,5,318,7.259831,108.201836,22,23
"172.16.133.116",53143,"172.16.139.250",5440,10,1022,1412,0,0,10,1022,0,0,7.26279,0.005529000000000117,1478748,0
"172.16.133.35",49916,"172.16.139.250",5440,12,1142,1413,0,0,12,1142,0,0,7.263956,0.016585999999999324,550825,0
"172.16.133.116",53144,"172.16.139.250",5440,10,1022,1414,0,0,10,1022,0,0,7.26921,0.005720999999999421,1429120,0
"172.16.133.18",49990,"157.56.238.6",443,185,81426,1415,0,0,85,35615,100,45811,7.277376,286.451564,994,1279
"172.16.133.84",58736,"172.16.139.250",5440,10,1022,1416,0,0,10,1022,0,0,7.279472,0.00524599999999964,1558520,0
"172.16.133.24",57674,"202.173.27.250",443,6,366,1417,0,0,4,246,2,120,7.297529,0.6199560000000002,3174,1548
"172.16.133.49",55712,"172.16.139.250",5440,10,1022,1418,0,0,10,1022,0,0,7.358104,0.005668000000000006,1442484,0
"157.56.241.150",443,"172.16.133.78",49315,10,775,1419,0,0,5,475,5,300,7.371655,240.221966,15,9
"172.16.133.95",56889,"172.16.139.250",5440,10,1022,1420,0,0,10,1022,0,0,7.392594,0.00556599999999996,1468918,0
"172.16.133.41",52721,"98.138.49.43",80,16,4792,1421,0,0,8,3084,8,1708,7.402413,22.644660000000002,1089,603
"172.16.133.41",52722,"74.117.199.102",80,10,2903,1422,0,0,6,1813,4,1090,7.409826,0.28737800000000036,50470,30343
"172.16.133.92",57626,"172.16.139.250",5440,12,1142,1423,0,0,12,1142,0,0,7.42132,0.00959800000000044,951864,0
"67.244.23.29",19730,"172.16.133.25",59777,66,4682,1424,0,0,35,2584,31,2098,7.42819,283.16717100000005,73,59
"172.16.133.41",52723,"206.188.4.2",80,13,4884,1425,0,0,8,3601,5,1283,7.429878,0.5138109999999996,56067,19976
"172.16.133.41",52724,"69.2.103.57",80,24,4836,1426,0,0,13,2625,11,2211,7.434948,289.07075,72,61
"172.16.133.85",58941,"96.43.146.22",443,37,16274,1427,0,0,21,13481,16,2793,7.435718,285.369945,377,78
"172.16.133.41",52725,"69.25.24.24",80,43,24356,1428,0,0,23,14649,20,9707,7.436597,289.090444,405,268
"172.16.133.41",52726,"23.62.151.196",80,21,4142,1429,0,0,11,2842,10,1300,7.436748,270.587227,84,38
"172.16.133.41",52727,"64.12.96.244",80,11,1512,1430,0,0,6,984,5,528,7.436895,12.575073,626,335
"172.16.133.41",52728,"208.71.125.72",80,8,1603,1431,0,0,5,950,3,653,7.43706,0.2116940000000005,35900,24677
"172.16.133.29",60823,"172.16.139.250",5440,12,1142,1432,0,0,12,1142,0,0,7.438883,0.006221000000000032,1468574,0
"172.16.133.53",65440,"216.115.208.199",443,135,26183,1433,0,0,60,12961,75,13222,7.445555,288.92218299999996,358,366
"172.16.133.44",64704,"172.16.139.250",5440,10,1022,1434,0,0,10,1022,0,0,7.446405,0.005331999999999226,1533383,0
"172.16.133.93",60524,"216.52.92.23",80,16,960,1435,0,0,8,480,8,480,7.462213,260.04632799999996,14,14
"172.16.133.41",52729,"23.0.51.167",80,24,4702,1436,0,0,12,2266,12,2436,7.466459,252.53829100000002,71,77
"172.16.133.41",52461,"74.125.226.77",80,20,6294,1437,0,0,11,2928,9,3366,7.469067,289.446476,80,93
"172.16.133.207",55879,"172.16.139.250",5440,10,1022,1438,0,0,10,1022,0,0,7.470101,0.01516699999999993,539065,0
"172.16.133.63",57778,"173.194.76.125",5222,20,2944,1439,0,0,10,600,10,2344,7.476516,270.038408,17,69
"172.16.133.83",57029,"172.16.139.250",5440,10,1022,1440,0,0,10,1022,0,0,7.478715,0.01482699999999948,551426,0
"172.16.133.18",50187,"157.56.238.6",443,202,70608,1441,0,0,97,36882,105,33726,7.479915,286.585164,1029,941
"172.16.133.20",62307,"172.16.128.169",8014,10,4598,1442,0,0,5,1898,5,2700,7.490133,2.974760999999999,5104,7261
"172.16.133.28",65279,"172.16.128.169",8014,10,4598,1443,0,0,5,1898,5,2700,7.491367,2.3736999999999995,6396,9099
"172.16.133.33",57824,"172.16.128.169",8014,10,4638,1444,0,0,5,1938,5,2700,7.495084,2.4644999999999992,6290,8764
"172.16.133.88",51220,"172.16.128.169",8014,10,4638,1445,0,0,5,1938,5,2700,7.495421,2.220219,6983,9728
"172.16.133.25",63349,"172.16.128.169",8014,10,4630,1446,0,0,5,1930,5,2700,7.496099,2.2621919999999998,6825,9548
"172.16.133.93",60605,"172.16.139.250",5440,12,1142,1447,0,0,12,1142,0,0,7.497035,0.0055509999999996396,1645829,0
"172.16.133.103",63422,"172.16.128.169",8014,10,4606,1448,0,0,5,1906,5,2700,7.498208,2.159471,7060,10002
"172.16.133.68",60665,"172.16.128.169",8014,15,6242,1449,0,0,8,3290,7,2952,7.498468,2.4620240000000004,10690,9592
"172.16.133.95",56890,"172.16.128.169",8014,10,4606,1450,0,0,5,1906,5,2700,7.49947,2.2599240000000007,6747,9557
"172.16.133.71",57542,"173.194.43.0",443,7,494,1451,0,0,5,354,2,140,7.503383,11.112836999999999,254,100
"172.16.133.34",50384,"172.16.128.169",8014,13,5498,1452,0,0,8,2802,5,2696,7.503765,11.508332000000001,1947,1874
"172.16.133.60",62128,"172.16.128.169",8014,19,7062,1453,0,0,11,4054,8,3008,7.507921,11.588971,2798,2076
"172.16.133.75",50882,"172.16.128.169",8014,12,4722,1454,0,0,7,2026,5,2696,7.508406,11.604247,1396,1858
"172.16.133.46",64540,"172.16.128.169",8014,14,5570,1455,0,0,8,2814,6,2756,7.5091909999999995,11.351469,1983,1942
"172.16.133.11",55088,"172.16.139.250",5440,12,1142,1456,0,0,12,1142,0,0,7.513331,0.01684299999999972,542421,0
"172.16.133.55",57524,"172.16.139.250",5440,10,1022,1457,0,0,10,1022,0,0,7.517041,0.0168740000000005,484532,0
"172.16.133.73",60514,"172.16.139.250",5440,10,1022,1458,0,0,10,1022,0,0,7.541694,0.016468000000000593,496478,0
"172.16.133.53",54045,"172.16.139.250",5440,12,1142,1459,0,0,12,1142,0,0,7.54392,0.006388000000000282,1430181,0
"172.16.133.21",53118,"172.16.139.250",5440,12,1142,1460,0,0,12,1142,0,0,7.546529,0.007153000000000631,1277226,0
"172.16.133.30",62556,"172.16.139.250",5440,10,1022,1461,0,0,10,1022,0,0,7.548982,0.018703000000000358,437149,0
"172.16.133.25",63350,"172.16.139.250",5440,10,1022,1462,0,0,10,1022,0,0,7.557816,0.005184999999999995,1576856,0
"172.16.133.34",50385,"172.16.139.250",5440,12,1142,1463,0,0,12,1142,0,0,7.5655280000000005,0.005303999999999753,1722473,0
"172.16.133.76",62356,"172.16.128.169",8014,10,4630,1464,0,0,5,1930,5,2700,7.577282,2.183574,7070,9892
"172.16.133.97",59315,"172.16.139.250",5440,10,1022,1465,0,0,10,1022,0,0,7.577363,0.005456999999999823,1498259,0
"172.16.133.18",50231,"157.56.238.6",443,181,81975,1466,0,0,81,36205,100,45770,7.582096,292.15744800000004,991,1253
"172.16.133.66",53378,"96.43.146.22",443,7,437,1467,0,0,3,180,4,257,7.584195,36.972139999999996,38,55
"172.16.133.66",53377,"96.43.146.22",443,6,377,1468,0,0,3,180,3,197,7.5891079999999995,36.96514500000001,38,42
"172.16.133.93",49423,"132.245.1.150",443,15,1288,1469,0,0,8,868,7,420,7.607384,240.03390100000001,28,13
"216.115.208.199",443,"172.16.133.26",53035,186,47996,1470,0,0,103,24034,83,23962,7.637971,285.70860600000003,672,670
"172.16.133.33",57825,"172.16.139.250",5440,12,1142,1471,0,0,12,1142,0,0,7.65263,0.006675999999999682,1368484,0
"172.16.133.41",52730,"69.2.103.57",80,23,4764,1472,0,0,13,2619,10,2145,7.6609110000000005,288.93493,72,59
"172.16.133.41",52426,"74.125.226.26",80,18,2470,1473,0,0,9,1418,9,1052,7.678268,242.345724,46,34
"172.16.133.68",60666,"172.16.139.250",5440,12,1142,1474,0,0,12,1142,0,0,7.683107,0.006293000000000326,1451771,0
"172.16.133.12",59656,"172.16.139.250",5440,12,1142,1475,0,0,12,1142,0,0,7.696293,0.0065830000000000055,1387817,0
"172.16.133.63",53821,"172.16.139.250",5440,12,1142,1476,0,0,12,1142,0,0,7.704574,0.0059149999999998926,1544547,0
"172.16.133.75",57857,"172.16.139.250",5500,194,92400,1477,0,0,194,92400,0,0,7.719951,240.196283,3077,0
"172.16.133.28",63807,"96.43.146.48",443,19,3273,1478,0,0,10,2425,9,848,7.720995,270.480813,71,25
"172.16.133.66",53795,"172.16.139.250",5440,10,1022,1479,0,0,10,1022,0,0,7.7209959999999995,0.0054230000000004,1507652,0
"172.16.133.82",61267,"172.16.139.250",5440,10,1022,1480,0,0,10,1022,0,0,7.733281,0.005765000000000242,1418213,0
"172.16.133.93",60526,"23.60.159.231",80,15,936,1481,0,0,8,480,7,456,7.736194,259.79821799999996,14,14
"172.16.133.93",60510,"23.32.180.174",80,15,936,1482,0,0,8,480,7,456,7.736196,259.771464,14,14
"172.16.133.235",2693,"172.16.128.169",8014,15,6138,1483,0,0,8,3190,7,2948,7.74365,4.088608,6241,5768
"172.16.133.93",60525,"23.60.159.231",80,15,936,1484,0,0,8,480,7,456,7.745209,259.788948,14,14
"172.16.133.41",52731,"69.2.103.57",80,24,4806,1485,0,0,13,2610,11,2196,7.748327,288.948647,72,60
"172.16.133.37",60551,"172.16.139.250",5440,10,1022,1486,0,0,10,1022,0,0,7.748443,0.005091000000000179,1605971,0
"172.16.133.71",57543,"173.194.43.0",443,33,8315,1487,0,0,19,3633,14,4682,7.750402,240.298485,120,155
"172.16.133.93",60498,"23.32.180.174",80,15,936,1488,0,0,8,480,7,456,7.762182,259.745247,14,14
"172.16.133.57",59185,"67.217.64.97",443,113,8547,1489,0,0,57,4381,56,4166,7.762703,291.688307,120,114
"96.43.146.22",443,"172.16.133.84",57724,40,18456,1490,0,0,17,2832,23,15624,7.77624,279.740026,80,446
"96.43.146.48",443,"172.16.133.121",56322,37,15260,1491,0,0,16,2836,21,12424,7.780141,53.302421,425,1864
"172.16.133.93",60528,"23.32.180.174",80,15,936,1492,0,0,8,480,7,456,7.816179,259.691732,14,14
"172.16.133.93",60527,"23.32.180.174",80,18,1116,1493,0,0,9,540,9,576,7.82121,249.69736,17,18
"172.16.133.93",60530,"23.32.180.174",80,15,936,1494,0,0,8,480,7,456,7.821212,259.687036,14,14
"172.16.133.93",60446,"23.6.20.174",80,15,936,1495,0,0,8,480,7,456,7.825184,259.689449,14,14
"172.16.133.93",60529,"23.32.180.174",80,15,936,1496,0,0,8,480,7,456,7.832228,259.675096,14,14
"157.56.234.118",443,"172.16.133.45",61078,10,775,1497,0,0,5,475,5,300,7.86048,240.54730700000002,15,9
"172.16.133.103",62688,"157.56.234.118",443,38,4217,1498,0,0,19,3077,19,1140,7.882686,270.23282700000004,91,33
"172.16.133.78",59029,"172.16.139.250",5440,12,1142,1499,0,0,12,1142,0,0,7.904835,0.015966999999999842,572180,0
"67.228.168.221",80,"172.16.133.126",57749,96,8465,1500,0,0,61,6347,35,2118,7.908011,284.865591,178,59
"172.16.133.93",60416,"23.6.20.174",80,6,366,1501,0,0,3,180,3,186,7.916225,9.608267999999999,149,154
"172.16.133.66",63793,"96.43.146.48",443,26,7981,1502,0,0,15,6705,11,1276,7.934196,292.018005,183,34
"50.30.152.70",33378,"172.16.133.114",55150,346,212799,1503,0,0,154,11856,192,200943,7.944456,280.417667,338,5732
"172.16.133.67",55915,"172.16.139.250",5440,10,1022,1504,0,0,10,1022,0,0,7.957826,0.005443000000000531,1502112,0
"172.16.133.41",52732,"173.194.43.45",80,30,7942,1505,0,0,17,4021,13,3921,7.964297,289.017092,111,108
"172.16.133.42",57012,"172.16.139.250",5440,12,1142,1506,0,0,12,1142,0,0,7.980429,0.018661999999999956,489550,0
"172.16.133.56",61349,"172.16.139.250",5440,12,1142,1507,0,0,12,1142,0,0,7.982246,0.005034000000000205,1814858,0
"157.56.242.198",443,"172.16.133.12",50693,29,4457,1508,0,0,17,3731,12,726,7.997496,266.265156,112,21
"172.16.133.12",50692,"157.56.242.198",443,44,8519,1509,0,0,23,7259,21,1260,7.999024,283.01741999999996,205,35
"157.56.237.150",443,"172.16.133.128",54502,14,1173,1510,0,0,7,753,7,420,8.031342,275.150062,21,12
"172.16.133.75",50883,"172.16.139.250",5440,12,1142,1511,0,0,12,1142,0,0,8.035794,0.0067320000000012925,1357100,0
"172.16.133.41",52446,"74.125.226.58",80,38,19370,1512,0,0,22,13235,16,6135,8.037634,289.182235,366,169
"172.16.133.41",52733,"172.16.139.250",5440,12,1142,1513,0,0,12,1142,0,0,8.037787,0.015237000000000833,599593,0
"172.16.133.85",52192,"172.16.139.250",5440,12,1142,1514,0,0,12,1142,0,0,8.054657,0.0061189999999999856,1493054,0
"172.16.133.93",60533,"107.22.184.229",80,6,360,1515,0,0,3,180,3,180,8.091266,19.428671,74,74
"172.16.133.93",60532,"107.22.184.229",80,6,366,1516,0,0,3,180,3,186,8.095224,19.423620999999997,74,76
"172.16.133.43",57709,"172.16.139.250",5440,12,1142,1517,0,0,12,1142,0,0,8.11045,0.015660999999999703,583359,0
"172.16.133.71",56709,"173.194.76.125",5222,60,12657,1518,0,0,30,2882,30,9775,8.115828,289.165188,79,270
"172.16.133.41",52374,"23.60.230.152",80,15,936,1519,0,0,8,480,7,456,8.115902,261.901546,14,13
"172.16.133.13",52984,"172.16.139.250",5440,10,1022,1520,0,0,10,1022,0,0,8.126021,0.005376000000000047,1520833,0
"172.16.133.93",60534,"64.236.116.18",80,15,900,1521,0,0,8,480,7,420,8.126269,259.388957,14,12
"172.16.133.39",62820,"216.115.209.97",443,54,4047,1522,0,0,27,2023,27,2024,8.135735,115.981757,139,139
"74.125.226.214",443,"172.16.133.76",60523,146,63947,1523,0,0,81,31375,65,32572,8.140434,291.65827199999995,860,893
"172.16.133.85",65372,"216.52.242.80",80,17,5724,1524,0,0,12,3628,5,2096,8.160888,266.695227,108,62
"172.16.133.20",62308,"172.16.139.250",5440,12,1142,1525,0,0,12,1142,0,0,8.174469,0.004903000000000546,"",""
"172.16.133.41",52472,"23.60.159.231",80,15,936,1526,0,0,8,480,7,456,8.178861,261.835254,14,13
"173.194.43.54",443,"172.16.133.25",60567,82,34670,1527,0,0,47,21767,35,12903,8.182233,283.735292,613,363
"172.16.133.28",65280,"172.16.139.250",5440,12,1142,1528,0,0,12,1142,0,0,8.20761,0.015485999999999223,589952,0
"172.16.133.41",52567,"74.125.226.58",443,17,1140,1529,0,0,8,480,9,660,8.215908,195.03266299999999,19,27
"172.16.133.99",55989,"172.16.139.250",5440,12,1142,1530,0,0,12,1142,0,0,8.23193,0.005053999999999448,1807677,0
"172.16.133.87",60125,"172.16.139.250",5440,12,1142,1531,0,0,12,1142,0,0,8.25506,0.016152999999999196,565591,0
"172.16.133.93",60473,"23.67.242.11",80,15,2143,1532,0,0,8,1365,7,778,8.257737,270.191717,40,23
"172.16.133.39",64210,"63.116.244.80",80,14,870,1533,0,0,8,480,6,390,8.269438,220.410684,17,14
"172.16.133.116",53145,"172.16.139.250",5440,12,1142,1534,0,0,12,1142,0,0,8.270482,0.006075000000000941,1503868,0
"172.16.133.116",53146,"172.16.139.250",5440,10,1022,1535,0,0,10,1022,0,0,8.277448,0.005150000000000432,1587572,0
"172.16.133.237",2267,"64.94.18.161",443,30,2420,1536,0,0,20,1510,10,910,8.282154,270.391239,44,26
"172.16.133.116",53147,"172.16.139.250",5440,10,1022,1537,0,0,10,1022,0,0,8.28342,0.016383000000001147,499053,0
"172.16.133.84",58737,"172.16.139.250",5440,12,1142,1538,0,0,12,1142,0,0,8.293417,0.015969000000000122,572108,0
"172.16.133.78",59030,"68.191.201.2",33593,6,374,1539,0,0,3,194,3,180,8.316664,1.2724390000000003,1219,1131
"172.16.133.21",52572,"96.43.146.22",443,45,21137,1540,0,0,26,18185,19,2952,8.338081,290.34812,501,81
"172.16.133.49",55713,"172.16.139.250",5440,12,1142,1541,0,0,12,1142,0,0,8.370922,0.006301999999999808,1449698,0
"172.16.133.41",52565,"67.69.174.136",80,17,3846,1542,0,0,9,3082,8,764,8.379947,254.375773,96,24
"172.16.133.93",60536,"205.234.225.216",80,15,936,1543,0,0,8,480,7,456,8.381236,259.152382,14,14
"172.16.133.95",56891,"172.16.139.250",5440,10,1022,1544,0,0,10,1022,0,0,8.406529,0.00541199999999975,1510716,0
"173.62.112.151",19429,"172.16.133.25",59901,80,5843,1545,0,0,41,3261,39,2582,8.414343,282.382042,92,73
"172.16.133.92",57627,"172.16.139.250",5440,10,1022,1546,0,0,10,1022,0,0,8.435485,0.005570999999999771,1467600,0
"173.194.76.125",5222,"172.16.133.78",61672,14,1546,1547,0,0,7,786,7,760,8.43554,279.777987,22,21
"172.16.133.118",58207,"180.153.30.250",443,6,366,1548,0,0,4,246,2,120,8.446703,0.695844000000001,2828,1379
"172.16.133.29",60824,"172.16.139.250",5440,10,1022,1549,0,0,10,1022,0,0,8.453189,0.005675999999999348,1440451,0
"172.16.133.44",64705,"172.16.139.250",5440,10,1022,1550,0,0,10,1022,0,0,8.460047,0.01454000000000022,562310,0
"172.16.133.41",52488,"23.21.215.52",80,8,480,1551,0,0,4,240,4,240,8.475898,21.540117,89,89
"172.16.133.207",55880,"172.16.139.250",5440,12,1142,1552,0,0,12,1142,0,0,8.485249,0.017869000000001023,511276,0
"172.16.133.83",57030,"172.16.139.250",5440,12,1142,1553,0,0,12,1142,0,0,8.493783,0.005041000000000295,1812338,0
"172.16.133.93",60606,"172.16.139.250",5440,12,1142,1554,0,0,12,1142,0,0,8.510216,0.004910999999999888,"",""
"172.16.133.35",49917,"172.16.139.250",5440,12,1142,1555,0,0,12,1142,0,0,8.510359,0.044961000000000695,203198,0
"172.16.133.11",55089,"172.16.139.250",5440,10,1022,1556,0,0,10,1022,0,0,8.526627,0.011115000000000208,735582,0
"172.16.133.55",57525,"172.16.139.250",5440,12,1142,1557,0,0,12,1142,0,0,8.530769,0.015420000000000655,592477,0
"96.43.146.22",443,"172.16.133.96",49799,30,18046,1558,0,0,12,2638,18,15408,8.546824,279.95948799999996,75,440
"172.16.133.113",55587,"172.16.139.250",135,8,492,1559,0,0,8,492,0,0,8.553712,0.011502999999999375,342171,0
"172.16.133.73",60515,"172.16.139.250",5440,10,1022,1560,0,0,10,1022,0,0,8.554617,0.01906600000000047,428826,0
"172.16.133.53",54046,"172.16.139.250",5440,10,1022,1561,0,0,10,1022,0,0,8.557334,0.020333999999998298,402085,0
"172.16.133.21",53119,"172.16.139.250",5440,10,1022,1562,0,0,10,1022,0,0,8.559888,0.0220729999999989,370407,0
"172.16.133.30",62557,"172.16.139.250",5440,10,1022,1563,0,0,10,1022,0,0,8.562999,0.005619000000001151,1455063,0
"172.16.133.113",55588,"172.16.139.250",5462,12,816,1564,0,0,12,816,0,0,8.569952,0.5086239999999993,12834,0
"172.16.133.25",63351,"172.16.139.250",5440,12,1142,1565,0,0,12,1142,0,0,8.571879,0.017930000000001556,509537,0
"172.16.133.34",50386,"172.16.139.250",5440,12,1142,1566,0,0,12,1142,0,0,8.580618,0.005309999999999704,1720527,0
"172.16.133.97",59316,"172.16.139.250",5440,12,1142,1567,0,0,12,1142,0,0,8.59132,0.006159000000000248,1483357,0
"157.56.238.6",443,"172.16.133.20",61073,10,883,1568,0,0,5,583,5,300,8.601228,215.68548800000002,21,11
"157.56.238.6",443,"172.16.133.46",62925,13,1177,1569,0,0,7,817,6,360,8.607181,212.611033,30,13
"172.16.133.53",53789,"96.43.146.22",443,9,557,1570,0,0,4,240,5,317,8.618298,83.226167,23,30
"172.16.133.53",53788,"96.43.146.22",443,9,557,1571,0,0,4,240,5,317,8.619216,83.22517900000001,23,30
"172.16.133.33",57826,"172.16.139.250",5440,12,1142,1572,0,0,12,1142,0,0,8.666571,0.006554000000001281,1393957,0
"157.56.242.198",443,"172.16.133.68",49723,84,36959,1573,0,0,57,35339,27,1620,8.673951,240.46394700000002,1175,53
"172.16.133.68",60667,"172.16.139.250",5440,10,1022,1574,0,0,10,1022,0,0,8.697059,0.005695000000001116,1435645,0
"172.16.133.12",59657,"172.16.139.250",5440,12,1142,1575,0,0,12,1142,0,0,8.711356,0.006173000000000428,1479993,0
"172.16.133.63",53822,"172.16.139.250",5440,10,1022,1576,0,0,10,1022,0,0,8.718515,0.014592000000000382,560307,0
"172.16.133.67",55916,"216.219.115.250",443,6,366,1577,0,0,4,246,2,120,8.720564,0.055782000000000664,35280,17209
"172.16.133.67",55917,"67.217.66.244",443,6,366,1578,0,0,4,246,2,120,8.731502,0.06587899999999891,29872,14572
"172.16.133.66",53796,"172.16.139.250",5440,12,1142,1579,0,0,12,1142,0,0,8.73493,0.006612999999999758,1381521,0
"193.182.8.24",443,"172.16.133.46",54846,65,18302,1580,0,0,37,16375,28,1927,8.739487,265.492252,493,58
"172.16.133.82",61268,"172.16.139.250",5440,12,1142,1581,0,0,12,1142,0,0,8.747072,0.015319000000001637,596383,0
"172.16.133.37",60552,"172.16.139.250",5440,10,1022,1582,0,0,10,1022,0,0,8.762105,0.005520999999999887,1480891,0
"172.16.133.24",57542,"204.14.235.118",443,10,600,1583,0,0,5,300,5,300,8.767155,127.225561,18,18
"172.16.133.87",59823,"96.43.146.50",443,11,677,1584,0,0,5,300,6,377,8.769987,127.20096,18,23
"172.16.133.87",59824,"96.43.146.50",443,11,677,1585,0,0,5,300,6,377,8.775013,127.19593599999999,18,23
"172.16.133.87",59822,"96.43.146.50",443,11,677,1586,0,0,5,300,6,377,8.775015,127.195999,18,23
"172.16.133.109",41844,"96.43.146.176",443,106,63321,1587,0,0,54,9519,52,53802,8.791247,3.1728109999999994,24001,135657
"172.16.133.67",55918,"68.64.30.250",443,6,366,1588,0,0,4,246,2,120,8.792544,0.10648899999999983,18480,9015
"172.16.133.24",57541,"204.14.235.118",443,10,600,1589,0,0,5,300,5,300,8.793129,127.20049500000002,18,18
"172.16.133.67",55919,"68.64.13.250",443,6,366,1590,0,0,4,246,2,120,8.796482,0.12393600000000049,15879,7745
"172.16.133.126",59489,"96.43.146.22",443,75,46962,1591,0,0,45,40577,30,6385,8.854335,276.69295,1173,184
"172.16.133.24",57603,"172.16.139.250",5440,4,240,1592,0,0,4,240,0,0,8.863584,6.4000000000064e-05,"",""
"172.16.133.24",57675,"172.16.139.250",5440,10,1020,1593,0,0,10,1020,0,0,8.86502,120.01165200000001,67,0
"172.16.133.78",59031,"172.16.139.250",5440,10,1022,1594,0,0,10,1022,0,0,8.918378,0.015443999999998681,529396,0
"173.194.43.47",443,"172.16.133.115",53569,6,450,1595,0,0,4,330,2,120,8.936959,0.032726000000000255,80669,29334
"172.16.133.28",64577,"216.52.242.80",80,16,5563,1596,0,0,7,3593,9,1970,8.964383,0.7613269999999996,37755,20700
"173.194.43.47",443,"172.16.133.115",53573,7,510,1597,0,0,4,330,3,180,8.968345,0.138224000000001,19099,10417
"173.194.43.47",443,"172.16.133.115",53571,7,510,1598,0,0,4,330,3,180,8.970918,0.13694900000000132,19277,10514
"172.16.133.67",55920,"172.16.139.250",5440,10,1022,1599,0,0,10,1022,0,0,8.971891,0.014805000000000845,552245,0
"173.194.43.47",443,"172.16.133.115",53572,7,510,1600,0,0,4,330,3,180,8.984369000000001,0.1232149999999983,21425,11686
"172.16.133.56",61350,"172.16.139.250",5440,12,1142,1601,0,0,12,1142,0,0,8.995219,0.005373999999999768,1700037,0
"172.16.133.42",57013,"172.16.139.250",5440,12,1142,1602,0,0,12,1142,0,0,9.008753,0.026341000000000392,346835,0
"172.16.133.75",50884,"172.16.139.250",5440,10,1022,1603,0,0,10,1022,0,0,9.05074,0.005391000000001256,1516601,0
"172.16.133.41",52734,"172.16.139.250",5440,10,1022,1604,0,0,10,1022,0,0,9.051577,0.01516900000000021,538994,0
"172.16.133.85",52193,"172.16.139.250",5440,10,1022,1605,0,0,10,1022,0,0,9.075097,0.005845000000000766,1398802,0
"172.16.133.88",64805,"157.56.238.6",443,22,1809,1606,0,0,11,1149,11,660,9.094915,269.348982,34,19
"172.16.133.132",50476,"76.13.6.174",80,9,1930,1607,0,0,5,717,4,1213,9.101265,0.09247400000000106,62028,104937
"172.16.133.132",54691,"98.139.161.29",80,9,1428,1608,0,0,5,715,4,713,9.106291,0.09452899999999964,60510,60341
"172.16.133.128",54500,"157.56.237.150",443,14,1205,1609,0,0,7,785,7,420,9.110747,290.40191599999997,21,11
"172.16.133.43",57710,"172.16.139.250",5440,10,1022,1610,0,0,10,1022,0,0,9.123536,0.005622999999999934,1454028,0
"172.16.133.13",52985,"172.16.139.250",5440,12,1142,1611,0,0,12,1142,0,0,9.141209,0.006005000000000038,1521398,0
"172.16.133.24",57676,"216.115.217.254",443,7,426,1612,0,0,4,246,3,180,9.166474000000001,0.05988999999999933,32860,24044
"172.16.133.20",62309,"172.16.139.250",5440,12,1142,1613,0,0,12,1142,0,0,9.190073,0.014749000000000123,619431,0
"172.16.133.132",52403,"98.139.240.23",80,9,1654,1614,0,0,5,1036,4,618,9.214436,0.12538800000000094,66098,39429
"172.16.133.28",65281,"172.16.139.250",5440,12,1142,1615,0,0,12,1142,0,0,9.222136,0.006511999999998963,1402948,0
"172.16.133.109",41845,"96.43.146.176",443,36,20704,1616,0,0,19,4261,17,16443,9.232118,2.7282550000000008,12494,48215
"172.16.133.87",59827,"96.43.146.50",443,11,677,1617,0,0,5,300,6,377,9.245021,126.72605500000002,18,23
"172.16.133.99",55990,"172.16.139.250",5440,12,1142,1618,0,0,12,1142,0,0,9.245635,0.01589399999999941,574808,0
"172.16.133.78",61011,"96.43.146.178",443,14,840,1619,0,0,7,420,7,420,9.248292,270.304912,12,12
"172.16.133.87",60126,"172.16.139.250",5440,12,1142,1620,0,0,12,1142,0,0,9.267899,0.0060920000000006524,1499671,0
"172.16.133.55",50190,"172.16.139.250",5447,12,1668,1621,0,0,12,1668,0,0,9.274228,262.39448,50,0
"172.16.133.35",49918,"172.16.139.250",5440,12,1142,1622,0,0,12,1142,0,0,9.281828,0.018361999999999767,497549,0
"172.16.133.39",51033,"132.245.1.150",443,10,795,1623,0,0,5,495,5,300,9.28183,243.22054300000002,16,9
"172.16.133.28",65108,"23.33.81.244",80,67,32970,1624,0,0,29,8559,38,24411,9.284052,263.954405,259,739
"172.16.133.116",53148,"172.16.139.250",5440,10,1022,1625,0,0,10,1022,0,0,9.285391,0.00741299999999967,1102927,0
"172.16.133.23",54987,"96.43.146.22",443,9,557,1626,0,0,4,240,5,317,9.288392,76.24921,25,33
"172.16.133.116",53149,"172.16.139.250",5440,12,1142,1627,0,0,12,1142,0,0,9.29384,0.0077110000000004675,1184800,0
"172.16.133.13",50026,"157.56.236.102",443,38,6021,1628,0,0,19,4881,19,1140,9.296361,290.48889,134,31
"172.16.133.116",53150,"172.16.139.250",5440,12,1142,1629,0,0,12,1142,0,0,9.302314,0.006385999999999115,1430629,0
"172.16.133.84",58738,"172.16.139.250",5440,10,1022,1630,0,0,10,1022,0,0,9.306167,0.014937999999999008,547328,0
"172.16.133.114",54346,"216.219.117.209",443,170,35060,1631,0,0,76,17358,94,17702,9.312245,283.387852,490,499
"172.16.133.116",50730,"173.194.43.39",443,37,11129,1632,0,0,19,9761,18,1368,9.312692,240.188152,325,45
"173.194.43.41",443,"172.16.133.87",59745,7,510,1633,0,0,4,330,3,180,9.323603,0.02118399999999987,124622,67975
"157.56.244.214",443,"172.16.133.76",60751,10,775,1634,0,0,5,475,5,300,9.357044,239.708124,15,10
"172.16.133.49",55714,"172.16.139.250",5440,10,1022,1635,0,0,10,1022,0,0,9.385276,0.01549300000000109,527722,0
"172.16.133.63",53512,"96.43.146.22",443,35,17125,1636,0,0,20,14490,15,2635,9.403118,285.3145,406,73
"172.16.133.95",56892,"172.16.139.250",5440,12,1142,1637,0,0,12,1142,0,0,9.42064,0.006236999999998716,1464806,0
"157.56.236.102",443,"172.16.133.13",50027,42,17092,1638,0,0,27,16192,15,900,9.424996,290.37312499999996,446,24
"172.16.133.11",54737,"96.43.146.22",443,5,317,1639,0,0,2,120,3,197,9.435914,0.04666299999999879,20573,33774
"172.16.133.11",54738,"96.43.146.22",443,5,317,1640,0,0,2,120,3,197,9.43617,0.04564899999999916,21030,34524
"172.16.133.11",54494,"96.43.146.48",443,5,317,1641,0,0,2,120,3,197,9.436253,0.046324999999999505,20723,34020
"172.16.133.53",49287,"96.43.146.48",443,26,8075,1642,0,0,15,5010,11,3065,9.446788,240.350551,166,102
"172.16.133.92",57628,"172.16.139.250",5440,10,1022,1643,0,0,10,1022,0,0,9.449316,0.006455000000000766,1266615,0
"172.16.133.29",60825,"172.16.139.250",5440,12,1142,1644,0,0,12,1142,0,0,9.468391,0.006594999999999018,1385291,0
"172.16.133.44",64706,"172.16.139.250",5440,10,1022,1645,0,0,10,1022,0,0,9.474309,0.00557300000000005,1467073,0
"172.16.133.115",53579,"23.67.242.73",80,7,432,1646,0,0,4,240,3,192,9.476971,75.97757499999999,25,20
"172.16.128.169",4503,"172.16.139.250",135,4,240,1647,0,0,2,120,2,120,9.490872,0.09900400000000076,9696,9696
"172.16.128.169",4408,"172.16.139.250",135,1,60,1648,0,0,1,60,0,0,9.491878,0,"",""
"172.16.133.207",55881,"172.16.139.250",5440,10,1022,1649,0,0,10,1022,0,0,9.499452,0.017250999999999905,473943,0
"172.16.133.41",52735,"199.102.234.31",80,11,3112,1650,0,0,6,2518,5,594,9.500399,0.11190799999999967,180005,42463
"172.16.133.83",57031,"172.16.139.250",5440,12,1142,1651,0,0,12,1142,0,0,9.507761,0.004903000000000546,"",""
"172.16.133.20",61071,"157.56.238.6",443,25,2127,1652,0,0,13,1407,12,720,9.508201,270.08229600000004,41,21
"132.245.1.150",443,"172.16.133.93",49248,19,2054,1653,0,0,10,1514,9,540,9.517303,270.13534699999997,44,15
"172.16.133.93",60607,"172.16.139.250",5440,12,1142,1654,0,0,12,1142,0,0,9.5241,0.011685999999999197,781790,0
"69.171.241.10",5222,"172.16.133.71",55292,48,9378,1655,0,0,24,7142,24,2236,9.53974,289.98951900000003,197,61
"172.16.133.11",55090,"172.16.139.250",5440,10,1022,1656,0,0,10,1022,0,0,9.54044,0.015679999999999694,521428,0
"172.16.133.55",57526,"172.16.139.250",5440,10,1022,1657,0,0,10,1022,0,0,9.544878,0.00739699999999921,1105312,0
"172.16.133.24",57677,"216.115.220.254",443,6,366,1658,0,0,4,246,2,120,9.561618,0.4659380000000013,4223,2060
"172.16.133.115",53580,"23.67.242.73",80,7,432,1659,0,0,4,240,3,192,9.565937,75.88868599999999,25,20
"172.16.133.73",60516,"172.16.139.250",5440,10,1022,1660,0,0,10,1022,0,0,9.569571,0.020068000000000197,407414,0
"172.16.133.53",54047,"172.16.139.250",5440,10,1022,1661,0,0,10,1022,0,0,9.572066,0.005695000000001116,1435645,0
"172.16.133.21",53120,"172.16.139.250",5440,10,1022,1662,0,0,10,1022,0,0,9.574008,0.0077750000000005315,1051575,0
"172.16.133.30",62558,"172.16.139.250",5440,10,1022,1663,0,0,10,1022,0,0,9.578031,0.008401000000000991,973217,0
"172.16.133.25",63352,"172.16.139.250",5440,12,1142,1664,0,0,12,1142,0,0,9.585706,0.007851999999999748,1163525,0
"172.16.133.34",50387,"172.16.139.250",5440,12,1142,1665,0,0,12,1142,0,0,9.594772,0.0145199999999992,629201,0
"172.16.133.97",59317,"172.16.139.250",5440,10,1022,1666,0,0,10,1022,0,0,9.604602,0.017103999999999786,478016,0
"172.16.133.28",65030,"216.52.242.80",80,44,34452,1667,0,0,18,6428,26,28024,9.623435,3.7924619999999987,13559,59115
"172.16.133.24",57678,"202.173.27.250",443,6,366,1668,0,0,4,246,2,120,9.628562,0.5534409999999994,3555,1734
"172.16.133.101",51136,"96.43.146.160",443,21,4795,1669,0,0,12,3708,9,1087,9.631962,115.65675399999999,256,75
"172.16.133.115",53578,"23.67.242.73",80,7,432,1670,0,0,4,240,3,192,9.656971,75.797652,25,20
"172.16.133.114",63425,"65.54.61.217",1863,17,1050,1671,0,0,10,618,7,432,9.660816,258.917658,19,13
"172.16.133.103",62436,"96.43.146.22",443,42,19080,1672,0,0,24,16188,18,2892,9.662694,289.87885700000004,446,79
"172.16.133.33",57827,"172.16.139.250",5440,12,1142,1673,0,0,12,1142,0,0,9.680754,0.016135999999999484,566187,0
"172.16.133.68",60668,"172.16.139.250",5440,10,1022,1674,0,0,10,1022,0,0,9.710906,0.011267000000000138,725659,0
"172.16.124.85",29856,"172.16.133.6",445,1,60,1675,0,0,1,60,0,0,9.723899,0,"",""
"172.16.133.12",59658,"172.16.139.250",5440,12,1142,1676,0,0,12,1142,0,0,9.724393,0.01052900000000001,867698,0
"172.16.133.63",53823,"172.16.139.250",5440,10,1022,1677,0,0,10,1022,0,0,9.732677,0.0072099999999988285,1133980,0
"172.16.133.115",53584,"173.194.43.57",80,6,366,1678,0,0,3,180,3,186,9.736969,15.664598,91,94
"172.16.133.96",53336,"173.194.43.53",443,33,8085,1679,0,0,18,6068,15,2017,9.739545,32.995278,1471,489
"172.16.133.66",53797,"172.16.139.250",5440,12,1142,1680,0,0,12,1142,0,0,9.749153,0.0054230000000004,1684676,0
"172.16.133.51",57460,"67.217.95.254",443,6,366,1681,0,0,4,246,2,120,9.757072,0.06256099999999876,31457,15345
"172.16.133.51",57461,"78.108.117.250",443,6,366,1682,0,0,4,246,2,120,9.758042,0.21821300000000043,9018,4399
"172.16.133.51",57462,"216.219.117.244",443,6,366,1683,0,0,4,246,2,120,9.759395,0.2214039999999997,8888,4335
"172.16.133.51",57463,"202.173.25.200",443,6,366,1684,0,0,4,246,2,120,9.761231,0.5431239999999988,3623,1767
"172.16.133.82",61269,"172.16.139.250",5440,10,1022,1685,0,0,10,1022,0,0,9.762336,0.005781999999999954,1414043,0
"172.16.133.37",60553,"172.16.139.250",5440,10,1022,1686,0,0,10,1022,0,0,9.778081,0.0064109999999999445,1275308,0
"157.56.242.198",443,"172.16.133.114",64373,4936,4731445,1687,0,0,3287,4632505,1649,98940,9.787983,280.368274,132183,2823
"132.245.2.22",443,"172.16.133.35",63714,29,10694,1688,0,0,16,9884,13,810,9.834859,225.94699400000002,349,28
"172.16.133.30",57167,"96.43.146.22",443,42,19865,1689,0,0,24,16824,18,3041,9.857549,282.000765,477,86
"172.16.133.44",64707,"107.23.112.156",80,12,1810,1690,0,0,7,1065,5,745,9.858136,61.504076999999995,138,96
"172.16.133.78",59032,"172.16.139.250",5440,12,1142,1691,0,0,12,1142,0,0,9.932395,0.018016000000001142,507104,0
"172.16.133.109",41873,"96.43.146.176",443,27,9948,1692,0,0,14,2629,13,7319,9.957737999999999,0.26159000000000177,80400,223831
"172.16.133.28",65031,"173.194.43.59",80,78,42249,1693,0,0,39,22693,39,19556,9.984022,253.384585,716,617
"172.16.133.28",65282,"216.52.242.80",80,132,116559,1694,0,0,48,20131,84,96428,9.98438,52.98374,3039,14559
"172.16.133.67",55921,"172.16.139.250",5440,12,1142,1695,0,0,12,1142,0,0,9.985968,0.016191000000000955,564264,0
"172.16.133.41",52040,"23.33.93.95",80,3,180,1696,0,0,2,120,1,60,9.986106,0.017093000000000913,56163,28081
"172.16.133.41",52064,"23.33.44.150",80,3,180,1697,0,0,2,120,1,60,9.9863,0.021698999999999913,44241,22120
"172.16.133.41",52029,"23.33.44.150",80,3,180,1698,0,0,2,120,1,60,9.986556,0.021392999999999773,44874,22437
"172.16.133.41",52059,"23.33.94.91",80,3,180,1699,0,0,2,120,1,60,9.986638,0.01965299999999992,48847,24423
"172.16.133.115",53597,"69.25.24.24",80,7,420,1700,0,0,4,240,3,180,9.989952,75.468603,25,19
"172.16.133.42",57014,"172.16.139.250",5440,12,1142,1701,0,0,12,1142,0,0,10.009811,0.06205500000000086,147224,0
"172.16.133.56",61351,"172.16.139.250",5440,10,1022,1702,0,0,10,1022,0,0,10.010045999999999,0.005080000000001306,1609448,0
"172.16.133.93",60454,"208.47.254.81",80,6,366,1703,0,0,3,180,3,186,10.017275,17.499018,82,85
"216.115.208.199",443,"172.16.133.56",60673,164,38459,1704,0,0,90,18946,74,19513,10.031996,279.919466,541,557
"172.16.133.93",60441,"173.194.43.59",80,14,870,1705,0,0,7,420,7,450,10.050243,197.458834,17,18
"172.16.133.75",50885,"172.16.139.250",5440,10,1022,1706,0,0,10,1022,0,0,10.063861,0.005717000000000638,1430120,0
"157.56.236.102",443,"172.16.133.73",57181,52,7628,1707,0,0,32,6428,20,1200,10.065521,284.29515100000003,180,33
"172.16.133.41",52736,"172.16.139.250",5440,12,1142,1708,0,0,12,1142,0,0,10.065702,0.015532000000000323,588204,0
"172.16.133.85",52194,"172.16.139.250",5440,10,1022,1709,0,0,10,1022,0,0,10.082756,0.00543700000000058,1503770,0
"172.16.133.28",65283,"8.27.243.253",80,17,3442,1710,0,0,9,1290,8,2152,10.095267,19.54489,528,880
"172.16.133.28",65284,"8.27.243.253",80,66,26313,1711,0,0,28,9066,38,17247,10.095533,19.544474,3710,7059
"172.16.133.28",65285,"8.27.243.253",80,55,27898,1712,0,0,23,5061,32,22837,10.095754,19.544498,2071,9347
"172.16.133.28",65286,"8.27.243.253",80,35,11984,1713,0,0,16,3918,19,8066,10.095984,19.544466999999997,1603,3301
"172.16.133.28",65287,"23.0.49.244",80,6,372,1714,0,0,4,246,2,126,10.096311,19.546835,100,51
"172.16.133.28",65288,"64.94.107.62",80,8,1677,1715,0,0,5,1214,3,463,10.096606,1.284980000000001,7558,2882
"172.16.133.28",65289,"64.94.107.62",80,10,2398,1716,0,0,6,1875,4,523,10.096836,9.08494,1651,460
"172.16.133.28",65290,"64.94.107.62",80,7,428,1717,0,0,4,246,3,182,10.097072,19.541152999999998,100,74
"172.16.133.28",65291,"208.111.161.254",80,56,44864,1718,0,0,22,3070,34,41794,10.097366,39.56653,620,8450
"172.16.133.28",65292,"208.111.161.254",80,35,30019,1719,0,0,10,2279,25,27740,10.097582,39.566109,460,5608
"172.16.133.28",65293,"138.108.6.20",80,11,3686,1720,0,0,6,2556,5,1130,10.097842,20.928536,977,431
"172.16.133.115",53598,"173.194.43.57",80,6,366,1721,0,0,3,180,3,186,10.127909,15.273538999999998,94,97
"172.16.133.85",60598,"172.16.139.250",5500,44,16376,1722,0,0,44,16376,0,0,10.129779,240.196826,545,0
"172.16.133.95",51254,"96.43.146.22",443,35,15833,1723,0,0,20,13405,15,2428,10.135728,255.49515799999998,419,76
"172.16.133.43",57711,"172.16.139.250",5440,10,1022,1724,0,0,10,1022,0,0,10.137741,0.0054549999999995435,1498808,0
"172.16.133.23",50791,"96.43.146.22",443,42,19050,1725,0,0,24,16158,18,2892,10.150453,289.69040099999995,446,79
"172.16.133.13",52986,"172.16.139.250",5440,10,1022,1726,0,0,10,1022,0,0,10.155277,0.015404999999999447,530736,0
"172.16.133.109",41874,"96.43.146.176",443,27,9572,1727,0,0,14,2640,13,6932,10.176586,0.24228399999999972,87170,228888
"172.16.133.93",60482,"216.38.172.159",80,16,960,1728,0,0,8,480,8,480,10.196256,257.383549,14,14
"172.16.133.20",62310,"172.16.139.250",5440,12,1142,1729,0,0,12,1142,0,0,10.204003,0.007028000000000034,1299943,0
"172.16.133.28",65294,"172.16.139.250",5440,12,1142,1730,0,0,12,1142,0,0,10.236119,0.006179999999998742,1478317,0
"172.16.133.99",55991,"172.16.139.250",5440,10,1022,1731,0,0,10,1022,0,0,10.259839,0.004993000000000691,"",""
"172.16.133.132",38710,"98.139.134.187",80,15,8483,1732,0,0,8,942,7,7541,10.268523,0.15034799999999926,50123,401255
"172.16.133.87",60127,"172.16.139.250",5440,10,1022,1733,0,0,10,1022,0,0,10.282995,0.0059909999999998576,1364713,0
"172.16.133.48",60317,"107.20.161.243",443,17,5459,1734,0,0,9,2021,8,3438,10.284004,13.639291,1185,2016
"172.16.133.35",49919,"172.16.139.250",5440,12,1142,1735,0,0,12,1142,0,0,10.297131,0.046336999999999406,197164,0
"172.16.133.116",53151,"172.16.139.250",5440,10,1022,1736,0,0,10,1022,0,0,10.299094,0.011872999999999578,688621,0
"172.16.133.116",53152,"172.16.139.250",5440,10,1022,1737,0,0,10,1022,0,0,10.311876,0.009686999999999557,844017,0
"172.16.133.84",58739,"172.16.139.250",5440,12,1142,1738,0,0,12,1142,0,0,10.320262,0.006339000000000539,1441236,0
"172.16.133.116",53153,"172.16.139.250",5440,12,1142,1739,0,0,12,1142,0,0,10.322477,0.00808500000000123,1129993,0
"172.16.133.116",52396,"96.43.146.48",443,1979,1656457,1740,0,0,865,736584,1114,919873,10.334608,268.793919,21922,27377
"172.16.133.116",52397,"96.43.146.48",443,1831,1541635,1741,0,0,824,720133,1007,821502,10.334883,268.872928,21426,24442
"172.16.133.85",51320,"96.43.146.22",443,39,18805,1742,0,0,23,16030,16,2775,10.342787,252.597122,507,87
"172.16.133.34",49418,"216.52.242.80",80,17,5391,1743,0,0,11,3568,6,1823,10.347528,257.623066,110,56
"172.16.133.132",50480,"76.13.6.174",80,12,3075,1744,0,0,7,861,5,2214,10.383134,0.4522130000000004,15231,39167
"172.16.133.109",41846,"96.43.146.176",443,9,2230,1745,0,0,5,1637,4,593,10.390981,1.5696189999999994,8343,3022
"172.16.133.49",55715,"172.16.139.250",5440,10,1022,1746,0,0,10,1022,0,0,10.400015,0.006235999999999464,1311096,0
"172.16.133.60",62106,"173.194.43.47",443,15,1014,1747,0,0,7,420,8,594,10.429274,150.000311,22,31
"172.16.133.95",56893,"172.16.139.250",5440,12,1142,1748,0,0,12,1142,0,0,10.434552,0.009714999999999918,940401,0
"172.16.133.132",54695,"98.139.161.29",80,10,1871,1749,0,0,6,1158,4,713,10.449823,0.44452800000000003,20840,12831
"172.16.133.93",60542,"74.217.78.184",80,6,366,1750,0,0,3,180,3,186,10.45025,27.135043999999997,53,54
"172.16.133.87",59990,"96.43.146.22",443,15,917,1751,0,0,7,420,8,497,10.453073,215.524958,15,18
"172.16.133.87",59991,"96.43.146.22",443,15,917,1752,0,0,7,420,8,497,10.455031,215.522065,15,18
"172.16.133.76",61904,"173.194.78.125",5222,13,841,1753,0,0,7,420,6,421,10.462829,257.878876,13,13
"172.16.133.92",57629,"172.16.139.250",5440,10,1022,1754,0,0,10,1022,0,0,10.463446,0.020202000000001163,404712,0
"172.16.133.132",44385,"98.138.19.88",80,11,1755,1755,0,0,6,807,5,948,10.469056,3.2244290000000007,2002,2352
"172.16.133.87",59992,"96.43.146.22",443,17,3664,1756,0,0,10,2956,7,708,10.473033,245.509914,96,23
"172.16.133.29",60826,"172.16.139.250",5440,10,1022,1757,0,0,10,1022,0,0,10.482066,0.006275999999999726,1302740,0
"172.16.133.44",64708,"172.16.139.250",5440,12,1142,1758,0,0,12,1142,0,0,10.48777,0.016206000000000387,563741,0
"172.16.133.132",52408,"98.139.240.23",80,10,1728,1759,0,0,6,1110,4,618,10.49704,3.112150999999999,2853,1588
"172.16.133.207",55882,"172.16.139.250",5440,12,1142,1760,0,0,12,1142,0,0,10.513207,0.017369000000000412,525994,0
"172.16.133.49",55146,"54.235.187.196",443,263,119744,1761,0,0,132,96560,131,23184,10.513977,271.461525,2845,683
"172.16.133.83",57032,"172.16.139.250",5440,12,1142,1762,0,0,12,1142,0,0,10.521761,0.0148880000000009,613648,0
"172.16.133.115",53614,"173.194.74.84",443,8,576,1763,0,0,4,240,4,336,10.52796,18.573006,103,144
"172.16.133.93",60608,"172.16.139.250",5440,10,1022,1764,0,0,10,1022,0,0,10.53906,0.005395000000000039,1515477,0
"172.16.133.11",55091,"172.16.139.250",5440,10,1022,1765,0,0,10,1022,0,0,10.554764,0.005839999999999179,1400000,0
"172.16.133.55",57527,"172.16.139.250",5440,10,1022,1766,0,0,10,1022,0,0,10.559212,0.015541999999999945,526058,0
"172.16.133.73",60517,"172.16.139.250",5440,10,1022,1767,0,0,10,1022,0,0,10.584509,0.005836999999999648,1400719,0
"172.16.133.53",54048,"172.16.139.250",5440,10,1022,1768,0,0,10,1022,0,0,10.586017,0.007993000000000805,1022895,0
"172.16.133.21",53121,"172.16.139.250",5440,12,1142,1769,0,0,12,1142,0,0,10.587869,0.015885000000000815,575133,0
"172.16.133.30",62559,"172.16.139.250",5440,10,1022,1770,0,0,10,1022,0,0,10.591924,0.006266999999999356,1304611,0
"172.16.133.25",63353,"172.16.139.250",5440,12,1142,1771,0,0,12,1142,0,0,10.59982,0.01903599999999983,479932,0
"172.16.133.115",49498,"157.56.244.214",443,10,775,1772,0,0,5,475,5,300,10.601247,240.214513,15,9
"172.16.133.34",50388,"172.16.139.250",5440,12,1142,1773,0,0,12,1142,0,0,10.60825,0.006382000000000332,1431526,0
"172.16.133.55",57006,"96.43.146.22",443,38,16716,1774,0,0,22,14298,16,2418,10.613902,289.270548,395,66
"172.16.133.97",59318,"172.16.139.250",5440,10,1022,1775,0,0,10,1022,0,0,10.618494,0.014571999999999363,561076,0
"172.16.133.115",53756,"23.46.17.144",80,11,684,1776,0,0,6,360,5,324,10.679924,174.880592,16,14
"172.16.133.78",58628,"96.43.146.22",443,17,1037,1777,0,0,8,480,9,557,10.680321,258.740586,14,17
"172.16.133.66",53523,"23.67.242.73",80,13,810,1778,0,0,7,420,6,390,10.694231,216.435072,15,14
"172.16.133.33",57828,"172.16.139.250",5440,12,1142,1779,0,0,12,1142,0,0,10.694681,0.016540000000000887,552357,0
"172.16.133.68",60669,"172.16.139.250",5440,10,1022,1780,0,0,10,1022,0,0,10.726296,0.015541999999999945,526058,0
"172.16.133.12",59659,"172.16.139.250",5440,12,1142,1781,0,0,12,1142,0,0,10.738663,0.007718999999999809,1183573,0
"172.16.133.63",53824,"172.16.139.250",5440,12,1142,1782,0,0,12,1142,0,0,10.746769,0.01626800000000017,561593,0
"172.16.133.67",55922,"216.219.115.250",443,6,366,1783,0,0,4,246,2,120,10.755622,0.10883799999999866,18081,8820
"172.16.133.66",53798,"172.16.139.250",5440,10,1022,1784,0,0,10,1022,0,0,10.763355,0.005472999999998507,1493879,0
"172.16.133.67",55923,"67.217.66.244",443,6,366,1785,0,0,4,246,2,120,10.766035,0.11825799999999909,16641,8117
"172.16.133.82",61270,"172.16.139.250",5440,12,1142,1786,0,0,12,1142,0,0,10.776238,0.016320000000000334,559803,0
"172.16.133.115",53635,"23.67.242.50",80,8,492,1787,0,0,5,300,3,192,10.77695,84.983761,28,18
"74.125.133.189",443,"172.16.133.73",57015,56,17271,1788,0,0,33,3057,23,14214,10.777054,267.028244,91,425
"172.16.133.115",53755,"23.46.17.144",80,11,684,1789,0,0,6,360,5,324,10.777892,174.782549,16,14
"23.33.47.60",443,"172.16.133.109",42574,6,433,1790,0,0,3,235,3,198,10.782157,0.05276300000000056,35631,30021
"23.33.47.60",443,"172.16.133.109",42575,6,433,1791,0,0,3,235,3,198,10.78226,0.05287099999999967,35558,29959
"172.16.133.37",60554,"172.16.139.250",5440,12,1142,1792,0,0,12,1142,0,0,10.791561,0.005466000000000193,1671423,0
"172.16.133.17",54473,"132.245.1.150",443,47,7827,1793,0,0,24,6447,23,1380,10.796236,270.037564,190,40
"172.16.133.115",53638,"23.67.242.50",80,8,492,1794,0,0,5,300,3,192,10.807927,84.94763900000001,28,18
"172.16.133.93",60545,"74.217.78.146",80,16,960,1795,0,0,8,480,8,480,10.84332,256.737168,14,14
"172.16.133.118",58208,"180.153.30.250",443,6,366,1796,0,0,4,246,2,120,10.847113,0.6906490000000005,2849,1389
"157.56.238.6",443,"172.16.133.21",54016,10,795,1797,0,0,5,495,5,300,10.856262,240.63665500000002,16,9
"172.16.133.67",55924,"68.64.30.250",443,6,366,1798,0,0,4,246,2,120,10.858583,0.10490000000000066,18760,9151
"172.16.133.67",55925,"68.64.13.250",443,6,366,1799,0,0,4,246,2,120,10.867517,0.11270900000000061,17460,8517
"172.16.133.90",51558,"172.16.128.169",8014,16,6777,1800,0,0,9,3820,7,2957,10.886514,2.48588,12293,9516
"172.16.133.115",53595,"173.194.43.58",80,10,618,1801,0,0,5,300,5,318,10.888932,114.592455,20,22
"172.16.133.41",52737,"199.102.234.31",80,11,3284,1802,0,0,6,2464,5,820,10.922331,0.13340499999999977,147760,49173
"172.16.133.78",57213,"173.194.43.39",443,103,57875,1803,0,0,32,7507,71,50368,10.925288,267.647343,224,1505
"172.16.133.78",59033,"172.16.139.250",5440,12,1142,1804,0,0,12,1142,0,0,10.94632,0.01638699999999993,557515,0
"216.115.208.199",443,"172.16.133.39",61143,179,44344,1805,0,0,95,20023,84,24321,10.966266,284.69561899999997,562,683
"172.16.131.10",443,"172.16.139.241",54129,774,294028,1806,0,0,374,60632,400,233396,10.995932,282.65044800000004,1716,6605
"172.16.133.67",55926,"172.16.139.250",5440,10,1022,1807,0,0,10,1022,0,0,10.999956,0.014755000000000962,554117,0
"172.16.133.56",61352,"172.16.139.250",5440,12,1142,1808,0,0,12,1142,0,0,11.024178,0.0048680000000000945,"",""
"172.16.133.42",57015,"172.16.139.250",5440,14,1274,1809,0,0,14,1274,0,0,11.043579,3.041080000000001,3351,0
"172.16.133.75",50886,"172.16.139.250",5440,10,1022,1810,0,0,10,1022,0,0,11.077982,0.015698000000000434,520830,0
"172.16.133.41",52738,"172.16.139.250",5440,10,1022,1811,0,0,10,1022,0,0,11.079413,0.005088999999999899,1606602,0
"172.16.133.28",65295,"173.194.43.57",80,21,2612,1812,0,0,11,1317,10,1295,11.084242,248.543872,42,41
"172.16.133.85",52195,"172.16.139.250",5440,12,1142,1813,0,0,12,1142,0,0,11.095803,0.005872000000000099,1555858,0
"172.16.133.53",51588,"96.43.146.22",443,37,16192,1814,0,0,21,13401,16,2791,11.113276,255.518565,419,87
"172.16.133.28",65296,"173.194.43.59",80,7,432,1815,0,0,4,246,3,186,11.117501,18.534398,106,80
"172.16.133.28",65297,"173.194.43.59",80,6,372,1816,0,0,4,246,2,126,11.117861,18.521343,106,54
"172.16.133.115",53599,"173.194.43.58",80,10,618,1817,0,0,5,300,5,318,11.117922,114.36385999999999,20,22
"172.16.133.28",65298,"173.194.43.57",80,6,372,1818,0,0,4,246,2,126,11.118093,18.521107,106,54
"172.16.133.28",65299,"173.194.43.57",80,6,372,1819,0,0,4,246,2,126,11.118275,18.520975,106,54
"107.20.158.52",8080,"172.16.133.153",56545,708,289150,1820,0,0,344,26428,364,262722,11.137474,285.68878,740,7356
"172.16.133.43",57712,"172.16.139.250",5440,10,1022,1821,0,0,10,1022,0,0,11.153013,0.005691999999999808,1436401,0
"172.16.133.115",53594,"173.194.43.58",80,10,618,1822,0,0,5,300,5,318,11.158866,114.321074,20,22
"172.16.133.28",65300,"23.0.49.244",80,6,372,1823,0,0,4,246,2,126,11.164076,18.478966999999997,106,54
"172.16.133.28",65301,"23.0.49.244",80,7,432,1824,0,0,4,246,3,186,11.164328,18.489229,106,80
"172.16.133.28",65302,"23.0.49.244",80,7,432,1825,0,0,4,246,3,186,11.164556,18.484149000000002,106,80
"172.16.133.28",65303,"23.0.49.244",80,6,372,1826,0,0,4,246,2,126,11.164774,18.478271999999997,106,54
"172.16.133.115",53645,"96.8.82.144",80,6,360,1827,0,0,5,300,1,60,11.167913,84.625086,28,5
"172.16.133.13",52987,"172.16.139.250",5440,10,1022,1828,0,0,10,1022,0,0,11.169126,0.008960000000000079,912499,0
"172.16.133.39",64245,"174.129.24.9",443,1948,2044584,1829,0,0,610,44086,1338,2000498,11.171376,13.622162000000001,25890,1174849
"172.16.133.33",49247,"172.16.139.250",5462,100,6088,1830,0,0,100,6088,0,0,11.17214,283.136762,172,0
"172.16.133.73",57180,"157.56.236.102",443,201,139175,1831,0,0,116,134075,85,5100,11.177018,270.30217300000004,3968,150
"172.16.133.115",53633,"96.8.82.144",80,6,360,1832,0,0,5,300,1,60,11.180922,84.61214600000001,28,5
"172.16.133.115",53646,"96.8.82.144",80,5,300,1833,0,0,4,240,1,60,11.180924,84.364595,22,5
"172.16.133.24",57679,"216.115.217.254",443,6,366,1834,0,0,4,246,2,120,11.200663,0.05956899999999976,33037,16115
"172.16.133.20",62311,"172.16.139.250",5440,12,1142,1835,0,0,12,1142,0,0,11.2179,0.014635000000000176,624256,0
"172.16.133.115",53644,"96.8.82.144",80,6,360,1836,0,0,5,300,1,60,11.22793,84.563814,28,5
"172.16.133.33",57313,"173.194.43.33",80,12,744,1837,0,0,6,360,6,384,11.228624,150.597805,19,20
"172.16.133.115",53654,"74.125.226.195",443,9,636,1838,0,0,5,300,4,336,11.228878,17.872633999999998,134,150
"172.16.133.115",53643,"96.8.82.144",80,6,360,1839,0,0,5,300,1,60,11.22888,84.562793,28,5
"172.16.133.115",53642,"96.8.82.144",80,6,360,1840,0,0,5,300,1,60,11.238925,84.55174000000001,28,5
"172.16.133.28",65304,"172.16.139.250",5440,10,1022,1841,0,0,10,1022,0,0,11.249129,0.01544299999999943,529430,0
"172.16.133.99",55992,"172.16.139.250",5440,10,1022,1842,0,0,10,1022,0,0,11.27433,0.0053389999999993165,1531372,0
"172.16.133.75",57858,"172.16.139.250",5462,112,6808,1843,0,0,112,6808,0,0,11.293885,273.01128900000003,199,0
"172.16.133.87",60128,"172.16.139.250",5440,10,1022,1844,0,0,10,1022,0,0,11.297447,0.005515000000000825,1482502,0
"172.16.133.47",56547,"23.20.41.5",443,40,16843,1845,0,0,20,8737,20,8106,11.310503,77.526984,901,836
"172.16.133.35",49920,"172.16.139.250",5440,12,1142,1846,0,0,12,1142,0,0,11.310947,0.05975100000000033,152901,0
"172.16.133.116",53154,"172.16.139.250",5440,10,1022,1847,0,0,10,1022,0,0,11.312554,0.016491000000000255,495785,0
"172.16.133.115",53562,"173.194.75.103",80,6,366,1848,0,0,3,180,3,186,11.317939,24.110738999999995,59,61
"172.16.133.116",53155,"172.16.139.250",5440,10,1022,1849,0,0,10,1022,0,0,11.329997,0.01514799999999994,539741,0
"172.16.133.84",58740,"172.16.139.250",5440,10,1022,1850,0,0,10,1022,0,0,11.334766,0.005653999999999826,1446055,0
"172.16.133.115",53657,"157.55.113.200",80,9,540,1851,0,0,5,300,4,240,11.337961,84.445739,28,22
"172.16.133.28",65055,"208.47.254.83",80,45,22386,1852,0,0,28,18450,17,3936,11.338811,252.70779100000001,584,124
"172.16.133.116",53156,"172.16.139.250",5440,12,1142,1853,0,0,12,1142,0,0,11.346035,0.005300999999999334,1723448,0
"172.16.133.41",52739,"199.102.234.31",80,12,3127,1854,0,0,6,2467,6,660,11.353781,0.6611570000000011,29850,7986
"172.16.133.20",62312,"173.194.74.84",443,63,29716,1855,0,0,27,4085,36,25631,11.394411,241.04496600000002,135,850
"172.16.133.67",55927,"173.194.41.111",443,40,6620,1856,0,0,20,2833,20,3787,11.397886,248.17216900000003,91,122
"172.16.133.20",62313,"74.125.226.207",443,14,4028,1857,0,0,8,958,6,3070,11.405144,2.8524329999999996,2686,8610
"172.16.133.49",55716,"172.16.139.250",5440,10,1022,1858,0,0,10,1022,0,0,11.412935,0.014525000000000787,562891,0
"172.16.133.82",51031,"96.43.146.48",443,26,8075,1859,0,0,15,5010,11,3065,11.415672,242.716321,165,101
"172.16.133.115",53668,"23.67.242.80",80,8,492,1860,0,0,4,240,4,252,11.418946,64.064402,29,31
"172.16.133.115",53600,"74.125.226.193",443,9,636,1861,0,0,4,240,5,396,11.420914,14.873102,129,213
"172.16.133.115",53669,"23.67.242.80",80,6,366,1862,0,0,3,180,3,186,11.428858,43.99958,32,33
"172.16.133.78",53247,"96.43.146.22",443,40,18244,1863,0,0,23,15714,17,2530,11.435295,280.854428,447,72
"172.16.133.20",62314,"173.194.43.43",443,14,3918,1864,0,0,8,968,6,2950,11.436645,2.8206819999999997,2745,8366
"172.16.133.25",61660,"96.43.146.48",443,11,677,1865,0,0,5,300,6,377,11.438982,121.58779500000001,19,24
"172.16.133.95",56894,"172.16.139.250",5440,10,1022,1866,0,0,10,1022,0,0,11.448683,0.01480299999999879,552320,0
"172.16.133.92",57630,"172.16.139.250",5440,10,1022,1867,0,0,10,1022,0,0,11.477228,0.01532100000000014,533646,0
"172.16.133.115",53666,"157.55.113.200",80,9,540,1868,0,0,5,300,4,240,11.478891,84.30131,28,22
"172.16.133.115",53667,"157.55.113.200",80,9,540,1869,0,0,5,300,4,240,11.478894,84.304877,28,22
"172.16.133.29",60827,"172.16.139.250",5440,10,1022,1870,0,0,10,1022,0,0,11.495304,0.006160999999998751,1327057,0
"172.16.133.44",64709,"172.16.139.250",5440,10,1022,1871,0,0,10,1022,0,0,11.502199,0.015253000000001293,536025,0
"172.16.133.207",55883,"172.16.139.250",5440,10,1022,1872,0,0,10,1022,0,0,11.526223,0.008608999999999867,949703,0
"172.16.133.25",63354,"173.194.75.106",443,234,132759,1873,0,0,87,19159,147,113600,11.535921,276.15072100000003,555,3290
"172.16.133.83",57033,"172.16.139.250",5440,12,1142,1874,0,0,12,1142,0,0,11.535922,0.014772999999999925,618425,0
"172.16.133.115",53660,"157.55.113.200",80,9,540,1875,0,0,5,300,4,240,11.538827,84.24177900000001,28,22
"172.16.133.25",63130,"96.43.146.178",443,11,677,1876,0,0,5,300,6,377,11.541951,121.47732900000001,19,24
"172.16.133.25",63132,"96.43.146.178",443,11,677,1877,0,0,5,300,6,377,11.552997,121.46539099999998,19,24
"172.16.133.93",60609,"172.16.139.250",5440,10,1022,1878,0,0,10,1022,0,0,11.553528,0.005321999999999605,1536264,0
"172.16.133.25",63129,"96.43.146.178",443,11,677,1879,0,0,5,300,6,377,11.554949,121.46503100000001,19,24
"172.16.133.25",63134,"96.43.146.178",443,11,677,1880,0,0,5,300,6,377,11.554950999999999,121.469421,19,24
"172.16.133.11",55092,"172.16.139.250",5440,10,1022,1881,0,0,10,1022,0,0,11.568754,0.005525999999999698,1479551,0
"172.16.133.115",53733,"173.194.43.38",80,10,618,1882,0,0,5,300,5,318,11.570899,113.91112100000001,21,22
"172.16.133.55",57528,"172.16.139.250",5440,10,1022,1883,0,0,10,1022,0,0,11.572801,0.006175999999999959,1323834,0
"108.160.160.163",80,"172.16.133.39",49279,18,3372,1884,0,0,12,1758,6,1614,11.575942,277.945455,50,46
"172.16.133.115",53567,"173.194.75.103",443,12,828,1885,0,0,5,300,7,528,11.57883,104.91168400000001,22,40
"172.16.133.115",53627,"173.194.43.60",80,10,618,1886,0,0,5,300,5,318,11.578831,113.90235200000001,21,22
"172.16.133.115",53727,"173.194.43.38",80,10,618,1887,0,0,5,300,5,318,11.578832,113.90307299999999,21,22
"172.16.133.60",61930,"96.43.146.22",443,35,15420,1888,0,0,20,12995,15,2425,11.595278,255.545302,406,75
"172.16.133.73",60518,"172.16.139.250",5440,10,1022,1889,0,0,10,1022,0,0,11.598718,0.016932999999999865,482844,0
"172.16.133.53",54049,"172.16.139.250",5440,10,1022,1890,0,0,10,1022,0,0,11.599408,0.005509999999999238,1483847,0
"172.16.133.21",53122,"172.16.139.250",5440,10,1022,1891,0,0,10,1022,0,0,11.602209,0.01731499999999997,472191,0
"172.16.133.30",62560,"172.16.139.250",5440,10,1022,1892,0,0,10,1022,0,0,11.606257,0.005436000000001329,1504047,0
"216.115.208.199",443,"172.16.133.25",63328,97,7308,1893,0,0,49,3684,48,3624,11.614493,277.569498,106,104
"172.16.133.25",63355,"172.16.139.250",5440,12,1142,1894,0,0,12,1142,0,0,11.616097,0.020668000000000575,442035,0
"172.16.133.34",50389,"172.16.139.250",5440,12,1142,1895,0,0,12,1142,0,0,11.622532,0.010396000000000072,878799,0
"172.16.133.97",59319,"172.16.139.250",5440,12,1142,1896,0,0,12,1142,0,0,11.632414,0.018422999999998524,495901,0
"172.16.133.115",53720,"173.194.43.45",80,10,618,1897,0,0,5,300,5,318,11.637962,113.84358399999999,21,22
"172.16.133.115",53776,"23.62.207.139",80,11,684,1898,0,0,6,360,5,324,11.640899,173.95512000000002,16,14
"172.16.133.20",50810,"172.16.139.250",5500,146,67124,1899,0,0,146,67124,0,0,11.706488,288.07455200000004,1864,0
"172.16.133.33",57829,"172.16.139.250",5440,10,1022,1900,0,0,10,1022,0,0,11.708463,0.07608699999999935,107455,0
"172.16.133.23",54994,"96.43.146.178",443,17,1037,1901,0,0,8,480,9,557,11.710475,263.81820700000003,14,16
"172.16.133.20",55095,"172.16.139.250",5462,70,4244,1902,0,0,70,4244,0,0,11.713906,272.589679,124,0
"172.16.133.25",63151,"96.43.146.22",443,19,6832,1903,0,0,10,5518,9,1314,11.714981,92.00625600000001,479,114
"172.16.133.20",55212,"172.16.139.250",5447,12,1680,1904,0,0,12,1680,0,0,11.734404,262.133797,51,0
"172.16.133.68",60670,"172.16.139.250",5440,10,1022,1905,0,0,10,1022,0,0,11.739302,0.05046399999999984,162016,0
"172.16.133.25",63133,"96.43.146.178",443,11,677,1906,0,0,5,300,6,377,11.745995,121.281049,19,24
"172.16.133.12",59660,"172.16.139.250",5440,10,1022,1907,0,0,10,1022,0,0,11.753512,0.040873999999998745,200029,0
"172.16.133.25",63128,"96.43.146.176",443,11,677,1908,0,0,5,300,6,377,11.754962,121.27073199999998,19,24
"172.16.133.56",61333,"23.32.180.174",80,3,180,1909,0,0,2,120,1,60,11.756491,0.07630599999999887,12580,6290
"172.16.133.56",61327,"206.188.4.26",80,3,180,1910,0,0,2,120,1,60,11.756609,0.08171100000000031,11748,5874
"172.16.133.63",53825,"172.16.139.250",5440,10,1022,1911,0,0,10,1022,0,0,11.760674,0.03835100000000047,213188,0
"172.16.133.25",63131,"96.43.146.178",443,11,677,1912,0,0,5,300,6,377,11.772956,121.25336000000001,19,24
"172.16.133.66",53799,"172.16.139.250",5440,10,1022,1913,0,0,10,1022,0,0,11.777026,0.02815400000000068,290402,0
"172.16.133.82",61271,"172.16.139.250",5440,10,1022,1914,0,0,10,1022,0,0,11.789637,0.02240899999999968,364853,0
"172.16.133.24",57680,"216.115.220.254",443,6,366,1915,0,0,4,246,2,120,11.795706,0.4977020000000003,3954,1928
"172.16.133.51",57464,"67.217.95.254",443,6,366,1916,0,0,4,246,2,120,11.799363,0.09303799999999995,21152,10318
"172.16.133.37",60555,"172.16.139.250",5440,10,1022,1917,0,0,10,1022,0,0,11.803936,0.015299000000000618,534414,0
"172.16.133.33",57417,"23.33.91.46",80,4,240,1918,0,0,3,180,1,60,11.816758,0.3198899999999991,4501,1500
"172.16.133.33",57405,"66.150.102.78",80,4,240,1919,0,0,3,180,1,60,11.816881,0.3441510000000001,4184,1394
"172.16.133.33",57404,"64.74.101.52",80,4,240,1920,0,0,3,180,1,60,11.816939,0.3286030000000011,4382,1460
"172.16.133.33",57420,"64.74.101.52",80,4,240,1921,0,0,3,180,1,60,11.816993,0.327693,4394,1464
"172.16.133.33",57419,"64.74.101.52",80,4,240,1922,0,0,3,180,1,60,11.816994,0.3276910000000015,4394,1464
"172.16.133.33",57425,"23.33.91.46",80,4,240,1923,0,0,3,180,1,60,11.817094,0.3259539999999994,4417,1472
"172.16.133.33",57423,"23.67.242.34",80,4,240,1924,0,0,3,180,1,60,11.817161,0.3249669999999991,4431,1477
"172.16.133.25",63142,"96.43.146.22",443,11,677,1925,0,0,5,300,6,377,11.842988,121.18117600000001,19,24
"172.16.133.25",63139,"96.43.146.176",443,11,677,1926,0,0,5,300,6,377,11.842992,121.17545199999999,19,24
"172.16.133.25",63144,"96.43.146.22",443,11,677,1927,0,0,5,300,6,377,11.844927,121.18033100000001,19,24
"172.16.133.25",63145,"96.43.146.22",443,11,677,1928,0,0,5,300,6,377,11.848936,121.16918199999999,19,24
"172.16.133.25",63149,"96.43.146.50",443,11,677,1929,0,0,5,300,6,377,11.852957,121.171787,19,24
"172.16.133.25",63146,"96.43.146.22",443,11,677,1930,0,0,5,300,6,377,11.852962,121.173288,19,24
"172.16.133.25",63147,"96.43.146.22",443,11,677,1931,0,0,5,300,6,377,11.855921,121.16802900000002,19,24
"172.16.133.25",63143,"96.43.146.22",443,11,677,1932,0,0,5,300,6,377,11.855923,121.16425399999999,19,24
"172.16.133.25",63148,"96.43.146.50",443,11,677,1933,0,0,5,300,6,377,11.855924,121.16976799999999,19,24
"172.16.133.25",63126,"64.56.203.22",443,10,600,1934,0,0,5,300,5,300,11.865918,121.20233000000002,19,19
"172.16.133.29",60498,"173.194.43.57",80,18,3152,1935,0,0,9,1474,9,1678,11.871169,275.432478,42,48
"172.16.133.51",57465,"216.219.117.244",443,6,366,1936,0,0,4,246,2,120,11.880106,0.21846600000000116,9008,4394
"172.16.133.51",57466,"78.108.117.250",443,6,366,1937,0,0,4,246,2,120,11.880181,0.21131100000000025,9313,4543
"172.16.133.109",35201,"96.43.149.26",443,6,407,1938,0,0,3,186,3,221,11.906825,0.039531000000000205,37641,44724
"172.16.133.109",35202,"96.43.149.26",443,6,407,1939,0,0,3,186,3,221,11.907085,0.03832899999999917,38821,46126
"172.16.133.109",35203,"96.43.149.26",443,6,407,1940,0,0,3,186,3,221,11.907233,0.03943399999999997,37733,44834
"172.16.133.109",35204,"96.43.149.26",443,6,407,1941,0,0,3,186,3,221,11.907449,0.039405000000000356,37761,44867
"172.16.133.109",35205,"96.43.149.26",443,6,407,1942,0,0,3,186,3,221,11.907596999999999,0.0385850000000012,38564,45820
"172.16.133.109",42570,"23.33.47.60",443,5,355,1943,0,0,3,186,2,169,11.908449,0.03230800000000045,46056,41847
"172.16.133.109",42571,"23.33.47.60",443,5,355,1944,0,0,3,186,2,169,11.908569,0.031508000000000536,47226,42909
"172.16.133.109",42572,"23.33.47.60",443,5,355,1945,0,0,3,186,2,169,11.908682,0.03251999999999988,45756,41574
"172.16.133.109",42573,"23.33.47.60",443,5,355,1946,0,0,3,186,2,169,11.908796,0.03149799999999914,47241,42923
"172.16.133.109",41847,"96.43.146.176",443,6,407,1947,0,0,3,186,3,221,11.909459,0.057629000000000374,25820,30678
"172.16.133.109",41848,"96.43.146.176",443,6,407,1948,0,0,3,186,3,221,11.909614,0.05767699999999998,25798,30653
"172.16.133.109",41849,"96.43.146.176",443,6,407,1949,0,0,3,186,3,221,11.909773,0.056579000000001045,26299,31248
"172.16.133.109",33643,"66.235.146.171",443,4,264,1950,0,0,2,132,2,132,11.910288,0.039671000000000234,26618,26618
"172.16.133.109",53487,"96.43.146.50",443,6,407,1951,0,0,3,186,3,221,11.910485,0.05710800000000127,26055,30958
"172.16.133.24",57681,"202.173.27.250",443,6,366,1952,0,0,4,246,2,120,11.910623,0.5736160000000012,3430,1673
"172.16.133.41",52062,"23.33.95.8",443,4,287,1953,0,0,2,120,2,167,11.915074,0.02781199999999906,34517,48036
"172.16.133.41",52077,"23.33.44.150",443,4,287,1954,0,0,2,120,2,167,11.915357,0.02847500000000025,33713,46918
"172.16.133.39",62232,"96.43.146.48",443,21,3369,1955,0,0,11,2461,10,908,11.93554,273.312505,72,26
"172.16.133.29",60505,"173.194.43.57",80,17,2670,1956,0,0,9,1672,8,998,11.951173,275.435499,48,28
"172.16.133.78",59034,"172.16.139.250",5440,12,1142,1957,0,0,12,1142,0,0,11.960319,0.01635899999999957,558469,0
"172.16.133.25",63140,"96.43.146.176",443,130,92041,1958,0,0,53,25235,77,66806,11.963025,274.163284,736,1949
"172.16.133.29",60739,"173.194.43.60",80,14,870,1959,0,0,7,420,7,450,11.991157,199.10074400000002,16,18
"172.16.133.93",60538,"67.69.196.40",80,15,936,1960,0,0,8,480,7,456,12.006367,255.52851599999997,15,14
"172.16.133.67",55928,"172.16.139.250",5440,10,1022,1961,0,0,10,1022,0,0,12.013816,0.015190000000000481,538248,0
"172.16.133.121",56392,"96.43.146.22",443,52,26032,1962,0,0,32,22712,20,3320,12.019277,244.65281,742,108
"172.16.133.109",51470,"96.43.146.178",443,7,482,1963,0,0,4,272,3,210,12.030274,0.07890100000000011,27578,21292
"172.16.133.51",57467,"202.173.25.200",443,6,366,1964,0,0,4,246,2,120,12.037213,0.5635790000000007,3491,1703
"172.16.133.56",61353,"172.16.139.250",5440,10,1022,1965,0,0,10,1022,0,0,12.037507,0.004744999999999777,"",""
"172.16.133.33",57702,"131.203.115.170",80,3,180,1966,0,0,1,60,2,120,12.057695,41.023477,11,23
"172.16.133.33",57730,"131.203.115.170",80,3,180,1967,0,0,1,60,2,120,12.070705,41.010684999999995,11,23
"172.16.133.75",50887,"172.16.139.250",5440,10,1022,1968,0,0,10,1022,0,0,12.091995,0.015701999999999217,520698,0
"172.16.133.41",52740,"172.16.139.250",5440,10,1022,1969,0,0,10,1022,0,0,12.093794,0.019978999999999303,409229,0
"172.16.133.85",52196,"172.16.139.250",5440,12,1142,1970,0,0,12,1142,0,0,12.110022,0.016140999999999295,566012,0
"172.16.133.109",41876,"96.43.146.176",443,7,482,1971,0,0,4,272,3,210,12.110072,0.08680299999999974,25068,19354
"172.16.133.53",53795,"96.43.146.22",443,9,557,1972,0,0,4,240,5,317,12.12837,79.717016,24,31
"172.16.133.53",53796,"96.43.146.22",443,9,557,1973,0,0,4,240,5,317,12.134311,79.704592,24,31
"172.16.133.43",57713,"172.16.139.250",5440,12,1142,1974,0,0,12,1142,0,0,12.165473,0.006186999999998832,1476644,0
"172.16.128.233",55214,"172.16.133.233",22,210,23532,1975,0,0,60,4996,150,18536,12.175278,11.166792,3579,13279
"172.16.133.20",62315,"208.111.160.6",80,50,35546,1976,0,0,20,2870,30,32676,12.177141,33.891641,677,7713
"172.16.133.20",62316,"208.111.160.6",80,84,73334,1977,0,0,31,3290,53,70044,12.177296,33.890477000000004,776,16534
"172.16.133.20",62317,"208.111.160.6",80,157,142816,1978,0,0,53,8466,104,134350,12.177453,63.892644000000004,1060,16821
"172.16.133.13",52988,"172.16.139.250",5440,10,1022,1979,0,0,10,1022,0,0,12.182324,0.017929000000000528,456020,0
"172.16.133.24",57682,"216.219.120.244",443,6,366,1980,0,0,4,246,2,120,12.19352,0.20659799999999962,9525,4646
"172.16.133.109",33658,"66.235.146.171",443,7,482,1981,0,0,4,272,3,210,12.198304,0.058971999999998914,36898,28488
"172.16.133.115",53675,"64.5.35.24",80,6,360,1982,0,0,5,300,1,60,12.201922,83.606104,28,5
"172.16.133.29",60740,"54.243.68.206",80,6,366,1983,0,0,3,180,3,186,12.205144,18.916868,76,78
"172.16.133.20",62318,"216.52.242.80",80,37,27722,1984,0,0,15,6136,22,21586,12.20792,28.524321,1720,6054
"172.16.133.20",62319,"172.16.139.250",5440,12,1142,1985,0,0,12,1142,0,0,12.231698,0.006123000000000545,1492079,0
"172.16.133.95",56895,"202.173.28.250",443,6,366,1986,0,0,4,246,2,120,12.233464,0.5223620000000011,3767,1837
"172.16.133.95",56896,"67.217.65.244",443,6,366,1987,0,0,4,246,2,120,12.234453,0.08265999999999885,23808,11613
"172.16.133.95",56897,"64.74.80.187",443,6,366,1988,0,0,4,246,2,120,12.234912,0.060268000000000654,32654,15928
"172.16.133.95",56898,"216.115.212.254",443,6,366,1989,0,0,4,246,2,120,12.236422,0.20774200000000143,9473,4621
"172.16.133.43",63424,"157.56.236.102",443,10,775,1990,0,0,5,475,5,300,12.242921,240.095591,15,9
"172.16.133.110",49253,"174.129.20.55",80,10,1098,1991,0,0,6,514,4,584,12.250811,0.11070699999999967,37143,42201
"172.16.133.109",53910,"70.42.13.101",443,6,374,1992,0,0,4,254,2,120,12.258305,0.041109000000000506,49429,23352
"172.16.133.28",65305,"172.16.139.250",5440,12,1142,1993,0,0,12,1142,0,0,12.263043,0.006126000000000076,1491348,0
"172.16.133.33",57738,"131.203.115.170",80,3,180,1994,0,0,1,60,2,120,12.270683,40.810487,11,23
"172.16.133.99",55993,"172.16.139.250",5440,12,1142,1995,0,0,12,1142,0,0,12.288393,0.01502400000000037,608093,0
"172.16.133.87",60129,"172.16.139.250",5440,10,1022,1996,0,0,10,1022,0,0,12.310195,0.005564999999998932,1469182,0
"172.16.133.116",53163,"172.16.139.250",5440,12,1142,1997,0,0,12,1142,0,0,12.328227,0.006582999999999117,1387817,0
"172.16.133.33",57737,"131.203.115.170",80,3,180,1998,0,0,1,60,2,120,12.330672,40.7502,11,23
"172.16.133.116",53164,"172.16.139.250",5440,10,1022,1999,0,0,10,1022,0,0,12.335579,0.005319000000000074,1537131,0
"172.16.133.116",53165,"172.16.139.250",5440,10,1022,2000,0,0,10,1022,0,0,12.341596,0.009521000000001223,858733,0
"172.16.133.35",49921,"172.16.139.250",5440,12,1142,2001,0,0,12,1142,0,0,12.345326,0.04310399999999959,211952,0
"172.16.133.109",42594,"23.33.47.60",443,6,412,2002,0,0,4,272,2,140,12.347484,0.055747999999999465,39032,20090
"172.16.133.84",58741,"172.16.139.250",5440,10,1022,2003,0,0,10,1022,0,0,12.348097,0.015461000000000169,528814,0
"172.16.133.20",62320,"172.16.139.250",5440,10,1022,2004,0,0,10,1022,0,0,12.359367,0.00804899999999975,1015778,0
"172.16.133.29",60741,"50.17.220.219",80,6,366,2005,0,0,3,180,3,186,12.361215,18.760913000000002,76,79
"172.16.133.118",56666,"157.56.234.118",443,199,28601,2006,0,0,101,22721,98,5880,12.37366,284.250462,639,165
"172.16.133.75",50709,"204.14.235.124",443,12,720,2007,0,0,6,360,6,360,12.377006,173.70342300000002,16,16
"172.16.133.20",60144,"96.43.146.176",443,65,43110,2008,0,0,29,17679,36,25431,12.379648,247.294135,571,822
"172.16.133.20",60145,"96.43.146.176",443,94,62080,2009,0,0,45,24929,49,37151,12.381349,265.993422,749,1117
"172.16.133.20",60149,"96.43.146.176",443,77,47414,2010,0,0,37,19274,40,28140,12.382569,266.065937,579,846
"172.16.133.25",63153,"64.56.203.22",443,10,600,2011,0,0,5,300,5,300,12.382964,120.68528199999999,19,19
"172.16.133.25",63155,"64.56.203.22",443,10,600,2012,0,0,5,300,5,300,12.384936,120.68337000000001,19,19
"172.16.133.20",60150,"96.43.146.176",443,136,92842,2013,0,0,65,38928,71,53914,12.385788,278.73893400000003,1117,1547
"172.16.133.25",63152,"64.56.203.22",443,10,600,2014,0,0,5,300,5,300,12.385926,120.68267000000002,19,19
"172.16.133.12",50689,"157.56.242.198",443,10,795,2015,0,0,5,495,5,300,12.386748,240.02169999999998,16,9
"172.16.133.20",61335,"96.43.146.48",443,74,45682,2016,0,0,36,20106,38,25576,12.386917,264.872947,607,772
"172.16.133.75",50710,"204.14.235.124",443,12,720,2017,0,0,6,360,6,360,12.386986,173.693504,16,16
"172.16.133.20",60143,"96.43.146.176",443,141,96415,2018,0,0,68,40152,73,56263,12.387734,266.15498199999996,1206,1691
"172.16.133.20",62261,"96.43.146.176",443,9,1759,2019,0,0,5,1155,4,604,12.392906,127.15201499999999,72,38
"173.194.43.53",443,"172.16.133.41",51520,182,65836,2020,0,0,89,19712,93,46124,12.394304,273.076088,577,1351
"172.16.133.109",36279,"96.43.148.26",443,7,482,2021,0,0,4,272,3,210,12.405095,0.06690100000000143,32525,25111
"172.16.133.116",58802,"172.16.139.250",5500,338,138004,2022,0,0,338,138004,0,0,12.425422,240.19669,4596,0
"172.16.133.49",55717,"172.16.139.250",5440,10,1022,2023,0,0,10,1022,0,0,12.427141,0.005725999999999232,1427872,0
"172.16.133.41",52741,"199.102.234.31",80,11,3126,2024,0,0,6,2526,5,600,12.453842999999999,0.137061000000001,147438,35020
"172.16.133.95",56899,"172.16.139.250",5440,10,1022,2025,0,0,10,1022,0,0,12.463054,0.015308000000000987,534099,0
"172.16.133.92",57631,"172.16.139.250",5440,10,1022,2026,0,0,10,1022,0,0,12.491698,0.01502400000000037,544195,0
"172.16.133.29",60536,"74.125.226.193",443,11,762,2027,0,0,5,300,6,462,12.498176,59.88091299999999,40,61
"172.16.133.29",60828,"172.16.139.250",5440,10,1022,2028,0,0,10,1022,0,0,12.507977,0.00542100000000012,1508208,0
"172.16.133.44",64710,"172.16.139.250",5440,10,1022,2029,0,0,10,1022,0,0,12.51626,0.021402999999999395,382002,0
"172.16.133.76",60748,"157.56.244.214",443,201,28483,2030,0,0,101,22483,100,6000,12.520123,240.023606,749,199
"172.16.133.33",57735,"131.203.115.170",80,3,180,2031,0,0,1,60,2,120,12.527706,40.553588,11,23
"172.16.133.207",55884,"172.16.139.250",5440,10,1022,2032,0,0,10,1022,0,0,12.54143,0.005041999999999547,1621578,0
"172.16.133.83",57034,"172.16.139.250",5440,12,1142,2033,0,0,12,1142,0,0,12.549003,0.02146799999999871,425563,0
"172.16.133.20",62321,"208.111.160.6",80,36,26856,2034,0,0,14,1620,22,25236,12.566385,33.502695,386,6026
"172.16.133.20",62322,"208.111.160.6",80,31,20347,2035,0,0,12,2009,19,18338,12.566739,33.502224,479,4378
"172.16.133.93",60610,"172.16.139.250",5440,12,1142,2036,0,0,12,1142,0,0,12.567107,0.017713999999999785,515750,0
"172.16.133.87",59833,"96.43.146.22",443,11,677,2037,0,0,5,300,6,377,12.570135,123.39991800000001,19,24
"172.16.133.87",59835,"96.43.146.22",443,11,677,2038,0,0,5,300,6,377,12.57516,123.394967,19,24
"172.16.133.11",55093,"172.16.139.250",5440,10,1022,2039,0,0,10,1022,0,0,12.583566,0.005627000000000493,1452994,0
"172.16.133.55",57529,"172.16.139.250",5440,10,1022,2040,0,0,10,1022,0,0,12.58707,0.006072999999998885,1346286,0
"172.16.133.73",60519,"172.16.139.250",5440,10,1022,2041,0,0,10,1022,0,0,12.610898,0.0060789999999997235,1344958,0
"172.16.133.53",54050,"172.16.139.250",5440,10,1022,2042,0,0,10,1022,0,0,12.613208,0.007738999999999052,1056467,0
"172.16.133.21",53123,"172.16.139.250",5440,12,1142,2043,0,0,12,1142,0,0,12.61497,0.015971999999999653,572001,0
"172.16.133.30",62561,"172.16.139.250",5440,10,1022,2044,0,0,10,1022,0,0,12.619152,0.0058749999999996305,1391659,0
"172.16.133.87",59836,"96.43.146.22",443,11,677,2045,0,0,5,300,6,377,12.627215,123.341149,19,24
"172.16.133.25",63356,"172.16.139.250",5440,10,1022,2046,0,0,10,1022,0,0,12.628085,0.017954999999998833,455360,0
"172.16.133.34",50390,"172.16.139.250",5440,12,1142,2047,0,0,12,1142,0,0,12.637005,0.0051469999999991245,1775014,0
"172.16.133.97",59320,"172.16.139.250",5440,10,1022,2048,0,0,10,1022,0,0,12.646505,0.014758999999999745,553967,0
"173.194.43.54",443,"172.16.133.48",58887,39,6256,2049,0,0,21,5052,18,1204,12.647358,108.24401,373,88
"172.16.133.49",49711,"157.56.234.118",443,10,775,2050,0,0,5,475,5,300,12.672233,240.059943,15,9
"172.16.133.18",50278,"174.129.20.55",443,27,10669,2051,0,0,14,3415,13,7254,12.702754,10.753687999999999,2540,5396
"172.16.133.33",57830,"172.16.139.250",5440,12,1142,2052,0,0,12,1142,0,0,12.723259,0.005671999999998789,1610719,0
"172.16.133.20",62007,"173.194.43.39",80,24,5979,2053,0,0,13,3846,11,2133,12.732611,275.829541,111,61
"172.16.133.115",53680,"23.67.242.59",80,8,492,2054,0,0,4,240,4,252,12.739949,72.71467200000001,26,27
"172.16.133.68",60671,"172.16.139.250",5440,10,1022,2055,0,0,10,1022,0,0,12.7531,0.016009999999999636,510680,0
"172.16.133.12",59661,"172.16.139.250",5440,12,1142,2056,0,0,12,1142,0,0,12.766305,0.008738000000001023,1045548,0
"172.16.133.63",53826,"172.16.139.250",5440,10,1022,2057,0,0,10,1022,0,0,12.776025,0.005663000000000196,1443757,0
"172.16.133.66",53800,"172.16.139.250",5440,12,1142,2058,0,0,12,1142,0,0,12.790943,0.006249999999999645,1461760,0
"172.16.133.109",43791,"96.43.146.48",443,32,13477,2059,0,0,17,1754,15,11723,12.800092,1.343388000000001,10445,69811
"172.16.133.82",61272,"172.16.139.250",5440,12,1142,2060,0,0,12,1142,0,0,12.804518,0.016671000000000546,548017,0
"172.16.133.20",62323,"208.111.160.6",80,9,558,2061,0,0,5,312,4,246,12.8165,13.253775,188,148
"172.16.133.37",60556,"172.16.139.250",5440,12,1142,2062,0,0,12,1142,0,0,12.817915,0.007043000000001243,1297174,0
"172.16.133.115",53628,"173.194.43.60",80,5,300,2063,0,0,3,180,2,120,12.831927,22.579509,63,42
"172.16.133.14",62971,"157.56.238.6",443,47,15314,2064,0,0,25,13994,22,1320,12.844502,270.07979900000004,414,39
"172.16.133.67",51819,"23.33.47.100",80,55,43045,2065,0,0,27,12623,28,30422,12.846968,266.766883,378,912
"172.16.133.87",59834,"96.43.146.22",443,11,677,2066,0,0,5,300,6,377,12.857206,123.112846,19,24
"173.194.43.53",443,"172.16.133.96",53312,31,4763,2067,0,0,15,3680,16,1083,12.894956,144.86934399999998,203,59
"172.16.133.115",53588,"173.194.43.58",80,5,300,2068,0,0,3,180,2,120,12.940924,22.470279999999995,64,42
"172.16.133.116",53166,"96.43.146.22",443,20,1603,2069,0,0,11,934,9,669,12.945992,273.517249,27,19
"172.16.133.116",53167,"96.43.146.22",443,20,1601,2070,0,0,11,932,9,669,12.946593,273.472804,27,19
"172.16.133.116",53168,"96.43.146.22",443,8,498,2071,0,0,5,312,3,186,12.947003,19.251262999999994,129,77
"172.16.133.116",53169,"96.43.146.22",443,20,1601,2072,0,0,11,932,9,669,12.94738,273.47781499999996,27,19
"172.16.133.116",53170,"96.43.146.22",443,20,1601,2073,0,0,11,932,9,669,12.947735,273.51539399999996,27,19
"157.56.238.6",443,"172.16.133.20",61080,10,795,2074,0,0,5,495,5,300,12.952139,240.535481,16,9
"172.16.133.78",59035,"172.16.139.250",5440,12,1142,2075,0,0,12,1142,0,0,12.9742,0.0066670000000002005,1370331,0
"172.16.133.25",61938,"96.43.146.22",443,5,317,2076,0,0,2,120,3,197,12.975106,0.05587599999999959,17180,28205
"74.125.226.86",443,"172.16.133.30",49490,70,18013,2077,0,0,33,3791,37,14222,12.985762,269.968658,112,421
"157.56.237.150",443,"172.16.133.50",49205,17,1501,2078,0,0,9,1015,8,486,13.000541,240.113411,33,16
"172.16.133.25",63165,"173.194.43.30",443,10,702,2079,0,0,4,240,6,462,13.025015,59.943314,32,61
"172.16.133.67",55929,"172.16.139.250",5440,10,1022,2080,0,0,10,1022,0,0,13.028081,0.005537999999999599,1476345,0
"172.16.133.103",61617,"172.16.139.250",5500,142,62732,2081,0,0,142,62732,0,0,13.040883000000001,240.2111,2089,0
"172.16.133.56",61354,"172.16.139.250",5440,10,1022,2082,0,0,10,1022,0,0,13.050108,0.00510300000000008,1602194,0
"157.56.232.214",443,"172.16.133.82",58586,17,2930,2083,0,0,9,2450,8,480,13.057364,240.18872199999998,81,15
"172.16.133.113",55589,"172.16.139.250",135,8,492,2084,0,0,8,492,0,0,13.083098,0.009624000000000521,408977,0
"172.16.133.66",53704,"132.245.2.22",443,38,4961,2085,0,0,19,3821,19,1140,13.095565,276.661413,110,32
"172.16.133.113",55590,"172.16.139.250",5462,10,696,2086,0,0,10,696,0,0,13.095838,0.5077929999999995,10965,0
"172.16.133.75",50888,"172.16.139.250",5440,10,1022,2087,0,0,10,1022,0,0,13.105996,0.00557300000000005,1467073,0
"172.16.133.41",52742,"172.16.139.250",5440,12,1142,2088,0,0,12,1142,0,0,13.107928,0.016439000000000092,555751,0
"172.16.133.30",49246,"172.16.139.250",5462,66,4004,2089,0,0,66,4004,0,0,13.116603,271.18793900000003,118,0
"172.16.133.40",52600,"172.16.139.250",5462,96,5848,2090,0,0,96,5848,0,0,13.117048,277.92549099999997,168,0
"172.16.133.53",62370,"172.16.139.250",5462,20,1200,2091,0,0,20,1200,0,0,13.11736,271.18717499999997,35,0
"172.16.133.56",49601,"172.16.139.250",5462,104,6284,2092,0,0,104,6284,0,0,13.11741,271.186427,185,0
"172.16.133.73",59295,"172.16.139.250",5462,20,1200,2093,0,0,20,1200,0,0,13.117513,271.187084,35,0
"172.16.133.43",63468,"172.16.139.250",5462,20,1200,2094,0,0,20,1200,0,0,13.11777,271.196988,35,0
"172.16.133.63",49367,"172.16.139.250",5462,20,1200,2095,0,0,20,1200,0,0,13.117773,271.189537,35,0
"172.16.133.95",49247,"172.16.139.250",5462,20,1200,2096,0,0,20,1200,0,0,13.117841,271.187985,35,0
"172.16.133.29",49810,"172.16.139.250",5462,20,1200,2097,0,0,20,1200,0,0,13.118232,271.187542,35,0
"172.16.133.26",49308,"172.16.139.250",5462,42,2564,2098,0,0,42,2564,0,0,13.118838,285.545247,71,0
"172.16.133.85",52197,"172.16.139.250",5440,12,1142,2099,0,0,12,1142,0,0,13.123816,0.006301000000000556,1449928,0
"172.16.133.85",60599,"172.16.139.250",5462,38,2280,2100,0,0,38,2280,0,0,13.125129,271.179353,67,0
"172.16.133.115",53689,"64.236.116.3",80,8,480,2101,0,0,5,300,3,180,13.150929,82.61376399999999,29,17
"172.16.133.33",57736,"131.203.115.170",80,3,180,2102,0,0,1,60,2,120,13.165681,39.914199,12,24
"172.16.133.43",57714,"172.16.139.250",5440,10,1022,2103,0,0,10,1022,0,0,13.179573,0.005418000000000589,1509043,0
"172.16.133.13",52989,"172.16.139.250",5440,10,1022,2104,0,0,10,1022,0,0,13.195289,0.005535000000000068,1477145,0
"172.16.133.116",53171,"96.43.146.22",443,21,4193,2105,0,0,12,1253,9,2940,13.196704,270.396521,37,86
"173.194.43.40",80,"172.16.133.43",57463,4,240,2106,0,0,2,120,2,120,13.200684,7.1443069999999995,134,134
"172.16.133.118",58209,"180.153.30.250",443,6,366,2107,0,0,4,246,2,120,13.226806,0.7863980000000002,2502,1220
"172.16.133.24",57683,"216.115.217.254",443,6,366,2108,0,0,4,246,2,120,13.230696,0.07320700000000002,26882,13113
"172.16.133.40",64526,"96.43.146.48",443,245,179709,2109,0,0,108,73366,137,106343,13.243953,278.962311,2103,3049
"172.16.133.20",62324,"172.16.139.250",5440,12,1142,2110,0,0,12,1142,0,0,13.244841,0.004903000000000546,"",""
"172.16.133.28",65306,"172.16.139.250",5440,12,1142,2111,0,0,12,1142,0,0,13.27708,0.006189000000000888,1476167,0
"172.16.133.120",49250,"157.56.241.150",443,19,1490,2112,0,0,10,950,9,540,13.277617,240.023338,31,17
"172.16.133.99",55994,"172.16.139.250",5440,12,1142,2113,0,0,12,1142,0,0,13.302078,0.005337000000000813,1711823,0
"172.16.133.87",60130,"172.16.139.250",5440,10,1022,2114,0,0,10,1022,0,0,13.324028,0.005473000000000283,1493879,0
"23.33.81.244",80,"172.16.133.43",57407,4,240,2115,0,0,2,120,2,120,13.324299,7.020378999999998,136,136
"172.16.133.73",55853,"74.125.226.201",443,169,76861,2116,0,0,76,37624,93,39237,13.330968,283.370805,1062,1107
"172.16.133.93",57921,"96.43.146.22",443,35,15838,2117,0,0,20,13410,15,2428,13.332392,255.46012599999997,419,76
"172.16.133.35",49922,"172.16.139.250",5440,12,1142,2118,0,0,12,1142,0,0,13.338887,0.008565000000000822,1066666,0
"172.16.128.169",3917,"172.16.139.250",80,9,1229,2119,0,0,5,488,4,741,13.342727,0.29725099999999927,13133,19942
"172.16.133.116",53172,"172.16.139.250",5440,12,1142,2120,0,0,12,1142,0,0,13.342975,0.006843000000001709,1335086,0
"172.16.133.60",62057,"173.194.43.63",443,11,762,2121,0,0,5,300,6,462,13.343313,104.955032,22,35
"172.16.133.116",53173,"172.16.139.250",5440,10,1022,2122,0,0,10,1022,0,0,13.350816,0.015237000000000833,536588,0
"172.16.133.20",62325,"138.108.6.20",80,8,1460,2123,0,0,4,802,4,658,13.358461,10.234817000000001,626,514
"172.16.133.84",58742,"172.16.139.250",5440,12,1142,2124,0,0,12,1142,0,0,13.362359,0.016415999999999542,556530,0
"172.16.133.116",53174,"172.16.139.250",5440,10,1022,2125,0,0,10,1022,0,0,13.367267,0.00541400000000003,1510158,0
"193.182.8.52",4070,"172.16.133.25",64779,1846,1827798,2126,0,0,1256,1789129,590,38669,13.422754,256.888156,55716,1204
"74.125.226.245",443,"172.16.133.16",54553,416,133698,2127,0,0,225,35505,191,98193,13.435081,270.49285699999996,1050,2904
"172.16.133.49",55718,"172.16.139.250",5440,10,1022,2128,0,0,10,1022,0,0,13.441274,0.01562900000000056,523130,0
"172.16.133.116",53175,"96.43.146.22",443,51,21815,2129,0,0,30,18656,21,3159,13.445145,253.30194600000002,589,99
"172.16.133.116",53176,"96.43.146.22",443,23,7128,2130,0,0,13,6128,10,1000,13.445385,80.756045,607,99
"172.16.133.21",63870,"96.43.146.48",443,340,277775,2131,0,0,144,99049,196,178726,13.468815,285.56365999999997,2774,5006
"172.16.133.21",65192,"96.43.146.48",443,335,276011,2132,0,0,142,103396,193,172615,13.469807,285.412438,2898,4838
"172.16.133.21",51141,"96.43.146.176",443,363,296462,2133,0,0,155,108165,208,188297,13.471035,285.400766,3031,5278
"172.16.133.21",50793,"96.43.146.176",443,350,282377,2134,0,0,149,107049,201,175328,13.473928,285.320178,3001,4915
"172.16.133.95",56900,"172.16.139.250",5440,10,1022,2135,0,0,10,1022,0,0,13.476792,0.014578000000000202,560845,0
"172.16.133.78",58442,"63.116.244.160",80,7,432,2136,0,0,4,240,3,192,13.488335,81.63063,23,18
"172.16.133.78",58443,"63.116.244.160",80,7,432,2137,0,0,4,240,3,192,13.488336,81.630631,23,18
"172.16.133.114",55301,"96.43.146.176",443,77,39655,2138,0,0,37,13779,40,25876,13.494816,136.093124,809,1521
"172.16.133.92",57632,"172.16.139.250",5440,10,1022,2139,0,0,10,1022,0,0,13.505165,0.022659000000000873,360827,0
"172.16.133.115",53690,"23.67.242.41",80,8,492,2140,0,0,5,300,3,192,13.510894,82.249087,29,18
"172.16.133.68",49722,"157.56.242.198",443,81,18447,2141,0,0,42,16107,39,2340,13.513372,241.035182,534,77
"172.16.133.29",60829,"172.16.139.250",5440,12,1142,2142,0,0,12,1142,0,0,13.52297,0.016451999999999245,555312,0
"172.16.133.44",64711,"172.16.139.250",5440,10,1022,2143,0,0,10,1022,0,0,13.529533,0.005756999999999124,1420184,0
"69.171.235.16",443,"172.16.133.40",61226,47,13552,2144,0,0,23,5049,24,8503,13.546747,282.053916,143,241
"172.16.133.207",55885,"172.16.139.250",5440,10,1022,2145,0,0,10,1022,0,0,13.555282,0.01728499999999933,473011,0
"172.16.133.43",55728,"96.43.146.22",443,35,15200,2146,0,0,20,12770,15,2430,13.560605,285.281544,358,68
"172.16.133.83",57035,"172.16.139.250",5440,10,1022,2147,0,0,10,1022,0,0,13.563917,0.004777000000000697,"",""
"172.16.133.33",57520,"173.194.74.95",80,6,366,2148,0,0,3,180,3,186,13.575704,18.276186000000003,78,81
"172.16.133.93",60611,"172.16.139.250",5440,10,1022,2149,0,0,10,1022,0,0,13.580214,0.0048680000000000945,"",""
"172.16.133.63",53500,"96.43.146.178",443,9,557,2150,0,0,4,240,5,317,13.595871,76.928674,24,32
"172.16.133.11",55094,"172.16.139.250",5440,10,1022,2151,0,0,10,1022,0,0,13.597168,0.0059269999999997935,1379449,0
"172.16.133.55",57530,"172.16.139.250",5440,12,1142,2152,0,0,12,1142,0,0,13.600661,0.0074019999999990205,1234261,0
"172.16.133.25",63150,"96.43.146.22",443,22,6972,2153,0,0,12,5608,10,1364,13.605681,285.371782,157,38
"172.16.133.63",53494,"96.43.146.50",443,9,557,2154,0,0,4,240,5,317,13.605807,76.913141,24,32
"172.16.133.63",53498,"96.43.146.178",443,9,557,2155,0,0,4,240,5,317,13.605808,76.914983,24,32
"172.16.133.63",53491,"96.43.146.50",443,9,557,2156,0,0,4,240,5,317,13.60581,76.91314,24,32
"172.16.133.63",53497,"96.43.146.178",443,9,557,2157,0,0,4,240,5,317,13.605811,76.914981,24,32
"172.16.133.63",53495,"96.43.146.50",443,9,557,2158,0,0,4,240,5,317,13.605856,76.911362,24,32
"172.16.133.63",53501,"96.43.146.178",443,9,557,2159,0,0,4,240,5,317,13.605857,76.917925,24,32
"172.16.133.63",53492,"96.43.146.50",443,9,557,2160,0,0,4,240,5,317,13.605858,76.914015,24,32
"172.16.133.63",53490,"96.43.146.50",443,9,557,2161,0,0,4,240,5,317,13.605859,76.913176,24,32
"172.16.133.63",53496,"96.43.146.178",443,9,557,2162,0,0,4,240,5,317,13.60591,76.920451,24,32
"172.16.133.115",53694,"23.67.242.11",80,8,492,2163,0,0,5,300,3,192,13.612919,82.14745599999999,29,18
"172.16.133.73",60520,"172.16.139.250",5440,10,1022,2164,0,0,10,1022,0,0,13.624908,0.020623000000000502,396450,0
"172.16.133.53",54051,"172.16.139.250",5440,12,1142,2165,0,0,12,1142,0,0,13.627351,0.0063579999999987535,1436929,0
"172.16.133.21",53124,"172.16.139.250",5440,10,1022,2166,0,0,10,1022,0,0,13.62975,0.008639999999999759,946296,0
"172.16.133.30",62562,"172.16.139.250",5440,10,1022,2167,0,0,10,1022,0,0,13.634226,0.00756299999999932,1081052,0
"172.16.133.25",63357,"172.16.139.250",5440,10,1022,2168,0,0,10,1022,0,0,13.641842,0.00892599999999888,915975,0
"172.16.133.34",50391,"172.16.139.250",5440,12,1142,2169,0,0,12,1142,0,0,13.650016,0.005190999999999946,1759969,0
"172.16.133.82",51039,"172.16.139.250",5500,106,42016,2170,0,0,106,42016,0,0,13.654376,240.19872199999998,1399,0
"172.16.133.97",59321,"172.16.139.250",5440,10,1022,2171,0,0,10,1022,0,0,13.660931,0.005487000000000464,1490067,0
"172.16.133.103",61618,"172.16.139.250",5462,68,4124,2172,0,0,68,4124,0,0,13.665715,280.64232000000004,117,0
"172.16.133.132",38715,"98.139.134.187",80,15,8483,2173,0,0,8,942,7,7541,13.66905,0.18692300000000017,40316,322742
"172.16.133.63",53202,"96.43.146.176",443,9,557,2174,0,0,4,240,5,317,13.70783,76.81695,24,33
"172.16.133.63",53200,"96.43.146.176",443,9,557,2175,0,0,4,240,5,317,13.707832,76.818625,24,33
"172.16.133.33",57831,"172.16.139.250",5440,10,1022,2176,0,0,10,1022,0,0,13.736768,0.015492000000000061,527756,0
"172.16.133.63",64785,"96.43.146.176",443,9,557,2177,0,0,4,240,5,317,13.747809,76.785743,25,33
"172.16.133.68",60672,"172.16.139.250",5440,10,1022,2178,0,0,10,1022,0,0,13.766068,0.005520999999999887,1480891,0
"172.16.133.12",59662,"172.16.139.250",5440,10,1022,2179,0,0,10,1022,0,0,13.78041,0.005354000000000525,1527082,0
"172.16.133.63",53827,"172.16.139.250",5440,10,1022,2180,0,0,10,1022,0,0,13.788708,0.005364000000000146,1524235,0
"172.16.133.132",50485,"76.13.6.174",80,9,1928,2181,0,0,5,717,4,1211,13.793627,0.11670200000000008,49150,83014
"172.16.133.66",53801,"172.16.139.250",5440,10,1022,2182,0,0,10,1022,0,0,13.805608,0.00540499999999966,1512673,0
"172.16.133.82",61273,"172.16.139.250",5440,10,1022,2183,0,0,10,1022,0,0,13.817447,0.005748999999999782,1422160,0
"172.16.133.37",60557,"172.16.139.250",5440,10,1022,2184,0,0,10,1022,0,0,13.832432,0.015587999999999269,524506,0
"172.16.133.63",53511,"96.43.146.22",443,9,557,2185,0,0,4,240,5,317,13.832886,76.678218,25,33
"172.16.133.63",53506,"96.43.146.22",443,9,557,2186,0,0,4,240,5,317,13.832888,76.70139900000001,25,33
"172.16.133.63",53508,"96.43.146.22",443,9,557,2187,0,0,4,240,5,317,13.83289,76.762018,25,33
"172.16.133.63",53510,"96.43.146.22",443,9,557,2188,0,0,4,240,5,317,13.832891,76.701397,25,33
"172.16.133.63",53507,"96.43.146.22",443,9,557,2189,0,0,4,240,5,317,13.832892,76.761048,25,33
"172.16.133.63",53509,"96.43.146.22",443,9,557,2190,0,0,4,240,5,317,13.832893,76.696934,25,33
"172.16.133.97",51866,"172.16.139.250",5500,266,136104,2191,0,0,266,136104,0,0,13.834791,240.198318,4533,0
"172.16.133.45",61052,"157.56.234.118",443,24,1980,2192,0,0,12,1260,12,720,13.855341,270.060655,37,21
"172.16.133.51",57468,"67.217.95.254",443,6,366,2193,0,0,4,246,2,120,13.859303,0.049877999999999645,39456,19246
"172.16.133.132",54700,"98.139.161.29",80,9,1428,2194,0,0,5,715,4,713,13.862937,0.11245699999999914,50863,50721
"172.16.133.132",44390,"98.138.19.88",80,10,1681,2195,0,0,5,733,5,948,13.881626,0.2646759999999997,22155,28653
"172.16.133.97",50770,"157.56.240.102",443,39,4888,2196,0,0,20,3748,19,1140,13.883966000000001,278.995832,107,32
"172.16.133.73",60187,"74.122.143.72",80,6,360,2197,0,0,3,180,3,180,13.895549,34.721627999999995,41,41
"172.16.133.126",51610,"157.56.244.214",443,10,775,2198,0,0,5,475,5,300,13.896031,239.99384,15,10
"172.16.133.63",53828,"199.59.149.230",443,27,10715,2199,0,0,12,3486,15,7229,13.90498,30.726157,907,1882
"172.16.133.63",53493,"96.43.146.50",443,9,557,2200,0,0,4,240,5,317,13.905796,76.61880500000001,25,33
"172.16.133.63",53499,"96.43.146.178",443,9,557,2201,0,0,4,240,5,317,13.905797,76.61229599999999,25,33
"172.16.133.132",52413,"98.139.240.23",80,9,1654,2202,0,0,5,1036,4,618,13.906828,0.180377,45948,27409
"172.16.133.63",53488,"64.56.203.22",443,8,480,2203,0,0,4,240,4,240,13.915811,76.68970399999999,25,25
"172.16.133.115",53652,"74.125.226.195",443,8,576,2204,0,0,4,240,4,336,13.920967,15.180912000000001,126,177
"172.16.133.115",53609,"173.194.43.45",80,6,366,2205,0,0,3,180,3,186,13.920969,21.490346000000002,67,69
"157.56.240.102",443,"172.16.133.97",50771,23,4310,2206,0,0,14,3770,9,540,13.925196,227.32562,132,19
"172.16.133.55",56822,"96.43.146.176",443,48,14944,2207,0,0,26,11736,22,3208,13.937134,285.948013,328,89
"172.16.133.115",53574,"23.67.242.50",80,8,492,2208,0,0,5,300,3,192,13.939971,81.820402,29,18
"172.16.133.115",53636,"23.67.242.50",80,7,432,2209,0,0,4,240,3,192,13.940918,81.58031600000001,23,18
"172.16.133.115",53719,"173.194.43.45",80,6,366,2210,0,0,3,180,3,186,13.96101,21.450083,67,69
"172.16.133.78",59036,"172.16.139.250",5440,12,1142,2211,0,0,12,1142,0,0,13.988501,0.006380000000000052,1431974,0
"172.16.133.51",57469,"78.108.117.250",443,6,366,2212,0,0,4,246,2,120,13.994169,0.24759799999999998,7948,3877
"172.16.133.41",52743,"199.102.234.31",80,11,3081,2213,0,0,6,2462,5,619,14.001981,0.14438299999999948,136414,34297
"172.16.133.163",3508,"173.194.75.147",80,3,180,2214,0,0,2,120,1,60,14.004369,0.06724900000000034,14275,7137
"172.16.133.163",3509,"173.194.75.147",80,3,180,2215,0,0,2,120,1,60,14.004481,0.06724099999999922,14277,7138
"172.16.133.163",3510,"173.194.75.147",80,3,180,2216,0,0,2,120,1,60,14.004539,0.06797700000000084,14122,7061
"172.16.133.51",57470,"216.219.117.244",443,6,366,2217,0,0,4,246,2,120,14.004933,0.23739000000000132,8290,4043
"172.16.133.53",53867,"96.43.146.48",443,11,677,2218,0,0,5,300,6,377,14.027417,127.82086299999999,18,23
"172.16.133.67",55930,"172.16.139.250",5440,10,1022,2219,0,0,10,1022,0,0,14.042137,0.008867999999999654,921966,0
"172.16.133.24",57684,"216.115.220.254",443,6,366,2220,0,0,4,246,2,120,14.056723,0.4629349999999999,4251,2073
"172.16.133.56",61355,"172.16.139.250",5440,12,1142,2221,0,0,12,1142,0,0,14.06442,0.0050469999999993576,1810184,0
"172.16.133.114",55302,"69.43.114.2",29677,3,194,2222,0,0,3,194,0,0,14.065411,8.980827,172,0
"172.16.133.78",58715,"216.52.242.80",80,117,92882,2223,0,0,45,23248,72,69634,14.080949,278.099729,668,2003
"172.16.133.42",57016,"172.16.139.250",5440,12,1142,2224,0,0,12,1142,0,0,14.084599,0.013361999999998986,683729,0
"172.16.133.115",53714,"184.173.190.13",80,9,540,2225,0,0,5,300,4,240,14.093915,81.670467,29,23
"172.16.133.109",57949,"23.33.81.213",443,42,26138,2226,0,0,19,1965,23,24173,14.098194,0.2983710000000013,52686,648132
"172.16.133.42",57017,"172.16.139.250",5440,12,1142,2227,0,0,12,1142,0,0,14.098273,0.02440599999999904,374334,0
"172.16.133.34",62891,"157.56.238.6",443,427,319206,2228,0,0,247,308406,180,10800,14.103821,275.961266,8940,313
"172.16.133.73",59435,"96.43.146.48",443,27,8630,2229,0,0,16,5076,11,3554,14.107981,240.351764,168,118
"172.16.133.75",50889,"172.16.139.250",5440,12,1142,2230,0,0,12,1142,0,0,14.119936,0.006613000000001534,1381521,0
"172.16.133.41",52744,"172.16.139.250",5440,10,1022,2231,0,0,10,1022,0,0,14.12228,0.008433000000000135,969524,0
"172.16.133.42",57018,"172.16.139.250",5440,12,1142,2232,0,0,12,1142,0,0,14.123441,0.01207199999999986,756792,0
"172.16.133.132",38720,"98.139.134.187",80,15,8483,2233,0,0,8,942,7,7541,14.132982,0.1744330000000005,43202,345851
"172.16.133.85",52198,"172.16.139.250",5440,12,1142,2234,0,0,12,1142,0,0,14.137838,0.0151419999999991,603354,0
"172.16.133.53",53676,"96.43.146.176",443,11,677,2235,0,0,5,300,6,377,14.144386,127.70381,18,23
"172.16.133.37",56098,"184.51.251.100",80,49,38676,2236,0,0,21,13408,28,25268,14.155371,266.030395,403,759
"96.43.146.22",443,"172.16.133.121",56476,56,26579,2237,0,0,23,3791,33,22788,14.18589,279.703223,108,651
"172.16.133.43",57715,"172.16.139.250",5440,10,1022,2238,0,0,10,1022,0,0,14.194444,0.014806000000000097,552208,0
"172.16.133.24",57685,"202.173.27.250",443,6,366,2239,0,0,4,246,2,120,14.206752,0.5534879999999998,3555,1734
"172.16.133.13",52990,"172.16.139.250",5440,12,1142,2240,0,0,12,1142,0,0,14.210281,0.0054669999999994445,1671117,0
"172.16.133.53",53679,"96.43.146.176",443,11,677,2241,0,0,5,300,6,377,14.234393,127.616486,18,23
"172.16.133.53",53842,"96.43.146.22",443,11,677,2242,0,0,5,300,6,377,14.252368,127.595827,18,23
"172.16.133.20",62326,"172.16.139.250",5440,10,1022,2243,0,0,10,1022,0,0,14.258943,0.015041999999999334,543544,0
"172.16.133.95",56901,"64.74.80.187",443,6,366,2244,0,0,4,246,2,120,14.265431,0.0516640000000006,38092,18581
"172.16.133.53",53678,"96.43.146.176",443,11,677,2245,0,0,5,300,6,377,14.267387,127.582635,18,23
"172.16.133.95",56902,"67.217.65.244",443,6,366,2246,0,0,4,246,2,120,14.276326,0.05591400000000135,35196,17169
"172.16.133.132",50490,"76.13.6.174",80,9,1924,2247,0,0,5,717,4,1207,14.277459,0.0986899999999995,58121,97841
"172.16.133.42",56866,"96.43.146.22",443,69,41899,2248,0,0,40,34928,29,6971,14.277953,260.715355,1071,213
"172.16.133.132",54705,"98.139.161.29",80,9,1428,2249,0,0,5,715,4,713,14.283092,0.1295540000000006,44151,44027
"172.16.133.28",65307,"172.16.139.250",5440,10,1022,2250,0,0,10,1022,0,0,14.290175,0.0059640000000005244,1370892,0
"172.16.133.24",57686,"216.219.120.244",443,6,366,2251,0,0,4,246,2,120,14.296651,0.1836120000000001,10718,5228
"172.16.133.51",57471,"202.173.25.200",443,7,426,2252,0,0,4,246,3,180,14.315279,0.5318459999999998,3700,2707
"172.16.133.99",55995,"172.16.139.250",5440,10,1022,2253,0,0,10,1022,0,0,14.316977,0.005017999999999745,1629334,0
"172.16.133.87",60131,"172.16.139.250",5440,12,1142,2254,0,0,12,1142,0,0,14.338601,0.006280999999999537,1454545,0
"172.16.133.20",62327,"64.94.107.18",80,8,1417,2255,0,0,5,954,3,463,14.339715,0.08456200000000003,90253,43802
"172.16.133.95",56903,"216.115.212.254",443,6,366,2256,0,0,4,246,2,120,14.344342,0.19742500000000085,9968,4862
"172.16.133.116",53177,"172.16.139.250",5440,10,1022,2257,0,0,10,1022,0,0,14.354374,0.010806000000000537,756616,0
"172.16.133.132",44395,"98.138.19.88",80,10,1681,2258,0,0,5,733,5,948,14.361225,0.17538600000000137,33434,43241
"172.16.133.116",53178,"172.16.139.250",5440,10,1022,2259,0,0,10,1022,0,0,14.366154,0.005361000000000615,1525088,0
"172.16.133.132",52418,"98.139.240.23",80,9,1654,2260,0,0,5,1036,4,618,14.370182,0.11881200000000014,69757,41611
"172.16.133.109",47261,"23.33.81.213",443,56,38480,2261,0,0,24,2321,32,36159,14.371516,0.2553560000000008,72714,1132818
"172.16.133.116",53179,"172.16.139.250",5440,10,1022,2262,0,0,10,1022,0,0,14.372469,0.0052620000000001,1553781,0
"172.16.133.20",62328,"208.47.254.81",80,16,2794,2263,0,0,9,1817,7,977,14.374934,91.686801,158,85
"172.16.133.84",58743,"172.16.139.250",5440,10,1022,2264,0,0,10,1022,0,0,14.376361,0.005630000000000024,1452220,0
"172.16.133.53",53680,"96.43.146.176",443,22,6114,2265,0,0,12,4892,10,1222,14.382907,270.26781900000003,144,36
"172.16.133.73",60200,"64.236.116.15",80,5,300,2266,0,0,3,180,2,120,14.383537,34.234460999999996,42,28
"172.16.133.33",57281,"173.194.75.99",443,8,576,2267,0,0,3,180,5,396,14.410724,14.880477999999998,96,212
"172.16.133.63",53513,"96.43.146.22",443,9,557,2268,0,0,4,240,5,317,14.412849,76.100071,25,33
"172.16.133.49",55719,"172.16.139.250",5440,12,1142,2269,0,0,12,1142,0,0,14.455194,0.015183999999999642,601685,0
"172.16.133.113",61327,"157.56.241.150",443,50,6202,2270,0,0,26,4762,24,1440,14.488725,270.01269,141,42
"172.16.133.95",56904,"172.16.139.250",5440,10,1022,2271,0,0,10,1022,0,0,14.489728,0.005805999999999756,1408198,0
"172.16.133.95",56905,"202.173.28.250",443,6,366,2272,0,0,4,246,2,120,14.494391,0.49437900000000035,3980,1941
"157.56.234.118",443,"172.16.133.49",49714,10,775,2273,0,0,5,475,5,300,14.508953,239.885211,15,10
"172.16.133.92",57633,"172.16.139.250",5440,10,1022,2274,0,0,10,1022,0,0,14.517992,0.012304000000000315,664499,0
"172.16.133.76",60750,"157.56.244.214",443,10,775,2275,0,0,5,475,5,300,14.528191,240.034966,15,9
"157.56.236.102",443,"172.16.133.89",55190,1,60,2276,0,0,1,60,0,0,14.533426,0,"",""
"172.16.133.132",38725,"98.139.134.187",80,15,8483,2277,0,0,8,942,7,7541,14.538269,0.16061799999999948,46918,375599
"172.16.133.29",60830,"172.16.139.250",5440,10,1022,2278,0,0,10,1022,0,0,14.538581,0.006921000000000177,1181332,0
"172.16.133.35",49923,"172.16.139.250",5440,12,1142,2279,0,0,12,1142,0,0,14.539447,0.35347100000000076,25846,0
"172.16.133.44",64712,"172.16.139.250",5440,10,1022,2280,0,0,10,1022,0,0,14.544392,0.015715000000000146,520267,0
"172.16.133.16",59330,"208.85.42.33",80,1879,1906989,2281,0,0,643,41114,1236,1865875,14.545021,2.157496,152450,6918668
"172.16.133.207",55886,"172.16.139.250",5440,12,1142,2282,0,0,12,1142,0,0,14.569399,0.016329999999999956,559461,0
"172.16.133.83",57036,"172.16.139.250",5440,10,1022,2283,0,0,10,1022,0,0,14.576969,0.00478099999999948,"",""
"172.16.133.93",60612,"172.16.139.250",5440,12,1142,2284,0,0,12,1142,0,0,14.594343,0.005300000000000082,1723773,0
"172.16.133.76",62079,"96.43.146.22",443,37,15760,2285,0,0,21,13290,16,2470,14.60629,279.211719,380,70
"172.16.133.93",49247,"132.245.1.150",443,28,2958,2286,0,0,15,2178,13,780,14.606518,265.994451,65,23
"172.16.133.11",55095,"172.16.139.250",5440,12,1142,2287,0,0,12,1142,0,0,14.610817,0.015577999999999648,586468,0
"172.16.133.55",57531,"172.16.139.250",5440,10,1022,2288,0,0,10,1022,0,0,14.614732,0.0061029999999995255,1339669,0
"172.16.133.53",53677,"96.43.146.176",443,11,677,2289,0,0,5,300,6,377,14.61743,127.233448,18,23
"172.16.133.63",53514,"96.43.146.22",443,9,557,2290,0,0,4,240,5,317,14.622879,75.89705000000001,25,33
"172.16.133.73",60521,"172.16.139.250",5440,10,1022,2291,0,0,10,1022,0,0,14.639337,0.0067550000000000665,1210362,0
"172.16.133.53",54052,"172.16.139.250",5440,12,1142,2292,0,0,12,1142,0,0,14.641328,0.008816000000001267,1036297,0
"172.16.133.21",53125,"172.16.139.250",5440,10,1022,2293,0,0,10,1022,0,0,14.644293,0.009075000000001054,900936,0
"172.16.133.30",62563,"172.16.139.250",5440,10,1022,2294,0,0,10,1022,0,0,14.648414,0.00923499999999855,885327,0
"172.16.133.25",63358,"172.16.139.250",5440,12,1142,2295,0,0,12,1142,0,0,14.655923,0.005691999999999808,1605059,0
"172.16.133.132",50495,"76.13.6.174",80,9,1930,2296,0,0,5,717,4,1213,14.66369,0.09728899999999996,58958,99744
"172.16.133.34",50392,"172.16.139.250",5440,10,1022,2297,0,0,10,1022,0,0,14.66514,0.005807000000000784,1407955,0
"172.16.133.97",59322,"172.16.139.250",5440,10,1022,2298,0,0,10,1022,0,0,14.674831,0.015429000000001025,529911,0
"172.16.133.73",60186,"68.142.253.40",80,6,360,2299,0,0,3,180,3,180,14.735558,33.952258,42,42
"172.16.133.33",57832,"172.16.139.250",5440,12,1142,2300,0,0,12,1142,0,0,14.751202,0.01625600000000027,562007,0
"172.16.133.132",54710,"98.139.161.29",80,9,1428,2301,0,0,5,715,4,713,14.751275,0.12076799999999999,47363,47231
"172.16.133.39",63486,"173.194.43.46",443,15,1014,2302,0,0,7,420,8,594,14.756498,149.91709600000002,22,31
"172.16.133.132",44400,"98.138.19.88",80,10,1681,2303,0,0,5,733,5,948,14.770452,0.18663899999999956,31418,40634
"172.16.133.132",52423,"98.139.240.23",80,9,1654,2304,0,0,5,1036,4,618,14.779101,0.1333769999999994,62139,37067
"172.16.133.68",60674,"172.16.139.250",5440,10,1022,2305,0,0,10,1022,0,0,14.780141,0.005729999999999791,1426876,0
"172.16.133.40",52395,"172.16.139.250",5500,228,108056,2306,0,0,228,108056,0,0,14.782274,275.97114700000003,3132,0
"172.16.133.23",55006,"173.194.43.32",443,14,954,2307,0,0,6,360,8,594,14.792515999999999,150.002148,19,31
"172.16.133.12",59663,"172.16.139.250",5440,12,1142,2308,0,0,12,1142,0,0,14.79907,0.005697999999998871,1603369,0
"172.16.133.207",49660,"157.56.245.198",443,11,870,2309,0,0,6,570,5,300,14.802629,240.03037600000002,18,9
"172.16.133.63",53829,"172.16.139.250",5440,10,1022,2310,0,0,10,1022,0,0,14.802925,0.005551999999999779,1472622,0
"172.16.133.66",53802,"172.16.139.250",5440,12,1142,2311,0,0,12,1142,0,0,14.819219,0.006149999999999878,1485528,0
"173.2.154.228",38024,"172.16.133.25",59803,91,6852,2312,0,0,49,3869,42,2983,14.831366,282.699756,109,84
"172.16.133.82",61274,"172.16.139.250",5440,12,1142,2313,0,0,12,1142,0,0,14.832607,0.006610000000000227,1382148,0
"172.16.133.33",57535,"23.67.242.59",80,7,432,2314,0,0,4,240,3,192,14.836733,76.99669,24,19
"172.16.133.37",60558,"172.16.139.250",5440,12,1142,2315,0,0,12,1142,0,0,14.845409,0.006429999999999936,1420839,0
"173.194.68.189",443,"172.16.133.29",53750,76,20628,2316,0,0,42,3846,34,16782,14.848077,278.715736,110,481
"172.16.133.73",60203,"23.67.242.8",80,5,306,2317,0,0,3,180,2,126,14.873556,33.738892,42,29
"172.16.133.45",61297,"173.194.75.106",80,21,3968,2318,0,0,10,1774,11,2194,14.885208,255.94655099999997,55,68
"172.16.133.93",60282,"173.194.43.9",443,281,114781,2319,0,0,137,62230,144,52551,14.88836,277.908187,1791,1512
"172.16.133.45",61040,"172.16.139.250",5500,214,104832,2320,0,0,214,104832,0,0,14.926262,281.708079,2977,0
"172.16.133.34",64341,"96.43.146.48",443,15,917,2321,0,0,7,420,8,497,14.946697,211.362314,15,18
"172.16.133.132",38730,"98.139.134.187",80,15,8483,2322,0,0,8,942,7,7541,14.962832,0.174828999999999,43104,345068
"172.16.133.45",61076,"172.16.139.250",5447,12,1668,2323,0,0,12,1668,0,0,14.984864,260.899921,51,0
"65.115.189.199",80,"172.16.133.25",63007,1,60,2324,0,0,1,60,0,0,14.985185,0,"",""
"172.16.133.78",59037,"172.16.139.250",5440,12,1142,2325,0,0,12,1142,0,0,15.002495,0.006902999999999437,1323482,0
"172.16.133.67",55931,"172.16.139.250",5440,10,1022,2326,0,0,10,1022,0,0,15.057385,0.005651000000000295,1446823,0
"172.16.133.56",61356,"172.16.139.250",5440,12,1142,2327,0,0,12,1142,0,0,15.078611,0.004844999999999544,"",""
"172.16.133.55",56811,"96.43.146.22",443,43,20773,2328,0,0,25,17887,18,2886,15.097108,248.420147,576,92
"172.16.133.132",50500,"76.13.6.174",80,9,1928,2329,0,0,5,717,4,1211,15.104232,0.1033760000000008,55486,93716
"172.16.133.114",55232,"96.43.146.22",443,6,394,2330,0,0,3,197,3,197,15.129207,0.04708900000000149,33468,33468
"172.16.133.75",50890,"172.16.139.250",5440,10,1022,2331,0,0,10,1022,0,0,15.133896,0.06200199999999967,131866,0
"172.16.133.41",52745,"172.16.139.250",5440,12,1142,2332,0,0,12,1142,0,0,15.135741,0.0649090000000001,140750,0
"172.16.133.85",52199,"172.16.139.250",5440,12,1142,2333,0,0,12,1142,0,0,15.151833,0.05225399999999958,174838,0
"172.16.133.82",51040,"172.16.139.250",5462,46,2804,2334,0,0,46,2804,0,0,15.165197,279.14515800000004,80,0
"172.16.133.42",57019,"172.16.139.250",5440,12,1142,2335,0,0,12,1142,0,0,15.166346,0.052774999999998684,173112,0
"172.16.133.132",54715,"98.139.161.29",80,9,1428,2336,0,0,5,715,4,713,15.182093,0.14373199999999997,39796,39684
"172.16.133.43",57716,"172.16.139.250",5440,12,1142,2337,0,0,12,1142,0,0,15.207718,0.006299999999999528,1450158,0
"172.16.133.132",44405,"98.138.19.88",80,10,1681,2338,0,0,5,733,5,948,15.21339,0.17895799999999973,32767,42378
"172.16.133.13",52991,"172.16.139.250",5440,10,1022,2339,0,0,10,1022,0,0,15.223621,0.015368999999999744,531979,0
"172.16.133.132",52428,"98.139.240.23",80,9,1653,2340,0,0,5,1035,4,618,15.242625,0.1273939999999989,64995,38808
"172.16.133.41",52746,"199.102.234.31",80,12,3172,2341,0,0,6,2518,6,654,15.245524,0.2542989999999996,79213,20574
"172.16.133.63",53538,"173.194.43.30",443,8,576,2342,0,0,3,180,5,396,15.272941,14.901699,96,212
"172.16.133.20",62329,"172.16.139.250",5440,10,1022,2343,0,0,10,1022,0,0,15.273159,0.1489950000000011,54874,0
"172.16.133.46",58151,"172.16.139.250",5447,10,1400,2344,0,0,10,1400,0,0,15.279556,239.983562,46,0
"172.16.133.28",65308,"172.16.139.250",5440,12,1142,2345,0,0,12,1142,0,0,15.305268,0.12195900000000037,74910,0
"172.16.133.99",55996,"172.16.139.250",5440,10,1022,2346,0,0,10,1022,0,0,15.330267,0.10016200000000097,81627,0
"172.16.133.82",60947,"96.43.146.22",443,15,917,2347,0,0,7,420,8,497,15.332347,210.464027,15,18
"172.16.133.63",64100,"157.55.130.152",40043,26,2920,2348,0,0,12,2072,14,848,15.346235,240.43487,68,28
"172.16.133.60",62055,"173.194.75.99",443,12,828,2349,0,0,5,300,7,528,15.347348,104.97974,22,40
"172.16.133.66",53589,"173.194.43.54",443,41,8838,2350,0,0,20,5682,21,3156,15.348909,210.294555,216,120
"172.16.133.87",60132,"172.16.139.250",5440,10,1022,2351,0,0,10,1022,0,0,15.353407,0.08095299999999916,100996,0
"172.16.133.116",53180,"172.16.139.250",5440,12,1142,2352,0,0,12,1142,0,0,15.368521,0.0755340000000011,120952,0
"172.16.133.84",58744,"172.16.139.250",5440,10,1022,2353,0,0,10,1022,0,0,15.39032,0.05756800000000162,142023,0
"172.16.133.35",49924,"172.16.139.250",5440,12,1142,2354,0,0,12,1142,0,0,15.397561,0.06996499999999983,130579,0
"172.16.133.128",64275,"74.125.226.199",443,76,26383,2355,0,0,38,17536,38,8847,15.411546,243.350366,576,290
"172.16.133.132",38735,"98.139.134.187",80,15,8483,2356,0,0,8,942,7,7541,15.422815,0.1520159999999997,49573,396852
"172.16.133.116",53181,"172.16.139.250",5440,10,1022,2357,0,0,10,1022,0,0,15.445311,0.0105240000000002,776890,0
"172.16.133.49",55720,"172.16.139.250",5440,12,1142,2358,0,0,12,1142,0,0,15.468391,0.006330000000000169,1443285,0
"172.16.133.163",3506,"173.194.75.147",80,3,180,2359,0,0,2,120,1,60,15.479418,0.03923799999999922,24466,12233
"172.16.133.163",3507,"173.194.75.147",80,3,180,2360,0,0,2,120,1,60,15.479482,0.03843899999999856,24974,12487
"172.16.133.163",3498,"173.194.43.46",80,3,180,2361,0,0,2,120,1,60,15.481755,0.020167000000000712,47602,23801
"172.16.133.116",53182,"172.16.139.250",5440,12,1142,2362,0,0,12,1142,0,0,15.482048,0.006473999999998981,1411183,0
"172.16.133.25",63359,"99.138.108.122",20350,3,194,2363,0,0,3,194,0,0,15.492161,9.00114,172,0
"172.16.133.95",56906,"172.16.139.250",5440,10,1022,2364,0,0,10,1022,0,0,15.503913,0.0062829999999998165,1301289,0
"172.16.133.132",50505,"76.13.6.174",80,9,1930,2365,0,0,5,717,4,1213,15.529886,0.09328300000000134,61490,104027
"172.16.133.92",57634,"172.16.139.250",5440,12,1142,2366,0,0,12,1142,0,0,15.535132,0.006774000000000058,1348686,0
"172.16.133.45",61312,"172.16.139.250",5440,12,1142,2367,0,0,12,1142,0,0,15.536406,0.009892000000000678,923574,0
"172.16.133.29",60831,"172.16.139.250",5440,10,1022,2368,0,0,10,1022,0,0,15.550593,0.006469000000000946,1263873,0
"172.16.133.45",60944,"96.43.146.176",443,161,124253,2369,0,0,73,55143,88,69110,15.556835,266.92413300000004,1652,2071
"172.16.133.44",64713,"172.16.139.250",5440,12,1142,2370,0,0,12,1142,0,0,15.557394,0.015227999999998687,599947,0
"172.16.133.45",61284,"96.43.146.176",443,200,152513,2371,0,0,84,58170,116,94343,15.563393,242.15424300000004,1921,3116
"172.16.133.207",55887,"172.16.139.250",5440,12,1142,2372,0,0,12,1142,0,0,15.583671,0.00520499999999835,1755235,0
"172.16.133.83",56600,"96.43.146.48",443,31,14549,2373,0,0,15,7444,16,7105,15.585854,270.40330600000004,220,210
"172.16.133.132",54720,"98.139.161.29",80,9,1428,2374,0,0,5,715,4,713,15.586466,0.13242400000000032,43194,43073
"172.16.133.45",61291,"96.43.146.178",443,17,4890,2375,0,0,10,3126,7,1764,15.587462,61.721693,405,228
"172.16.133.83",57037,"96.43.146.48",443,80,53224,2376,0,0,43,30304,37,22920,15.58873,278.174452,871,659
"172.16.133.83",57038,"96.43.146.48",443,137,97308,2377,0,0,71,54063,66,43245,15.590566,246.25515900000002,1756,1404
"172.16.133.83",57039,"96.43.146.48",443,36,15215,2378,0,0,18,7876,18,7339,15.590999,270.818544,232,216
"172.16.133.83",57040,"172.16.139.250",5440,12,1142,2379,0,0,12,1142,0,0,15.591937,0.004654999999999632,"",""
"172.16.133.93",60613,"172.16.139.250",5440,12,1142,2380,0,0,12,1142,0,0,15.608267,0.01456300000000077,627343,0
"172.16.133.132",44410,"98.138.19.88",80,10,1681,2381,0,0,5,733,5,948,15.608268,0.2124429999999986,27602,35698
"172.16.133.132",52433,"98.139.240.23",80,9,1654,2382,0,0,5,1036,4,618,15.617165,0.14405,57535,34321
"172.16.133.83",57041,"96.43.146.48",443,192,142680,2383,0,0,89,50194,103,92486,15.617393,245.71931899999998,1634,3011
"172.16.133.83",57042,"96.43.146.48",443,97,68357,2384,0,0,52,37613,45,30744,15.619355,245.47721899999996,1225,1001
"172.16.133.11",55096,"172.16.139.250",5440,10,1022,2385,0,0,10,1022,0,0,15.62515,0.015874000000000166,515056,0
"172.16.133.55",57532,"172.16.139.250",5440,10,1022,2386,0,0,10,1022,0,0,15.628661,0.016634000000001592,491523,0
"172.16.133.73",60522,"172.16.139.250",5440,10,1022,2387,0,0,10,1022,0,0,15.652804,0.006007999999999569,1360852,0
"172.16.133.53",54053,"172.16.139.250",5440,10,1022,2388,0,0,10,1022,0,0,15.655279,0.00713400000000064,1146061,0
"172.16.133.21",53126,"172.16.139.250",5440,10,1022,2389,0,0,10,1022,0,0,15.658218,0.015852000000000643,515770,0
"172.16.133.30",62564,"172.16.139.250",5440,10,1022,2390,0,0,10,1022,0,0,15.661444,0.005565000000000708,1469182,0
"172.16.133.25",63360,"172.16.139.250",5440,10,1022,2391,0,0,10,1022,0,0,15.670368,0.007540999999999798,1084206,0
"172.16.133.28",65309,"208.111.161.254",80,43,36687,2392,0,0,13,4008,30,32679,15.671507,33.991122000000004,943,7691
"172.16.133.34",50393,"172.16.139.250",5440,10,1022,2393,0,0,10,1022,0,0,15.678044,0.005632000000000303,1451704,0
"172.16.133.97",59323,"172.16.139.250",5440,10,1022,2394,0,0,10,1022,0,0,15.688632,0.007199999999999207,1135555,0
"172.16.133.78",59038,"67.69.196.147",80,6,372,2395,0,0,4,246,2,126,15.70888,19.380815,101,52
"172.16.133.78",59039,"67.69.196.147",80,6,372,2396,0,0,4,246,2,126,15.709001,19.379075,101,52
"172.16.133.78",59041,"208.111.161.254",80,8,492,2397,0,0,4,246,4,246,15.709309,19.360763000000006,101,101
"172.16.133.78",59042,"208.111.161.254",80,8,492,2398,0,0,4,246,4,246,15.709435,19.36058,101,101
"172.16.133.78",59043,"138.108.7.20",80,4,252,2399,0,0,2,126,2,126,15.709623,10.350497,97,97
"172.16.133.78",59044,"138.108.7.20",80,4,252,2400,0,0,2,126,2,126,15.70973,13.87799,72,72
"172.16.133.78",59045,"138.108.7.20",80,8,1543,2401,0,0,4,885,4,658,15.709902,16.179993,437,325
"172.16.133.78",59046,"173.194.43.59",80,6,372,2402,0,0,4,246,2,126,15.710141,19.353817999999997,101,52
"172.16.133.78",59047,"8.27.243.253",80,9,1389,2403,0,0,5,306,4,1083,15.710293,19.357142000000003,126,447
"172.16.133.78",59048,"8.27.243.253",80,13,2547,2404,0,0,7,847,6,1700,15.710424,9.354975,724,1453
"172.16.133.78",59049,"8.27.243.253",80,9,1389,2405,0,0,5,306,4,1083,15.71055,19.356570000000005,126,447
"172.16.133.78",59050,"8.27.243.253",80,9,1389,2406,0,0,5,306,4,1083,15.710678,19.356977,126,447
"172.16.133.78",59051,"8.27.243.253",80,9,1389,2407,0,0,5,306,4,1083,15.710806,19.356764000000005,126,447
"172.16.133.78",59052,"8.27.243.253",80,12,2802,2408,0,0,6,787,6,2015,15.710936,9.354351999999999,673,1723
"172.16.133.90",51473,"74.125.226.192",443,9,636,2409,0,0,4,240,5,396,15.720123,14.867982,129,213
"172.16.133.90",51427,"157.56.245.198",443,20,1670,2410,0,0,10,1070,10,600,15.729379,270.039583,31,17
"172.16.133.114",55303,"96.43.146.176",443,13,1187,2411,0,0,7,681,6,506,15.757674,5.905244999999999,922,685
"172.16.133.114",55304,"96.43.146.176",443,13,1187,2412,0,0,7,681,6,506,15.758906,5.904057999999999,922,685
"172.16.133.114",55305,"96.43.146.176",443,13,1187,2413,0,0,7,681,6,506,15.758907,5.905028999999999,922,685
"172.16.133.114",55306,"96.43.146.176",443,13,1187,2414,0,0,7,681,6,506,15.758908,5.904010000000001,922,685
"172.16.133.114",55307,"96.43.146.176",443,13,1187,2415,0,0,7,681,6,506,15.758909,5.891674000000002,924,687
"172.16.133.78",58983,"96.43.146.176",443,17,3386,2416,0,0,9,2797,8,589,15.762885,270.36065,82,17
"172.16.133.78",55383,"96.43.146.176",443,17,3453,2417,0,0,9,2864,8,589,15.764229,270.345361,84,17
"172.16.133.78",58984,"96.43.146.176",443,34,22798,2418,0,0,12,2985,22,19813,15.765137,270.429395,88,586
"172.16.133.33",57833,"172.16.139.250",5440,10,1022,2419,0,0,10,1022,0,0,15.765137,0.01598200000000105,511575,0
"172.16.133.78",58982,"96.43.146.176",443,74,63480,2420,0,0,25,7709,49,55771,15.76672,259.90160699999996,237,1716
"172.16.133.63",53442,"96.43.146.22",443,7,437,2421,0,0,3,180,4,257,15.790949,34.731643000000005,41,59
"172.16.133.68",60675,"172.16.139.250",5440,12,1142,2422,0,0,12,1142,0,0,15.794231,0.006458000000000297,1414679,0
"172.16.133.41",52600,"63.215.202.6",80,14,840,2423,0,0,8,480,6,360,15.800034,264.269793,14,10
"172.16.133.12",59664,"172.16.139.250",5440,12,1142,2424,0,0,12,1142,0,0,15.809312,0.00630999999999915,1447860,0
"172.16.133.116",53099,"96.43.146.22",443,20,9156,2425,0,0,11,7791,9,1365,15.809474,72.985477,853,149
"172.16.133.116",52399,"96.43.146.48",443,1800,1527499,2426,0,0,792,699159,1008,828340,15.812781,263.26331700000003,21245,25171
"172.16.133.26",49322,"132.245.1.150",443,10,795,2427,0,0,5,495,5,300,15.81314,240.031856,16,9
"172.16.133.63",53830,"172.16.139.250",5440,10,1022,2428,0,0,10,1022,0,0,15.817275,0.005499999999999616,1486545,0
"172.16.133.132",38740,"98.139.134.187",80,15,8483,2429,0,0,8,942,7,7541,15.820923,0.20872699999999966,36104,289028
"172.16.133.66",53803,"172.16.139.250",5440,10,1022,2430,0,0,10,1022,0,0,15.833147,0.005698999999999899,1434637,0
"172.16.133.82",61275,"172.16.139.250",5440,10,1022,2431,0,0,10,1022,0,0,15.846479,0.00557500000000033,1466547,0
"172.16.133.37",60559,"172.16.139.250",5440,10,1022,2432,0,0,10,1022,0,0,15.860312,0.014920999999999296,547952,0
"65.54.49.142",443,"172.16.133.45",61062,8,1840,2433,0,0,4,1588,4,252,15.865987,282.708435,44,7
"172.16.133.41",51884,"173.194.43.40",443,16,1080,2434,0,0,7,420,9,660,15.880017,195.015538,17,27
"172.16.133.67",62086,"157.56.242.198",443,144,38888,2435,0,0,76,34808,68,4080,15.886405,273.74012999999997,1017,119
"172.16.133.51",57472,"67.217.95.254",443,6,366,2436,0,0,4,246,2,120,15.891327,0.07515099999999997,26187,12774
"157.56.242.198",443,"172.16.133.67",62087,100,22288,2437,0,0,64,20128,36,2160,15.922523,241.22324399999997,667,71
"172.16.133.132",50510,"76.13.6.174",80,9,1927,2438,0,0,5,717,4,1210,15.947683,0.13527800000000134,42401,71556
"172.16.133.39",64233,"95.211.37.195",5938,19,1374,2439,0,0,13,906,6,468,15.962773,279.69816399999996,25,13
"172.16.133.25",62933,"96.43.146.22",443,34,16148,2440,0,0,20,13420,14,2728,15.991055,255.49088400000002,420,85
"172.16.133.41",52468,"173.194.75.103",80,14,870,2441,0,0,7,420,7,450,15.992986,204.025539,16,17
"172.16.133.42",58770,"96.43.146.48",443,25,8055,2442,0,0,15,5010,10,3045,15.999637,240.56570899999997,166,101
"172.16.133.41",52540,"173.194.75.103",80,14,870,2443,0,0,7,420,7,450,15.99998,204.018749,16,17
"68.64.5.249",443,"172.16.133.83",56980,3,180,2444,0,0,1,60,2,120,16.017799,70.89735300000001,6,13
"172.16.133.78",59053,"172.16.139.250",5440,8,902,2445,0,0,8,902,0,0,16.020406,0.015406999999999726,468358,0
"172.16.133.28",65310,"8.27.243.253",80,37,13899,2446,0,0,17,5454,20,8445,16.028653,13.612022000000003,3205,4963
"172.16.133.28",65311,"8.27.243.253",80,31,10657,2447,0,0,15,4596,16,6061,16.028836,13.611739,2701,3562
"172.16.133.132",54725,"98.139.161.29",80,9,1428,2448,0,0,5,715,4,713,16.041021,0.2490869999999994,22963,22899
"172.16.133.20",61371,"23.33.81.244",80,3,180,2449,0,0,2,120,1,60,16.044334,0.03284800000000132,29225,14612
"172.16.133.20",61383,"23.33.81.244",80,3,180,2450,0,0,2,120,1,60,16.044419,0.03027099999999905,31713,15856
"172.16.133.20",61675,"23.33.81.244",80,3,180,2451,0,0,2,120,1,60,16.044476,0.030132000000001824,31859,15929
"172.16.133.20",61676,"23.33.81.244",80,3,180,2452,0,0,2,120,1,60,16.044478,0.030532999999998367,31441,15720
"172.16.133.68",49735,"157.56.242.198",443,10,795,2453,0,0,5,495,5,300,16.045405,240.01996600000004,16,9
"172.16.133.29",60832,"216.52.242.80",80,106,60615,2454,0,0,50,29790,56,30825,16.045543,278.483369,855,885
"172.16.133.132",44415,"98.138.19.88",80,10,1681,2455,0,0,5,733,5,948,16.06305,0.32690200000000047,17938,23199
"172.16.133.67",55932,"172.16.139.250",5440,10,1022,2456,0,0,10,1022,0,0,16.071187,0.014918000000001541,548062,0
"172.16.133.132",52438,"98.139.240.23",80,10,1713,2457,0,0,6,1095,4,618,16.072097,0.5518339999999995,15874,8959
"172.16.133.28",65312,"216.52.242.80",80,6,372,2458,0,0,4,246,2,126,16.080617,13.63513,144,73
"172.16.133.56",61357,"172.16.139.250",5440,10,1022,2459,0,0,10,1022,0,0,16.092325,0.004751000000002392,"",""
"172.16.133.41",52394,"173.192.115.20",80,14,840,2460,0,0,7,420,7,420,16.110027,213.943906,15,15
"172.16.133.82",49257,"74.125.133.125",443,19,3712,2461,0,0,9,600,10,3112,16.110437,280.482904,17,88
"172.16.133.42",57020,"172.16.139.250",5440,12,1142,2462,0,0,12,1142,0,0,16.112196,0.07730399999999804,118182,0
"172.16.133.33",57493,"96.43.146.176",443,265,211176,2463,0,0,122,108404,143,102772,16.132712,242.46064199999998,3576,3390
"172.16.133.51",57473,"78.108.117.250",443,6,366,2464,0,0,4,246,2,120,16.140147,0.29146800000000184,6752,3293
"172.16.133.51",57474,"216.219.117.244",443,6,366,2465,0,0,4,246,2,120,16.141923,0.28976000000000113,6791,3313
"172.16.133.75",50891,"172.16.139.250",5440,10,1022,2466,0,0,10,1022,0,0,16.148167,0.016014999999999446,510521,0
"172.16.133.41",52747,"172.16.139.250",5440,10,1022,2467,0,0,10,1022,0,0,16.14998,0.01794699999999949,455563,0
"172.16.133.85",52200,"172.16.139.250",5440,10,1022,2468,0,0,10,1022,0,0,16.166056,0.01972499999999755,414499,0
"172.16.133.60",62064,"173.194.74.95",80,10,618,2469,0,0,5,300,5,318,16.167368,112.00483000000001,21,22
"172.16.133.16",59177,"208.85.40.20",80,36,22140,2470,0,0,18,11167,18,10973,16.208668,263.582671,338,333
"172.16.133.66",53390,"96.43.146.50",443,17,1037,2471,0,0,8,480,9,557,16.219327,263.76047,14,16
"172.16.133.43",57717,"172.16.139.250",5440,10,1022,2472,0,0,10,1022,0,0,16.221553,0.005334999999998757,1532521,0
"172.16.133.28",65313,"208.111.161.254",80,8,492,2473,0,0,4,246,4,246,16.233619,13.409474,146,146
"172.16.133.66",50012,"172.16.139.250",5447,10,1380,2474,0,0,10,1380,0,0,16.23362,239.982492,46,0
"172.16.133.28",65314,"208.111.161.254",80,8,492,2475,0,0,4,246,4,246,16.233755,13.410250000000001,146,146
"172.16.133.28",65315,"208.111.161.254",80,8,492,2476,0,0,4,246,4,246,16.233914,13.410024,146,146
"172.16.133.28",65316,"216.52.242.80",80,6,372,2477,0,0,4,246,2,126,16.2341,13.484281,145,74
"172.16.133.13",52992,"172.16.139.250",5440,10,1022,2478,0,0,10,1022,0,0,16.240745,0.015177999999998804,538674,0
"157.56.244.214",443,"172.16.133.11",49562,34,25568,2479,0,0,22,24842,12,726,16.287005,239.90629600000003,828,24
"172.16.133.20",62330,"172.16.139.250",5440,10,1022,2480,0,0,10,1022,0,0,16.287953,0.006088999999999345,1342749,0
"157.56.245.198",443,"172.16.133.90",51428,14,1173,2481,0,0,7,753,7,420,16.29001,243.02257600000002,24,13
"172.16.133.95",56907,"64.74.80.187",443,7,432,2482,0,0,5,312,2,120,16.293625,3.050053000000002,818,314
"172.16.133.95",56908,"67.217.65.244",443,6,366,2483,0,0,4,246,2,120,16.305468,0.08870199999999784,22186,10822
"172.16.133.28",65317,"172.16.139.250",5440,12,1142,2484,0,0,12,1142,0,0,16.319507,0.006359999999997257,1436477,0
"157.56.240.102",443,"172.16.133.99",52161,71,33481,2485,0,0,47,32041,24,1440,16.326144,280.683908,913,41
"157.56.232.214",443,"172.16.133.44",49225,69,35193,2486,0,0,46,33813,23,1380,16.326319,277.55084,974,39
"172.16.133.99",52160,"157.56.240.102",443,71,16692,2487,0,0,37,14652,34,2040,16.327384,280.480711,417,58
"172.16.133.44",49224,"157.56.232.214",443,69,16257,2488,0,0,36,14277,33,1980,16.327769,280.573233,407,56
"157.56.245.198",443,"172.16.133.33",49313,92,48662,2489,0,0,64,46982,28,1680,16.333888,268.30894,1400,50
"172.16.133.33",49306,"157.56.245.198",443,90,21717,2490,0,0,47,19137,43,2580,16.335435,276.416772,553,74
"172.16.133.99",55997,"172.16.139.250",5440,10,1022,2491,0,0,10,1022,0,0,16.344179,0.014900000000000801,548724,0
"172.16.133.132",38745,"98.139.134.187",80,15,8483,2492,0,0,8,942,7,7541,16.35862,0.13900800000000046,54212,433989
"172.16.133.87",60133,"172.16.139.250",5440,12,1142,2493,0,0,12,1142,0,0,16.366417,0.006477000000000288,1410529,0
"172.16.133.20",62239,"173.194.43.36",80,14,870,2494,0,0,7,420,7,450,16.367201,199.68804400000002,16,18
"172.16.133.116",53183,"172.16.139.250",5440,10,1022,2495,0,0,10,1022,0,0,16.383812,0.005162999999999585,1583575,0
"172.16.133.116",53184,"172.16.139.250",5440,10,1022,2496,0,0,10,1022,0,0,16.3899,0.015261999999999887,535709,0
"172.16.133.24",57687,"216.219.120.244",443,6,366,2497,0,0,4,246,2,120,16.391527,0.17510400000000104,11239,5482
"172.16.133.35",49925,"172.16.139.250",5440,12,1142,2498,0,0,12,1142,0,0,16.398694,0.014654000000000167,623447,0
"172.16.133.114",55308,"96.43.146.22",443,13,1191,2499,0,0,7,685,6,506,16.404715,5.258201,1042,769
"172.16.133.116",53185,"172.16.139.250",5440,10,1022,2500,0,0,10,1022,0,0,16.406023,0.006575999999999027,1243309,0
"172.16.133.114",55309,"96.43.146.22",443,13,1191,2501,0,0,7,685,6,506,16.406597,5.256318,1042,770
"172.16.133.84",58745,"172.16.139.250",5440,10,1022,2502,0,0,10,1022,0,0,16.407386,0.009243000000001445,884561,0
"172.16.133.114",55310,"96.43.146.22",443,13,1191,2503,0,0,7,685,6,506,16.416579,5.232679000000001,1047,773
"172.16.133.114",55311,"96.43.146.22",443,13,1191,2504,0,0,7,685,6,506,16.436453,5.212333000000001,1051,776
"172.16.133.114",55312,"96.43.146.22",443,18,4392,2505,0,0,10,3512,8,880,16.437425,116.158946,241,60
"172.16.133.95",56909,"216.115.212.254",443,6,366,2506,0,0,4,246,2,120,16.449522,0.19128999999999863,10288,5018
"172.16.133.114",55313,"96.43.146.22",443,53,29465,2507,0,0,31,25100,22,4365,16.471881,263.136842,763,132
"172.16.133.114",55314,"96.43.146.22",443,13,1191,2508,0,0,7,685,6,506,16.473442,5.186251000000002,1056,780
"172.16.133.132",50515,"76.13.6.174",80,9,1929,2509,0,0,5,717,4,1212,16.478921,0.10107899999999859,56747,95924
"172.16.133.49",55721,"172.16.139.250",5440,12,1142,2510,0,0,12,1142,0,0,16.482091,0.005735999999998853,1592747,0
"172.16.133.114",55315,"96.43.146.22",443,13,1191,2511,0,0,7,685,6,506,16.485675,5.160187999999998,1061,784
"172.16.133.132",54730,"98.139.161.29",80,9,1428,2512,0,0,5,715,4,713,16.491137,0.11904200000000031,48050,47915
"172.16.133.83",57043,"216.52.242.80",80,16,3205,2513,0,0,11,2170,5,1035,16.492783,270.55287500000003,64,30
"172.16.133.116",52398,"96.43.146.48",443,2296,1943684,2514,0,0,1011,884582,1285,1059102,16.493503,263.489092,26857,32156
"172.16.133.116",53186,"96.43.146.176",443,1114,932809,2515,0,0,490,421853,624,510956,16.498868,262.637069,12849,15563
"172.16.133.29",60601,"96.43.146.176",443,15,917,2516,0,0,7,420,8,497,16.500267,214.664398,15,18
"172.16.133.29",60606,"96.43.146.176",443,15,917,2517,0,0,7,420,8,497,16.515319,214.648532,15,18
"172.16.133.95",56910,"172.16.139.250",5440,10,1022,2518,0,0,10,1022,0,0,16.51806,0.015420000000002432,530220,0
"172.16.133.92",57635,"172.16.139.250",5440,10,1022,2520,0,0,10,1022,0,0,16.548307,0.015485999999999223,527960,0
"172.16.133.29",60833,"172.16.139.250",5440,10,1022,2521,0,0,10,1022,0,0,16.564386,0.005973000000000894,1368826,0
"172.16.133.44",64714,"172.16.139.250",5440,10,1022,2522,0,0,10,1022,0,0,16.571709,0.015440000000001675,529533,0
"172.16.133.132",52442,"98.139.240.23",80,9,1653,2523,0,0,5,1035,4,618,16.577134,0.10712499999999991,77292,46151
"172.16.125.220",22318,"172.16.133.233",80,7,420,2524,0,0,4,240,3,180,16.585493,0.19406199999999885,9893,7420
"172.16.133.51",57475,"202.173.25.200",443,6,366,2525,0,0,4,246,2,120,16.586078,0.5510339999999978,3571,1742
"172.16.133.207",55888,"172.16.139.250",5440,10,1022,2526,0,0,10,1022,0,0,16.596604,0.014469000000001841,565070,0
"172.16.133.83",57044,"172.16.139.250",5440,12,1142,2527,0,0,12,1142,0,0,16.605112,0.014982000000003382,609798,0
"172.16.133.132",44421,"98.138.19.88",80,10,1681,2528,0,0,5,733,5,948,16.620715,0.18260199999999926,32113,41532
"172.16.133.93",60614,"172.16.139.250",5440,10,1022,2529,0,0,10,1022,0,0,16.622697,0.013991000000000753,584375,0
"172.16.133.11",55097,"172.16.139.250",5440,10,1022,2530,0,0,10,1022,0,0,16.640517,0.015596999999999639,524203,0
"172.16.133.55",57533,"172.16.139.250",5440,10,1022,2531,0,0,10,1022,0,0,16.646739,0.014714000000001448,555661,0
"172.16.133.73",60523,"172.16.139.250",5440,10,1022,2532,0,0,10,1022,0,0,16.66691,0.019969999999997157,409414,0
"172.16.133.53",54054,"172.16.139.250",5440,10,1022,2533,0,0,10,1022,0,0,16.668193,0.022872000000003112,357467,0
"172.16.133.21",53127,"172.16.139.250",5440,10,1022,2534,0,0,10,1022,0,0,16.672431,0.005935000000000912,1377590,0
"172.16.133.30",62565,"172.16.139.250",5440,10,1022,2535,0,0,10,1022,0,0,16.675469,0.0074380000000005,1099220,0
"172.16.133.114",55316,"96.43.146.22",443,13,1193,2536,0,0,7,687,6,506,16.681008,5.907181000000001,930,685
"172.16.133.114",55317,"96.43.146.22",443,13,1193,2537,0,0,7,687,6,506,16.681011,5.915870999999999,929,684
"172.16.133.114",55318,"96.43.146.22",443,13,1193,2538,0,0,7,687,6,506,16.681013,5.914133,929,684
"172.16.133.25",63361,"172.16.139.250",5440,12,1142,2539,0,0,12,1142,0,0,16.682837,0.011843999999999966,771361,0
"172.16.133.34",50394,"172.16.139.250",5440,10,1022,2540,0,0,10,1022,0,0,16.692422,0.006211999999997886,1316162,0
"172.16.133.97",59324,"172.16.139.250",5440,10,1022,2541,0,0,10,1022,0,0,16.70293,0.005383000000001914,1518855,0
"172.16.133.41",52620,"8.18.45.80",80,6,360,2542,0,0,3,180,3,180,16.730004,53.281669,27,27
"172.16.133.95",56911,"202.173.28.250",443,6,366,2543,0,0,4,246,2,120,16.74653,0.5033369999999984,3909,1907
"172.16.133.33",57834,"172.16.139.250",5440,12,1142,2544,0,0,12,1142,0,0,16.778852,0.006275999999999726,1455704,0
"172.16.133.132",38750,"98.139.134.187",80,15,8483,2545,0,0,8,942,7,7541,16.787832,0.20083699999999993,37522,300382
"172.16.133.68",60676,"172.16.139.250",5440,10,1022,2546,0,0,10,1022,0,0,16.809381,0.0054960000000008336,1487627,0
"172.16.133.20",62238,"173.194.43.39",80,14,870,2547,0,0,7,420,7,450,16.819171,199.242077,16,18
"172.16.133.12",59665,"172.16.139.250",5440,12,1142,2548,0,0,12,1142,0,0,16.823908,0.005504000000001952,1659883,0
"172.16.133.63",53831,"172.16.139.250",5440,12,1142,2549,0,0,12,1142,0,0,16.831255,0.01600300000000132,570892,0
"172.16.133.66",53804,"172.16.139.250",5440,10,1022,2550,0,0,10,1022,0,0,16.848001,0.005628000000001521,1452736,0
"172.16.133.82",61276,"172.16.139.250",5440,10,1022,2551,0,0,10,1022,0,0,16.860389,0.005545999999998941,1474215,0
"172.16.133.37",60560,"172.16.139.250",5440,12,1142,2552,0,0,12,1142,0,0,16.874972,0.006546000000000163,1395661,0
"172.16.133.63",53397,"216.52.242.80",80,23,10221,2553,0,0,15,6402,8,3819,16.892991,276.982375,184,110
"172.16.133.20",62231,"173.194.43.47",80,14,870,2554,0,0,7,420,7,450,16.89421,199.16682400000002,16,18
"172.16.133.85",51795,"96.43.146.48",443,11,677,2555,0,0,5,300,6,377,16.909124,124.704387,19,24
"172.16.133.85",51798,"96.43.146.48",443,11,677,2556,0,0,5,300,6,377,16.909125,124.70517499999998,19,24
"172.16.133.20",62241,"173.194.43.39",80,14,870,2557,0,0,7,420,7,450,16.914201,199.147162,16,18
"172.16.133.85",51797,"96.43.146.48",443,11,677,2558,0,0,5,300,6,377,16.928141,124.68537300000001,19,24
"172.16.133.132",50520,"76.13.6.174",80,9,1929,2559,0,0,5,717,4,1212,16.949025,0.11708300000000094,48990,82813
"172.16.133.12",59666,"96.43.146.22",443,18,1477,2560,0,0,10,868,8,609,16.972146,270.399838,25,18
"172.16.133.12",59667,"96.43.146.22",443,18,1477,2561,0,0,10,868,8,609,16.972363,270.39961700000003,25,18
"172.16.133.12",59668,"96.43.146.50",443,18,1476,2562,0,0,10,867,8,609,16.974645,270.430302,25,18
"172.16.133.12",59669,"96.43.146.22",443,18,1475,2563,0,0,10,866,8,609,16.975556,270.401386,25,18
"172.16.133.12",59670,"96.43.146.22",443,19,1535,2564,0,0,10,866,9,669,16.975716,270.527077,25,19
"172.16.133.12",59671,"96.43.146.22",443,18,1475,2565,0,0,10,866,8,609,16.975825,270.399141,25,18
"172.16.133.12",59672,"96.43.146.22",443,18,1475,2566,0,0,10,866,8,609,16.97592,270.39606100000003,25,18
"172.16.133.12",59673,"96.43.146.22",443,18,1475,2567,0,0,10,866,8,609,16.976016,270.395967,25,18
"172.16.133.41",52622,"8.18.45.81",80,6,360,2568,0,0,3,180,3,180,16.985037,53.026429,27,27
"172.16.133.20",62227,"173.194.43.55",80,16,2251,2569,0,0,8,1520,8,731,16.989222,244.35311299999998,49,23
"172.16.133.12",59674,"96.43.146.48",443,185,161998,2570,0,0,71,41001,114,120997,17.01454,273.46745799999997,1199,3539
"172.16.133.12",59675,"96.43.146.48",443,80,59784,2571,0,0,31,13651,49,46133,17.014665,273.39738500000004,399,1349
"172.16.133.12",59676,"96.43.146.48",443,80,64078,2572,0,0,29,13593,51,50485,17.014772,273.42724400000003,397,1477
"172.16.133.12",59677,"96.43.146.48",443,98,78561,2573,0,0,34,11570,64,66991,17.014874,273.234959,338,1961
"172.16.133.132",54735,"98.139.161.29",80,9,1428,2574,0,0,5,715,4,713,17.025819,0.13025100000000123,43915,43792
"172.16.133.78",59054,"172.16.139.250",5440,12,1142,2575,0,0,12,1142,0,0,17.030923,0.008746999999999616,1044472,0
"172.16.133.132",52447,"98.139.240.23",80,9,1653,2576,0,0,5,1035,4,618,17.050783,0.10948000000000135,75630,45158
"172.16.133.78",59055,"64.94.107.23",80,8,1515,2577,0,0,5,1052,3,463,17.069286,0.07196699999999723,116942,51468
"172.16.133.20",62228,"173.194.43.55",80,58,47203,2578,0,0,20,6191,38,41012,17.073257,244.749104,202,1340
"172.16.133.67",55933,"172.16.139.250",5440,10,1022,2579,0,0,10,1022,0,0,17.085377,0.005663999999999447,1443502,0
"172.16.133.56",61358,"172.16.139.250",5440,10,1022,2580,0,0,10,1022,0,0,17.106624,0.005169999999999675,1581431,0
"172.16.133.29",60644,"96.43.146.22",443,15,917,2581,0,0,7,420,8,497,17.107315,214.056424,15,18
"172.16.133.42",57021,"172.16.139.250",5440,12,1142,2582,0,0,12,1142,0,0,17.117427,0.020897999999998973,437171,0
"172.16.133.63",53674,"96.43.146.22",443,26,10505,2583,0,0,14,8862,12,1643,17.15297,161.69368999999998,438,81
"172.16.133.75",50706,"204.14.235.124",443,16,960,2584,0,0,8,480,8,480,17.158088,259.001461,14,14
"172.16.133.75",50892,"172.16.139.250",5440,10,1022,2585,0,0,10,1022,0,0,17.16164,0.014639000000002511,558508,0
"172.16.133.41",52748,"172.16.139.250",5440,10,1022,2586,0,0,10,1022,0,0,17.162862,0.006557000000000812,1246911,0
"172.16.133.75",50707,"204.14.235.124",443,16,960,2587,0,0,8,480,8,480,17.163081,258.992066,14,14
"172.16.133.75",50705,"204.14.235.124",443,16,960,2588,0,0,8,480,8,480,17.168071,258.991534,14,14
"172.16.133.20",62242,"173.194.43.46",80,14,870,2589,0,0,7,420,7,450,17.177206,198.882818,16,18
"172.16.133.85",52201,"172.16.139.250",5440,10,1022,2590,0,0,10,1022,0,0,17.180538,0.005251000000001227,1557036,0
"172.16.133.20",62237,"173.194.43.46",80,21,6461,2591,0,0,11,3548,10,2913,17.193193,244.58806199999998,116,95
"172.16.133.92",56346,"96.43.146.48",443,16,977,2592,0,0,8,480,8,497,17.21512,213.738355,17,18
"172.16.133.43",57718,"172.16.139.250",5440,10,1022,2593,0,0,10,1022,0,0,17.235334,0.014950999999999937,546853,0
"172.16.133.116",52378,"173.194.43.40",443,9,636,2594,0,0,4,240,5,396,17.239528,14.944493999999999,128,211
"172.16.133.18",50126,"157.56.238.6",443,210,143776,2595,0,0,92,55058,118,88718,17.249752,183.590922,2399,3865
"172.16.133.13",52993,"172.16.139.250",5440,10,1022,2596,0,0,10,1022,0,0,17.251224,0.01462399999999775,559080,0
"172.16.133.20",62230,"173.194.43.47",80,50,37767,2597,0,0,18,1832,32,35935,17.253267,244.36154,59,1176
"172.16.133.46",64541,"192.147.107.14",8883,8,521,2598,0,0,5,335,3,186,17.257756,0.16345600000000005,16395,9103
"172.16.133.20",62244,"173.194.43.38",80,18,3401,2599,0,0,9,2616,9,785,17.28422,244.54618399999998,85,25
"172.16.133.20",62243,"173.194.43.38",80,16,2614,2600,0,0,8,1889,8,725,17.287241,244.54060500000003,61,23
"172.16.133.20",62331,"172.16.139.250",5440,10,1022,2601,0,0,10,1022,0,0,17.301495,0.014096999999999582,579981,0
"172.16.133.232",443,"172.16.128.234",36174,84,15550,2602,0,0,41,4598,43,10952,17.303648,275.85785799999996,133,317
"172.16.133.29",56011,"96.43.146.176",443,25,6384,2603,0,0,14,4820,11,1564,17.317331,271.83336299999996,141,46
"172.16.133.28",65318,"172.16.139.250",5440,12,1142,2604,0,0,12,1142,0,0,17.332342,0.006439000000000306,1418853,0
"172.16.133.99",55998,"172.16.139.250",5440,12,1142,2605,0,0,12,1142,0,0,17.358566,0.0051120000000004495,1787167,0
"172.16.133.87",60134,"172.16.139.250",5440,10,1022,2606,0,0,10,1022,0,0,17.380144,0.0062069999999998515,1317222,0
"172.16.133.116",53187,"172.16.139.250",5440,10,1022,2607,0,0,10,1022,0,0,17.396402,0.005402000000000129,1513513,0
"172.16.133.92",57506,"96.43.146.176",443,14,857,2608,0,0,7,420,7,437,17.397112,213.352463,15,16
"172.16.128.201",2977,"172.16.133.6",1179,1,60,2609,0,0,1,60,0,0,17.401114,0,"",""
"172.16.128.201",2976,"172.16.133.6",1179,1,60,2610,0,0,1,60,0,0,17.401295,0,"",""
"172.16.128.201",2974,"172.16.133.6",1179,4,240,2611,0,0,2,120,2,120,17.401395,0.09506499999999818,10098,10098
"172.16.128.201",2975,"172.16.133.6",1179,4,240,2612,0,0,2,120,2,120,17.401559,0.09626300000000043,9972,9972
"172.16.128.201",2972,"172.16.133.6",1179,4,240,2613,0,0,2,120,2,120,17.401663,0.09633400000000236,9965,9965
"172.16.128.201",2973,"172.16.133.6",1179,4,240,2614,0,0,2,120,2,120,17.401802,0.09632900000000078,9965,9965
"172.16.128.201",2971,"172.16.133.6",1179,4,240,2615,0,0,2,120,2,120,17.401919,0.09630699999999948,9968,9968
"172.16.128.201",2970,"172.16.133.6",135,4,240,2616,0,0,2,120,2,120,17.402074,0.09625700000000137,9973,9973
"172.16.128.201",2969,"172.16.133.6",135,4,240,2617,0,0,2,120,2,120,17.402077,0.096383000000003,9960,9960
"172.16.128.201",2966,"172.16.133.6",135,4,240,2618,0,0,2,120,2,120,17.402304,0.09624999999999773,9974,9974
"172.16.133.35",49926,"172.16.139.250",5440,12,1142,2619,0,0,12,1142,0,0,17.402356,0.010885999999999285,839243,0
"172.16.128.201",2964,"172.16.133.6",135,4,240,2620,0,0,2,120,2,120,17.40241,0.09627199999999903,9971,9971
"172.16.128.201",2968,"172.16.133.6",135,4,240,2621,0,0,2,120,2,120,17.402572,0.09620999999999924,9978,9978
"172.16.133.116",53188,"172.16.139.250",5440,10,1022,2622,0,0,10,1022,0,0,17.403353,0.005409000000000219,1511554,0
"172.16.133.116",53189,"172.16.139.250",5440,10,1022,2623,0,0,10,1022,0,0,17.40959,0.0072449999999975034,1128502,0
"172.16.133.84",58746,"172.16.139.250",5440,12,1142,2624,0,0,12,1142,0,0,17.418567,0.015955000000001718,572610,0
"172.16.133.207",55625,"216.115.208.203",443,7,420,2625,0,0,4,240,3,180,17.436586,81.60285100000002,23,17
"157.56.242.198",443,"172.16.133.24",55821,30,13128,2626,0,0,19,12468,11,660,17.468018,240.13490199999998,415,21
"172.16.133.75",50704,"204.14.235.124",443,16,960,2627,0,0,8,480,8,480,17.483141,258.67729,14,14
"172.16.133.93",60593,"72.21.211.130",80,3,180,2628,0,0,2,120,1,60,17.491703,0.03621000000000052,26512,13256
"172.16.133.49",55722,"172.16.139.250",5440,12,1142,2629,0,0,12,1142,0,0,17.497063,0.006799999999998363,1343529,0
"172.16.133.20",61079,"157.56.238.6",443,10,795,2630,0,0,5,495,5,300,17.508366,240.08942600000003,16,9
"172.16.133.116",59016,"172.16.139.250",5447,16,1920,2631,0,0,16,1920,0,0,17.531456,227.76430200000001,67,0
"172.16.133.95",56912,"172.16.139.250",5440,10,1022,2632,0,0,10,1022,0,0,17.532073,0.005268999999998414,1551717,0
"172.16.133.41",52623,"67.69.174.130",80,14,870,2633,0,0,8,480,6,390,17.550082,262.471474,14,11
"172.16.133.92",57636,"172.16.139.250",5440,10,1022,2634,0,0,10,1022,0,0,17.561534,0.00546799999999692,1495245,0
"172.16.133.85",60791,"96.43.146.176",443,25,8055,2635,0,0,15,5010,10,3045,17.569679999999998,240.416024,166,101
"172.16.133.29",60834,"172.16.139.250",5440,12,1142,2636,0,0,12,1142,0,0,17.577918,0.008001000000000147,1141857,0
"172.16.133.44",64715,"172.16.139.250",5440,10,1022,2637,0,0,10,1022,0,0,17.584296,0.005584000000002476,1464183,0
"172.16.133.63",52431,"216.52.242.80",80,222,206022,2638,0,0,74,32460,148,173562,17.593005,282.321967,919,4918
"172.16.133.113",55591,"172.16.139.250",135,8,492,2639,0,0,8,492,0,0,17.60565,0.009878999999997973,398420,0
"172.16.133.207",55889,"172.16.139.250",5440,10,1022,2640,0,0,10,1022,0,0,17.610305,0.005911999999998585,1382949,0
"172.16.133.113",55592,"172.16.139.250",5462,10,696,2641,0,0,10,696,0,0,17.615972,0.5194280000000013,10719,0
"172.16.133.83",57045,"172.16.139.250",5440,12,1142,2642,0,0,12,1142,0,0,17.619127,0.013968000000001979,654066,0
"172.16.133.93",60615,"172.16.139.250",5440,10,1022,2643,0,0,10,1022,0,0,17.637558,0.014516000000000417,563240,0
"172.16.133.11",55098,"172.16.139.250",5440,10,1022,2644,0,0,10,1022,0,0,17.652958,0.014588999999997299,560422,0
"172.16.133.55",57534,"172.16.139.250",5440,10,1022,2645,0,0,10,1022,0,0,17.656778,0.014784999999999826,552992,0
"172.16.133.26",52834,"96.43.146.176",443,13,797,2646,0,0,6,360,7,437,17.662031,174.912396,16,19
"172.16.133.33",53877,"96.43.146.176",443,154,115820,2647,0,0,69,48982,85,66838,17.666769,240.523578,1629,2223
"172.16.133.29",60835,"216.52.242.80",80,6,372,2648,0,0,4,246,2,126,17.672538,13.513480000000001,145,74
"172.16.133.73",60524,"172.16.139.250",5440,10,1022,2649,0,0,10,1022,0,0,17.681046,0.00565700000000291,1445289,0
"172.16.133.53",54055,"172.16.139.250",5440,10,1022,2650,0,0,10,1022,0,0,17.683728,0.006765000000001464,1208573,0
"172.16.133.21",53128,"172.16.139.250",5440,10,1022,2651,0,0,10,1022,0,0,17.685713,0.008846000000001908,924259,0
"172.16.133.30",62567,"172.16.139.250",5440,10,1022,2652,0,0,10,1022,0,0,17.689405,0.00922599999999818,886191,0
"172.16.133.25",63362,"172.16.139.250",5440,12,1142,2653,0,0,12,1142,0,0,17.698566,0.014022000000000645,651547,0
"172.16.133.34",50395,"172.16.139.250",5440,12,1142,2654,0,0,12,1142,0,0,17.704956,0.014744000000000312,619641,0
"172.16.133.29",60254,"23.67.242.73",80,39,21299,2655,0,0,15,3459,24,17840,17.711689,269.75800200000003,102,529
"172.16.133.96",52697,"157.56.236.102",443,76,24115,2656,0,0,36,12472,40,11643,17.716191,156.88867499999998,635,593
"172.16.133.97",59325,"172.16.139.250",5440,12,1142,2657,0,0,12,1142,0,0,17.716592,0.01534600000000097,595334,0
"172.16.133.29",60836,"206.33.41.253",80,15,2525,2658,0,0,8,920,7,1605,17.735143,13.386547,549,959
"172.16.133.29",60837,"206.33.41.253",80,13,2523,2659,0,0,7,860,6,1663,17.735294,13.386198,513,993
"172.16.133.29",60838,"206.33.41.253",80,13,2416,2660,0,0,7,860,6,1556,17.735393,13.386197000000003,513,929
"172.16.133.29",60839,"206.33.41.253",80,13,2558,2661,0,0,7,860,6,1698,17.735492999999998,13.385997000000003,513,1014
"172.16.133.41",52625,"23.67.243.19",80,6,366,2662,0,0,3,180,3,186,17.742046,22.263834,64,66
"172.16.133.33",57835,"172.16.139.250",5440,10,1022,2663,0,0,10,1022,0,0,17.792973,0.009159000000000361,892673,0
"172.16.133.207",55626,"216.115.208.203",443,7,420,2664,0,0,4,240,3,180,17.808576,81.21781299999999,23,17
"172.16.133.68",60677,"172.16.139.250",5440,10,1022,2665,0,0,10,1022,0,0,17.823429,0.0057000000000009265,1434385,0
"172.16.133.12",59678,"172.16.139.250",5440,12,1142,2666,0,0,12,1142,0,0,17.837699,0.006288999999998879,1452695,0
"172.16.133.63",53832,"172.16.139.250",5440,12,1142,2667,0,0,12,1142,0,0,17.845392,0.006073000000000661,1504363,0
"172.16.133.66",53805,"172.16.139.250",5440,10,1022,2668,0,0,10,1022,0,0,17.861044,0.06417000000000073,127411,0
"193.182.8.38",4070,"172.16.133.91",51368,32,3175,2669,0,0,15,1176,17,1999,17.862649,269.153386,34,59
"172.16.133.82",61277,"172.16.139.250",5440,12,1142,2670,0,0,12,1142,0,0,17.873674,0.05598499999999973,163186,0
"172.16.133.33",49246,"172.16.139.250",5500,248,122156,2671,0,0,248,122156,0,0,17.878262,256.909507,3803,0
"172.16.133.37",60561,"172.16.139.250",5440,10,1022,2672,0,0,10,1022,0,0,17.888327,0.045260999999999996,180641,0
"172.16.133.51",57476,"67.217.95.254",443,6,366,2673,0,0,4,246,2,120,17.930246,0.04215999999999909,46679,22770
"172.16.133.68",60678,"204.236.235.239",80,10,1433,2674,0,0,5,948,5,485,17.98681,0.0779980000000009,97233,49744
"172.16.133.121",56483,"173.194.75.104",443,308,151818,2675,0,0,122,31260,186,120558,18.010734,253.51144699999998,986,3804
"172.16.133.78",59056,"172.16.139.250",5440,10,1022,2676,0,0,10,1022,0,0,18.044291,0.005654999999997301,1445800,0
"172.16.133.26",52835,"96.43.146.176",443,13,797,2677,0,0,6,360,7,437,18.092949,174.482363,16,20
"172.16.133.67",55934,"172.16.139.250",5440,10,1022,2678,0,0,10,1022,0,0,18.099065,0.008966000000000918,911889,0
"172.16.133.56",61359,"172.16.139.250",5440,12,1142,2679,0,0,12,1142,0,0,18.120775,0.005863000000001506,1558246,0
"172.16.133.42",57022,"172.16.139.250",5440,12,1142,2680,0,0,12,1142,0,0,18.125199,0.022438000000001068,407166,0
"172.16.133.75",50893,"172.16.139.250",5440,10,1022,2681,0,0,10,1022,0,0,18.176091,0.0056189999999993745,1455063,0
"172.16.133.41",52749,"172.16.139.250",5440,10,1022,2682,0,0,10,1022,0,0,18.176984,0.008319999999997663,982692,0
"172.16.133.121",56484,"173.194.43.54",80,6,372,2683,0,0,4,246,2,126,18.186936,10.054927,195,100
"172.16.133.121",56485,"173.194.43.54",443,14,3509,2684,0,0,8,958,6,2551,18.187191,0.4629870000000018,16553,44078
"172.16.133.85",52202,"172.16.139.250",5440,10,1022,2685,0,0,10,1022,0,0,18.193905,0.08837899999999976,92510,0
"172.16.133.33",51959,"172.16.139.250",5500,4,396,2686,0,0,4,396,0,0,18.231487,0.020712999999997095,152947,0
"172.16.133.43",57719,"172.16.139.250",5440,10,1022,2687,0,0,10,1022,0,0,18.248595,0.09924099999999925,82385,0
"172.16.133.13",52994,"172.16.139.250",5440,12,1142,2688,0,0,12,1142,0,0,18.266349,0.08575299999999686,106538,0
"172.16.133.12",63233,"172.16.139.250",5447,16,2240,2689,0,0,16,2240,0,0,18.282001,252.81654899999998,70,0
"172.16.133.33",57658,"96.43.146.48",443,6,360,2690,0,0,3,180,3,180,18.308652,1.2461250000000028,1155,1155
"172.16.133.33",57836,"96.43.146.48",443,41,15461,2691,0,0,21,5708,20,9753,18.308926,104.728916,436,745
"172.16.133.28",65052,"173.194.43.57",80,14,870,2692,0,0,7,420,7,450,18.310196,201.317733,16,17
"172.16.133.20",62332,"172.16.139.250",5440,12,1142,2693,0,0,12,1142,0,0,18.315363,0.07784299999999789,117364,0
"172.16.133.51",57478,"78.108.117.250",443,6,366,2694,0,0,4,246,2,120,18.316154,0.21290799999999876,9243,4508
"172.16.133.51",57477,"216.219.117.244",443,6,366,2695,0,0,4,246,2,120,18.316156,0.22556000000000154,8724,4256
"172.16.133.21",51712,"172.16.139.250",5447,16,1908,2696,0,0,16,1908,0,0,18.323197,262.029689,58,0
"172.16.133.56",61094,"173.194.43.39",443,9,636,2697,0,0,4,240,5,396,18.336556,14.955354,128,211
"216.137.33.105",443,"172.16.133.87",60096,4,240,2698,0,0,2,120,2,120,18.339111,7.679891000000001,125,125
"216.137.33.105",443,"172.16.133.87",60094,4,240,2699,0,0,2,120,2,120,18.34006,7.678345999999998,125,125
"216.137.33.105",443,"172.16.133.87",60095,4,240,2700,0,0,2,120,2,120,18.341563,7.6773039999999995,125,125
"172.16.133.28",65319,"172.16.139.250",5440,10,1022,2701,0,0,10,1022,0,0,18.346093,0.06870400000000032,119003,0
"172.16.133.95",56913,"67.217.65.244",443,6,366,2702,0,0,4,246,2,120,18.36761,0.12317799999999934,15976,7793
"172.16.133.99",55999,"172.16.139.250",5440,12,1142,2703,0,0,12,1142,0,0,18.372052,0.06330799999999925,144310,0
"172.16.133.28",65039,"173.194.43.45",80,14,870,2704,0,0,7,420,7,450,18.37521,201.24809499999998,16,17
"172.16.133.87",60135,"172.16.139.250",5440,12,1142,2705,0,0,12,1142,0,0,18.393951,0.04626700000000028,197462,0
"216.137.33.105",443,"172.16.133.87",60098,4,240,2706,0,0,2,120,2,120,18.406751,7.610610000000001,126,126
"216.137.33.105",443,"172.16.133.87",60099,6,360,2707,0,0,3,180,3,180,18.406867,7.611746,189,189
"216.137.33.105",443,"172.16.133.87",60097,6,360,2708,0,0,3,180,3,180,18.406947,7.6123259999999995,189,189
"157.56.238.6",443,"172.16.133.21",51049,10,795,2709,0,0,5,495,5,300,18.410273,239.70891000000003,16,10
"172.16.133.116",53190,"172.16.139.250",5440,12,1142,2710,0,0,12,1142,0,0,18.41186,0.03201699999999974,285348,0
"172.16.133.92",57509,"96.43.146.176",443,15,917,2711,0,0,7,420,8,497,18.423164,212.326481,15,18
"172.16.133.92",57510,"96.43.146.176",443,15,917,2712,0,0,7,420,8,497,18.423165,212.34876799999998,15,18
"172.16.133.92",57515,"96.43.146.22",443,15,917,2713,0,0,7,420,8,497,18.42615,212.366715,15,18
"172.16.133.35",49927,"172.16.139.250",5440,12,1142,2714,0,0,12,1142,0,0,18.428556,0.04178399999999982,218648,0
"172.16.133.84",58747,"172.16.139.250",5440,12,1142,2715,0,0,12,1142,0,0,18.432438,0.014685000000000059,622131,0
"172.16.133.92",57514,"96.43.146.22",443,15,917,2716,0,0,7,420,8,497,18.4352,212.394971,15,18
"172.16.133.92",57516,"96.43.146.22",443,15,917,2717,0,0,7,420,8,497,18.435202,212.394895,15,18
"172.16.133.92",57513,"96.43.146.22",443,15,917,2718,0,0,7,420,8,497,18.435203,212.397953,15,18
"172.16.133.92",57512,"96.43.146.22",443,15,917,2719,0,0,7,420,8,497,18.436148,212.381776,15,18
"172.16.133.116",53191,"172.16.139.250",5440,12,1142,2720,0,0,12,1142,0,0,18.444809,0.019245999999998986,474696,0
"172.16.133.116",53192,"172.16.139.250",5440,10,1022,2721,0,0,10,1022,0,0,18.464824,0.006771000000000527,1207502,0
"172.16.133.93",53483,"96.43.146.48",443,466,421443,2722,0,0,161,26980,305,394463,18.486369,251.093152,859,12567
"172.16.133.121",56454,"96.43.146.22",443,23,10912,2723,0,0,14,9744,9,1168,18.494183,42.578066,1830,219
"172.16.133.49",55723,"172.16.139.250",5440,10,1022,2724,0,0,10,1022,0,0,18.511233,0.015468999999999511,528540,0
"172.16.133.95",56914,"172.16.139.250",5440,12,1142,2725,0,0,12,1142,0,0,18.546051,0.006089000000002898,1500410,0
"172.16.133.95",56915,"216.115.212.254",443,6,366,2726,0,0,4,246,2,120,18.552627,0.18704199999999815,10521,5132
"172.16.133.121",56486,"74.125.226.193",443,14,4029,2727,0,0,8,958,6,3071,18.55796,4.5494749999999975,1684,5400
"172.16.133.121",56487,"173.194.43.3",443,15,4089,2728,0,0,8,958,7,3131,18.558948,2.05246,3734,12203
"172.16.133.121",56488,"74.125.226.207",443,14,4029,2729,0,0,8,958,6,3071,18.559889,4.547746,1685,5402
"172.16.133.121",56489,"173.194.43.44",443,14,3946,2730,0,0,8,980,6,2966,18.560092,1.3829379999999993,5669,17157
"172.16.133.92",57637,"172.16.139.250",5440,10,1022,2731,0,0,10,1022,0,0,18.575554,0.005535999999999319,1476878,0
"172.16.133.29",60840,"172.16.139.250",5440,12,1142,2732,0,0,12,1142,0,0,18.593163,0.006365999999999872,1435124,0
"172.16.133.44",64716,"172.16.139.250",5440,10,1022,2733,0,0,10,1022,0,0,18.599527,0.006370000000000431,1283516,0
"172.16.133.115",49478,"157.56.244.214",443,106,14183,2734,0,0,53,11003,53,3180,18.608158,270.293101,325,94
"172.16.133.36",64968,"132.245.2.22",443,45,17166,2735,0,0,22,9773,23,7393,18.609399,151.271497,516,390
"132.245.1.150",443,"172.16.133.39",49362,10,795,2736,0,0,5,495,5,300,18.610893,240.433165,16,9
"172.16.133.207",55890,"172.16.139.250",5440,12,1142,2737,0,0,12,1142,0,0,18.624538,0.01918799999999976,476130,0
"172.16.133.83",57046,"172.16.139.250",5440,10,1022,2738,0,0,10,1022,0,0,18.633185,0.0050600000000002865,1615810,0
"172.16.133.93",60616,"172.16.139.250",5440,10,1022,2739,0,0,10,1022,0,0,18.650303,0.016206000000000387,504504,0
"172.16.133.121",56490,"173.194.43.54",443,732,520883,2740,0,0,271,94295,461,426588,18.650567,264.9251,2847,12881
"172.16.133.11",55099,"172.16.139.250",5440,12,1142,2741,0,0,12,1142,0,0,18.665885,0.018318000000000723,498744,0
"172.16.133.55",57535,"172.16.139.250",5440,10,1022,2742,0,0,10,1022,0,0,18.671026,0.0171449999999993,476873,0
"172.16.133.73",60525,"172.16.139.250",5440,12,1142,2743,0,0,12,1142,0,0,18.694873,0.006511999999997187,1402948,0
"172.16.133.53",54056,"172.16.139.250",5440,10,1022,2744,0,0,10,1022,0,0,18.697738,0.006858999999998616,1192010,0
"172.16.133.21",53129,"172.16.139.250",5440,10,1022,2745,0,0,10,1022,0,0,18.700379,0.015817999999999444,516879,0
"172.16.133.30",62568,"172.16.139.250",5440,12,1142,2746,0,0,12,1142,0,0,18.703347,0.005548999999998472,1646422,0
"172.16.133.25",63363,"172.16.139.250",5440,10,1022,2747,0,0,10,1022,0,0,18.711292,0.009142999999998125,894236,0
"172.16.133.34",50396,"172.16.139.250",5440,12,1142,2748,0,0,12,1142,0,0,18.718852,0.014836999999999989,615757,0
"172.16.133.97",59326,"172.16.139.250",5440,12,1142,2749,0,0,12,1142,0,0,18.730629,0.015391999999998518,593555,0
"157.56.241.150",443,"172.16.133.72",49238,10,863,2750,0,0,5,563,5,300,18.741103,255.478521,17,9
"172.16.133.25",63364,"173.194.43.55",443,15,4086,2751,0,0,8,956,7,3130,18.751859,4.249556000000002,1799,5892
"172.16.133.25",63365,"173.194.43.6",443,16,5167,2752,0,0,9,1024,7,4143,18.752024,0.8284850000000006,9887,40005
"172.16.133.25",63366,"173.194.43.42",443,28,2689,2753,0,0,14,1471,14,1218,18.752177,244.240963,48,39
"172.16.133.25",63367,"74.125.226.199",443,14,4028,2754,0,0,8,958,6,3070,18.753103,4.222547000000002,1815,5816
"172.16.133.25",63368,"74.125.226.207",443,26,2490,2755,0,0,13,1379,13,1111,18.7536,244.239266,45,36
"172.16.133.60",61889,"216.52.242.80",80,11,2951,2756,0,0,9,2096,2,855,18.761459,256.6043,65,26
"172.16.133.37",60390,"216.115.208.203",443,11,660,2757,0,0,6,360,5,300,18.78955,169.550306,16,14
"172.16.133.33",57837,"172.16.139.250",5440,12,1142,2758,0,0,12,1142,0,0,18.807345,0.015596999999999639,585753,0
"172.16.133.76",61765,"96.43.146.22",443,35,15581,2759,0,0,20,13150,15,2431,18.829494,255.57212399999997,411,76
"172.16.133.68",60679,"172.16.139.250",5440,10,1022,2760,0,0,10,1022,0,0,18.8375,0.005612000000002837,1456878,0
"172.16.133.12",59679,"172.16.139.250",5440,10,1022,2761,0,0,10,1022,0,0,18.849653,0.005483999999999156,1490882,0
"172.16.133.51",57479,"202.173.25.200",443,6,366,2762,0,0,4,246,2,120,18.858321,0.5271499999999989,3733,1821
"172.16.133.63",53834,"172.16.139.250",5440,12,1142,2763,0,0,12,1142,0,0,18.858888,0.006215999999998445,1469755,0
"173.194.76.125",5222,"172.16.133.114",54053,91,38842,2764,0,0,56,34682,35,4160,18.870289,280.819054,988,118
"172.16.133.66",53806,"172.16.139.250",5440,12,1142,2765,0,0,12,1142,0,0,18.875102,0.005704000000001486,1601683,0
"172.16.133.56",61050,"216.52.242.80",80,4,240,2766,0,0,3,180,1,60,18.87655,32.984401,43,14
"172.16.133.82",61278,"172.16.139.250",5440,10,1022,2767,0,0,10,1022,0,0,18.887704,0.005525999999999698,1479551,0
"172.16.133.37",60562,"172.16.139.250",5440,10,1022,2768,0,0,10,1022,0,0,18.902562,0.005206000000001154,1570495,0
"172.16.133.60",62103,"173.194.43.9",80,10,618,2769,0,0,5,300,5,318,18.905424,109.253607,21,23
"172.16.133.21",53130,"172.16.139.250",5440,12,1142,2770,0,0,12,1142,0,0,18.908432,0.00574100000000044,1591360,0
"172.16.133.21",63842,"96.43.146.48",443,255,197809,2771,0,0,113,81391,142,116418,18.931673,279.989397,2325,3326
"172.16.133.21",63839,"96.43.146.48",443,465,412366,2772,0,0,174,90948,291,321418,18.933132,279.857715,2599,9188
"172.16.133.21",53008,"96.43.146.176",443,9,1771,2773,0,0,5,1168,4,603,18.943674,228.82626399999998,40,21
"172.16.133.95",56916,"202.173.28.250",443,6,366,2774,0,0,4,246,2,120,19.006667,0.4997359999999986,3938,1921
"172.16.133.78",53253,"96.43.146.22",443,35,15497,2775,0,0,20,13070,15,2427,19.019449,256.527806,407,75
"172.16.133.101",49237,"157.56.241.150",443,26,2511,2776,0,0,13,1731,13,780,19.021235,270.032968,51,23
"172.16.133.60",62073,"173.194.75.99",80,10,618,2777,0,0,5,300,5,318,19.025439,109.15213800000001,21,23
"172.16.133.78",59057,"172.16.139.250",5440,10,1022,2778,0,0,10,1022,0,0,19.058323,0.005820999999997412,1404569,0
"172.16.133.44",64726,"184.73.225.104",443,22,7388,2779,0,0,11,2094,11,5294,19.067547,5.373103,3117,7882
"172.16.133.67",55935,"172.16.139.250",5440,10,1022,2780,0,0,10,1022,0,0,19.112711,0.0059729999999973415,1368826,0
"172.16.133.69",50747,"64.94.18.131",80,30,2420,2781,0,0,20,1510,10,910,19.132876,274.244077,44,26
"172.16.133.56",61360,"172.16.139.250",5440,12,1142,2782,0,0,12,1142,0,0,19.135161,0.00531000000000148,1720527,0
"172.16.133.42",57023,"172.16.139.250",5440,12,1142,2783,0,0,12,1142,0,0,19.140149,0.05350299999999919,170756,0
"157.56.238.6",443,"172.16.133.21",51051,10,795,2784,0,0,5,495,5,300,19.142431,240.66173400000002,16,9
"50.19.123.188",443,"172.16.133.153",38469,59,6606,2785,0,0,29,3264,30,3342,19.176855,270.735191,96,98
"172.16.133.75",50894,"172.16.139.250",5440,10,1022,2786,0,0,10,1022,0,0,19.190114,0.005651000000000295,1446823,0
"172.16.133.41",52750,"172.16.139.250",5440,10,1022,2787,0,0,10,1022,0,0,19.191082,0.008581999999996981,952691,0
"172.16.133.85",52203,"172.16.139.250",5440,10,1022,2788,0,0,10,1022,0,0,19.207954,0.005465999999998417,1495792,0
"172.16.133.56",61014,"216.52.242.80",80,4,240,2789,0,0,3,180,1,60,19.250542,32.628646,44,14
"172.16.133.43",57720,"172.16.139.250",5440,12,1142,2790,0,0,12,1142,0,0,19.263617,0.006384000000000611,1431077,0
"172.16.133.13",52995,"172.16.139.250",5440,12,1142,2791,0,0,12,1142,0,0,19.279284,0.006160999999998751,1482876,0
"172.16.133.37",60395,"67.217.67.129",443,10,631,2792,0,0,5,300,5,331,19.302582,118.94308899999999,20,22
"172.16.133.37",60394,"67.217.67.129",443,10,631,2793,0,0,5,300,5,331,19.302583,109.001138,22,24
"208.111.160.6",80,"172.16.133.29",60771,4,240,2794,0,0,2,120,2,120,19.305989,1.7904230000000005,536,536
"172.16.133.37",60391,"67.217.67.129",443,10,631,2795,0,0,5,300,5,331,19.307502,108.99716599999999,22,24
"172.16.133.37",60392,"67.217.67.129",443,10,631,2796,0,0,5,300,5,331,19.308452,118.936246,20,22
"172.16.133.37",60396,"67.217.67.129",443,10,631,2797,0,0,5,300,5,331,19.308453,108.996412,22,24
"172.16.133.20",62333,"172.16.139.250",5440,12,1142,2798,0,0,12,1142,0,0,19.328141,0.014591000000002907,626139,0
"172.16.133.28",65320,"172.16.139.250",5440,10,1022,2799,0,0,10,1022,0,0,19.361561000000002,0.006165999999996785,1325981,0
"172.16.133.116",53193,"208.47.254.83",80,58,21307,2800,0,0,38,15745,20,5562,19.362989,273.47488,460,162
"172.16.133.99",56000,"172.16.139.250",5440,12,1142,2801,0,0,12,1142,0,0,19.386138,0.005071000000000936,1801617,0
"172.16.133.44",64727,"157.56.234.137",443,6,374,2802,0,0,3,194,3,180,19.402033,1.2560660000000006,1235,1146
"172.16.133.87",60136,"172.16.139.250",5440,12,1142,2803,0,0,12,1142,0,0,19.4095,0.01617999999999853,564647,0
"172.16.133.116",53194,"172.16.139.250",5440,12,1142,2804,0,0,12,1142,0,0,19.424653,0.006000000000000227,1522666,0
"172.16.133.35",49928,"172.16.139.250",5440,12,1142,2805,0,0,12,1142,0,0,19.425405,0.02762199999999737,330750,0
"172.16.133.116",53195,"172.16.139.250",5440,10,1022,2806,0,0,10,1022,0,0,19.431316,0.0164880000000025,495875,0
"172.16.133.84",58748,"172.16.139.250",5440,12,1142,2807,0,0,12,1142,0,0,19.446399,0.009828999999999866,929494,0
"172.16.133.116",53196,"172.16.139.250",5440,10,1022,2808,0,0,10,1022,0,0,19.448676,0.010749000000000564,760628,0
"172.16.133.116",53197,"8.27.243.253",80,18,4860,2809,0,0,9,988,9,3872,19.475922,12.697475,622,2439
"172.16.133.116",53198,"8.27.243.253",80,21,7345,2810,0,0,10,1478,11,5867,19.476054,12.697236,931,3696
"172.16.133.116",53199,"8.27.243.253",80,18,7054,2811,0,0,8,1358,10,5696,19.476167,12.692412000000001,855,3590
"172.16.133.116",53200,"8.27.243.253",80,21,7411,2812,0,0,10,1478,11,5933,19.476292,12.696866999999997,931,3738
"172.16.133.116",53201,"8.27.243.253",80,29,12461,2813,0,0,13,2100,16,10361,19.476403,12.696499999999997,1323,6528
"172.16.133.116",53202,"8.27.243.253",80,17,4032,2814,0,0,9,982,8,3050,19.476516,12.696977,618,1921
"172.16.133.21",51050,"157.56.238.6",443,11,894,2815,0,0,6,594,5,300,19.522555,240.08281899999997,19,9
"172.16.133.49",55724,"172.16.139.250",5440,12,1142,2816,0,0,12,1142,0,0,19.525423,0.013083000000001732,698310,0
"172.16.133.60",62062,"173.194.75.99",80,10,618,2817,0,0,5,300,5,318,19.531499,108.645411,22,23
"172.16.133.25",63369,"173.194.43.35",80,82,67209,2818,0,0,30,9693,52,57516,19.556391,269.70595799999995,287,1706
"172.16.133.95",56917,"172.16.139.250",5440,12,1142,2819,0,0,12,1142,0,0,19.560033,0.015268999999999977,598336,0
"172.16.133.128",55063,"172.16.139.250",5500,114,47864,2820,0,0,114,47864,0,0,19.56575,240.19810800000002,1594,0
"172.16.133.25",63370,"173.194.43.34",80,181,177284,2821,0,0,55,5409,126,171875,19.565906,271.62793,159,5062
"172.16.133.25",63371,"173.194.43.34",80,6,372,2822,0,0,4,246,2,126,19.566154,18.286106,107,55
"172.16.133.25",63372,"173.194.43.34",80,6,372,2823,0,0,4,246,2,126,19.566332,18.286099000000004,107,55
"172.16.133.25",63373,"173.194.43.6",443,55,18777,2824,0,0,25,5863,30,12914,19.580968,240.34855600000003,195,429
"172.16.133.114",55319,"96.43.146.22",443,21,4279,2825,0,0,9,1074,12,3205,19.582033,28.518446,301,899
"172.16.133.92",57638,"172.16.139.250",5440,10,1022,2826,0,0,10,1022,0,0,19.589434,0.015343999999998914,532846,0
"172.16.133.25",63374,"173.194.43.36",80,7,432,2827,0,0,4,246,3,186,19.594096,18.258935,107,81
"172.16.133.25",63375,"173.194.43.36",80,6,372,2828,0,0,4,246,2,126,19.594368,18.258321,107,55
"172.16.133.25",63376,"173.194.43.36",80,6,372,2829,0,0,4,246,2,126,19.594571,18.258117000000002,107,55
"172.16.133.29",60841,"172.16.139.250",5440,10,1022,2830,0,0,10,1022,0,0,19.606227,0.005361000000000615,1525088,0
"172.16.133.44",64728,"172.16.139.250",5440,10,1022,2831,0,0,10,1022,0,0,19.614582,0.015441000000002703,529499,0
"172.16.133.42",56851,"173.194.75.106",443,13,888,2832,0,0,6,360,7,528,19.622421,104.984726,27,40
"172.16.133.207",55891,"172.16.139.250",5440,12,1142,2833,0,0,12,1142,0,0,19.639527,0.01578100000000049,578924,0
"172.16.133.114",55320,"96.43.146.22",443,21,4279,2834,0,0,9,1074,12,3205,19.645162,29.033784000000004,295,883
"172.16.133.83",57047,"172.16.139.250",5440,12,1142,2835,0,0,12,1142,0,0,19.646035,0.005350999999997441,1707344,0
"172.16.133.25",63067,"173.194.43.37",443,8,576,2836,0,0,3,180,5,396,19.646102,14.980823000000001,96,211
"172.16.133.83",63465,"157.56.237.150",443,127,44043,2837,0,0,68,40503,59,3540,19.652832,240.08537,1349,117
"216.137.33.141",80,"172.16.133.114",55263,4,240,2838,0,0,2,120,2,120,19.655761,8.489125000000001,113,113
"172.16.133.93",60617,"172.16.139.250",5440,10,1022,2839,0,0,10,1022,0,0,19.664449,0.0046219999999976835,"",""
"172.16.133.11",55100,"172.16.139.250",5440,12,1142,2840,0,0,12,1142,0,0,19.680325,0.04519099999999909,202164,0
"172.16.133.55",57536,"172.16.139.250",5440,12,1142,2841,0,0,12,1142,0,0,19.685432,0.027453000000001282,332786,0
"172.16.133.116",52449,"23.0.49.244",80,63,31292,2842,0,0,30,8147,33,23145,19.708049,268.340775,242,690
"172.16.133.73",60526,"172.16.139.250",5440,10,1022,2843,0,0,10,1022,0,0,19.70904,0.03164599999999851,258358,0
"172.16.133.53",54057,"172.16.139.250",5440,12,1142,2844,0,0,12,1142,0,0,19.711395,0.02213700000000074,412702,0
"172.16.133.21",53131,"172.16.139.250",5440,10,1022,2845,0,0,10,1022,0,0,19.713442,0.023085999999999274,354154,0
"172.16.133.30",62569,"172.16.139.250",5440,10,1022,2846,0,0,10,1022,0,0,19.716374,0.03114800000000173,262488,0
"172.16.133.25",63377,"172.16.139.250",5440,12,1142,2847,0,0,12,1142,0,0,19.726448,0.017602000000000118,519031,0
"172.16.133.116",52504,"23.0.49.244",80,37,16003,2848,0,0,16,3732,21,12271,19.730452,246.22195599999998,121,398
"172.16.133.34",50397,"172.16.139.250",5440,10,1022,2849,0,0,10,1022,0,0,19.733186,0.01823299999999861,448417,0
"172.16.133.97",59327,"172.16.139.250",5440,12,1142,2850,0,0,12,1142,0,0,19.745148,0.021259000000000583,429747,0
"157.56.242.198",443,"172.16.133.68",49737,10,795,2851,0,0,5,495,5,300,19.764054,240.049127,16,9
"172.16.133.33",57838,"172.16.139.250",5440,10,1022,2852,0,0,10,1022,0,0,19.822177,0.0055720000000007985,1467336,0
"172.16.133.49",49705,"157.56.234.118",443,98,22143,2853,0,0,50,19263,48,2880,19.836228,270.112871,570,85
"172.16.133.68",60680,"172.16.139.250",5440,10,1022,2854,0,0,10,1022,0,0,19.850548,0.005434999999998524,1504323,0
"172.16.133.12",59680,"172.16.139.250",5440,12,1142,2855,0,0,12,1142,0,0,19.865146,0.006244000000002359,1463164,0
"172.16.133.63",53835,"172.16.139.250",5440,12,1142,2856,0,0,12,1142,0,0,19.873101,0.00689400000000262,1325210,0
"172.16.133.66",53807,"172.16.139.250",5440,12,1142,2857,0,0,12,1142,0,0,19.888999,0.005892000000002895,1550577,0
"172.16.133.82",61279,"172.16.139.250",5440,12,1142,2858,0,0,12,1142,0,0,19.90237,0.013314999999998633,686143,0
"172.16.133.67",55794,"172.16.139.250",5440,6,360,2859,0,0,6,360,0,0,19.913688,0.001217999999997943,"",""
"172.16.133.37",60563,"172.16.139.250",5440,10,1022,2860,0,0,10,1022,0,0,19.916232,0.014904999999998836,548540,0
"172.16.133.67",55936,"172.16.139.250",5440,10,1020,2861,0,0,10,1020,0,0,19.928328,1.013456999999999,8051,0
"172.16.133.72",49237,"157.56.241.150",443,10,895,2862,0,0,5,595,5,300,19.930814,259.053928,18,9
"172.16.133.132",44426,"98.138.19.88",80,10,1681,2863,0,0,5,733,5,948,19.942293,0.1965369999999993,29836,38588
"172.16.133.121",56491,"173.194.43.44",443,46,7920,2864,0,0,23,2887,23,5033,19.943372,241.68750599999998,95,166
"172.16.133.66",49611,"96.43.146.22",443,40,18240,2865,0,0,23,15407,17,2833,19.954348,280.044774,440,80
"172.16.133.67",55937,"172.16.139.250",5440,10,1026,2866,0,0,10,1026,0,0,19.993645,0.006653999999997495,1233543,0
"172.16.133.82",54128,"157.56.232.214",443,116,21816,2867,0,0,60,18456,56,3360,20.036648,270.022904,546,99
"172.16.133.78",59058,"172.16.139.250",5440,10,1022,2868,0,0,10,1022,0,0,20.072691,0.005630000000000024,1452220,0
"172.16.133.25",62036,"208.89.13.133",80,50,18313,2869,0,0,20,10083,30,8230,20.079954,270.43927,298,243
"172.16.133.132",38755,"98.139.134.187",80,15,8483,2870,0,0,8,942,7,7541,20.126024,0.1564869999999985,48157,385514
"172.16.133.67",55938,"172.16.139.250",5440,10,1022,2871,0,0,10,1022,0,0,20.127104,0.007643000000001621,1069737,0
"172.16.133.56",61361,"172.16.139.250",5440,12,1142,2872,0,0,12,1142,0,0,20.148661,0.004993999999999943,"",""
"172.16.133.53",59078,"157.56.234.118",443,450,326273,2873,0,0,262,314981,188,11292,20.183734,270.06239999999997,9330,334
"172.16.133.42",57024,"172.16.139.250",5440,12,1142,2874,0,0,12,1142,0,0,20.184485,0.08901800000000293,102630,0
"172.16.133.25",63378,"74.125.170.42",80,1682,1879574,2875,0,0,451,30823,1231,1848751,20.204034,77.65715800000001,3175,190452
"172.16.133.75",50895,"172.16.139.250",5440,10,1022,2876,0,0,10,1022,0,0,20.204127,0.05225899999999939,156451,0
"172.16.133.25",63379,"74.125.170.42",80,1751,1902437,2877,0,0,499,35320,1252,1867117,20.204128,77.65621,3638,192346
"172.16.133.41",52751,"172.16.139.250",5440,12,1142,2878,0,0,12,1142,0,0,20.204851,0.054303999999998354,168238,0
"172.16.133.85",52204,"172.16.139.250",5440,12,1142,2879,0,0,12,1142,0,0,20.222303,0.04455600000000004,205045,0
"172.16.133.25",63380,"173.194.43.32",80,31,10042,2880,0,0,15,1695,16,8347,20.222593,247.56097300000002,54,269
"172.16.133.33",49374,"172.16.139.250",5447,10,1400,2881,0,0,10,1400,0,0,20.240142,222.11941900000002,50,0
"172.16.133.132",50525,"76.13.6.174",80,9,1927,2882,0,0,5,717,4,1210,20.250842,0.10050299999999979,57072,96315
"172.16.133.132",54740,"98.139.161.29",80,9,1428,2883,0,0,5,715,4,713,20.255798,0.10593300000000028,53996,53845
"172.16.133.184",54992,"205.216.16.228",80,130,102390,2884,0,0,57,3526,73,98864,20.267314,0.8826040000000006,31959,896111
"172.16.133.43",57721,"172.16.139.250",5440,10,1022,2885,0,0,10,1022,0,0,20.278133,0.015185999999999922,538390,0
"172.16.133.13",52996,"172.16.139.250",5440,10,1022,2886,0,0,10,1022,0,0,20.294294999999998,0.014694000000002205,556417,0
"172.16.133.47",56548,"107.22.210.163",5222,297,205228,2887,0,0,121,12441,176,192787,20.341398,265.996159,374,5798
"172.16.133.47",56549,"107.22.210.163",5222,6,372,2888,0,0,4,246,2,126,20.341399,0.052105000000000956,37769,19345
"172.16.133.20",62334,"172.16.139.250",5440,12,1142,2889,0,0,12,1142,0,0,20.342247,0.0049740000000007,"",""
"172.16.133.76",62351,"173.194.43.5",443,15,1014,2890,0,0,7,420,8,594,20.351142,150.046248,22,31
"172.16.133.132",52452,"98.139.240.23",80,9,1653,2891,0,0,5,1035,4,618,20.352397,0.165420000000001,50054,29887
"172.16.133.121",56492,"173.194.43.32",443,50,9832,2892,0,0,25,4826,25,5006,20.354863,247.55427799999998,155,161
"172.16.133.28",65321,"172.16.139.250",5440,12,1142,2893,0,0,12,1142,0,0,20.374333,0.01606999999999914,568512,0
"172.16.133.99",56001,"172.16.139.250",5440,10,1022,2894,0,0,10,1022,0,0,20.400305,0.005068000000001405,1613259,0
"172.16.133.67",55939,"172.16.139.250",5440,12,1212,2895,0,0,12,1212,0,0,20.420811,0.050778999999998575,190945,0
"172.16.133.87",60137,"172.16.139.250",5440,12,1142,2896,0,0,12,1142,0,0,20.421954,0.006344000000002126,1440100,0
"172.16.133.116",53204,"172.16.139.250",5440,10,1022,2897,0,0,10,1022,0,0,20.439144,0.00540499999999966,1512673,0
"172.16.133.116",53205,"172.16.139.250",5440,10,1022,2898,0,0,10,1022,0,0,20.447156,0.005590000000001538,1462611,0
"172.16.133.116",53206,"172.16.139.250",5440,10,1022,2899,0,0,10,1022,0,0,20.456584,0.006159000000000248,1327488,0
"172.16.133.84",58749,"172.16.139.250",5440,10,1022,2900,0,0,10,1022,0,0,20.460602,0.005554999999997534,1471827,0
"172.16.133.95",56918,"67.217.65.244",443,6,366,2901,0,0,4,246,2,120,20.462668999999998,0.16994200000000248,11580,5648
"172.16.133.35",49929,"172.16.139.250",5440,12,1142,2902,0,0,12,1142,0,0,20.51036,0.052597000000002225,173698,0
"172.16.133.132",39768,"206.190.56.191",80,5,300,2903,0,0,3,180,2,120,20.520128,15.171115,94,63
"172.16.133.49",55725,"172.16.139.250",5440,10,1022,2904,0,0,10,1022,0,0,20.538797,0.0055189999999996076,1481427,0
"172.16.133.93",59700,"96.43.146.48",443,104,84203,2905,0,0,39,9237,65,74966,20.557519,241.320038,306,2485
"172.16.133.25",63381,"173.194.43.38",80,23,6766,2906,0,0,12,1500,11,5266,20.558764,268.557548,44,156
"172.16.133.25",63382,"173.194.43.46",80,24,8227,2907,0,0,12,1500,12,6727,20.560517,268.499559,44,200
"172.16.133.25",63383,"173.194.43.32",80,25,7035,2908,0,0,12,1113,13,5922,20.561472,247.22219499999997,36,191
"172.16.133.25",63384,"173.194.43.32",80,24,6802,2909,0,0,11,1053,13,5749,20.561637,247.22173,34,186
"172.16.133.25",63385,"173.194.43.32",80,24,5710,2910,0,0,12,1113,12,4597,20.562075,247.22108400000002,36,148
"172.16.133.95",56919,"172.16.139.250",5440,12,1142,2911,0,0,12,1142,0,0,20.574189,0.006128999999997831,1490618,0
"172.16.133.25",63386,"173.194.43.32",80,25,6815,2912,0,0,12,1113,13,5702,20.582971,247.20047900000003,36,184
"172.16.133.25",63387,"173.194.43.32",80,22,4023,2913,0,0,11,1053,11,2970,20.583177,247.20058299999997,34,96
"172.16.133.25",63388,"173.194.43.38",80,24,8329,2914,0,0,12,1504,12,6825,20.583353,268.47544,44,203
"172.16.133.25",63389,"173.194.43.38",80,21,5488,2915,0,0,11,1444,10,4044,20.583518,268.530214,43,120
"172.16.133.25",63390,"173.194.43.38",80,22,4317,2916,0,0,11,1053,11,3264,20.583676,247.19958899999997,34,105
"172.16.133.25",63391,"173.194.43.46",80,22,3378,2917,0,0,11,1053,11,2325,20.583834,247.197979,34,75
"172.16.133.25",63392,"173.194.43.46",80,22,4329,2918,0,0,11,1053,11,3276,20.583995,247.19896799999998,34,106
"172.16.133.93",60315,"96.43.146.48",443,77,61667,2919,0,0,29,6401,48,55266,20.587507,241.28910600000003,212,1832
"172.16.133.121",56493,"173.194.43.3",443,108,44205,2920,0,0,47,15884,61,28321,20.587623,243.671872,521,929
"172.16.133.23",56653,"172.16.139.250",5500,334,165680,2921,0,0,334,165680,0,0,20.590692,240.195735,5518,0
"172.16.133.92",57639,"172.16.139.250",5440,12,1142,2922,0,0,12,1142,0,0,20.601296,0.01616799999999685,565066,0
"172.16.133.29",60842,"172.16.139.250",5440,10,1022,2923,0,0,10,1022,0,0,20.620372,0.016615999999999076,492055,0
"172.16.133.44",64729,"172.16.139.250",5440,10,1022,2924,0,0,10,1022,0,0,20.627759,0.005475000000000563,1493333,0
"172.16.133.95",56920,"216.115.212.254",443,6,366,2925,0,0,4,246,2,120,20.645693,0.19991199999999765,9844,4802
"172.16.133.207",55892,"172.16.139.250",5440,12,1142,2926,0,0,12,1142,0,0,20.653043,0.015869999999999607,575677,0
"172.16.133.44",64730,"157.56.236.89",443,6,374,2927,0,0,3,194,3,180,20.658628,1.276059,1216,1128
"172.16.133.83",57048,"172.16.139.250",5440,12,1142,2928,0,0,12,1142,0,0,20.660125,0.004925000000000068,"",""
"172.16.133.73",59949,"96.43.146.48",443,17,3226,2929,0,0,9,2432,8,794,20.669686,270.229808,71,23
"172.16.133.93",60618,"172.16.139.250",5440,12,1142,2930,0,0,12,1142,0,0,20.678711,0.014374000000000109,635592,0
"157.56.242.198",443,"172.16.133.68",55078,10,795,2931,0,0,5,495,5,300,20.681577,240.11462999999998,16,9
"172.16.133.11",55101,"172.16.139.250",5440,12,1142,2932,0,0,12,1142,0,0,20.693958,0.006223000000002088,1468102,0
"172.16.133.55",57537,"172.16.139.250",5440,10,1022,2933,0,0,10,1022,0,0,20.698892,0.005371999999997712,1521965,0
"172.16.133.67",55940,"172.16.139.250",5440,10,1296,2934,0,0,10,1296,0,0,20.720496,0.058171999999999,178230,0
"172.16.133.53",54058,"172.16.139.250",5440,12,1142,2935,0,0,12,1142,0,0,20.724677,0.010249000000001729,891404,0
"172.16.133.73",60527,"172.16.139.250",5440,12,1142,2936,0,0,12,1142,0,0,20.724864,0.0058000000000006935,1575172,0
"172.16.133.78",59059,"172.16.128.169",8014,19,6539,2937,0,0,10,3467,9,3072,20.726355,38.683819,716,635
"172.16.133.21",53132,"172.16.139.250",5440,12,1142,2938,0,0,12,1142,0,0,20.728778,0.011237000000001274,813028,0
"172.16.133.30",62571,"172.16.139.250",5440,10,1022,2939,0,0,10,1022,0,0,20.732152,0.011630000000000251,703009,0
"172.16.133.25",63393,"172.16.139.250",5440,12,1142,2940,0,0,12,1142,0,0,20.739098,0.008634000000000697,1058142,0
"172.16.133.34",50398,"172.16.139.250",5440,10,1022,2941,0,0,10,1022,0,0,20.747304,0.015260999999998859,535744,0
"172.16.133.97",59328,"172.16.139.250",5440,10,1022,2942,0,0,10,1022,0,0,20.759603,0.01469900000000024,556228,0
"96.43.146.22",443,"172.16.133.48",51580,12,3876,2943,0,0,6,1134,6,2742,20.77547,55.852277,162,392
"172.16.133.41",51307,"96.43.146.48",443,96,68607,2944,0,0,47,37237,49,31370,20.79513,275.306917,1082,911
"172.16.133.120",53253,"96.43.146.22",443,14,4375,2945,0,0,7,3636,7,739,20.799863,35.063148999999996,829,168
"172.16.133.33",57839,"172.16.139.250",5440,12,1142,2946,0,0,12,1142,0,0,20.835472,0.015427999999999997,592170,0
"172.16.133.33",57840,"172.16.139.250",5440,10,1022,2947,0,0,10,1022,0,0,20.854854,0.005584999999999951,1463921,0
"172.16.133.68",60681,"172.16.139.250",5440,10,1022,2948,0,0,10,1022,0,0,20.864463,0.005648999999998239,1447335,0
"172.16.133.12",59681,"172.16.139.250",5440,10,1022,2949,0,0,10,1022,0,0,20.877732,0.005480999999999625,1491698,0
"172.16.133.56",50579,"96.43.146.48",443,424,360060,2950,0,0,169,96589,255,263471,20.880607,249.634004,3095,8443
"172.16.133.63",53836,"172.16.139.250",5440,10,1022,2951,0,0,10,1022,0,0,20.887359,0.005427000000000959,1506541,0
"172.16.133.66",53808,"172.16.139.250",5440,10,1022,2952,0,0,10,1022,0,0,20.903132,0.005162999999999585,1583575,0
"172.16.133.82",61280,"172.16.139.250",5440,10,1022,2953,0,0,10,1022,0,0,20.915736,0.005735000000001378,1425632,0
"172.16.133.37",60564,"172.16.139.250",5440,10,1022,2954,0,0,10,1022,0,0,20.930746,0.017815000000002357,458939,0
"172.16.133.73",59948,"96.43.146.48",443,7,437,2955,0,0,3,180,4,257,20.933735,31.537362,45,65
"172.16.133.67",55941,"172.16.139.250",5440,10,1020,2956,0,0,10,1020,0,0,20.943879,120.008834,67,0
"172.16.133.67",55942,"172.16.139.250",5440,10,1026,2957,0,0,10,1026,0,0,20.943881,0.04915899999999951,166968,0
"172.16.133.25",61589,"74.125.226.195",443,45,13582,2958,0,0,24,11879,21,1703,20.960798,263.49757,360,51
"172.16.133.93",60258,"96.43.146.48",443,112,93545,2959,0,0,40,9213,72,84332,20.972504999999998,241.068336,305,2798
"172.16.133.73",57865,"96.43.146.48",443,7,437,2960,0,0,3,180,4,257,20.989748,31.489316000000002,45,65
"132.245.1.150",443,"172.16.133.26",49323,10,795,2961,0,0,5,495,5,300,20.994029,239.89004899999998,16,10
"172.16.133.11",54491,"96.43.146.48",443,24,5890,2962,0,0,13,4614,11,1276,20.996177,270.556077,136,37
"172.16.133.73",59947,"96.43.146.48",443,7,437,2963,0,0,3,180,4,257,20.999721,31.479411,45,65
"172.16.133.184",45698,"204.14.232.101",443,31,13386,2964,0,0,16,1681,15,11705,21.071676,0.1792669999999994,75016,522349
"172.16.133.78",59060,"172.16.139.250",5440,10,1022,2965,0,0,10,1022,0,0,21.08636,0.016308999999999685,501318,0
"172.16.133.75",50657,"173.194.43.60",80,8,492,2966,0,0,4,240,4,252,21.135205,69.107349,27,29
"172.16.133.67",55943,"172.16.139.250",5440,12,1142,2967,0,0,12,1142,0,0,21.141379,0.006149999999998101,1485528,0
"172.16.133.47",56550,"184.72.255.145",443,23,9615,2968,0,0,12,2958,11,6657,21.146405,1.303443999999999,18154,40857
"172.16.133.93",60316,"96.43.146.48",443,96,80958,2969,0,0,35,6702,61,74256,21.158542,240.725166,222,2467
"172.16.133.73",56805,"172.16.139.250",5500,20,1740,2970,0,0,20,1740,0,0,21.159881,240.198079,57,0
"172.16.133.126",59469,"96.43.146.22",443,9,557,2971,0,0,4,240,5,317,21.160041,75.54312300000001,25,33
"172.16.133.56",61362,"172.16.139.250",5440,12,1142,2972,0,0,12,1142,0,0,21.162448,0.005820999999997412,1569489,0
"172.16.133.42",57025,"172.16.139.250",5440,12,1142,2973,0,0,12,1142,0,0,21.171981,0.014199000000001405,643425,0
"172.16.133.23",55008,"96.43.146.22",443,20,1285,2974,0,0,7,420,13,865,21.181619,237.417037,14,29
"172.16.133.23",55009,"96.43.146.22",443,20,1285,2975,0,0,7,420,13,865,21.181621,237.097194,14,29
"172.16.133.23",55007,"96.43.146.22",443,20,1285,2976,0,0,7,420,13,865,21.19864,236.78930400000002,14,29
"172.16.133.23",55011,"96.43.146.22",443,19,1208,2977,0,0,7,420,12,788,21.198641,227.87734,14,27
"172.16.133.23",55010,"96.43.146.22",443,20,1285,2978,0,0,7,420,13,865,21.198644,237.54818699999998,14,29
"172.16.133.34",50194,"173.194.43.36",443,11,762,2979,0,0,5,300,6,462,21.206922,59.989422999999995,40,61
"172.16.133.75",50896,"172.16.139.250",5440,10,1022,2980,0,0,10,1022,0,0,21.218345,0.005421999999999372,1507930,0
"172.16.133.41",52752,"172.16.139.250",5440,10,1022,2981,0,0,10,1022,0,0,21.219239,0.008223999999998455,994163,0
"172.16.133.23",55016,"96.43.146.22",443,19,1208,2982,0,0,7,420,12,788,21.230638,226.259516,14,27
"172.16.133.85",52205,"172.16.139.250",5440,10,1022,2983,0,0,10,1022,0,0,21.236187,0.005921000000000731,1380847,0
"172.16.133.23",55014,"96.43.146.22",443,20,1285,2984,0,0,7,420,13,865,21.239607,238.49262000000002,14,29
"172.16.133.23",55015,"96.43.146.22",443,19,1208,2985,0,0,7,420,12,788,21.239609,229.81518,14,27
"172.16.133.95",56921,"202.173.28.250",443,6,366,2986,0,0,4,246,2,120,21.259702,0.516494999999999,3810,1858
"172.16.133.73",59939,"23.32.176.63",443,113,51274,2987,0,0,53,26654,60,24620,21.284777,264.433444,806,744
"172.16.133.43",57722,"172.16.139.250",5440,12,1142,2988,0,0,12,1142,0,0,21.291718,0.010926000000001324,836170,0
"172.16.133.13",52997,"172.16.139.250",5440,12,1142,2989,0,0,12,1142,0,0,21.308503,0.006081999999999255,1502137,0
"172.16.133.95",56922,"64.74.80.187",443,6,366,2990,0,0,4,246,2,120,21.324702,0.0801840000000027,24543,11972
"172.16.133.73",60528,"173.194.75.99",443,14,3506,2991,0,0,8,957,6,2549,21.343159,0.316396000000001,24197,64450
"172.16.133.20",62335,"172.16.139.250",5440,12,1142,2992,0,0,12,1142,0,0,21.355986,0.00633099999999942,1443057,0
"172.16.133.28",65322,"172.16.139.250",5440,10,1022,2993,0,0,10,1022,0,0,21.389033,0.014714999999998923,555623,0
"172.16.133.75",50656,"216.52.242.80",80,6,360,2994,0,0,5,300,1,60,21.411232,128.91483900000003,18,3
"172.16.133.99",56003,"172.16.139.250",5440,10,1022,2995,0,0,10,1022,0,0,21.414151,0.014537000000000688,562426,0
"172.16.133.87",60138,"172.16.139.250",5440,10,1022,2996,0,0,10,1022,0,0,21.435795,0.015181000000001887,538567,0
"172.16.133.30",57098,"96.43.146.176",443,88,53951,2997,0,0,42,26149,46,27802,21.441969,271.687864,769,818
"172.16.133.73",60529,"173.194.43.40",80,69,43632,2998,0,0,29,12115,40,31517,21.447962,239.133502,405,1054
"172.16.133.35",49930,"172.16.139.250",5440,12,1142,2999,0,0,12,1142,0,0,21.44906,0.013859000000000066,659210,0
"172.16.133.73",60530,"173.194.43.40",80,7,432,3000,0,0,4,246,3,186,21.449549,17.158452999999998,114,86
"172.16.133.73",60531,"173.194.43.40",80,64,38046,3001,0,0,31,15670,33,22376,21.449819,237.444208,527,753
"172.16.133.73",60532,"173.194.43.40",80,6,372,3002,0,0,4,246,2,126,21.449985,17.158073999999996,114,58
"172.16.133.73",60533,"173.194.43.40",80,127,101935,3003,0,0,46,21531,81,80404,21.450219,237.440448,725,2709
"172.16.133.73",60534,"173.194.43.40",80,6,372,3004,0,0,4,246,2,126,21.451027,17.157082,114,58
"172.16.133.73",60535,"173.194.43.36",80,6,372,3005,0,0,4,246,2,126,21.45154,17.149208,114,58
"172.16.133.73",60536,"173.194.43.36",80,73,51676,3006,0,0,29,5422,44,46254,21.451872,271.86354,159,1361
"172.16.133.73",60537,"173.194.43.36",80,36,20982,3007,0,0,15,2085,21,18897,21.452254,272.89594500000004,61,553
"172.16.133.73",60538,"173.194.43.39",80,6,372,3008,0,0,4,246,2,126,21.452485,17.148202,114,58
"172.16.133.73",60539,"173.194.43.39",80,58,48654,3009,0,0,19,2858,39,45796,21.452617,268.16281000000004,85,1366
"172.16.133.73",60540,"173.194.43.39",80,6,372,3010,0,0,4,246,2,126,21.452776,17.147911999999998,114,58
"172.16.133.73",60541,"173.194.43.39",80,6,372,3011,0,0,4,246,2,126,21.452935,17.148042999999998,114,58
"172.16.133.73",60542,"173.194.43.39",80,31,15836,3012,0,0,14,2197,17,13639,21.453065,272.88121800000005,64,399
"172.16.133.116",53207,"172.16.139.250",5440,10,1022,3013,0,0,10,1022,0,0,21.454216,0.00864999999999938,945202,0
"172.16.133.87",65527,"157.56.240.102",443,339,101121,3014,0,0,178,91461,161,9660,21.456662,270.018893,2709,286
"172.16.133.73",60543,"173.194.43.35",80,50,34453,3015,0,0,19,2925,31,31528,21.462488,272.89049,85,924
"172.16.133.73",60544,"173.194.43.35",80,32,14362,3016,0,0,15,2274,17,12088,21.46261,272.870654,66,354
"172.16.133.73",60545,"173.194.43.35",80,26,10251,3017,0,0,12,1485,14,8766,21.462723,272.87176500000004,43,256
"172.16.133.73",60546,"173.194.43.35",80,6,372,3018,0,0,4,246,2,126,21.462819,17.136991,114,58
"172.16.133.73",60547,"173.194.43.37",443,14,4048,3019,0,0,8,962,6,3086,21.463007,0.9668039999999998,7960,25535
"172.16.133.73",60548,"173.194.43.41",80,6,372,3020,0,0,4,246,2,126,21.463171,17.136588,114,58
"172.16.133.73",60549,"173.194.43.41",80,6,372,3021,0,0,4,246,2,126,21.463312,17.137726000000004,114,58
"172.16.133.73",60550,"173.194.43.41",80,6,372,3022,0,0,4,246,2,126,21.463409,17.134776000000002,114,58
"172.16.133.73",60551,"173.194.43.41",80,6,372,3023,0,0,4,246,2,126,21.463553,17.136252000000002,114,58
"172.16.133.73",60552,"173.194.43.41",80,6,372,3024,0,0,4,246,2,126,21.463725,17.136082,114,58
"172.16.133.116",53208,"172.16.139.250",5440,10,1022,3025,0,0,10,1022,0,0,21.463727,0.005377000000002852,1520550,0
"172.16.133.73",60553,"173.194.43.41",80,6,372,3026,0,0,4,246,2,126,21.463875,17.144185,114,58
"172.16.133.73",60554,"173.194.43.41",80,6,372,3027,0,0,4,246,2,126,21.46396,17.144039999999997,114,58
"172.16.133.73",60555,"173.194.43.41",80,7,432,3028,0,0,4,246,3,186,21.464127,17.143934999999995,114,86
"172.16.133.73",60556,"173.194.43.41",80,7,432,3029,0,0,4,246,3,186,21.464251,17.142932999999996,114,86
"172.16.133.73",60557,"173.194.43.41",80,6,372,3030,0,0,4,246,2,126,21.46434,17.142691,114,58
"172.16.133.73",60558,"173.194.43.41",80,6,372,3031,0,0,4,246,2,126,21.464491,17.143511999999998,114,58
"172.16.133.116",53209,"172.16.139.250",5440,10,1022,3032,0,0,10,1022,0,0,21.469977,0.005327999999998667,1534534,0
"172.16.133.84",58750,"172.16.139.250",5440,10,1022,3033,0,0,10,1022,0,0,21.474857,0.0055429999999994095,1475013,0
"172.16.133.73",60559,"74.125.0.74",80,6,372,3034,0,0,4,246,2,126,21.50003,17.107101000000004,115,58
"172.16.133.73",60560,"74.125.0.74",80,6,372,3035,0,0,4,246,2,126,21.500153,17.10524,115,58
"172.16.133.73",60561,"74.125.0.74",80,6,372,3036,0,0,4,246,2,126,21.5003,17.105090999999998,115,58
"172.16.133.73",60562,"208.117.233.13",80,7,432,3037,0,0,4,246,3,186,21.505599,17.100665000000003,115,87
"172.16.133.73",60563,"208.117.233.13",80,6,372,3038,0,0,4,246,2,126,21.505788,17.099602,115,58
"172.16.133.73",60564,"208.117.233.13",80,7,432,3039,0,0,4,246,3,186,21.505916,17.101212000000004,115,87
"172.16.133.73",60565,"208.117.233.13",80,6,372,3040,0,0,4,246,2,126,21.506046,17.098499999999998,115,58
"172.16.133.121",56494,"173.194.43.61",443,35,5184,3041,0,0,18,3440,17,1744,21.509767,240.12696,114,58
"172.16.133.126",61269,"96.43.146.22",443,35,16246,3042,0,0,20,13818,15,2428,21.527938,255.57340299999998,432,76
"172.16.133.49",55726,"172.16.139.250",5440,12,1142,3043,0,0,12,1142,0,0,21.55326,0.007079999999998421,1290395,0
"172.16.133.95",56923,"172.16.139.250",5440,12,1142,3044,0,0,12,1142,0,0,21.58827,0.007373999999998659,1238947,0
"172.16.133.73",59946,"96.43.146.48",443,7,437,3045,0,0,3,180,4,257,21.58978,30.888338,46,66
"172.16.133.21",52700,"96.43.146.22",443,37,15858,3046,0,0,21,13066,16,2792,21.593481,255.495269,409,87
"172.16.133.95",50001,"96.43.146.176",443,25,8055,3047,0,0,15,5010,10,3045,21.603674,240.35008299999998,166,101
"172.16.133.92",57640,"172.16.139.250",5440,12,1142,3048,0,0,12,1142,0,0,21.618058,0.01576000000000022,579695,0
"172.16.133.29",60843,"172.16.139.250",5440,10,1022,3049,0,0,10,1022,0,0,21.634227,0.005435000000002077,1504323,0
"172.16.133.44",64731,"172.16.139.250",5440,12,1142,3050,0,0,12,1142,0,0,21.641584,0.01545499999999933,591135,0
"173.194.43.21",443,"172.16.133.73",59664,95,26011,3051,0,0,52,4766,43,21245,21.641897,272.60880999999995,139,623
"172.16.133.73",60566,"173.194.75.99",443,96,27695,3052,0,0,48,17315,48,10380,21.660064,242.58739999999997,571,342
"172.16.133.126",61129,"96.43.146.48",443,7,437,3053,0,0,3,180,4,257,21.662549,35.045871,41,58
"157.56.234.118",443,"172.16.133.118",56668,190,97870,3054,0,0,123,93838,67,4032,21.663747,273.767853,2742,117
"172.16.133.207",55893,"172.16.139.250",5440,10,1022,3055,0,0,10,1022,0,0,21.666774,0.004774000000001166,"",""
"172.16.133.83",57049,"172.16.139.250",5440,12,1142,3056,0,0,12,1142,0,0,21.674289,0.013780999999998045,662941,0
"172.16.133.67",55944,"172.16.139.250",5440,12,1194,3057,0,0,12,1194,0,0,21.675603,0.0077120000000014954,1238589,0
"172.16.133.126",61127,"96.43.146.48",443,7,437,3058,0,0,3,180,4,257,21.677221,35.036333,41,58
"172.16.133.83",55589,"96.43.146.22",443,34,13186,3059,0,0,19,10772,15,2414,21.690633,277.215503,310,69
"172.16.133.93",60619,"172.16.139.250",5440,12,1142,3060,0,0,12,1142,0,0,21.692671,0.005064999999998321,1803751,0
"172.16.133.126",61126,"96.43.146.48",443,7,437,3061,0,0,3,180,4,257,21.7066,35.008272999999996,41,58
"172.16.133.11",55102,"172.16.139.250",5440,12,1142,3062,0,0,12,1142,0,0,21.708523,0.006275000000002251,1455936,0
"172.16.133.39",49589,"173.194.68.125",5222,14,907,3063,0,0,7,420,7,487,21.710529,257.19550699999996,13,15
"172.16.133.55",57538,"172.16.139.250",5440,10,1022,3064,0,0,10,1022,0,0,21.71337,0.0154299999999985,529876,0
"172.16.133.73",60567,"172.16.139.250",5440,12,1142,3065,0,0,12,1142,0,0,21.736533,0.018209999999999837,501702,0
"172.16.133.53",54059,"172.16.139.250",5440,10,1022,3066,0,0,10,1022,0,0,21.738382,0.005649999999999267,1447079,0
"172.16.133.126",61130,"96.43.146.48",443,7,437,3067,0,0,3,180,4,257,21.73997,34.970771,41,58
"172.16.133.21",53133,"172.16.139.250",5440,12,1142,3068,0,0,12,1142,0,0,21.741512,0.018768999999998925,486760,0
"172.16.133.30",62572,"172.16.139.250",5440,10,1022,3069,0,0,10,1022,0,0,21.744352,0.005331999999999226,1533383,0
"172.16.133.25",63394,"172.16.139.250",5440,12,1142,3070,0,0,12,1142,0,0,21.75442,0.008929000000001963,1023182,0
"172.16.133.34",50399,"172.16.139.250",5440,12,1142,3071,0,0,12,1142,0,0,21.76134,0.0059459999999980084,1536495,0
"172.16.133.97",59329,"172.16.139.250",5440,10,1022,3072,0,0,10,1022,0,0,21.773677,0.005424000000001428,1507374,0
"172.16.133.116",60098,"96.43.146.176",443,25,8055,3073,0,0,15,5010,10,3045,21.7811,240.34720000000002,166,101
"132.245.1.150",443,"172.16.133.26",49327,34,13882,3074,0,0,21,13102,13,780,21.787603,240.716545,435,25
"172.16.133.33",57841,"172.16.139.250",5440,12,1142,3075,0,0,12,1142,0,0,21.849556,0.006343999999998573,1440100,0
"172.16.133.68",60682,"172.16.139.250",5440,10,1022,3076,0,0,10,1022,0,0,21.878214,0.005919999999999703,1381081,0
"172.16.133.12",59682,"172.16.139.250",5440,12,1142,3077,0,0,12,1142,0,0,21.892501,0.007929000000000741,1152226,0
"172.16.133.63",53837,"172.16.139.250",5440,10,1022,3078,0,0,10,1022,0,0,21.901399,0.0066089999999974225,1237100,0
"172.16.133.41",52098,"23.33.85.239",443,4,287,3079,0,0,2,120,2,167,21.91424,0.02470299999999881,38861,54082
"172.16.133.41",52104,"66.235.144.18",443,4,240,3080,0,0,2,120,2,120,21.914606,0.030264999999999986,31719,31719
"172.16.133.41",52094,"23.33.44.150",443,4,287,3081,0,0,2,120,2,167,21.914877,0.024152999999998315,39746,55314
"172.16.133.41",52096,"23.33.44.150",443,4,287,3082,0,0,2,120,2,167,21.915115,0.02382599999999968,40292,56073
"172.16.133.66",53809,"172.16.139.250",5440,10,1022,3083,0,0,10,1022,0,0,21.91723,0.005703000000000458,1433631,0
"172.16.133.82",61281,"172.16.139.250",5440,10,1022,3084,0,0,10,1022,0,0,21.929454,0.015698000000000434,520830,0
"172.16.133.44",64732,"157.56.240.137",443,6,374,3085,0,0,3,194,3,180,21.935165,1.0824649999999991,1433,1330
"172.16.133.37",60565,"172.16.139.250",5440,10,1022,3086,0,0,10,1022,0,0,21.943636,0.006521999999996808,1253603,0
"172.16.133.75",50648,"216.52.242.80",80,6,360,3087,0,0,5,300,1,60,21.951245,128.374974,18,3
"172.16.133.41",52312,"172.16.139.250",5440,6,360,3088,0,0,6,360,0,0,22.081793,0.0009779999999999234,"",""
"172.16.133.41",52753,"172.16.139.250",5440,12,1140,3089,0,0,12,1140,0,0,22.083233,120.010862,75,0
"172.16.133.78",59061,"172.16.139.250",5440,12,1142,3090,0,0,12,1142,0,0,22.100782,0.016083000000001846,568053,0
"172.16.133.113",55593,"172.16.139.250",135,8,492,3091,0,0,8,492,0,0,22.139828,0.015062999999997828,261302,0
"172.16.133.67",55945,"172.16.139.250",5440,10,1022,3092,0,0,10,1022,0,0,22.155964,0.015031999999997936,543906,0
"172.16.133.113",55594,"172.16.139.250",5462,12,816,3093,0,0,12,816,0,0,22.157989,0.5101389999999988,12796,0
"172.16.133.66",53517,"173.194.43.45",80,8,492,3094,0,0,4,240,4,252,22.166411,64.956173,29,31
"172.16.133.56",61363,"172.16.139.250",5440,12,1142,3095,0,0,12,1142,0,0,22.176912,0.005289999999998685,1727032,0
"172.16.133.42",57026,"172.16.139.250",5440,12,1142,3096,0,0,12,1142,0,0,22.1865,0.04141800000000018,220580,0
"172.16.133.24",57604,"54.235.187.196",443,160,64757,3097,0,0,81,49514,79,15243,22.20289,270.469975,1464,450
"172.16.133.66",53519,"173.194.43.58",80,8,492,3098,0,0,4,240,4,252,22.226441,64.89614499999999,29,31
"172.16.133.12",59683,"96.43.146.50",443,19,1536,3099,0,0,10,867,9,669,22.230333,270.448718,25,19
"172.16.133.26",52987,"96.43.146.48",443,144,103439,3100,0,0,62,44344,82,59095,22.231141,276.544186,1282,1709
"172.16.133.41",52754,"172.16.139.250",5440,12,1142,3101,0,0,12,1142,0,0,22.233089,0.015146999999998911,603155,0
"172.16.133.75",50897,"172.16.139.250",5440,10,1022,3102,0,0,10,1022,0,0,22.235183,0.006430000000001712,1271539,0
"172.16.133.12",59684,"96.43.146.22",443,25,4648,3103,0,0,14,3571,11,1077,22.243401,271.75481,105,31
"172.16.133.12",59685,"96.43.146.22",443,19,1537,3104,0,0,10,868,9,669,22.243607,270.434409,25,19
"172.16.133.12",59686,"96.43.146.22",443,19,1537,3105,0,0,10,868,9,669,22.243794,270.43550300000004,25,19
"172.16.133.12",59687,"96.43.146.22",443,55,28610,3106,0,0,30,23877,25,4733,22.243996,27.756149000000004,6881,1364
"172.16.133.12",59688,"96.43.146.22",443,19,1537,3107,0,0,10,868,9,669,22.244237,270.430831,25,19
"172.16.133.12",59689,"96.43.146.22",443,19,1537,3108,0,0,10,868,9,669,22.244469,270.430743,25,19
"172.16.133.85",52206,"172.16.139.250",5440,10,1022,3109,0,0,10,1022,0,0,22.250056,0.005304999999999893,1541187,0
"172.16.133.235",4113,"64.94.18.135",80,30,2420,3110,0,0,20,1510,10,910,22.266065,270.513013,44,26
"172.16.133.23",55013,"96.43.146.22",443,19,1208,3111,0,0,7,420,12,788,22.270666,229.01037,14,27
"172.16.133.27",60911,"157.56.238.6",443,99,31673,3112,0,0,50,16671,49,15002,22.271163,273.158596,488,439
"172.16.133.43",57723,"172.16.139.250",5440,10,1022,3113,0,0,10,1022,0,0,22.304653,0.007986999999999966,1023663,0
"157.56.242.198",443,"172.16.133.24",56621,10,795,3114,0,0,5,495,5,300,22.312833,240.12422599999996,16,9
"172.16.133.128",64539,"216.52.242.80",80,163,140466,3115,0,0,57,22920,106,117546,22.31671,276.094969,664,3405
"172.16.133.13",52998,"172.16.139.250",5440,10,1022,3116,0,0,10,1022,0,0,22.322918,0.05543699999999774,147482,0
"172.16.133.128",64871,"23.33.81.244",80,7,432,3117,0,0,4,240,3,192,22.356696,83.316077,23,18
"172.16.133.40",50079,"50.16.236.32",80,10,1473,3118,0,0,5,988,5,485,22.366748,0.09477000000000046,83401,40941
"172.16.133.20",62336,"172.16.139.250",5440,10,1022,3119,0,0,10,1022,0,0,22.370289,0.012747000000000952,641405,0
"172.16.133.25",49362,"157.56.240.102",443,73,36731,3120,0,0,40,34751,33,1980,22.393364,270.025045,1029,58
"172.16.133.28",65323,"172.16.139.250",5440,10,1022,3121,0,0,10,1022,0,0,22.402193,0.006104999999998029,1339230,0
"172.16.133.47",56551,"184.72.255.145",80,12,3005,3122,0,0,7,1970,5,1035,22.422599,60.60630099999999,260,136
"172.16.133.99",56004,"172.16.139.250",5440,12,1142,3123,0,0,12,1142,0,0,22.428279,0.01469200000000015,621835,0
"172.16.133.87",60139,"172.16.139.250",5440,10,1022,3124,0,0,10,1022,0,0,22.449732,0.015405999999998699,530702,0
"172.16.133.35",49931,"172.16.139.250",5440,12,1142,3125,0,0,12,1142,0,0,22.465064,0.019227999999998246,475140,0
"172.16.133.121",56386,"96.43.146.22",443,25,11029,3126,0,0,14,9760,11,1269,22.465357,37.734104,2069,269
"172.16.133.116",53210,"172.16.139.250",5440,10,1022,3127,0,0,10,1022,0,0,22.468299000000002,0.015529999999998267,526464,0
"172.16.133.128",64900,"23.33.81.244",80,7,432,3128,0,0,4,240,3,192,22.471654,83.204768,23,18
"172.16.133.116",53211,"172.16.139.250",5440,12,1142,3129,0,0,12,1142,0,0,22.484401,0.006677000000003375,1368279,0
"172.16.133.84",58751,"172.16.139.250",5440,10,1022,3130,0,0,10,1022,0,0,22.488678,0.0063120000000012055,1295310,0
"172.16.133.116",53212,"172.16.139.250",5440,10,1022,3131,0,0,10,1022,0,0,22.491994,0.007420000000003313,1101886,0
"172.16.133.39",49293,"67.221.174.64",443,12,720,3132,0,0,6,360,6,360,22.496776,270.30634599999996,10,10
"172.16.128.233",55219,"172.16.133.233",22,201,23510,3133,0,0,73,5576,128,17934,22.502539,12.143892999999998,3673,11814
"172.16.133.128",64902,"23.33.81.244",80,7,432,3134,0,0,4,240,3,192,22.551691,83.12379999999999,23,18
"172.16.133.128",64903,"23.33.81.244",80,7,432,3135,0,0,4,240,3,192,22.560686,83.115686,23,18
"172.16.133.49",55727,"172.16.139.250",5440,12,1142,3136,0,0,12,1142,0,0,22.567086,0.015340999999999383,595528,0
"172.16.133.73",60568,"173.194.43.37",443,14,4049,3137,0,0,8,962,6,3087,22.589193,6.712598999999997,1146,3679
"172.16.133.128",64970,"23.67.242.73",80,44,22211,3138,0,0,18,6174,26,16037,22.591677,237.83057300000002,207,539
"172.16.133.95",56924,"172.16.139.250",5440,10,1022,3139,0,0,10,1022,0,0,22.602493,0.005341000000001372,1530799,0
"173.194.76.189",443,"172.16.133.116",50344,62,16459,3140,0,0,34,3211,28,13248,22.603706,276.469598,92,383
"172.16.133.92",57641,"172.16.139.250",5440,12,1142,3141,0,0,12,1142,0,0,22.631205,0.005586999999998454,1635224,0
"172.16.133.29",60844,"172.16.139.250",5440,12,1142,3142,0,0,12,1142,0,0,22.648253,0.006336999999998483,1441691,0
"172.16.133.44",64733,"172.16.139.250",5440,12,1142,3143,0,0,12,1142,0,0,22.654922,0.016505000000002212,553529,0
"172.16.133.207",55894,"172.16.139.250",5440,12,1142,3144,0,0,12,1142,0,0,22.68066,0.04406900000000036,207311,0
"172.16.133.83",57050,"172.16.139.250",5440,12,1142,3145,0,0,12,1142,0,0,22.689148,0.026765000000001038,341341,0
"172.16.133.13",52625,"96.43.146.22",443,5,317,3146,0,0,2,120,3,197,22.697589,0.052825999999999596,18172,29833
"172.16.133.13",52627,"96.43.146.22",443,5,317,3147,0,0,2,120,3,197,22.697922,0.053360000000001406,17991,29535
"172.16.133.13",51955,"96.43.146.176",443,5,317,3148,0,0,2,120,3,197,22.698192,0.053152000000000754,18061,29650
"172.16.133.42",57849,"172.16.139.250",5500,8,696,3149,0,0,8,696,0,0,22.698324,60.240993,92,0
"172.16.133.93",60620,"172.16.139.250",5440,10,1022,3150,0,0,10,1022,0,0,22.706591,0.01451799999999892,563162,0
"172.16.133.13",52615,"96.43.146.176",443,5,317,3151,0,0,2,120,3,197,22.720975,0.04863500000000087,19738,32404
"172.16.133.11",55103,"172.16.139.250",5440,12,1142,3152,0,0,12,1142,0,0,22.723141,0.006577000000000055,1389083,0
"172.16.133.55",57539,"172.16.139.250",5440,12,1142,3153,0,0,12,1142,0,0,22.725984,0.007563999999998572,1207826,0
"172.16.133.13",52620,"96.43.146.176",443,5,317,3154,0,0,2,120,3,197,22.729815,0.05034100000000308,19069,31306
"172.16.133.13",52619,"96.43.146.176",443,5,317,3155,0,0,2,120,3,197,22.737779,0.05219800000000063,18391,30192
"172.16.133.13",52206,"96.43.146.50",443,5,317,3156,0,0,2,120,3,197,22.738048,0.05202300000000193,18453,30294
"172.16.133.13",52621,"96.43.146.22",443,5,317,3157,0,0,2,120,3,197,22.73829,0.052680999999999756,18222,29915
"172.16.133.13",52623,"96.43.146.22",443,5,317,3158,0,0,2,120,3,197,22.738517,0.05245199999999883,18302,30046
"172.16.133.13",52624,"96.43.146.22",443,5,317,3159,0,0,2,120,3,197,22.738735,0.05218400000000045,18396,30200
"172.16.133.13",52622,"96.43.146.22",443,5,317,3160,0,0,2,120,3,197,22.738953,0.054623000000002975,17575,28852
"172.16.133.73",60569,"172.16.139.250",5440,10,1022,3161,0,0,10,1022,0,0,22.74943,0.005548000000000997,1473684,0
"172.16.133.53",54060,"172.16.139.250",5440,12,1142,3162,0,0,12,1142,0,0,22.752439,0.0073019999999992535,1251164,0
"172.16.133.21",53134,"172.16.139.250",5440,12,1142,3163,0,0,12,1142,0,0,22.756507,0.007419000000002285,1231432,0
"172.16.133.30",62573,"172.16.139.250",5440,12,1142,3164,0,0,12,1142,0,0,22.759621,0.007500000000000284,1218133,0
"172.16.133.25",63395,"172.16.139.250",5440,12,1142,3165,0,0,12,1142,0,0,22.768044,0.005095000000000738,1793130,0
"172.16.133.34",50400,"172.16.139.250",5440,12,1142,3166,0,0,12,1142,0,0,22.775283,0.005198999999997511,1757261,0
"172.16.133.45",61261,"96.43.146.178",443,12,3918,3167,0,0,7,2109,5,1809,22.782421,14.287495,1180,1012
"172.16.133.97",59330,"172.16.139.250",5440,12,1142,3168,0,0,12,1142,0,0,22.78691,0.006182000000002574,1477838,0
"172.16.133.41",51452,"96.43.146.22",443,41,18078,3169,0,0,23,15479,18,2599,22.85519,238.225592,519,87
"172.16.133.33",57842,"172.16.139.250",5440,10,1022,3170,0,0,10,1022,0,0,22.862925,0.00570199999999943,1433882,0
"172.16.133.68",60683,"172.16.139.250",5440,12,1142,3171,0,0,12,1142,0,0,22.892032,0.005945000000000533,1536753,0
"172.16.133.73",59945,"96.43.146.48",443,7,437,3172,0,0,3,180,4,257,22.894761,39.574783,36,51
"172.16.133.39",49303,"205.188.9.102",443,23,1762,3173,0,0,11,660,12,1102,22.899014,270.038052,19,32
"172.16.133.12",59690,"172.16.139.250",5440,12,1142,3174,0,0,12,1142,0,0,22.906402,0.005801999999999197,1574629,0
"172.16.133.63",53838,"172.16.139.250",5440,10,1022,3175,0,0,10,1022,0,0,22.914403,0.005969000000000335,1369743,0
"172.16.133.66",53810,"172.16.139.250",5440,8,902,3176,0,0,8,902,0,0,22.931785,0.005621999999998906,1283528,0
"172.16.133.82",61282,"172.16.139.250",5440,10,1022,3177,0,0,10,1022,0,0,22.943621,0.005784999999999485,1413310,0
"172.16.133.37",60566,"172.16.139.250",5440,12,1142,3178,0,0,12,1142,0,0,22.957582,0.014739000000002278,619852,0
"172.16.133.12",50967,"157.56.242.198",443,10,795,3179,0,0,5,495,5,300,22.969959,240.01817100000002,16,9
"172.16.133.27",60826,"157.56.238.6",443,201,68219,3180,0,0,101,37872,100,30347,22.971401,272.903844,1110,889
"172.16.133.25",58994,"96.43.146.22",443,5,317,3181,0,0,2,120,3,197,22.975341,0.04856499999999997,19767,32451
"172.16.133.75",50898,"216.115.208.203",443,24,6317,3182,0,0,12,1235,12,5082,22.979625,271.245818,36,149
"172.16.133.75",50899,"216.115.208.203",443,24,6317,3183,0,0,12,1235,12,5082,22.97976,271.181042,36,149
"172.16.133.75",50900,"216.115.208.203",443,24,6317,3184,0,0,12,1235,12,5082,22.979871,271.243152,36,149
"172.16.133.75",50901,"216.115.208.203",443,24,6317,3185,0,0,12,1235,12,5082,22.979981,271.245685,36,149
"172.16.133.75",50902,"216.115.208.203",443,24,6317,3186,0,0,12,1235,12,5082,22.980088,271.245474,36,149
"172.16.133.75",50903,"216.115.208.203",443,39,12535,3187,0,0,18,4423,21,8112,22.980351,272.035283,130,238
"172.16.128.169",8014,"172.16.133.55",57229,4,240,3188,0,0,2,120,2,120,22.989013,0.09559899999999999,10041,10041
"172.16.133.55",57540,"172.16.128.169",8014,9,1412,3189,0,0,6,1050,3,362,22.989785,10.192024,824,284
"172.16.133.29",49317,"157.56.237.150",443,22,1825,3190,0,0,11,1165,11,660,23.008635,270.079976,34,19
"172.16.133.44",64734,"157.56.244.217",443,6,374,3191,0,0,3,194,3,180,23.018139,1.1454179999999994,1354,1257
"157.56.232.214",443,"172.16.133.82",54105,29,23392,3192,0,0,21,22912,8,480,23.030757,239.52363000000003,765,16
"172.16.133.78",59062,"172.16.139.250",5440,12,1142,3193,0,0,12,1142,0,0,23.114802,0.007051000000000585,1295702,0
"172.16.133.92",49563,"172.16.139.250",5462,52,3164,3194,0,0,52,3164,0,0,23.117327,271.19302600000003,93,0
"172.16.133.99",49296,"172.16.139.250",5462,30,1800,3195,0,0,30,1800,0,0,23.11911,271.189861,53,0
"172.16.133.88",51484,"172.16.139.250",5462,20,1200,3196,0,0,20,1200,0,0,23.119112,271.189698,35,0
"172.16.133.49",49675,"172.16.139.250",5462,20,1200,3197,0,0,20,1200,0,0,23.120129,271.186577,35,0
"172.16.133.41",51190,"172.16.139.250",5462,62,3764,3198,0,0,62,3764,0,0,23.120131,271.196415,111,0
"172.16.133.55",50093,"172.16.139.250",5462,20,1200,3199,0,0,20,1200,0,0,23.120409,271.18395,35,0
"172.16.133.93",49243,"172.16.139.250",5462,20,1200,3200,0,0,20,1200,0,0,23.120587,271.189578,35,0
"172.16.133.97",51969,"172.16.139.250",5462,110,6688,3201,0,0,110,6688,0,0,23.120942,271.189346,197,0
"172.16.133.72",50263,"172.16.139.250",5462,20,1200,3202,0,0,20,1200,0,0,23.12418,271.198828,35,0
"172.16.133.44",54044,"172.16.139.250",5462,20,1200,3203,0,0,20,1200,0,0,23.124733,271.17746900000003,35,0
"173.194.43.54",443,"172.16.133.54",64139,106,40494,3204,0,0,50,6049,56,34445,23.154824,247.388229,195,1113
"172.16.133.132",39727,"216.185.152.144",80,42,26308,3205,0,0,22,1436,20,24872,23.164875,3.616567,3176,55017
"172.16.133.67",55946,"172.16.139.250",5440,10,1022,3206,0,0,10,1022,0,0,23.168199,0.005374999999997243,1521116,0
"172.16.133.40",53203,"111.221.77.150",40011,72,9311,3207,0,0,34,6595,38,2716,23.176299,274.739364,192,79
"172.16.133.56",61364,"172.16.139.250",5440,12,1142,3208,0,0,12,1142,0,0,23.190962,0.01550500000000099,589229,0
"172.16.133.42",57027,"172.16.139.250",5440,12,1142,3209,0,0,12,1142,0,0,23.200024,0.012595000000001022,725367,0
"172.16.133.46",62924,"157.56.238.6",443,28,2414,3210,0,0,14,1574,14,840,23.228801,258.08301500000005,48,26
"172.16.133.75",50904,"172.16.139.250",5440,10,1022,3211,0,0,10,1022,0,0,23.245798,0.06582399999999922,124210,0
"172.16.133.41",52755,"172.16.139.250",5440,10,1022,3212,0,0,10,1022,0,0,23.247103,0.053930000000001144,151603,0
"172.16.133.78",58404,"173.194.43.59",80,6,366,3213,0,0,3,180,3,186,23.252554,21.806856,66,68
"173.194.43.54",443,"172.16.133.115",53216,66,32063,3214,0,0,37,21739,29,10324,23.252723,250.45565399999998,694,329
"172.16.133.85",52207,"172.16.139.250",5440,12,1142,3215,0,0,12,1142,0,0,23.266267,0.044003000000000014,207622,0
"172.16.133.20",62337,"173.194.43.43",443,14,3918,3216,0,0,8,968,6,2950,23.292814,0.964735000000001,8027,24462
"172.16.133.20",62338,"74.125.226.207",443,14,4027,3217,0,0,8,958,6,3069,23.293089,0.9647200000000034,7944,25449
"172.16.133.75",50831,"96.43.146.22",443,17,1037,3218,0,0,8,480,9,557,23.295287,262.74197200000003,14,16
"172.16.133.75",50832,"96.43.146.22",443,17,1037,3219,0,0,8,480,9,557,23.295289,262.7326,14,16
"172.16.133.75",50833,"96.43.146.22",443,17,1037,3220,0,0,8,480,9,557,23.299258000000002,262.738905,14,16
"172.16.133.43",57724,"172.16.139.250",5440,10,1022,3221,0,0,10,1022,0,0,23.319902,0.0062400000000018,1310256,0
"172.16.133.13",52999,"172.16.139.250",5440,10,1022,3222,0,0,10,1022,0,0,23.33562,0.005615999999999843,1455840,0
"172.16.133.95",56925,"64.74.80.187",443,6,366,3223,0,0,4,246,2,120,23.383854,0.07875299999999896,24989,12190
"172.16.133.20",62339,"172.16.139.250",5440,12,1142,3224,0,0,12,1142,0,0,23.383856,0.019826999999999373,460785,0
"172.16.133.44",49426,"157.56.232.214",443,10,775,3225,0,0,5,475,5,300,23.408949,240.01644799999997,15,9
"172.16.133.28",65324,"172.16.139.250",5440,10,1022,3226,0,0,10,1022,0,0,23.417306,0.01562799999999953,523163,0
"172.16.133.87",60140,"172.16.139.250",5440,10,1022,3227,0,0,10,1022,0,0,23.46394,0.01864399999999833,438532,0
"172.16.133.99",56005,"172.16.139.250",5440,12,1142,3228,0,0,12,1142,0,0,23.465854,0.007736000000001297,1180972,0
"172.16.133.92",51785,"172.16.139.250",5500,156,63104,3229,0,0,156,63104,0,0,23.475243,256.30169900000004,1969,0
"172.16.133.116",53213,"172.16.139.250",5440,10,1022,3230,0,0,10,1022,0,0,23.480276,0.006011000000000877,1360173,0
"172.16.133.116",53214,"172.16.139.250",5440,10,1022,3231,0,0,10,1022,0,0,23.486874,0.014596000000000942,560153,0
"172.16.133.116",53215,"172.16.139.250",5440,10,1022,3232,0,0,10,1022,0,0,23.501886,0.017659000000001868,462993,0
"172.16.133.84",58752,"172.16.139.250",5440,10,1022,3233,0,0,10,1022,0,0,23.502181,0.02817399999999992,290196,0
"172.16.133.92",55910,"172.16.139.250",5500,10,1068,3234,0,0,10,1068,0,0,23.539672,2.5546919999999993,3344,0
"172.16.133.35",49932,"172.16.139.250",5440,12,1142,3235,0,0,12,1142,0,0,23.565495,0.011599000000000359,787654,0
"108.160.161.158",80,"172.16.133.82",52243,15,2700,3236,0,0,10,1465,5,1235,23.570301,222.285972,52,44
"172.16.133.120",53419,"173.194.43.34",443,11,762,3237,0,0,5,300,6,462,23.577001,59.900583,40,61
"172.16.133.49",55728,"172.16.139.250",5440,12,1142,3238,0,0,12,1142,0,0,23.580943,0.006232999999998157,1465746,0
"172.16.133.23",54927,"96.43.146.48",443,17,1037,3239,0,0,8,480,9,557,23.590704,261.938179,14,17
"172.16.133.23",50541,"96.43.146.176",443,63,31912,3240,0,0,30,14980,33,16932,23.608669,270.66119199999997,442,500
"172.16.133.23",54930,"96.43.146.48",443,17,1037,3241,0,0,8,480,9,557,23.611645,261.916127,14,17
"172.16.133.95",56926,"172.16.139.250",5440,12,1142,3242,0,0,12,1142,0,0,23.616233,0.006143999999999039,1486979,0
"172.16.133.29",60845,"172.16.139.250",5440,12,1142,3243,0,0,12,1142,0,0,23.662866,0.006470000000000198,1412055,0
"172.16.133.44",64735,"172.16.139.250",5440,10,1022,3244,0,0,10,1022,0,0,23.669668,0.005597999999999104,1460521,0
"172.16.133.37",59826,"157.56.234.118",443,10,775,3245,0,0,5,475,5,300,23.679769,240.05844600000003,15,9
"172.16.133.92",57525,"96.43.146.176",443,82,60681,3246,0,0,37,27584,45,33097,23.685485,244.709009,901,1082
"172.16.133.92",57642,"172.16.139.250",5440,12,1142,3247,0,0,12,1142,0,0,23.686354,0.00610799999999756,1495743,0
"172.16.133.207",55895,"172.16.139.250",5440,12,1142,3248,0,0,12,1142,0,0,23.695588,0.014852999999998673,615094,0
"172.16.133.83",57051,"172.16.139.250",5440,12,1142,3249,0,0,12,1142,0,0,23.703251,0.013625999999998584,670482,0
"172.16.133.93",60621,"172.16.139.250",5440,10,1022,3250,0,0,10,1022,0,0,23.719702,0.004790999999997325,"",""
"172.16.133.92",57519,"96.43.146.22",443,15,917,3251,0,0,7,420,8,497,23.726358,216.934334,15,18
"172.16.133.92",57511,"96.43.146.176",443,165,127448,3252,0,0,76,58564,89,68884,23.732005,241.519,1939,2281
"172.16.133.11",55104,"172.16.139.250",5440,12,1142,3253,0,0,12,1142,0,0,23.736021,0.052700999999999,173355,0
"172.16.133.23",54929,"96.43.146.48",443,17,1037,3254,0,0,8,480,9,557,23.738693,261.790121,14,17
"172.16.133.55",57541,"172.16.139.250",5440,12,1142,3255,0,0,12,1142,0,0,23.73991,0.03439600000000098,265612,0
"172.16.133.55",50193,"157.56.232.214",443,5279,4481255,3256,0,0,3158,4353905,2121,127350,23.741556,241.031562,144509,4226
"172.16.133.73",60570,"172.16.139.250",5440,10,1022,3257,0,0,10,1022,0,0,23.764013,0.014096000000002107,580022,0
"157.56.241.150",443,"172.16.133.60",55459,10,775,3258,0,0,5,475,5,300,23.765616,240.759957,15,9
"172.16.133.53",54061,"172.16.139.250",5440,10,1022,3259,0,0,10,1022,0,0,23.766695,0.01518300000000039,538497,0
"172.16.133.21",53135,"172.16.139.250",5440,12,1142,3260,0,0,12,1142,0,0,23.769403,0.024792999999998955,368491,0
"172.16.133.11",49450,"157.56.244.214",443,139,30150,3261,0,0,72,26130,67,4020,23.771332,269.760676,774,119
"172.16.133.30",62574,"172.16.139.250",5440,12,1142,3262,0,0,12,1142,0,0,23.772462,0.038163000000000835,239394,0
"172.16.133.25",63396,"172.16.139.250",5440,12,1142,3263,0,0,12,1142,0,0,23.780917,0.01661200000000207,549963,0
"172.16.133.34",50401,"172.16.139.250",5440,10,1022,3264,0,0,10,1022,0,0,23.789365,0.025141000000001412,325205,0
"172.16.133.97",59331,"172.16.139.250",5440,10,1022,3265,0,0,10,1022,0,0,23.800728,0.017531999999999215,466347,0
"172.16.133.126",61255,"96.43.146.22",443,110,63204,3266,0,0,65,54396,45,8808,23.8018,255.51532499999996,1703,275
"157.56.244.214",443,"172.16.133.11",49454,131,61415,3267,0,0,86,58715,45,2700,23.813619,269.722304,1741,80
"172.16.133.47",56552,"93.184.215.248",80,34,28243,3268,0,0,12,1326,22,26917,23.844388,5.489519000000001,1932,39226
"172.16.133.47",56553,"216.137.33.45",443,22,9997,3269,0,0,9,1529,13,8468,23.844641,120.298206,101,563
"172.16.133.126",59272,"96.43.146.22",443,9,557,3270,0,0,4,240,5,317,23.862688,82.961162,23,30
"107.20.234.161",443,"172.16.133.232",48124,56,6216,3271,0,0,28,3108,28,3108,23.866026,270.226695,92,92
"172.16.133.33",57843,"172.16.139.250",5440,10,1022,3272,0,0,10,1022,0,0,23.876658,0.015807999999999822,517206,0
"172.16.133.68",60684,"172.16.139.250",5440,10,1022,3273,0,0,10,1022,0,0,23.906752,0.005622999999999934,1454028,0
"172.16.133.56",60940,"157.56.236.102",443,31,8584,3274,0,0,17,7744,14,840,23.918831,240.08015,258,27
"172.16.133.12",59691,"172.16.139.250",5440,12,1142,3275,0,0,12,1142,0,0,23.921251,0.005478999999997569,1667457,0
"172.16.133.63",53839,"172.16.139.250",5440,10,1022,3276,0,0,10,1022,0,0,23.929328,0.005076999999999998,1610399,0
"172.16.133.23",54926,"96.43.146.48",443,17,1037,3277,0,0,8,480,9,557,23.940699,261.58707400000003,14,17
"172.16.133.66",53811,"172.16.139.250",5440,12,1142,3278,0,0,12,1142,0,0,23.946532,0.008416000000000423,1085551,0
"172.16.133.87",60079,"96.43.146.176",443,12,3504,3279,0,0,7,1124,5,2380,23.947079,86.704669,103,219
"172.16.133.82",61283,"172.16.139.250",5440,10,1022,3280,0,0,10,1022,0,0,23.957884,0.005478000000000094,1492515,0
"172.16.133.37",60567,"172.16.139.250",5440,10,1022,3281,0,0,10,1022,0,0,23.972474,0.005563000000002205,1469710,0
"172.16.133.44",64413,"96.43.146.176",443,15,917,3282,0,0,7,420,8,497,23.984743,214.198049,15,18
"157.56.242.198",443,"172.16.133.67",62031,10,795,3283,0,0,5,495,5,300,23.998013,239.91299399999997,16,10
"204.246.169.230",443,"172.16.133.24",57651,4,240,3284,0,0,2,120,2,120,24.021352,1.8832449999999987,509,509
"216.137.33.45",443,"172.16.133.24",57644,4,240,3285,0,0,2,120,2,120,24.0264,1.8844950000000011,509,509
"172.16.133.35",49671,"96.43.146.48",443,11,677,3286,0,0,5,300,6,377,24.036001,120.245013,19,25
"172.16.133.35",49673,"96.43.146.22",443,11,677,3287,0,0,5,300,6,377,24.036002,120.248512,19,25
"172.16.133.35",49675,"96.43.146.22",443,11,677,3288,0,0,5,300,6,377,24.0363,120.248216,19,25
"204.246.169.230",443,"172.16.133.24",57650,4,240,3289,0,0,2,120,2,120,24.039027,1.8678619999999988,513,513
"172.16.133.48",60318,"107.20.161.243",443,18,5550,3290,0,0,10,2112,8,3438,24.046014,2.1996350000000007,7681,12503
"172.16.133.29",60632,"172.16.139.250",5440,4,240,3291,0,0,4,240,0,0,24.066425,0.000718000000002661,"",""
"172.16.133.53",53939,"172.16.139.250",5440,4,240,3292,0,0,4,240,0,0,24.066657,0.000537000000001342,"",""
"172.16.133.44",64575,"172.16.139.250",5440,6,360,3293,0,0,6,360,0,0,24.066841,0.0009399999999999409,"",""
"172.16.133.46",64530,"172.16.139.250",5440,4,240,3294,0,0,4,240,0,0,24.066843,0.0004100000000022419,"",""
"172.16.133.29",60846,"172.16.139.250",5440,10,1020,3295,0,0,10,1020,0,0,24.067087,120.01100000000001,67,0
"172.16.133.53",54062,"172.16.139.250",5440,10,1020,3296,0,0,10,1020,0,0,24.067254,120.01036200000001,67,0
"172.16.133.44",64736,"172.16.139.250",5440,10,1020,3297,0,0,10,1020,0,0,24.068365,120.01024100000001,67,0
"172.16.133.46",64542,"172.16.139.250",5440,10,1020,3298,0,0,10,1020,0,0,24.068812,120.00891899999999,67,0
"172.16.133.43",57603,"172.16.139.250",5440,4,240,3299,0,0,4,240,0,0,24.081833,0.00014399999999881175,"",""
"172.16.133.33",57713,"172.16.139.250",5440,4,240,3300,0,0,4,240,0,0,24.081927,0.00011100000000041632,"",""
"172.16.133.43",57725,"172.16.139.250",5440,10,1020,3301,0,0,10,1020,0,0,24.08247,120.01065399999999,67,0
"172.16.133.33",57844,"172.16.139.250",5440,12,1140,3302,0,0,12,1140,0,0,24.08264,120.011402,75,0
"172.16.133.78",59063,"172.16.139.250",5440,10,1022,3303,0,0,10,1022,0,0,24.128715,0.0160979999999995,507889,0
"172.16.133.45",61292,"172.16.139.250",5440,4,240,3304,0,0,4,240,0,0,24.145255,0.00030200000000135674,"",""
"172.16.133.34",50280,"172.16.139.250",5440,4,240,3305,0,0,4,240,0,0,24.145314,0.00012300000000209366,"",""
"172.16.133.88",51218,"172.16.139.250",5440,4,240,3306,0,0,4,240,0,0,24.14549,0.00019999999999953388,"",""
"172.16.133.34",50402,"172.16.139.250",5440,10,1020,3307,0,0,10,1020,0,0,24.146009,120.01060000000001,67,0
"172.16.133.45",61313,"172.16.139.250",5440,10,1020,3308,0,0,10,1020,0,0,24.146948,120.009372,67,0
"172.16.133.88",51221,"172.16.139.250",5440,10,1020,3309,0,0,10,1020,0,0,24.147561,120.02436,67,0
"172.16.133.45",61285,"96.43.146.176",443,13,797,3310,0,0,6,360,7,437,24.151503,171.820726,16,20
"172.16.133.115",53737,"23.67.242.72",80,10,618,3311,0,0,5,300,5,318,24.155896,101.326942,23,25
"172.16.133.35",49674,"96.43.146.22",443,11,677,3312,0,0,5,300,6,377,24.157618,120.12701399999999,19,25
"172.16.133.78",58837,"172.16.139.250",5440,6,360,3313,0,0,6,360,0,0,24.159824,0.0008569999999998856,"",""
"172.16.133.12",59531,"172.16.139.250",5440,6,360,3314,0,0,6,360,0,0,24.160111,0.0009389999999989129,"",""
"172.16.133.207",55772,"172.16.139.250",5440,6,360,3315,0,0,6,360,0,0,24.160372,0.00035600000000002296,"",""
"172.16.133.63",53681,"172.16.139.250",5440,4,240,3316,0,0,4,240,0,0,24.16079,6.800000000239947e-05,"",""
"172.16.133.128",65019,"172.16.139.250",5440,6,360,3317,0,0,6,360,0,0,24.160925,0.001125000000001819,"",""
"172.16.133.35",49669,"96.43.146.48",443,11,677,3318,0,0,5,300,6,377,24.161108,120.12352600000001,19,25
"172.16.133.78",59064,"172.16.139.250",5440,10,1020,3319,0,0,10,1020,0,0,24.161244,120.01166500000001,67,0
"172.16.133.207",55896,"172.16.139.250",5440,10,1020,3320,0,0,10,1020,0,0,24.161302,120.009792,67,0
"172.16.133.63",53840,"172.16.139.250",5440,10,1020,3321,0,0,10,1020,0,0,24.161355,120.010093,67,0
"172.16.133.12",59692,"172.16.139.250",5440,12,1140,3322,0,0,12,1140,0,0,24.161623,120.01117500000001,75,0
"172.16.133.75",50744,"172.16.139.250",5440,4,240,3323,0,0,4,240,0,0,24.162043,9.799999999771103e-05,"",""
"172.16.133.60",62107,"172.16.139.250",5440,6,360,3324,0,0,6,360,0,0,24.16235,0.00028700000000014825,"",""
"172.16.133.128",65025,"172.16.139.250",5440,10,1020,3325,0,0,10,1020,0,0,24.16253,120.009188,67,0
"172.16.133.75",50905,"172.16.139.250",5440,10,1020,3326,0,0,10,1020,0,0,24.162638,120.010092,67,0
"172.16.133.35",49785,"172.16.139.250",5440,6,360,3327,0,0,6,360,0,0,24.164231,0.005530999999997732,520701,0
"172.16.133.60",62129,"172.16.139.250",5440,10,1020,3328,0,0,10,1020,0,0,24.164291,120.00818800000002,67,0
"172.16.133.44",64737,"157.56.234.137",80,8,884,3329,0,0,5,532,3,352,24.166863,0.2065640000000002,20603,13632
"172.16.133.75",50837,"96.43.146.22",443,17,1037,3330,0,0,8,480,9,557,24.169285,261.857672,14,17
"172.16.133.75",50838,"96.43.146.22",443,17,1037,3331,0,0,8,480,9,557,24.169287,261.857729,14,17
"172.16.133.35",49933,"172.16.139.250",5440,12,1140,3332,0,0,12,1140,0,0,24.169761,120.004243,75,0
"172.16.133.75",50839,"96.43.146.22",443,17,1037,3333,0,0,8,480,9,557,24.171308,261.85664199999997,14,17
"172.16.133.67",55947,"172.16.139.250",5440,12,1142,3334,0,0,12,1142,0,0,24.182568,0.006277000000000754,1455472,0
"172.16.133.56",61365,"172.16.139.250",5440,12,1142,3335,0,0,12,1142,0,0,24.204733,0.005145999999999873,1775359,0
"172.16.133.103",63397,"172.16.139.250",5440,4,240,3336,0,0,4,240,0,0,24.209679,0.00019899999999850593,"",""
"172.16.133.103",63423,"172.16.139.250",5440,10,1020,3337,0,0,10,1020,0,0,24.210798,120.007368,67,0
"172.16.133.37",60423,"172.16.139.250",5440,4,240,3338,0,0,4,240,0,0,24.210859,0.00011999999999900979,"",""
"172.16.133.37",60568,"172.16.139.250",5440,12,1140,3339,0,0,12,1140,0,0,24.211457,120.00759400000001,75,0
"172.16.133.45",61286,"96.43.146.176",443,13,797,3340,0,0,6,360,7,437,24.221519,171.753513,16,20
"172.16.133.120",53427,"173.194.74.95",443,11,762,3341,0,0,5,300,6,462,24.22706,59.887986000000005,40,61
"172.16.133.153",58627,"209.112.253.15",80,177,151418,3342,0,0,71,4795,106,146623,24.233503,2.37988,16118,492875
"172.16.133.75",50906,"172.16.139.250",5440,10,1022,3343,0,0,10,1022,0,0,24.260221,0.005523000000000167,1480354,0
"172.16.133.41",52756,"172.16.139.250",5440,12,1142,3344,0,0,12,1142,0,0,24.261232,0.008241999999999194,1108468,0
"172.16.133.42",57028,"172.16.139.250",5440,12,1142,3345,0,0,12,1142,0,0,24.277094,0.13226099999999974,69075,0
"172.16.133.85",52208,"172.16.139.250",5440,10,1022,3346,0,0,10,1022,0,0,24.279145,0.06155299999999997,132828,0
"172.16.133.87",60141,"96.43.146.22",443,19,1537,3347,0,0,10,868,9,669,24.296134,270.372994,25,19
"172.16.133.75",50907,"67.217.67.129",443,47,27302,3348,0,0,20,9316,27,17986,24.296469,91.722858,812,1568
"172.16.133.75",50908,"67.217.67.129",443,26,9401,3349,0,0,13,3724,13,5677,24.296833,91.72005300000001,324,495
"172.16.133.75",50909,"67.217.67.129",443,77,60622,3350,0,0,28,7926,49,52696,24.297058,91.72253,691,4596
"172.16.133.44",64738,"157.56.240.22",443,29,11184,3351,0,0,13,3953,16,7231,24.305568,1.7053259999999995,18544,33921
"172.16.133.43",57726,"172.16.139.250",5440,10,1022,3352,0,0,10,1022,0,0,24.33368,0.010317999999998051,792401,0
"172.16.133.13",53000,"172.16.139.250",5440,12,1142,3353,0,0,12,1142,0,0,24.349586,0.08281799999999961,110314,0
"172.16.133.87",53068,"96.43.146.176",443,162,134964,3354,0,0,58,15930,104,119034,24.392489,266.655111,477,3571
"172.16.133.20",62340,"172.16.139.250",5440,12,1142,3355,0,0,12,1142,0,0,24.398541,0.03922599999999932,232906,0
"172.16.133.50",49204,"157.56.237.150",443,30,2513,3356,0,0,15,1613,15,900,24.416922,271.815538,47,26
"172.16.133.28",65325,"172.16.139.250",5440,12,1142,3357,0,0,12,1142,0,0,24.431198,0.011046000000000333,827086,0
"172.16.133.97",54103,"96.43.146.176",443,26,8115,3358,0,0,15,5010,11,3105,24.440425,240.352036,166,103
"172.16.133.95",54528,"96.43.146.48",443,24,6428,3359,0,0,13,5152,11,1276,24.443953,270.81267599999995,152,37
"172.16.133.99",49295,"172.16.139.250",5500,64,31096,3360,0,0,64,31096,0,0,24.451278,240.201709,1035,0
"172.16.133.99",56006,"172.16.139.250",5440,12,1142,3361,0,0,12,1142,0,0,24.457036,0.014945000000000874,611308,0
"172.16.133.87",60142,"172.16.139.250",5440,10,1022,3362,0,0,10,1022,0,0,24.477586,0.0051420000000028665,1590042,0
"216.137.33.105",443,"172.16.133.24",57660,4,240,3363,0,0,2,120,2,120,24.4835,1.4250889999999998,673,673
"216.137.33.105",443,"172.16.133.24",57661,4,240,3364,0,0,2,120,2,120,24.483595,1.4259679999999975,673,673
"216.137.33.105",443,"172.16.133.24",57658,4,240,3365,0,0,2,120,2,120,24.483733,1.4255530000000007,673,673
"216.137.33.105",443,"172.16.133.24",57663,4,240,3366,0,0,2,120,2,120,24.484074,1.4253579999999992,673,673
"216.137.33.105",443,"172.16.133.24",57662,4,240,3367,0,0,2,120,2,120,24.484181,1.424856000000002,673,673
"216.137.33.105",443,"172.16.133.24",57659,4,240,3368,0,0,2,120,2,120,24.484277,1.4254020000000018,673,673
"172.16.133.35",49934,"172.16.139.250",5440,12,1142,3369,0,0,12,1142,0,0,24.492469,0.06339300000000136,144116,0
"172.16.133.116",53216,"172.16.139.250",5440,10,1022,3370,0,0,10,1022,0,0,24.495821,0.005728000000001288,1427374,0
"172.16.133.95",49358,"157.56.240.102",443,20909,17845737,3371,0,0,12518,17342229,8391,503508,24.497485,241.02545899999998,575614,16712
"172.16.133.116",53217,"172.16.139.250",5440,10,1022,3372,0,0,10,1022,0,0,24.502343,0.009069000000000216,901532,0
"172.16.133.41",51184,"96.43.146.48",443,26,8115,3373,0,0,15,5010,11,3105,24.51073,240.343218,166,103
"172.16.133.116",53218,"172.16.139.250",5440,10,1022,3374,0,0,10,1022,0,0,24.512261,0.00668500000000094,1223036,0
"172.16.133.84",58753,"172.16.139.250",5440,10,1022,3375,0,0,10,1022,0,0,24.51663,0.019541000000000253,418402,0
"172.16.133.40",62988,"157.56.245.198",443,36,4506,3376,0,0,19,3486,17,1020,24.526476,274.870992,101,29
"172.16.133.101",51137,"96.43.146.176",443,25,9510,3377,0,0,13,4078,12,5432,24.529707,115.76977099999999,281,375
"172.16.133.49",55729,"172.16.139.250",5440,12,1142,3378,0,0,12,1142,0,0,24.594499,0.01585900000000251,576076,0
"172.16.133.36",65073,"72.233.61.123",443,29,8691,3379,0,0,16,2142,13,6549,24.617184,30.726796999999998,557,1705
"172.16.133.75",50910,"67.217.67.129",443,23,4708,3380,0,0,11,3353,12,1355,24.627214,91.393167,293,118
"172.16.133.95",56927,"172.16.139.250",5440,12,1142,3381,0,0,12,1142,0,0,24.630324,0.005686999999998221,1606470,0
"204.93.223.146",443,"172.16.133.24",57630,1,60,3382,0,0,1,60,0,0,24.638726,0,"",""
"172.16.133.92",57643,"172.16.139.250",5440,12,1142,3383,0,0,12,1142,0,0,24.659579,0.006495999999998503,1406403,0
"172.16.133.29",60847,"172.16.139.250",5440,12,1142,3384,0,0,12,1142,0,0,24.676063,0.017915000000002124,509963,0
"173.194.68.189",443,"172.16.133.73",53338,70,18246,3385,0,0,41,3734,29,14512,24.683273,266.859351,111,435
"172.16.133.44",64739,"172.16.139.250",5440,10,1022,3386,0,0,10,1022,0,0,24.68379,0.005478000000000094,1492515,0
"172.16.133.120",53243,"96.43.146.48",443,179,142395,3387,0,0,81,49366,98,93029,24.703967,259.379294,1522,2869
"172.16.133.207",55897,"172.16.139.250",5440,12,1142,3388,0,0,12,1142,0,0,24.7087,0.016338000000001074,559187,0
"172.16.133.83",57052,"172.16.139.250",5440,12,1142,3389,0,0,12,1142,0,0,24.716361,0.004713999999999885,"",""
"172.16.133.33",49377,"157.56.245.198",443,10,775,3390,0,0,5,475,5,300,24.727002,240.036164,15,9
"157.56.242.198",443,"172.16.133.24",55881,10,795,3391,0,0,5,495,5,300,24.727756,240.19635399999999,16,9
"172.16.133.93",60622,"172.16.139.250",5440,12,1142,3392,0,0,12,1142,0,0,24.73448,0.004943999999998283,"",""
"172.16.133.43",57418,"96.43.146.176",443,7,437,3393,0,0,3,180,4,257,24.742926,32.463635,44,63
"172.16.133.11",55105,"172.16.139.250",5440,12,1142,3394,0,0,12,1142,0,0,24.750114,0.006292999999999438,1451771,0
"172.16.133.55",57542,"172.16.139.250",5440,12,1142,3395,0,0,12,1142,0,0,24.754626000000002,0.006365999999999872,1435124,0
"172.16.133.73",60571,"172.16.139.250",5440,12,1142,3396,0,0,12,1142,0,0,24.778148,0.022578999999996796,404623,0
"172.16.133.53",54063,"172.16.139.250",5440,12,1142,3397,0,0,12,1142,0,0,24.780492,0.006852999999999554,1333138,0
"172.16.133.45",61343,"96.43.146.48",443,25,8055,3398,0,0,15,5010,10,3045,24.782969,240.35127199999997,166,101
"172.16.133.21",53136,"172.16.139.250",5440,10,1022,3399,0,0,10,1022,0,0,24.783687,0.008323000000000746,982338,0
"172.16.133.30",62575,"172.16.139.250",5440,12,1142,3400,0,0,12,1142,0,0,24.787067,0.00891499999999823,1024789,0
"172.16.133.126",61225,"96.43.146.22",443,9,557,3401,0,0,4,240,5,317,24.789976,82.033697,23,30
"172.16.133.25",63397,"172.16.139.250",5440,12,1142,3402,0,0,12,1142,0,0,24.795162,0.008782000000000068,1040309,0
"172.16.133.126",61224,"96.43.146.22",443,9,557,3403,0,0,4,240,5,317,24.797653,82.02619800000001,23,30
"172.16.133.34",50403,"172.16.139.250",5440,12,1142,3404,0,0,12,1142,0,0,24.803347,0.004954000000001457,"",""
"172.16.133.97",59332,"172.16.139.250",5440,10,1022,3405,0,0,10,1022,0,0,24.816011,0.015398000000001133,530978,0
"172.16.133.93",60299,"96.43.146.48",443,78,54308,3406,0,0,36,6829,42,47479,24.879638,238.677036,228,1591
"172.16.133.33",57845,"172.16.139.250",5440,10,1022,3407,0,0,10,1022,0,0,24.889829,0.005711000000001576,1431623,0
"172.16.133.126",61223,"96.43.146.22",443,9,557,3408,0,0,4,240,5,317,24.893248,81.930678,23,30
"172.16.133.126",61226,"96.43.146.22",443,9,557,3409,0,0,4,240,5,317,24.899353,81.924572,23,30
"172.16.133.126",61227,"96.43.146.22",443,9,557,3410,0,0,4,240,5,317,24.899355,81.924415,23,30
"172.16.133.28",65054,"173.194.43.57",443,14,948,3411,0,0,7,420,7,528,24.900305,107.21810199999999,31,39
"172.16.133.68",60685,"172.16.139.250",5440,10,1022,3412,0,0,10,1022,0,0,24.921417,0.005611999999999284,1456878,0
"172.16.133.12",59693,"172.16.139.250",5440,12,1142,3413,0,0,12,1142,0,0,24.93413,0.006185999999999581,1476883,0
"172.16.133.63",53841,"172.16.139.250",5440,10,1022,3414,0,0,10,1022,0,0,24.943322,0.005379000000001355,1519985,0
"172.16.133.66",53812,"172.16.139.250",5440,10,1022,3415,0,0,10,1022,0,0,24.959403000000002,0.005248999999999171,1557630,0
"172.16.133.82",61284,"172.16.139.250",5440,10,1022,3416,0,0,10,1022,0,0,24.972729,0.015952999999999662,512505,0
"172.16.133.37",60569,"172.16.139.250",5440,12,1142,3417,0,0,12,1142,0,0,24.986255,0.008006000000001734,1141144,0
"172.16.133.66",53485,"216.52.242.80",80,29,17267,3418,0,0,15,4789,14,12478,25.036461,266.52281400000004,143,374
"172.16.133.35",57084,"96.43.146.22",443,36,17098,3419,0,0,21,14672,15,2426,25.103,256.06694899999997,458,75
"172.16.133.78",59065,"172.16.139.250",5440,12,1142,3420,0,0,12,1142,0,0,25.14156,0.016574000000002087,551224,0
"172.16.133.67",55948,"172.16.139.250",5440,12,1142,3421,0,0,12,1142,0,0,25.196679,0.006585000000001173,1387395,0
"172.16.133.87",59816,"96.43.146.50",443,51,26929,3422,0,0,26,16376,25,10553,25.211901,252.511148,518,334
"172.16.133.56",61366,"172.16.139.250",5440,12,1142,3423,0,0,12,1142,0,0,25.218685,0.005026999999998338,1817386,0
"172.16.133.28",65086,"172.16.139.250",5440,4,240,3424,0,0,4,240,0,0,25.223764,0.0001449999999998397,"",""
"172.16.133.30",62444,"172.16.139.250",5440,6,360,3425,0,0,6,360,0,0,25.22401,0.0009130000000006078,"",""
"172.16.133.21",53006,"172.16.139.250",5440,6,360,3426,0,0,6,360,0,0,25.22434,0.0009209999999981733,"",""
"172.16.133.28",65326,"172.16.139.250",5440,12,1140,3427,0,0,12,1140,0,0,25.224631,120.02571099999999,75,0
"172.16.133.83",56906,"172.16.139.250",5440,4,240,3428,0,0,4,240,0,0,25.224691,5.200000000016303e-05,"",""
"172.16.133.83",57053,"172.16.139.250",5440,12,1140,3429,0,0,12,1140,0,0,25.225056,120.024779,75,0
"172.16.133.68",60547,"172.16.139.250",5440,6,360,3430,0,0,6,360,0,0,25.225112,0.0009100000000010766,"",""
"172.16.133.55",57401,"172.16.139.250",5440,6,360,3431,0,0,6,360,0,0,25.225348,0.0008349999999985869,"",""
"172.16.133.30",62576,"172.16.139.250",5440,10,1020,3432,0,0,10,1020,0,0,25.225477,116.70039799999999,69,0
"172.16.133.21",53137,"172.16.139.250",5440,10,1020,3433,0,0,10,1020,0,0,25.225798,120.02508,67,0
"172.16.133.11",54984,"172.16.139.250",5440,6,360,3434,0,0,6,360,0,0,25.226114,0.0009340000000008786,"",""
"172.16.133.95",56784,"172.16.139.250",5440,6,360,3435,0,0,6,360,0,0,25.226436,0.0009739999999993643,"",""
"172.16.133.55",57543,"172.16.139.250",5440,12,1140,3436,0,0,12,1140,0,0,25.226497,120.02478300000001,75,0
"172.16.133.68",60686,"172.16.139.250",5440,10,1020,3437,0,0,10,1020,0,0,25.226581,120.026384,67,0
"172.16.133.73",60386,"172.16.139.250",5440,6,360,3438,0,0,6,360,0,0,25.226719,0.0008499999999997954,"",""
"172.16.133.11",55106,"172.16.139.250",5440,10,1020,3439,0,0,10,1020,0,0,25.22757,120.006173,67,0
"172.16.133.56",61213,"172.16.139.250",5440,4,240,3440,0,0,4,240,0,0,25.227675,0.00017799999999823513,"",""
"172.16.133.73",60572,"172.16.139.250",5440,10,1020,3441,0,0,10,1020,0,0,25.227849,120.02356,67,0
"172.16.133.85",52081,"172.16.139.250",5440,4,240,3442,0,0,4,240,0,0,25.227852,0.000256000000000256,"",""
"172.16.133.95",56928,"172.16.139.250",5440,10,1020,3443,0,0,10,1020,0,0,25.227897,120.00599799999999,67,0
"172.16.133.45",61314,"67.152.103.227",80,139,113125,3444,0,0,58,16355,81,96770,25.228174,134.349306,973,5762
"172.16.133.56",61367,"172.16.139.250",5440,12,1140,3445,0,0,12,1140,0,0,25.2283,120.026731,75,0
"172.16.133.97",59212,"172.16.139.250",5440,4,240,3446,0,0,4,240,0,0,25.228455,0.0003609999999980573,"",""
"172.16.133.45",61315,"67.152.103.227",80,77,55262,3447,0,0,35,8741,42,46521,25.228625,144.346157,484,2578
"172.16.133.85",52209,"172.16.139.250",5440,10,1020,3448,0,0,10,1020,0,0,25.22876,120.025056,67,0
"172.16.133.13",52857,"172.16.139.250",5440,6,360,3449,0,0,6,360,0,0,25.228899,0.0009709999999998331,"",""
"172.16.133.97",59333,"172.16.139.250",5440,10,1020,3450,0,0,10,1020,0,0,25.229184,120.02528899999999,67,0
"172.16.133.84",58588,"172.16.139.250",5440,4,240,3451,0,0,4,240,0,0,25.229619,6.700000000137152e-05,"",""
"172.16.133.42",57029,"172.16.139.250",5440,12,1142,3452,0,0,12,1142,0,0,25.229809,0.01744199999999907,523793,0
"172.16.133.66",53619,"172.16.139.250",5440,6,360,3453,0,0,6,360,0,0,25.229916,0.00017800000000178784,"",""
"172.16.133.84",58754,"172.16.139.250",5440,12,1140,3454,0,0,12,1140,0,0,25.230203,120.021473,75,0
"172.16.133.20",62158,"172.16.139.250",5440,6,360,3455,0,0,6,360,0,0,25.23045,0.0004139999999992483,"",""
"172.16.133.66",53813,"172.16.139.250",5440,10,1020,3456,0,0,10,1020,0,0,25.230674,120.003558,67,0
"172.16.133.13",53001,"172.16.139.250",5440,10,1020,3457,0,0,10,1020,0,0,25.230732,120.00343600000001,67,0
"172.16.133.25",63242,"172.16.139.250",5440,6,360,3458,0,0,6,360,0,0,25.231147,0.00036300000000011323,"",""
"172.16.133.20",62341,"172.16.139.250",5440,12,1140,3459,0,0,12,1140,0,0,25.23146,120.02098000000001,75,0
"172.16.133.40",50071,"172.16.139.250",5440,6,360,3460,0,0,6,360,0,0,25.231607,0.00021699999999924557,"",""
"172.16.133.25",63398,"172.16.139.250",5440,12,1140,3461,0,0,12,1140,0,0,25.232012,120.002758,75,0
"172.16.133.92",57478,"172.16.139.250",5440,6,360,3462,0,0,6,360,0,0,25.232557,0.0009569999999996526,"",""
"172.16.133.116",52797,"172.16.139.250",5440,4,240,3463,0,0,4,240,0,0,25.232756,0.00013500000000021828,"",""
"172.16.133.23",55005,"172.16.139.250",5440,4,240,3464,0,0,4,240,0,0,25.233091,0.00013899999999722468,"",""
"172.16.133.116",53219,"172.16.139.250",5440,12,1140,3465,0,0,12,1140,0,0,25.233309,120.01729700000001,75,0
"172.16.133.40",50080,"172.16.139.250",5440,10,1020,3466,0,0,10,1020,0,0,25.23331,120.00146299999999,67,0
"172.16.133.92",57644,"172.16.139.250",5440,10,1020,3467,0,0,10,1020,0,0,25.234041,120.021372,67,0
"172.16.133.23",55041,"172.16.139.250",5440,10,1020,3468,0,0,10,1020,0,0,25.237883,120.01548000000001,67,0
"157.56.232.214",443,"172.16.133.55",50195,487,75716,3469,0,0,320,65696,167,10020,25.245964999999998,256.082883,2052,313
"172.16.133.45",61316,"93.184.216.119",80,74,84698,3470,0,0,15,1267,59,83431,25.254512,15.554383999999999,651,42910
"172.16.133.75",50911,"172.16.139.250",5440,10,1022,3471,0,0,10,1022,0,0,25.274187,0.005417999999998813,1509043,0
"172.16.133.41",52757,"172.16.139.250",5440,12,1142,3472,0,0,12,1142,0,0,25.275074,0.009026999999999674,1012074,0
"74.125.226.85",443,"172.16.133.26",49397,1215,1099741,3473,0,0,874,969433,341,130308,25.275462,265.147379,29249,3931
"172.16.133.29",60611,"96.43.146.22",443,13,797,3474,0,0,6,360,7,437,25.276534,165.888382,17,21
"172.16.133.29",60609,"96.43.146.22",443,12,737,3475,0,0,6,360,6,377,25.277573,165.885481,17,18
"172.16.133.45",61317,"67.152.103.227",80,40,24040,3476,0,0,20,5475,20,18565,25.27906,134.29852899999997,326,1105
"172.16.133.29",60614,"96.43.146.22",443,13,797,3477,0,0,6,360,7,437,25.282543,165.873436,17,21
"172.16.133.29",60608,"96.43.146.22",443,13,797,3478,0,0,6,360,7,437,25.282544,165.882179,17,21
"172.16.133.29",60610,"96.43.146.22",443,13,797,3479,0,0,6,360,7,437,25.285597,165.87926000000002,17,21
"172.16.133.29",60607,"96.43.146.22",443,13,797,3480,0,0,6,360,7,437,25.285598,165.878231,17,21
"172.16.133.85",52210,"172.16.139.250",5440,10,1022,3481,0,0,10,1022,0,0,25.292062,0.014858999999997735,550238,0
"23.0.49.244",80,"172.16.133.66",53674,4,240,3482,0,0,2,120,2,120,25.321252,1.8150879999999994,528,528
"172.16.133.43",57727,"172.16.139.250",5440,12,1142,3483,0,0,12,1142,0,0,25.346796,0.007726999999999151,1182347,0
"172.16.128.169",4504,"172.16.139.250",1030,250,62212,3484,0,0,131,25508,119,36704,25.351014,251.964033,809,1165
"172.16.133.13",53002,"172.16.139.250",5440,12,1142,3485,0,0,12,1142,0,0,25.363657,0.016145999999999106,565836,0
"172.16.133.163",3515,"173.194.75.147",443,315,120548,3486,0,0,131,16959,184,103589,25.368664,270.573674,501,3062
"172.16.133.163",3516,"173.194.74.95",443,39,6841,3487,0,0,18,1934,21,4907,25.368973,240.21737399999998,64,163
"172.16.133.163",3517,"173.194.43.35",443,62,17094,3488,0,0,28,3216,34,13878,25.369365,263.96302399999996,97,420
"172.16.133.73",60573,"74.121.142.246",80,6,372,3489,0,0,4,246,2,126,25.391364,13.211568000000003,148,76
"172.16.133.73",60574,"74.121.142.246",80,6,372,3490,0,0,4,246,2,126,25.391481,13.209558000000001,148,76
"172.16.133.73",60575,"74.121.142.246",80,6,372,3491,0,0,4,246,2,126,25.39159,13.209159999999997,148,76
"157.56.232.214",443,"172.16.133.82",54129,103,41453,3492,0,0,66,39227,37,2226,25.392968,239.839473,1308,74
"172.16.133.73",60576,"173.194.43.45",80,6,372,3493,0,0,4,246,2,126,25.398794,13.202183000000002,149,76
"172.16.133.73",60577,"173.194.43.45",80,23,6296,3494,0,0,13,3673,10,2623,25.39891,269.287445,109,77
"172.16.133.20",62342,"172.16.139.250",5440,12,1142,3495,0,0,12,1142,0,0,25.412455,0.01460999999999757,625325,0
"172.16.133.121",54691,"70.184.144.100",47061,60,4176,3496,0,0,28,1814,32,2362,25.41951,266.992342,54,70
"172.16.133.28",65327,"172.16.139.250",5440,12,1142,3497,0,0,12,1142,0,0,25.445592,0.005587999999999482,1634931,0
"172.16.133.66",53486,"216.52.242.80",80,90,56991,3498,0,0,43,19308,47,37683,25.446464,256.129608,603,1176
"172.16.133.99",56007,"172.16.139.250",5440,12,1142,3499,0,0,12,1142,0,0,25.469324,0.014718999999999482,620694,0
"172.16.133.30",61972,"96.43.146.176",443,10,617,3500,0,0,5,300,5,317,25.473105,80.656866,29,31
"172.16.133.87",60144,"172.16.139.250",5440,12,1142,3501,0,0,12,1142,0,0,25.491675,0.015467000000001008,590676,0
"172.16.133.29",60604,"96.43.146.176",443,13,797,3502,0,0,6,360,7,437,25.496591,165.65939,17,21
"172.16.133.116",53220,"172.16.139.250",5440,10,1022,3503,0,0,10,1022,0,0,25.509583,0.00821900000000042,994768,0
"172.16.133.35",49935,"172.16.139.250",5440,12,1142,3504,0,0,12,1142,0,0,25.511057,0.055934000000000594,163335,0
"172.16.133.68",55076,"157.56.242.198",443,10,795,3505,0,0,5,495,5,300,25.512828,240.024156,16,9
"172.16.133.116",53221,"172.16.139.250",5440,10,1022,3506,0,0,10,1022,0,0,25.51847,0.011541999999998609,708369,0
"172.16.133.20",62190,"173.194.43.35",443,14,954,3507,0,0,6,360,8,594,25.528512,149.99571799999998,19,31
"172.16.133.84",58755,"172.16.139.250",5440,10,1022,3508,0,0,10,1022,0,0,25.530524,0.005669000000001034,1442229,0
"172.16.133.116",53222,"172.16.139.250",5440,10,1022,3509,0,0,10,1022,0,0,25.530809,0.009121999999997854,896294,0
"172.16.133.45",61318,"173.194.75.106",80,34,15306,3510,0,0,16,5531,18,9775,25.533901,245.298384,180,318
"172.16.133.29",60605,"96.43.146.176",443,13,797,3511,0,0,6,360,7,437,25.545607,165.611306,17,21
"172.16.133.63",57096,"172.16.139.250",5447,12,1668,3512,0,0,12,1668,0,0,25.554662,245.268892,54,0
"173.194.43.21",443,"172.16.133.93",51093,53,15135,3513,0,0,27,3683,26,11452,25.562375,261.047572,112,350
"172.16.133.45",61319,"67.152.103.227",80,99,76392,3514,0,0,42,13354,57,63038,25.564337,134.01373900000002,797,3763
"172.16.133.45",61320,"67.152.103.227",80,93,71178,3515,0,0,42,14044,51,57134,25.570232,134.007431,838,3410
"172.16.133.87",59805,"96.43.146.48",443,19,13697,3516,0,0,12,13260,7,437,25.573192,3.8950260000000014,27234,897
"172.16.133.87",59807,"96.43.146.48",443,55,42494,3517,0,0,29,28761,26,13733,25.574294,3.8939220000000034,59089,28214
"172.16.133.87",59806,"96.43.146.48",443,45,37058,3518,0,0,26,28564,19,8494,25.575698,16.472336000000002,13872,4125
"172.16.133.40",50081,"74.125.226.227",443,7,438,3519,0,0,5,312,2,126,25.599783,13.042885000000002,191,77
"172.16.133.75",50566,"173.194.43.41",80,5,300,3520,0,0,3,180,2,120,25.607326,24.635553,58,38
"172.16.133.49",55730,"172.16.139.250",5440,10,1022,3521,0,0,10,1022,0,0,25.609063,0.01937300000000164,422030,0
"172.16.133.45",61321,"173.194.43.40",80,7,438,3522,0,0,5,312,2,126,25.641813,15.168246000000003,164,66
"172.16.133.95",56929,"172.16.139.250",5440,10,1022,3523,0,0,10,1022,0,0,25.644254,0.007010999999998546,1166167,0
"74.125.226.246",443,"172.16.133.75",57932,96,29922,3524,0,0,46,6708,50,23214,25.649714,273.05777,196,680
"172.16.133.92",57645,"172.16.139.250",5440,10,1022,3525,0,0,10,1022,0,0,25.674179,0.006835999999999842,1196021,0
"172.16.133.43",57435,"96.43.146.22",443,7,437,3526,0,0,3,180,4,257,25.679935,31.525674000000002,45,65
"172.16.133.43",57433,"96.43.146.176",443,7,437,3527,0,0,3,180,4,257,25.689916,31.516645999999998,45,65
"172.16.133.43",57436,"96.43.146.22",443,7,437,3528,0,0,3,180,4,257,25.689917,31.521512,45,65
"172.16.133.43",57437,"96.43.146.22",443,7,437,3529,0,0,3,180,4,257,25.690916,31.520514999999996,45,65
"172.16.133.43",57434,"96.43.146.22",443,7,437,3530,0,0,3,180,4,257,25.690918,31.519442,45,65
"172.16.133.43",57432,"96.43.146.176",443,7,437,3531,0,0,3,180,4,257,25.690919,31.520511,45,65
"172.16.133.29",60848,"172.16.139.250",5440,10,1022,3532,0,0,10,1022,0,0,25.69092,0.020172999999999774,405294,0
"172.16.133.43",57438,"96.43.146.22",443,7,437,3533,0,0,3,180,4,257,25.692905,31.519603,45,65
"172.16.133.43",57431,"96.43.146.176",443,7,437,3534,0,0,3,180,4,257,25.692907,31.517453999999997,45,65
"172.16.133.43",57440,"96.43.146.22",443,7,437,3535,0,0,3,180,4,257,25.695893,31.515534,45,65
"172.16.133.43",57439,"96.43.146.22",443,7,437,3536,0,0,3,180,4,257,25.695895,31.514467000000003,45,65
"172.16.133.44",64740,"172.16.139.250",5440,10,1022,3537,0,0,10,1022,0,0,25.696837,0.00527800000000056,1549071,0
"172.16.133.35",57559,"96.43.146.22",443,51,31821,3538,0,0,31,27571,20,4250,25.704231,256.512594,859,132
"172.16.133.207",55898,"172.16.139.250",5440,10,1022,3539,0,0,10,1022,0,0,25.723868,0.014526000000000039,562852,0
"172.16.133.83",57054,"172.16.139.250",5440,12,1142,3540,0,0,12,1142,0,0,25.730272,0.013940999999999093,655333,0
"172.16.133.43",57441,"96.43.146.22",443,6,377,3541,0,0,3,180,3,197,25.742893,31.466489,45,50
"172.16.133.53",56051,"96.43.146.22",443,34,15697,3542,0,0,20,13330,14,2367,25.743741,255.470573,417,74
"172.16.133.29",60603,"96.43.146.176",443,12,737,3543,0,0,6,360,6,377,25.745603,165.410425,17,18
"172.16.133.93",60623,"172.16.139.250",5440,10,1022,3544,0,0,10,1022,0,0,25.748307,0.00451800000000091,"",""
"172.16.133.66",53673,"23.0.49.244",80,7,426,3545,0,0,4,240,3,186,25.756515,51.371829999999996,37,28
"172.16.133.66",53671,"23.0.49.244",80,7,426,3546,0,0,4,240,3,186,25.76149,51.367852,37,28
"172.16.133.11",55107,"172.16.139.250",5440,12,1142,3547,0,0,12,1142,0,0,25.764637,0.006420999999999566,1422831,0
"172.16.133.87",59820,"96.43.146.48",443,90,64509,3548,0,0,48,43438,42,21071,25.764809,256.943966,1352,656
"172.16.133.55",57544,"172.16.139.250",5440,10,1022,3549,0,0,10,1022,0,0,25.768039,0.015483999999997167,528028,0
"172.16.133.66",53670,"23.0.49.244",80,6,366,3550,0,0,3,180,3,186,25.771496,11.363004000000004,126,130
"172.16.133.87",59821,"96.43.146.48",443,111,84323,3551,0,0,59,56655,52,27668,25.774724,252.574338,1794,876
"172.16.133.87",60145,"64.56.203.22",443,20,8049,3552,0,0,11,3400,9,4649,25.783909,10.237496999999998,2656,3632
"172.16.133.87",60146,"64.56.203.22",443,32,19701,3553,0,0,15,5764,17,13937,25.784115,40.233121,1146,2771
"172.16.133.87",60093,"64.56.203.22",443,24,17494,3554,0,0,11,5268,13,12226,25.786357,10.234102000000004,4117,9557
"172.16.133.66",53510,"173.194.43.59",80,35,15234,3555,0,0,16,7510,19,7724,25.786521,241.36150400000002,248,256
"172.16.133.73",60578,"172.16.139.250",5440,12,1142,3556,0,0,12,1142,0,0,25.791566,0.021715000000000373,420723,0
"172.16.133.53",54064,"172.16.139.250",5440,12,1142,3557,0,0,12,1142,0,0,25.794635,0.005812999999999846,1571649,0
"172.16.133.21",53138,"172.16.139.250",5440,10,1022,3558,0,0,10,1022,0,0,25.797427,0.00716600000000156,1140943,0
"172.16.133.75",50912,"67.217.67.129",443,16,1402,3559,0,0,8,765,8,637,25.799864,90.219361,67,56
"172.16.133.75",50913,"67.217.67.129",443,15,1342,3560,0,0,8,765,7,577,25.800366,90.21906200000001,67,51
"172.16.133.30",62577,"172.16.139.250",5440,12,1142,3561,0,0,12,1142,0,0,25.801583,0.007328999999998587,1246554,0
"172.16.133.25",63399,"172.16.139.250",5440,12,1142,3562,0,0,12,1142,0,0,25.809124,0.007241999999997972,1261529,0
"172.16.133.34",50404,"172.16.139.250",5440,10,1022,3563,0,0,10,1022,0,0,25.817187,0.014607999999999066,559693,0
"172.16.133.97",59334,"172.16.139.250",5440,10,1022,3564,0,0,10,1022,0,0,25.828831,0.006678999999998325,1224135,0
"172.16.133.40",50082,"74.125.226.227",443,34,5281,3565,0,0,17,2461,17,2820,25.848932,240.11919699999999,81,93
"172.16.133.132",55189,"216.185.152.111",80,11,1782,3566,0,0,6,760,5,1022,25.862423,5.677482000000001,1070,1440
"172.16.133.45",61322,"173.194.43.40",80,24,5181,3567,0,0,13,3375,11,1806,25.888875,252.49753600000003,106,57
"172.16.133.33",57846,"172.16.139.250",5440,10,1022,3568,0,0,10,1022,0,0,25.90483,0.018705000000000638,437102,0
"172.16.133.35",49485,"216.52.242.80",80,5,300,3569,0,0,4,240,1,60,25.906483,82.976258,23,5
"172.16.133.93",60330,"172.16.139.250",5440,6,360,3570,0,0,6,360,0,0,25.917668,0.0003379999999992833,"",""
"172.16.133.93",60624,"172.16.139.250",5440,12,1140,3571,0,0,12,1140,0,0,25.918567,120.002553,75,0
"172.16.133.45",61245,"96.43.146.22",443,5,317,3572,0,0,2,120,3,197,25.934633,0.10151999999999717,9456,15524
"172.16.133.68",60687,"172.16.139.250",5440,12,1142,3573,0,0,12,1142,0,0,25.93478,0.008852999999998445,1031966,0
"172.16.133.12",59694,"172.16.139.250",5440,12,1142,3574,0,0,12,1142,0,0,25.948825,0.006865000000001231,1330808,0
"172.16.133.63",53842,"172.16.139.250",5440,12,1142,3575,0,0,12,1142,0,0,25.956838,0.007158999999997917,1276155,0
"172.16.133.66",53814,"172.16.139.250",5440,10,1022,3576,0,0,10,1022,0,0,25.972782,0.007025999999999755,1163677,0
"172.16.133.235",2694,"172.16.131.10",8080,22,4169,3577,0,0,11,2379,11,1790,25.981545,18.438695,1032,776
"172.16.133.82",61285,"172.16.139.250",5440,10,1022,3578,0,0,10,1022,0,0,25.98528,0.015057999999999794,542967,0
"172.16.133.37",50535,"209.107.209.26",80,35,27516,3579,0,0,13,4929,22,22587,25.985619,250.869479,157,720
"172.16.133.66",53501,"23.33.81.244",80,42,22244,3580,0,0,21,5703,21,16541,25.996461,265.95723399999997,171,497
"172.16.133.66",53672,"23.0.49.244",80,6,366,3581,0,0,3,180,3,186,25.996462,11.137800999999996,129,133
"172.16.133.37",60570,"172.16.139.250",5440,10,1022,3582,0,0,10,1022,0,0,25.99948,0.015381000000001421,531564,0
"172.16.133.44",64741,"132.245.2.22",443,19,8509,3583,0,0,9,1929,10,6580,26.014857,0.2578010000000006,59860,204188
"172.16.133.40",50083,"173.194.43.33",443,52,17039,3584,0,0,25,2935,27,14104,26.026361,240.18062600000002,97,469
"172.16.133.121",56498,"74.125.226.193",443,46,13041,3585,0,0,21,3849,25,9192,26.030134,240.741091,127,305
"172.16.133.66",53518,"173.194.43.34",443,317,260019,3586,0,0,104,41815,213,218204,26.041466,238.181689,1404,7328
"172.16.133.20",61690,"216.52.242.80",80,3,180,3587,0,0,2,120,1,60,26.043824,0.09472299999999834,10134,5067
"172.16.133.20",61296,"216.52.242.80",80,3,180,3588,0,0,2,120,1,60,26.043895,0.0941200000000002,10199,5099
"172.16.133.87",59862,"96.43.146.22",443,72,39044,3589,0,0,41,32727,31,6317,26.052457,235.38791299999997,1112,214
"172.16.133.45",61323,"67.152.103.227",80,88,64019,3590,0,0,39,13174,49,50845,26.073103,133.504322,789,3046
"172.16.133.12",59695,"96.43.146.22",443,22,4255,3591,0,0,12,1255,10,3000,26.085904,270.40919599999995,37,88
"172.16.133.12",59696,"96.43.146.22",443,26,7246,3592,0,0,15,3898,11,3348,26.086096,266.051001,117,100
"172.16.133.12",59697,"96.43.146.22",443,63,31607,3593,0,0,35,24444,28,7163,26.086275,266.777917,733,214
"172.16.133.132",36182,"216.185.152.144",80,24,11588,3594,0,0,13,2066,11,9522,26.08914,6.609456999999999,2500,11525
"172.16.133.43",53361,"96.43.146.176",443,23,9550,3595,0,0,14,8388,9,1162,26.089915,270.63998499999997,247,34
"172.16.133.28",65248,"74.125.226.198",443,17,1140,3596,0,0,8,480,9,660,26.11532,196.007431,19,26
"172.16.133.28",65250,"74.125.226.207",443,18,1200,3597,0,0,9,540,9,660,26.134331,195.988532,22,26
"172.16.133.11",53700,"216.52.242.80",80,19,5798,3598,0,0,12,3914,7,1884,26.135319,265.66902400000004,117,56
"172.16.133.78",59066,"172.16.139.250",5440,10,1022,3599,0,0,10,1022,0,0,26.155864,0.01537699999999731,531703,0
"172.16.133.67",55949,"172.16.139.250",5440,10,1022,3600,0,0,10,1022,0,0,26.211378,0.0054680000000004725,1495245,0
"172.16.133.48",60319,"216.52.242.80",80,6,372,3601,0,0,4,246,2,126,26.216641,6.271240000000002,313,160
"172.16.133.67",62100,"157.56.242.198",443,20,1966,3602,0,0,10,1366,10,600,26.217872,232.39835599999998,47,20
"172.16.133.48",60313,"96.43.146.176",443,6,394,3603,0,0,3,197,3,197,26.218526,0.04332300000000089,36377,36377
"172.16.133.56",61368,"172.16.139.250",5440,12,1142,3604,0,0,12,1142,0,0,26.233893,0.008921000000000845,1024100,0
"172.16.133.42",57030,"172.16.139.250",5440,12,1142,3605,0,0,12,1142,0,0,26.246676,0.012356000000000478,739397,0
"172.16.133.75",50914,"172.16.139.250",5440,12,1142,3606,0,0,12,1142,0,0,26.287239,0.006343000000001098,1440327,0
"172.16.133.41",52758,"172.16.139.250",5440,12,1142,3607,0,0,12,1142,0,0,26.288948,0.015146999999998911,603155,0
"172.16.133.85",52211,"172.16.139.250",5440,12,1142,3608,0,0,12,1142,0,0,26.306476,0.016096000000001,567594,0
"172.16.133.45",61095,"173.194.43.39",443,98,46197,3609,0,0,49,26465,49,19732,26.313534,262.89337,805,600
"157.56.234.118",443,"172.16.133.49",49707,81,35867,3610,0,0,54,34241,27,1626,26.345246,226.18687,1211,57
"172.16.133.43",57728,"172.16.139.250",5440,10,1022,3611,0,0,10,1022,0,0,26.362009,0.005456999999999823,1498259,0
"172.16.133.132",50383,"23.67.242.10",80,22,6948,3612,0,0,12,1892,10,5056,26.368294,9.317642,1624,4341
"172.16.133.132",50384,"23.67.242.10",80,26,12656,3613,0,0,14,1640,12,11016,26.368639,9.320552999999997,1407,9455
"172.16.133.48",60320,"69.174.248.253",80,27,20053,3614,0,0,11,1569,16,18484,26.368777,0.5852339999999998,21447,252671
"172.16.133.132",50385,"23.67.242.10",80,17,7158,3615,0,0,10,1387,7,5771,26.368908,9.320021999999998,1190,4953
"172.16.133.132",50386,"23.67.242.10",80,10,1935,3616,0,0,6,787,4,1148,26.36923,9.319753999999996,675,985
"172.16.133.132",50387,"23.67.242.10",80,16,7217,3617,0,0,9,998,7,6219,26.370089,9.31879,856,5338
"172.16.133.132",50388,"23.67.242.10",80,10,2378,3618,0,0,6,771,4,1607,26.370416,9.318631000000003,661,1379
"172.16.133.13",53003,"172.16.139.250",5440,10,1022,3619,0,0,10,1022,0,0,26.377555,0.005810000000000315,1407228,0
"172.16.133.20",62343,"172.16.139.250",5440,10,1022,3620,0,0,10,1022,0,0,26.426698000000002,0.004907999999996804,"",""
"172.16.133.87",59852,"96.43.146.22",443,11,677,3621,0,0,5,300,6,377,26.439754,129.542938,18,23
"172.16.133.28",65328,"172.16.139.250",5440,12,1142,3622,0,0,12,1142,0,0,26.458325,0.006158000000002772,1483598,0
"172.16.133.48",60321,"67.228.168.216",80,9,1425,3623,0,0,6,1239,3,186,26.465243,2.7800549999999973,3565,535
"172.16.133.87",59851,"96.43.146.22",443,11,677,3624,0,0,5,300,6,377,26.47375,129.50983,18,23
"172.16.128.203",3798,"172.16.133.6",135,4,240,3625,0,0,2,120,2,120,26.475292,0.09355400000000103,10261,10261
"172.16.128.203",3799,"172.16.133.6",1080,4,240,3626,0,0,2,120,2,120,26.476267,0.09265200000000107,10361,10361
"172.16.133.99",56008,"172.16.139.250",5440,12,1142,3627,0,0,12,1142,0,0,26.482884,0.01663600000000187,549170,0
"172.16.133.28",65247,"173.194.43.55",443,16,1080,3628,0,0,7,420,9,660,26.498321,195.091699,17,27
"172.16.133.87",60147,"172.16.139.250",5440,12,1142,3629,0,0,12,1142,0,0,26.506235,0.00616499999999931,1481914,0
"172.16.133.66",53714,"23.67.242.32",80,13,810,3630,0,0,7,420,6,390,26.506518,210.635565,15,14
"172.16.133.153",58808,"141.101.113.194",80,102,83137,3631,0,0,44,3012,58,80125,26.513461,0.20851800000000154,115558,3074075
"172.16.133.24",57520,"207.171.163.132",443,5,300,3632,0,0,3,180,2,120,26.519556,39.405358,36,24
"172.16.133.35",49936,"172.16.139.250",5440,12,1142,3633,0,0,12,1142,0,0,26.519686,0.014247999999998484,641212,0
"172.16.133.116",53223,"172.16.139.250",5440,12,1142,3634,0,0,12,1142,0,0,26.525964,0.011722000000002453,779389,0
"172.16.133.87",59829,"173.194.43.30",443,32,7826,3635,0,0,15,6405,17,1421,26.528849,266.930334,191,42
"172.16.133.116",53224,"172.16.139.250",5440,10,1022,3636,0,0,10,1022,0,0,26.538194,0.0059280000000008215,1379217,0
"172.16.133.24",57519,"207.171.163.132",443,5,300,3637,0,0,3,180,2,120,26.539552,39.387057999999996,36,24
"172.16.133.116",53225,"172.16.139.250",5440,12,1142,3638,0,0,12,1142,0,0,26.544702,0.006024999999997505,1516348,0
"172.16.133.84",58756,"172.16.139.250",5440,10,1022,3639,0,0,10,1022,0,0,26.544963,0.008777999999999508,931419,0
"172.16.133.56",61369,"38.100.166.70",80,13,4675,3640,0,0,6,2339,7,2336,26.546147,0.13435299999999728,139274,139096
"172.16.133.25",63020,"173.194.43.32",80,10,612,3641,0,0,5,300,5,312,26.558393,61.22107000000001,39,40
"172.16.133.48",59749,"199.127.194.80",80,2,120,3642,0,0,1,60,1,60,26.57766,8.499999999855845e-05,"",""
"172.16.133.48",59920,"199.127.194.80",80,2,120,3643,0,0,1,60,1,60,26.578925,7.799999999846818e-05,"",""
"172.16.133.49",55731,"172.16.139.250",5440,10,1022,3644,0,0,10,1022,0,0,26.622999,0.005651000000000295,1446823,0
"172.16.133.87",60148,"204.232.250.57",443,16,4537,3645,0,0,9,3557,7,980,26.630137,9.324907999999997,3051,840
"157.56.242.198",443,"172.16.133.67",62101,11,1078,3646,0,0,6,778,5,300,26.640593,240.69251799999998,25,9
"172.16.133.95",56930,"172.16.139.250",5440,12,1142,3647,0,0,12,1142,0,0,26.659652,0.006364999999998844,1435349,0
"172.16.133.113",55595,"172.16.139.250",135,8,492,3648,0,0,8,492,0,0,26.672494,0.007404000000001076,531604,0
"172.16.133.113",55596,"172.16.139.250",5462,12,816,3649,0,0,12,816,0,0,26.680688,0.5136889999999994,12708,0
"172.16.133.92",57646,"172.16.139.250",5440,12,1142,3650,0,0,12,1142,0,0,26.687612,0.008919999999999817,1024215,0
"172.16.133.153",58596,"64.17.236.31",80,66,42668,3651,0,0,34,2450,32,40218,26.70133,3.6641140000000014,5349,87809
"172.16.133.29",60849,"172.16.139.250",5440,10,1022,3652,0,0,10,1022,0,0,26.704604,0.0051640000000006125,1583268,0
"172.16.133.44",64742,"172.16.139.250",5440,12,1142,3653,0,0,12,1142,0,0,26.71054,0.015335999999997796,595722,0
"172.16.133.207",55899,"172.16.139.250",5440,12,1142,3654,0,0,12,1142,0,0,26.736732,0.004950000000000898,"",""
"172.16.133.83",57055,"172.16.139.250",5440,12,1142,3655,0,0,12,1142,0,0,26.744426,0.01389599999999902,657455,0
"172.16.133.48",60322,"208.47.254.58",80,20,10652,3656,0,0,10,1400,10,9252,26.756071,94.39811499999999,118,784
"172.16.133.48",60323,"208.47.254.89",80,15,5317,3657,0,0,8,889,7,4428,26.756475000000002,94.39661100000001,75,375
"172.16.133.48",60324,"69.174.248.253",80,31,25849,3658,0,0,12,1588,19,24261,26.75714,0.7405979999999985,17153,262069
"172.16.133.48",60325,"69.174.248.253",80,12,3220,3659,0,0,6,1226,6,1994,26.758221,0.36541500000000227,26840,43654
"172.16.133.48",60326,"69.174.248.253",80,10,2035,3660,0,0,5,1158,5,877,26.760405,0.36237400000000264,25564,19361
"172.16.133.93",60625,"172.16.139.250",5440,12,1142,3661,0,0,12,1142,0,0,26.761702,0.01619099999999918,564264,0
"172.16.133.48",60327,"69.174.248.253",80,12,2241,3662,0,0,6,1236,6,1005,26.762389,0.3613500000000016,27364,22249
"172.16.133.48",60328,"93.184.216.139",80,28,16803,3663,0,0,12,1111,16,15692,26.762849,5.6994229999999995,1559,22026
"172.16.133.48",60329,"69.174.248.253",80,43,37337,3664,0,0,16,1788,27,35549,26.76285,0.7672269999999983,18643,370675
"172.16.133.48",60330,"216.151.187.105",80,43,34681,3665,0,0,18,2366,25,32315,26.765333,94.386767,200,2738
"172.16.133.48",60331,"208.47.254.73",80,117,112847,3666,0,0,42,4989,75,107858,26.767257999999998,94.383151,422,9142
"172.16.133.48",60332,"208.47.254.75",80,11,3724,3667,0,0,6,735,5,2989,26.768392,94.38248300000001,62,253
"172.16.133.48",60333,"174.37.29.147",80,8,1627,3668,0,0,5,1152,3,475,26.771669,0.33082100000000025,27857,11486
"172.16.133.48",60334,"208.47.254.58",80,11,3769,3669,0,0,6,795,5,2974,26.777338,94.373538,67,252
"172.16.133.48",60335,"23.59.225.224",80,71,64519,3670,0,0,28,5600,43,58919,26.778499,94.366547,474,4994
"172.16.133.11",55108,"172.16.139.250",5440,10,1022,3671,0,0,10,1022,0,0,26.7785,0.007244000000000028,1128658,0
"172.16.133.48",60336,"23.46.20.239",80,57,51261,3672,0,0,22,3528,35,47733,26.780787,94.367153,299,4046
"172.16.133.55",57545,"172.16.139.250",5440,12,1142,3673,0,0,12,1142,0,0,26.782442,0.015333000000001817,595839,0
"172.16.133.48",60337,"65.55.227.188",80,8,2920,3674,0,0,4,910,4,2010,26.784329,60.56232,120,265
"172.16.133.73",60579,"172.16.139.250",5440,12,1142,3675,0,0,12,1142,0,0,26.807728,0.018128999999998285,503943,0
"172.16.133.35",63712,"132.245.2.22",443,32,4128,3676,0,0,16,3168,16,960,26.809102,270.035954,93,28
"172.16.133.53",54065,"172.16.139.250",5440,12,1142,3677,0,0,12,1142,0,0,26.809153,0.0069720000000010884,1310384,0
"172.16.133.21",53139,"172.16.139.250",5440,10,1022,3678,0,0,10,1022,0,0,26.811811,0.01843600000000123,443480,0
"172.16.133.30",62578,"172.16.139.250",5440,10,1022,3679,0,0,10,1022,0,0,26.814649,0.01955600000000146,418081,0
"172.16.133.25",63400,"172.16.139.250",5440,12,1142,3680,0,0,12,1142,0,0,26.823423,0.016574000000002087,551224,0
"172.16.133.34",50405,"172.16.139.250",5440,12,1142,3681,0,0,12,1142,0,0,26.831315,0.014596000000000942,625924,0
"172.16.133.97",59335,"172.16.139.250",5440,10,1022,3682,0,0,10,1022,0,0,26.84277,0.006820999999998634,1198651,0
"172.16.133.82",64223,"96.43.146.22",443,35,15798,3683,0,0,20,13235,15,2563,26.852677,233.98358499999998,452,87
"172.16.133.48",60338,"93.184.216.139",80,6,372,3684,0,0,4,246,2,126,26.864095,5.482816,358,183
"172.16.133.48",60339,"68.142.108.128",80,16,5764,3685,0,0,7,823,9,4941,26.869655,3.515265999999997,1872,11244
"172.16.133.48",60340,"76.74.248.163",80,12,2343,3686,0,0,6,1174,6,1169,26.870294,75.226917,124,124
"172.16.133.48",60341,"23.60.241.224",80,7,432,3687,0,0,4,246,3,186,26.875705,5.586430000000004,352,266
"172.16.133.36",65074,"54.243.254.190",443,25,7786,3688,0,0,14,4128,11,3658,26.883698,67.399518,489,434
"172.16.133.28",65244,"173.194.75.99",443,17,1140,3689,0,0,8,480,9,660,26.901357,195.027941,19,27
"172.16.133.43",57413,"23.33.81.244",80,5,306,3690,0,0,3,180,2,126,26.909956,33.430217999999996,43,30
"172.16.133.48",60342,"67.69.174.17",80,7,432,3691,0,0,4,246,3,186,26.911293,5.550286999999997,354,268
"172.16.133.48",60343,"67.69.174.17",80,6,372,3692,0,0,4,246,2,126,26.911641,5.550492000000002,354,181
"172.16.133.43",57415,"23.33.81.244",80,5,306,3693,0,0,3,180,2,126,26.91191,33.424769,43,30
"172.16.133.48",60344,"69.174.248.253",80,13,6652,3694,0,0,6,1210,7,5442,26.912416,0.4245999999999981,22797,102534
"172.16.133.48",60345,"67.69.174.9",80,6,372,3695,0,0,4,246,2,126,26.913664,5.546153999999998,354,181
"172.16.133.48",60346,"67.69.174.25",80,6,372,3696,0,0,4,246,2,126,26.917384,5.538116000000002,355,182
"172.16.133.33",57847,"172.16.139.250",5440,12,1142,3697,0,0,12,1142,0,0,26.918684,0.006299999999999528,1450158,0
"172.16.133.43",57412,"23.33.81.244",80,5,306,3698,0,0,3,180,2,126,26.920928,33.421074000000004,43,30
"172.16.133.43",57414,"23.33.81.244",80,5,306,3699,0,0,3,180,2,126,26.926917,33.41427899999999,43,30
"172.16.133.48",60347,"173.192.61.230",80,8,1620,3700,0,0,5,1098,3,522,26.94384,1.836148999999999,4783,2274
"172.16.133.68",60688,"172.16.139.250",5440,10,1022,3701,0,0,10,1022,0,0,26.948538,0.007282000000000011,1122768,0
"172.16.133.35",49681,"96.43.146.178",443,11,677,3702,0,0,5,300,6,377,26.955281,127.38578,18,23
"172.16.133.12",59698,"172.16.139.250",5440,12,1142,3703,0,0,12,1142,0,0,26.962129,0.006173999999997903,1479753,0
"172.16.133.21",54060,"157.56.238.6",443,39,7566,3704,0,0,20,6426,19,1140,26.962889,248.39112300000002,206,36
"172.16.133.35",49684,"96.43.146.178",443,11,677,3705,0,0,5,300,6,377,26.969596,127.37137100000001,18,23
"172.16.133.63",53843,"172.16.139.250",5440,10,1022,3706,0,0,10,1022,0,0,26.971156,0.0052880000000001814,1546142,0
"172.16.133.48",60348,"69.174.248.253",80,12,2247,3707,0,0,6,1198,6,1049,26.971977,0.3531790000000008,27136,23761
"172.16.133.35",49683,"96.43.146.178",443,11,677,3708,0,0,5,300,6,377,26.972542,127.367594,18,23
"172.16.133.35",49682,"96.43.146.178",443,11,677,3709,0,0,5,300,6,377,26.972544,127.368514,18,23
"172.16.133.48",60349,"69.174.248.253",80,12,2444,3710,0,0,6,1219,6,1225,26.972922,0.36176499999999834,26956,27089
"172.16.133.48",60350,"69.174.248.253",80,15,7603,3711,0,0,7,1288,8,6315,26.972924,0.4635379999999998,22229,108987
"172.16.133.66",53815,"172.16.139.250",5440,10,1022,3712,0,0,10,1022,0,0,26.987375,0.0054899999999982185,1489253,0
"172.16.133.82",61286,"172.16.139.250",5440,10,1022,3713,0,0,10,1022,0,0,26.999727,0.005427999999998434,1506263,0
"172.16.133.37",60571,"172.16.139.250",5440,10,1022,3714,0,0,10,1022,0,0,27.014168,0.00519599999999798,1573518,0
"172.16.133.35",49690,"96.43.146.22",443,11,677,3715,0,0,5,300,6,377,27.029594,127.31154000000001,18,23
"172.16.133.48",60351,"23.60.158.239",80,6,372,3716,0,0,4,246,2,126,27.044797,5.398708000000003,364,186
"172.16.133.48",60352,"65.55.227.188",80,6,372,3717,0,0,3,186,3,186,27.047025,5.3007349999999995,280,280
"172.16.133.56",61370,"69.28.187.188",80,29,10232,3718,0,0,13,8634,16,1598,27.057764,4.733992000000001,14590,2700
"172.16.133.56",61371,"69.28.187.188",80,29,10232,3719,0,0,13,8634,16,1598,27.057881,4.731489000000003,14598,2701
"172.16.133.56",61372,"69.28.187.188",80,29,10232,3720,0,0,13,8634,16,1598,27.05798,4.733674999999998,14591,2700
"172.16.133.56",61373,"69.28.187.188",80,29,10232,3721,0,0,13,8634,16,1598,27.058081,4.7333929999999995,14592,2700
"172.16.133.56",61374,"69.28.187.188",80,29,10232,3722,0,0,13,8634,16,1598,27.05818,4.733923999999998,14590,2700
"172.16.133.56",61375,"69.28.187.188",80,24,7812,3723,0,0,11,6552,13,1260,27.058277,4.730905,11079,2130
"172.16.133.48",60353,"69.164.34.128",80,16,5186,3724,0,0,7,1280,9,3906,27.06002,7.298459999999999,1403,4281
"172.16.133.48",60354,"63.251.134.223",80,5,308,3725,0,0,3,186,2,122,27.066049,5.282291999999998,281,184
"172.16.133.48",60355,"63.251.134.223",80,9,1532,3726,0,0,6,1050,3,482,27.066469,94.088316,89,40
"172.16.133.48",60356,"72.233.111.159",80,6,372,3727,0,0,4,246,2,126,27.067707,5.395524999999999,364,186
"172.16.133.28",65251,"173.194.43.9",443,17,1140,3728,0,0,8,480,9,660,27.113296,195.026465,19,27
"172.16.133.25",63401,"23.67.243.89",80,24,11590,3729,0,0,11,1400,13,10190,27.150493,50.354552999999996,222,1618
"172.16.133.39",64248,"174.129.24.9",443,22,5369,3730,0,0,11,4210,11,1159,27.162986,7.646361000000002,4404,1212
"172.16.133.78",58476,"173.194.43.35",443,8,576,3731,0,0,3,180,5,396,27.166678,14.974720999999999,96,211
"172.16.133.78",59067,"172.16.139.250",5440,12,1142,3732,0,0,12,1142,0,0,27.169656,0.0062360000000012406,1465041,0
"172.16.133.113",55597,"173.252.110.27",443,21,5605,3733,0,0,10,3643,11,1962,27.194246,92.89183299999999,313,168
"172.16.133.113",55598,"173.252.110.27",443,15,1256,3734,0,0,7,622,8,634,27.194247,92.943283,53,54
"172.16.133.35",49672,"96.43.146.48",443,11,677,3735,0,0,5,300,6,377,27.199362,127.141773,18,23
"172.16.133.92",57328,"96.43.146.176",443,2,120,3736,0,0,1,60,1,60,27.206022,7.699999999744023e-05,"",""
"172.16.133.92",57647,"96.43.146.176",443,21,4107,3737,0,0,12,2540,9,1567,27.206446,195.502345,103,64
"172.16.133.67",55950,"172.16.139.250",5440,10,1022,3738,0,0,10,1022,0,0,27.225055,0.01608099999999979,508426,0
"172.16.133.48",60357,"69.174.248.253",80,12,2525,3739,0,0,6,1230,6,1295,27.230303,0.3016609999999993,32619,34343
"172.16.133.48",60358,"69.174.248.253",80,12,2438,3740,0,0,6,1222,6,1216,27.234008,0.29915800000000203,32678,32517
"172.16.133.35",49688,"64.56.203.22",443,10,600,3741,0,0,5,300,5,300,27.234346,127.13806899999999,18,18
"172.16.133.56",61376,"172.16.139.250",5440,10,1022,3742,0,0,10,1022,0,0,27.246324,0.014538999999999191,562349,0
"172.16.133.48",60359,"69.174.248.253",80,12,5502,3743,0,0,6,1201,6,4301,27.246793,0.29530300000000054,32536,116517
"172.16.133.42",57031,"172.16.139.250",5440,12,1142,3744,0,0,12,1142,0,0,27.262123,0.008683000000001329,1052170,0
"172.16.133.72",51660,"96.43.146.22",443,35,15485,3745,0,0,20,13060,15,2425,27.263135,264.37818200000004,395,73
"172.16.133.35",49691,"96.43.146.22",443,11,677,3746,0,0,5,300,6,377,27.272057,127.069003,18,23
"172.16.133.132",36189,"216.185.152.144",80,6,380,3747,0,0,3,194,3,186,27.277042,6.228552999999998,249,238
"172.16.133.75",50915,"172.16.139.250",5440,10,1022,3748,0,0,10,1022,0,0,27.3013,0.005445999999999174,1501285,0
"172.16.133.41",52759,"172.16.139.250",5440,10,1022,3749,0,0,10,1022,0,0,27.303079,0.014431999999999334,566518,0
"172.16.133.44",64421,"96.43.146.22",443,37,16506,3750,0,0,21,14042,16,2464,27.308813,234.57687700000002,478,84
"172.16.133.85",52212,"172.16.139.250",5440,10,1022,3751,0,0,10,1022,0,0,27.320382,0.0171910000000004,475597,0
"172.16.133.48",60360,"69.174.248.253",80,24,17228,3752,0,0,10,1484,14,15744,27.340952,0.6014119999999998,19740,209427
"157.56.52.30",40036,"172.16.133.39",49262,59,5284,3753,0,0,32,1944,27,3340,27.350678,269.977301,57,98
"172.16.133.68",60689,"173.194.74.121",80,11,2072,3754,0,0,6,1216,5,856,27.352025,5.611774999999998,1733,1220
"172.16.133.43",57729,"172.16.139.250",5440,12,1142,3755,0,0,12,1142,0,0,27.374732,0.00614699999999857,1486253,0
"172.16.133.13",53004,"172.16.139.250",5440,12,1142,3756,0,0,12,1142,0,0,27.391594,0.006325999999997833,1444198,0
"172.16.133.25",63402,"23.67.243.89",80,15,1834,3757,0,0,8,882,7,952,27.40341,60.11043899999999,117,126
"172.16.133.48",60361,"69.174.248.253",80,18,11487,3758,0,0,8,1400,10,10087,27.414998,0.47792699999999755,23434,168845
"172.16.133.48",60362,"69.174.248.253",80,22,15496,3759,0,0,9,1451,13,14045,27.433623,0.6525259999999982,17789,172192
"172.16.133.48",60363,"69.174.248.253",80,12,2254,3760,0,0,6,1282,6,972,27.438534,0.28973299999999824,35398,26838
"172.16.133.20",62344,"172.16.139.250",5440,12,1142,3761,0,0,12,1142,0,0,27.440996,0.014366000000002543,635945,0
"172.16.133.48",60364,"69.174.248.253",80,12,3080,3762,0,0,6,1260,6,1820,27.442962,0.2941439999999993,34268,49499
"172.16.133.43",57401,"216.52.242.80",80,4,240,3763,0,0,3,180,1,60,27.453893,32.962903,43,14
"172.16.133.28",65329,"172.16.139.250",5440,10,1022,3764,0,0,10,1022,0,0,27.47215,0.005400000000001626,1514074,0
"172.16.133.99",56009,"172.16.139.250",5440,10,1022,3765,0,0,10,1022,0,0,27.498553,0.0052880000000001814,1546142,0
"172.16.133.87",59854,"96.43.146.50",443,11,677,3766,0,0,5,300,6,377,27.498814,128.485635,18,23
"172.16.133.87",59856,"96.43.146.50",443,11,677,3767,0,0,5,300,6,377,27.498833,128.482979,18,23
"172.16.133.87",59857,"96.43.146.50",443,11,677,3768,0,0,5,300,6,377,27.499824,128.48462700000002,18,23
"172.16.133.37",59862,"72.246.23.100",80,21,7530,3769,0,0,10,3776,11,3754,27.503701,246.355717,122,121
"172.16.133.87",60149,"172.16.139.250",5440,10,1022,3770,0,0,10,1022,0,0,27.519886,0.017226000000000852,474631,0
"172.16.133.116",53226,"172.16.139.250",5440,10,1022,3771,0,0,10,1022,0,0,27.535772,0.005317999999999046,1537420,0
"172.16.133.116",53227,"172.16.139.250",5440,10,1022,3772,0,0,10,1022,0,0,27.541878,0.005358999999998559,1525657,0
"172.16.133.35",49937,"172.16.139.250",5440,12,1142,3773,0,0,12,1142,0,0,27.542266,0.03620099999999837,252368,0
"172.16.133.116",53228,"172.16.139.250",5440,10,1022,3774,0,0,10,1022,0,0,27.548586,0.005393999999999011,1515758,0
"172.16.133.84",58757,"172.16.139.250",5440,10,1022,3775,0,0,10,1022,0,0,27.558875,0.015284000000001186,534938,0
"172.16.133.67",51963,"63.84.95.66",80,36,26727,3776,0,0,14,4140,22,22587,27.59773,251.12856799999997,131,719
"172.16.133.43",57419,"216.52.242.80",80,4,240,3777,0,0,3,180,1,60,27.603934,32.813734999999994,43,14
"172.16.133.49",55732,"172.16.139.250",5440,12,1142,3778,0,0,12,1142,0,0,27.636463,0.07342600000000132,124424,0
"157.56.241.150",443,"172.16.133.101",49238,14,1872,3779,0,0,8,1512,6,360,27.638962,240.71585199999998,50,11
"172.16.133.116",52420,"173.194.43.59",80,6,366,3780,0,0,3,180,3,186,27.645689,24.517203,58,60
"172.16.133.87",59858,"64.56.203.22",443,10,600,3781,0,0,5,300,5,300,27.659862,128.37102099999998,18,18
"172.16.133.95",56931,"172.16.139.250",5440,12,1142,3782,0,0,12,1142,0,0,27.673143,0.056719000000001074,161074,0
"172.16.133.92",57648,"172.16.139.250",5440,10,1022,3783,0,0,10,1022,0,0,27.70171,0.03480600000000322,234902,0
"172.16.133.63",53403,"23.33.81.244",80,3,180,3784,0,0,2,120,1,60,27.703542,0.017804000000001707,53920,26960
"172.16.133.63",53416,"23.33.81.244",80,3,180,3785,0,0,2,120,1,60,27.703642,0.018553000000000708,51743,25871
"172.16.133.63",53289,"23.33.81.244",80,3,180,3786,0,0,2,120,1,60,27.7037,0.017595000000000027,54560,27280
"172.16.133.29",60850,"172.16.139.250",5440,10,1022,3787,0,0,10,1022,0,0,27.718559,0.021740000000001203,376080,0
"172.16.133.44",64743,"172.16.139.250",5440,12,1142,3788,0,0,12,1142,0,0,27.724677,0.019971000000001737,457463,0
"172.16.133.68",60690,"205.251.242.39",80,12,3891,3789,0,0,7,1051,5,2840,27.746893,5.217033000000001,1611,4354
"172.16.133.207",55900,"172.16.139.250",5440,12,1142,3790,0,0,12,1142,0,0,27.751062,0.004968999999999113,"",""
"172.16.133.83",57056,"172.16.139.250",5440,12,1142,3791,0,0,12,1142,0,0,27.758516,0.014796000000000475,617464,0
"172.16.133.114",52550,"205.188.2.206",443,20,1200,3792,0,0,10,600,10,600,27.762485,268.62098699999996,17,17
"172.16.133.93",60626,"172.16.139.250",5440,10,1022,3793,0,0,10,1022,0,0,27.776401,0.015193000000000012,538142,0
"172.16.133.11",55109,"172.16.139.250",5440,12,1142,3794,0,0,12,1142,0,0,27.792545,0.0072489999999980625,1260311,0
"172.16.133.55",57546,"172.16.139.250",5440,10,1022,3795,0,0,10,1022,0,0,27.796416,0.006467999999998142,1264069,0
"172.16.133.48",60365,"208.47.254.64",80,12,3937,3796,0,0,7,987,5,2950,27.798859,93.35380799999999,84,252
"172.16.133.73",60580,"172.16.139.250",5440,12,1142,3797,0,0,12,1142,0,0,27.820485,0.0064819999999983224,1409441,0
"172.16.133.53",54066,"172.16.139.250",5440,12,1142,3798,0,0,12,1142,0,0,27.823004,0.016491999999999507,553965,0
"172.16.133.128",57274,"96.43.146.176",443,27,8630,3799,0,0,16,5076,11,3554,27.824221,240.43484800000002,168,118
"172.16.133.21",53140,"172.16.139.250",5440,12,1142,3800,0,0,12,1142,0,0,27.824579,0.018995000000000317,480968,0
"172.16.133.30",62579,"172.16.139.250",5440,12,1142,3801,0,0,12,1142,0,0,27.828066,0.006430999999999187,1420618,0
"172.16.133.29",60671,"96.43.146.22",443,36,15829,3802,0,0,20,13365,16,2464,27.83061,234.09818199999998,456,84
"172.16.133.33",57673,"216.52.242.80",80,7,420,3803,0,0,6,360,1,60,27.835769,174.064794,16,2
"172.16.133.115",53678,"173.194.43.59",80,20,2354,3804,0,0,10,1242,10,1112,27.83652,247.73915399999998,40,35
"172.16.133.25",63403,"172.16.139.250",5440,10,1022,3805,0,0,10,1022,0,0,27.837463,0.00903600000000182,904825,0
"172.16.133.34",50406,"172.16.139.250",5440,12,1142,3806,0,0,12,1142,0,0,27.845195,0.014793000000000944,617589,0
"172.16.133.97",59336,"172.16.139.250",5440,12,1142,3807,0,0,12,1142,0,0,27.857916,0.006650000000000489,1373834,0
"172.16.133.48",60366,"69.174.248.253",80,12,2126,3808,0,0,6,1391,6,735,27.875056999999998,2.3105350000000016,4816,2544
"172.16.133.23",54928,"96.43.146.48",443,32,17522,3809,0,0,13,3206,19,14316,27.902766,252.037105,101,454
"172.16.133.78",58400,"8.20.172.30",80,8,480,3810,0,0,4,240,4,240,27.909659,77.152537,24,24
"172.16.133.66",53536,"173.194.43.60",80,8,492,3811,0,0,4,240,4,252,27.916535,69.208006,27,29
"172.16.133.33",57848,"172.16.139.250",5440,10,1022,3812,0,0,10,1022,0,0,27.931614,0.014749999999999375,554305,0
"172.16.133.126",61334,"173.194.75.105",443,41,9251,3813,0,0,19,4941,22,4310,27.936494,254.787659,155,135
"172.16.133.48",60367,"23.33.111.139",80,70,63835,3814,0,0,26,1937,44,61898,27.944959,93.210623,166,5312
"172.16.133.48",60368,"69.174.248.253",80,12,3349,3815,0,0,6,1365,6,1984,27.947954,0.34289599999999965,31846,46288
"172.16.133.48",60369,"67.69.174.17",80,6,372,3816,0,0,4,246,2,126,27.94868,5.412617999999998,363,186
"172.16.133.68",60691,"172.16.139.250",5440,10,1022,3817,0,0,10,1022,0,0,27.962466,0.014798000000002531,552507,0
"172.16.133.33",57674,"173.194.43.60",80,10,618,3818,0,0,5,300,5,318,27.96273,113.86705,21,22
"172.16.133.48",60370,"69.174.248.253",80,19,12795,3819,0,0,8,1487,11,11308,27.964892,0.5295230000000011,22465,170840
"172.16.133.12",59699,"172.16.139.250",5440,10,1022,3820,0,0,10,1022,0,0,27.977164,0.0060040000000007865,1361758,0
"172.16.133.63",53844,"172.16.139.250",5440,12,1142,3821,0,0,12,1142,0,0,27.98551,0.006444999999999368,1417532,0
"172.16.133.66",53816,"172.16.139.250",5440,10,1022,3822,0,0,10,1022,0,0,28.000368,0.005954999999996602,1372963,0
"157.56.232.214",443,"172.16.133.51",53000,14,1173,3823,0,0,7,753,7,420,28.010692,240.54099100000002,25,13
"172.16.133.26",53044,"54.235.187.196",443,50,24570,3824,0,0,30,19540,20,5030,28.010771,270.79127200000005,577,148
"172.16.133.82",61288,"172.16.139.250",5440,12,1142,3825,0,0,12,1142,0,0,28.012864,0.016186000000001144,564438,0
"172.16.133.37",60572,"172.16.139.250",5440,10,1022,3826,0,0,10,1022,0,0,28.027801,0.005476999999999066,1492788,0
"172.16.133.120",53172,"96.43.146.22",443,40,20402,3827,0,0,25,17505,15,2897,28.074907,255.51757700000002,548,90
"172.16.133.33",57688,"173.194.43.58",80,10,618,3828,0,0,5,300,5,318,28.142802,113.691826,21,22
"172.16.133.48",60371,"173.252.110.27",80,33,13861,3829,0,0,14,2588,19,11273,28.143378,93.016727,222,969
"172.16.133.48",60372,"173.194.43.34",443,9,1037,3830,0,0,5,664,4,373,28.145076,0.04505200000000187,117908,66234
"172.16.133.48",60373,"173.252.110.27",80,7,432,3831,0,0,4,246,3,186,28.14882,5.195987000000002,378,286
"172.16.133.48",60374,"69.174.248.253",80,175,173440,3832,0,0,60,4570,115,168870,28.149509,1.2212470000000017,29936,1106213
"172.16.133.73",60326,"216.52.242.80",80,6,360,3833,0,0,5,300,1,60,28.14987,120.520588,19,3
"172.16.133.78",59068,"172.16.139.250",5440,10,1022,3834,0,0,10,1022,0,0,28.183668,0.015544999999999476,525956,0
"172.16.133.33",57303,"173.194.43.45",80,9,552,3835,0,0,5,300,4,252,28.184753,113.649876,21,17
"172.16.133.132",57686,"96.43.146.176",443,32,13484,3836,0,0,17,1740,15,11744,28.211184,0.27048300000000225,51463,347349
"172.16.133.78",58489,"173.194.75.104",80,6,366,3837,0,0,3,180,3,186,28.213732,16.870157,85,88
"172.16.133.67",55951,"172.16.139.250",5440,10,1022,3838,0,0,10,1022,0,0,28.238672,0.011275999999998731,725079,0
"172.16.133.116",53229,"172.16.139.250",5440,12,1142,3839,0,0,12,1142,0,0,28.239048,0.007585999999999871,1204323,0
"172.16.133.43",57394,"96.43.146.176",443,7,437,3840,0,0,3,180,4,257,28.243941,38.916794,37,52
"172.16.133.48",60375,"208.47.254.67",80,6,372,3841,0,0,4,246,2,126,28.2478,6.0654959999999996,324,166
"172.16.133.12",59151,"23.32.177.224",80,3,180,3842,0,0,2,120,1,60,28.248055,0.02817399999999992,34073,17036
"172.16.133.12",59147,"23.32.177.224",80,3,180,3843,0,0,2,120,1,60,28.248212,0.027205000000002144,35287,17643
"172.16.133.48",60376,"23.33.98.110",443,16,3258,3844,0,0,9,954,7,2304,28.24898,6.063184000000003,1258,3039
"172.16.133.41",51189,"172.16.139.250",5500,166,66632,3845,0,0,166,66632,0,0,28.26037,241.000148,2211,0
"172.16.133.56",61377,"172.16.139.250",5440,10,1022,3846,0,0,10,1022,0,0,28.260796,0.054880000000000706,148979,0
"172.16.133.42",57032,"172.16.139.250",5440,12,1142,3847,0,0,12,1142,0,0,28.270938,0.05156999999999812,177157,0
"172.16.133.48",60377,"74.125.226.7",443,74,49274,3848,0,0,31,5051,43,44223,28.296669,92.86393000000001,435,3809
"50.16.211.32",8080,"172.16.133.18",49388,78,19496,3849,0,0,38,5008,40,14488,28.307231,270.100805,148,429
"172.16.133.75",50916,"172.16.139.250",5440,10,1022,3850,0,0,10,1022,0,0,28.315454,0.009534999999999627,857472,0
"172.16.133.41",52760,"172.16.139.250",5440,10,1022,3851,0,0,10,1022,0,0,28.317178,0.019201000000002466,425811,0
"172.16.133.85",52213,"172.16.139.250",5440,10,1022,3852,0,0,10,1022,0,0,28.33511,0.006161999999999779,1326841,0
"172.16.133.48",60378,"131.253.14.73",80,10,5600,3853,0,0,5,1361,5,4239,28.357348,5.411093000000001,2012,6267
"172.16.133.48",60379,"69.174.248.253",80,10,2657,3854,0,0,5,1293,5,1364,28.35828,0.31797699999999907,32530,34316
"172.16.133.48",60380,"69.174.248.253",80,16,9356,3855,0,0,7,1417,9,7939,28.358642,0.4218390000000021,26872,150559
"172.16.133.48",60381,"69.174.248.253",80,21,14492,3856,0,0,9,1537,12,12955,28.359023,0.5419309999999982,22689,191242
"172.16.133.48",60382,"69.174.248.253",80,10,2228,3857,0,0,5,1302,5,926,28.359024,0.3327379999999991,31303,22263
"172.16.133.22",49181,"64.94.18.142",80,27,2178,3858,0,0,18,1359,9,819,28.362337,243.79266099999998,44,26
"157.56.242.198",443,"172.16.133.24",55888,10,795,3859,0,0,5,495,5,300,28.363409,240.55381599999998,16,9
"172.16.133.48",60383,"23.59.228.136",80,60,48093,3860,0,0,26,7345,34,40748,28.363809,92.787587,633,3513
"50.16.211.32",8080,"172.16.133.27",60889,71,16774,3861,0,0,35,4550,36,12224,28.370801,270.05895499999997,134,362
"50.16.211.32",8080,"172.16.133.39",49189,71,20810,3862,0,0,41,4804,30,16006,28.382752,271.17018,141,472
"172.16.133.48",60384,"131.253.14.73",80,5,308,3863,0,0,3,186,2,122,28.387782,5.941604999999996,250,164
"172.16.133.43",57730,"172.16.139.250",5440,10,1022,3864,0,0,10,1022,0,0,28.388841,0.014576999999999174,560883,0
"172.16.133.48",60385,"69.174.248.253",80,12,3139,3865,0,0,6,1360,6,1779,28.391114,0.32310099999999764,33673,44048
"172.16.133.163",1321,"172.16.139.250",5500,20,1740,3866,0,0,20,1740,0,0,28.392535,240.19194899999997,57,0
"172.16.133.13",53005,"172.16.139.250",5440,12,1142,3867,0,0,12,1142,0,0,28.405922,0.006405000000000882,1426385,0
"172.16.133.48",60386,"67.69.174.115",80,65,55114,3868,0,0,25,1898,40,53216,28.415786,92.748985,163,4590
"172.16.133.132",42622,"38.70.64.178",80,35,21315,3869,0,0,19,1447,16,19868,28.418184,0.4027840000000005,28739,394613
"157.56.234.118",443,"172.16.133.103",62689,21,5170,3870,0,0,13,4690,8,480,28.438501,248.600022,150,15
"172.16.133.78",58541,"173.194.43.59",80,6,366,3871,0,0,3,180,3,186,28.443708,16.614981,86,89
"172.16.133.20",62345,"172.16.139.250",5440,10,1022,3872,0,0,10,1022,0,0,28.454621,0.016131999999998925,506818,0
"172.16.133.44",63813,"96.43.146.48",443,7,437,3873,0,0,3,180,4,257,28.474836,29.725643,48,69
"172.16.133.103",63375,"63.116.244.131",80,3,180,3874,0,0,2,120,1,60,28.483217,0.026652999999999594,36018,18009
"172.16.133.28",65330,"172.16.139.250",5440,10,1022,3875,0,0,10,1022,0,0,28.486266,0.014898999999999774,548761,0
"172.16.133.132",60534,"23.33.95.139",80,80,65106,3876,0,0,35,2630,45,62476,28.492285,7.193332000000002,2924,69482
"172.16.133.73",60581,"173.194.43.60",80,42,26892,3877,0,0,16,3807,26,23085,28.502009,266.44592,114,693
"172.16.133.73",60582,"173.194.43.60",80,22,4301,3878,0,0,11,1378,11,2923,28.509438,250.084652,44,93
"172.16.133.99",56010,"172.16.139.250",5440,10,1022,3879,0,0,10,1022,0,0,28.511155,0.01470199999999977,556114,0
"172.16.133.87",60150,"172.16.139.250",5440,12,1142,3880,0,0,12,1142,0,0,28.533686,0.009146000000001209,998906,0
"172.16.133.35",49938,"172.16.139.250",5440,12,1142,3881,0,0,12,1142,0,0,28.547893,0.012653000000000247,722042,0
"172.16.133.116",53230,"172.16.139.250",5440,10,1022,3882,0,0,10,1022,0,0,28.552767,0.016185000000000116,505159,0
"172.16.133.116",53231,"172.16.139.250",5440,10,1022,3883,0,0,10,1022,0,0,28.570845,0.005348000000001463,1528795,0
"172.16.133.84",58758,"172.16.139.250",5440,12,1142,3884,0,0,12,1142,0,0,28.572685,0.016313000000000244,560044,0
"172.16.133.48",60387,"69.174.248.253",80,10,2029,3885,0,0,5,1292,5,737,28.574421,0.3270300000000006,31605,18028
"172.16.133.116",53232,"172.16.139.250",5440,10,1022,3886,0,0,10,1022,0,0,28.577154,0.006173000000000428,1324477,0
"172.16.133.48",60388,"69.174.248.253",80,10,2022,3887,0,0,5,1299,5,723,28.587012,0.31557699999999755,32930,18328
"172.16.133.103",63432,"184.73.225.104",443,22,7388,3888,0,0,11,2094,11,5294,28.589402,5.389871999999997,3108,7857
"172.16.133.48",60389,"208.47.254.66",80,6,372,3889,0,0,4,246,2,126,28.592539,5.720759000000005,344,176
"172.16.133.48",60390,"74.125.226.219",80,16,6431,3890,0,0,9,2643,7,3788,28.606529,92.541707,228,327
"172.16.133.48",60391,"69.174.248.253",80,10,1999,3891,0,0,5,1297,5,702,28.616814,0.295971999999999,35057,18974
"172.16.133.48",60392,"23.60.225.244",80,49,41389,3892,0,0,19,1584,30,39805,28.635588,92.527466,136,3441
"172.16.133.49",55733,"172.16.139.250",5440,10,1022,3893,0,0,10,1022,0,0,28.651207,0.08356900000000067,97835,0
"172.16.133.26",49393,"74.125.133.125",5222,14,907,3894,0,0,7,420,7,487,28.663202,257.239504,13,15
"172.16.133.48",60393,"173.194.43.33",443,45,18022,3895,0,0,22,3499,23,14523,28.668576,92.485609,302,1256
"172.16.133.48",60394,"204.145.89.40",80,18,9399,3896,0,0,9,2102,9,7297,28.681073,0.5993669999999973,28056,97396
"172.16.133.48",60395,"69.174.248.253",80,11,1996,3897,0,0,6,1361,5,635,28.685339,0.6383950000000027,17055,7957
"172.16.133.95",56932,"172.16.139.250",5440,12,1142,3898,0,0,12,1142,0,0,28.686187,0.052365999999999246,174464,0
"172.16.133.48",60396,"208.47.254.24",80,29,17819,3899,0,0,13,1644,16,16175,28.710421,92.44377,142,1399
"172.16.133.48",60397,"74.125.226.60",80,7,432,3900,0,0,4,246,3,186,28.711259,5.619475999999999,350,264
"172.16.133.92",57649,"172.16.139.250",5440,12,1142,3901,0,0,12,1142,0,0,28.715892,0.03071599999999819,297434,0
"172.16.133.48",60398,"74.125.226.205",80,30,19803,3902,0,0,14,2205,16,17598,28.722612,92.428529,190,1523
"65.55.71.205",443,"172.16.133.63",64115,6,378,3903,0,0,3,180,3,198,28.7245,240.209192,5,6
"172.16.133.29",60851,"172.16.139.250",5440,10,1022,3904,0,0,10,1022,0,0,28.7325,0.02248599999999712,363604,0
"172.16.133.44",64744,"172.16.139.250",5440,12,1142,3905,0,0,12,1142,0,0,28.739288,0.020236000000000587,451472,0
"172.16.133.132",53189,"38.70.64.178",80,72,50583,3906,0,0,36,2538,36,48045,28.746672,1.0650300000000001,19064,360891
"172.16.133.207",55901,"172.16.139.250",5440,12,1142,3907,0,0,12,1142,0,0,28.764484,0.004823999999999273,"",""
"172.16.133.83",57057,"172.16.139.250",5440,12,1142,3908,0,0,12,1142,0,0,28.77252,0.004684999999998496,"",""
"172.16.133.93",60627,"172.16.139.250",5440,12,1142,3909,0,0,12,1142,0,0,28.790573,0.005023000000001332,1818833,0
"172.16.133.35",49473,"23.33.81.244",80,3,180,3910,0,0,2,120,1,60,28.790575,0.02182900000000032,43978,21989
"172.16.133.35",49474,"23.33.81.244",80,3,180,3911,0,0,2,120,1,60,28.791278,0.021714000000002898,44211,22105
"172.16.133.35",49386,"23.33.81.244",80,3,180,3912,0,0,2,120,1,60,28.791368,0.02172400000000252,44190,22095
"172.16.133.24",55820,"157.56.242.198",443,25,3515,3913,0,0,13,2795,12,720,28.799549,247.253035,90,23
"172.16.133.26",49325,"132.245.1.150",443,27,4138,3914,0,0,14,3358,13,780,28.800978,250.54673200000002,107,24
"172.16.133.48",60399,"69.174.248.253",80,13,5123,3915,0,0,7,2420,6,2703,28.803932,0.6272950000000002,30862,34471
"172.16.133.48",60400,"69.174.248.253",80,11,2992,3916,0,0,6,2362,5,630,28.804355,0.6225099999999983,30354,8096
"172.16.133.48",60401,"69.174.248.253",80,13,4432,3917,0,0,7,2410,6,2022,28.804356,0.6258370000000006,30806,25846
"172.16.133.11",55110,"172.16.139.250",5440,12,1142,3918,0,0,12,1142,0,0,28.806545,0.007899000000001877,1156602,0
"172.16.133.55",57547,"172.16.139.250",5440,10,1022,3919,0,0,10,1022,0,0,28.81064,0.006845999999999464,1194274,0
"172.16.133.58",53925,"157.56.241.150",443,59,12624,3920,0,0,30,10884,29,1740,28.812401,243.583402,357,57
"172.16.133.48",60402,"69.174.248.253",80,11,3645,3921,0,0,6,2346,5,1299,28.814126,0.6220529999999975,30171,16705
"172.16.133.24",52112,"173.194.76.125",5222,14,907,3922,0,0,7,420,7,487,28.819618,257.09887000000003,13,15
"172.16.133.53",54067,"172.16.139.250",5440,10,1022,3923,0,0,10,1022,0,0,28.837350999999998,0.005691000000002333,1436654,0
"172.16.133.21",53141,"172.16.139.250",5440,10,1022,3924,0,0,10,1022,0,0,28.838555,0.01613800000000154,506630,0
"172.16.133.73",60583,"172.16.139.250",5440,12,1142,3925,0,0,12,1142,0,0,28.838605,0.008976999999998014,1017711,0
"132.245.2.22",443,"172.16.133.36",63644,60,18913,3926,0,0,30,10425,30,8488,28.83895,244.61915299999998,340,277
"172.16.133.40",50084,"96.43.146.48",443,90,59945,3927,0,0,41,23211,49,36734,28.840431,262.35382999999996,707,1120
"172.16.133.40",50085,"96.43.146.48",443,18,1471,3928,0,0,10,862,8,609,28.840688,270.585436,25,18
"157.56.245.198",443,"172.16.133.40",62989,31,13423,3929,0,0,19,12697,12,726,28.840752,270.75402199999996,375,21
"172.16.133.30",62580,"172.16.139.250",5440,10,1022,3930,0,0,10,1022,0,0,28.842346,0.008362000000001757,977756,0
"172.16.133.48",60403,"74.125.226.13",80,8,504,3931,0,0,5,312,3,192,28.842604,5.487595999999996,454,279
"172.16.133.48",60404,"64.94.43.110",80,8,685,3932,0,0,5,312,3,373,28.850182,5.480555999999996,455,544
"172.16.133.25",63404,"172.16.139.250",5440,10,1022,3933,0,0,10,1022,0,0,28.851222,0.0071989999999999554,1135713,0
"172.16.133.48",60405,"72.21.91.19",80,13,1877,3934,0,0,7,897,6,980,28.852968,5.507268,1303,1423
"172.16.133.48",60406,"173.192.61.226",80,10,4916,3935,0,0,6,2820,4,2096,28.855339,0.5673229999999982,39765,29556
"172.16.133.34",50407,"172.16.139.250",5440,10,1022,3936,0,0,10,1022,0,0,28.860011,0.0062600000000010425,1306070,0
"172.16.133.73",60584,"173.194.41.111",80,23,4859,3937,0,0,14,3662,9,1197,28.860061,268.991794,108,35
"172.16.133.97",59337,"172.16.139.250",5440,10,1022,3938,0,0,10,1022,0,0,28.870958,0.01544099999999915,529499,0
"172.16.133.48",60407,"67.69.174.137",80,6,372,3939,0,0,4,246,2,126,28.872353,5.553399000000002,354,181
"172.16.133.73",60585,"173.194.43.60",80,8,504,3940,0,0,5,312,3,192,28.882549,19.727422999999998,126,77
"172.16.133.48",60408,"173.192.61.226",80,9,2450,3941,0,0,5,1182,4,1268,28.882597,0.9902270000000009,9549,10244
"172.16.133.73",60586,"173.194.43.60",80,8,504,3942,0,0,5,312,3,192,28.882762,19.728868,126,77
"172.16.133.73",60587,"173.194.41.111",80,6,372,3943,0,0,4,246,2,126,28.882911,19.796965,99,50
"204.93.223.146",443,"172.16.133.24",57629,1,60,3944,0,0,1,60,0,0,28.882913,0,"",""
"172.16.133.73",60588,"173.194.41.111",80,6,372,3945,0,0,4,246,2,126,28.88302,19.796855000000004,99,50
"172.16.133.73",60589,"173.194.43.36",80,8,504,3946,0,0,5,312,3,192,28.883159,19.728419000000002,126,77
"172.16.133.35",49523,"216.52.242.80",80,5,300,3947,0,0,4,240,1,60,28.883374,80.059719,23,5
"172.16.133.73",60590,"173.194.43.42",443,30,3174,3948,0,0,16,1997,14,1177,28.88354,243.562262,65,38
"172.16.133.48",60409,"69.174.248.253",80,7,438,3949,0,0,5,312,2,126,28.908265,8.491290999999997,293,118
"172.16.133.48",60410,"74.125.226.47",443,21,2093,3950,0,0,13,1328,8,765,28.928371,92.233993,115,66
"172.16.133.103",63433,"157.56.236.89",443,5,314,3951,0,0,3,194,2,120,28.938868,3.718639000000003,417,258
"172.16.133.25",63027,"23.32.182.35",80,4,240,3952,0,0,3,180,1,60,28.94444,38.841594,37,12
"172.16.133.33",57849,"172.16.139.250",5440,10,1022,3953,0,0,10,1022,0,0,28.945729,0.005465000000000941,1496065,0
"172.16.133.21",60004,"96.43.146.176",443,26,8115,3954,0,0,15,5010,11,3105,28.963204,240.37130500000004,166,103
"172.16.133.45",61324,"74.125.226.40",80,21,2574,3955,0,0,11,1804,10,770,28.96942,241.86328499999996,59,25
"172.16.133.68",60692,"172.16.139.250",5440,10,1022,3956,0,0,10,1022,0,0,28.977561,0.017765999999998172,460204,0
"172.16.133.12",59700,"172.16.139.250",5440,12,1142,3957,0,0,12,1142,0,0,28.989845,0.008752000000001203,1043875,0
"172.16.133.48",60411,"23.60.244.136",80,8,504,3958,0,0,5,312,3,192,28.997068,5.327460000000002,468,288
"172.16.133.63",53845,"172.16.139.250",5440,10,1022,3959,0,0,10,1022,0,0,28.999301,0.0057189999999991414,1429620,0
"172.16.133.48",60412,"208.44.23.59",80,13,3071,3960,0,0,8,2281,5,790,29.010839,92.20764799999999,197,68
"172.16.133.48",60413,"208.44.23.59",80,11,2519,3961,0,0,7,2031,4,488,29.014302,92.206648,176,42
"172.16.133.66",53817,"172.16.139.250",5440,10,1022,3962,0,0,10,1022,0,0,29.015408,0.005478999999997569,1492243,0
"172.16.133.73",60591,"173.194.43.34",443,20,4644,3963,0,0,8,958,12,3686,29.026176,244.830724,31,120
"172.16.133.82",61289,"172.16.139.250",5440,10,1022,3964,0,0,10,1022,0,0,29.027601,0.036151000000000266,226162,0
"172.16.133.37",60573,"172.16.139.250",5440,12,1142,3965,0,0,12,1142,0,0,29.04362,0.02464300000000108,370734,0
"172.16.133.44",64415,"96.43.146.22",443,6,377,3966,0,0,3,180,3,197,29.048914,39.133618,36,40
"172.16.133.44",64417,"96.43.146.22",443,6,377,3967,0,0,3,180,3,197,29.054861,39.128567000000004,36,40
"172.16.133.44",64418,"96.43.146.22",443,6,377,3968,0,0,3,180,3,197,29.058856,39.125490000000006,36,40
"172.16.133.44",64419,"96.43.146.22",443,6,377,3969,0,0,3,180,3,197,29.058902,39.12452499999999,36,40
"172.16.133.44",64416,"96.43.146.22",443,6,377,3970,0,0,3,180,3,197,29.05992,39.124371999999994,36,40
"172.16.133.23",54989,"96.43.146.176",443,5,300,3971,0,0,3,180,2,120,29.101462,0.3415379999999999,4216,2810
"172.16.133.23",55042,"96.43.146.176",443,51,17226,3972,0,0,29,7708,22,9518,29.101817,114.885732,536,662
"172.16.133.48",60414,"208.44.23.59",80,8,498,3973,0,0,5,312,3,186,29.110196,8.300476,300,179
"172.16.133.55",50092,"172.16.139.250",5500,20,1740,3974,0,0,20,1740,0,0,29.111781,240.20972799999998,57,0
"172.16.133.73",60592,"173.194.43.34",443,7,432,3975,0,0,4,246,3,186,29.133202,19.478059,101,76
"172.16.133.120",53160,"96.43.146.22",443,40,20399,3976,0,0,25,17500,15,2899,29.177036,255.551531,547,90
"172.16.133.78",59069,"172.16.139.250",5440,10,1022,3977,0,0,10,1022,0,0,29.19781,0.006170999999998372,1324906,0
"172.16.133.44",64420,"96.43.146.22",443,7,437,3978,0,0,3,180,4,257,29.2289,38.955393,36,52
"96.43.146.22",443,"172.16.133.47",54529,25,13075,3979,0,0,10,2110,15,10965,29.241885,224.003218,75,391
"172.16.133.67",55952,"172.16.139.250",5440,12,1142,3980,0,0,12,1142,0,0,29.252582,0.006226999999999094,1467159,0
"172.16.133.48",60415,"69.174.248.253",80,10,2848,3981,0,0,5,1294,5,1554,29.262195,0.31353300000000317,33017,39651
"172.16.133.48",60416,"69.174.248.253",80,10,2441,3982,0,0,5,1302,5,1139,29.267573,0.31832999999999956,32720,28624
"172.16.133.56",61378,"172.16.139.250",5440,10,1022,3983,0,0,10,1022,0,0,29.27517,0.005013999999999186,1630634,0
"172.16.133.42",57033,"172.16.139.250",5440,12,1142,3984,0,0,12,1142,0,0,29.287994,0.009943999999997288,918744,0
"172.16.133.73",60593,"173.194.43.37",443,86,25461,3985,0,0,44,16435,42,9026,29.302357,265.146305,495,272
"172.16.133.48",60417,"74.125.226.13",80,14,6971,3986,0,0,7,850,7,6121,29.317135,91.844875,74,533
"172.16.133.48",60418,"74.125.226.47",443,47,26090,3987,0,0,21,2350,26,23740,29.324266,91.844018,204,2067
"172.16.133.75",50917,"172.16.139.250",5440,12,1142,3988,0,0,12,1142,0,0,29.329195,0.011802000000002977,774106,0
"172.16.133.41",52761,"172.16.139.250",5440,12,1142,3989,0,0,12,1142,0,0,29.331198,0.013344000000000023,684652,0
"172.16.133.95",49246,"172.16.139.250",5500,20,1740,3990,0,0,20,1740,0,0,29.336669,240.20244399999999,57,0
"132.245.1.150",443,"172.16.133.39",51034,10,795,3991,0,0,5,495,5,300,29.340942,240.66009000000003,16,9
"172.16.133.85",52214,"172.16.139.250",5440,10,1022,3992,0,0,10,1022,0,0,29.34956,0.006015000000001436,1359268,0
"96.43.146.22",443,"172.16.133.87",60085,16,5078,3993,0,0,10,2362,6,2716,29.351102,24.468453999999998,772,888
"172.16.133.44",64414,"96.43.146.176",443,22,5876,3994,0,0,12,4660,10,1216,29.368909,270.515219,137,35
"172.16.133.43",57731,"172.16.139.250",5440,12,1142,3995,0,0,12,1142,0,0,29.403658,0.015505999999998465,589191,0
"172.16.133.13",53006,"172.16.139.250",5440,10,1022,3996,0,0,10,1022,0,0,29.419673,0.0054210000000018965,1508208,0
"172.16.133.48",60419,"67.69.196.153",80,7,432,3997,0,0,4,246,3,186,29.462096,5.868027999999999,335,253
"172.16.133.20",62346,"172.16.139.250",5440,12,1142,3998,0,0,12,1142,0,0,29.468487,0.004982000000001818,"",""
"172.16.133.207",55277,"96.43.146.48",443,13,797,3999,0,0,6,360,7,437,29.483934,169.47320299999998,16,20
"172.16.133.28",65331,"172.16.139.250",5440,12,1142,4000,0,0,12,1142,0,0,29.5005,0.016122000000002856,566679,0
"172.16.133.48",60420,"69.174.248.254",80,12,3507,4001,0,0,6,1359,6,2148,29.503256,0.300732,36151,57140
"172.16.133.48",60421,"69.174.248.254",80,12,3455,4002,0,0,6,1361,6,2094,29.503651,0.2906029999999973,37466,57645
"172.16.133.48",60422,"69.174.248.254",80,12,3514,4003,0,0,6,1362,6,2152,29.503653,0.29829600000000056,36527,57714
"172.16.133.48",60423,"69.174.248.254",80,15,8960,4004,0,0,7,1401,8,7559,29.503654,0.40168099999999995,27902,150547
"172.16.133.48",60424,"69.174.248.254",80,13,5736,4005,0,0,6,1344,7,4392,29.503656,0.39570099999999897,27172,88794
"172.16.133.48",60425,"69.174.248.254",80,12,4155,4006,0,0,6,1343,6,2812,29.504112,0.2997709999999998,35840,75043
"172.16.133.132",52446,"173.194.43.32",80,33,18975,4007,0,0,18,2237,15,16738,29.514373,6.171298,2899,21697
"172.16.133.76",62358,"173.194.43.33",443,49,14871,4008,0,0,26,8267,23,6604,29.519384,240.36641500000002,275,219
"172.16.133.132",37044,"204.246.169.230",80,16,6333,4009,0,0,9,924,7,5409,29.524653999999998,6.161222000000002,1199,7023
"172.16.133.99",56011,"172.16.139.250",5440,10,1022,4010,0,0,10,1022,0,0,29.526513,0.00632399999999933,1292852,0
"172.16.133.35",49670,"96.43.146.48",443,14,857,4011,0,0,7,420,7,437,29.540255,214.759886,15,16
"172.16.133.87",60151,"172.16.139.250",5440,10,1022,4012,0,0,10,1022,0,0,29.54785,0.07743899999999826,105579,0
"172.16.133.35",49939,"172.16.139.250",5440,12,1142,4013,0,0,12,1142,0,0,29.562029,0.07672700000000177,119071,0
"172.16.133.116",53233,"172.16.139.250",5440,12,1142,4014,0,0,12,1142,0,0,29.564804,0.06509400000000198,140350,0
"172.16.133.48",60426,"74.125.226.192",80,30,19918,4015,0,0,14,3283,16,16635,29.566687,91.57323,286,1453
"172.16.133.48",60427,"74.125.226.192",80,6,372,4016,0,0,4,246,2,126,29.571454,5.732749000000002,343,175
"172.16.133.48",60428,"72.233.111.159",80,11,2037,4017,0,0,6,1446,5,591,29.583189,75.171702,153,62
"172.16.133.84",58759,"172.16.139.250",5440,12,1142,4018,0,0,12,1142,0,0,29.585772,0.03552400000000233,257178,0
"172.16.133.95",56933,"199.59.148.247",80,11,1722,4019,0,0,6,963,5,759,29.602225,36.25340799999999,212,167
"172.16.133.116",53234,"172.16.139.250",5440,12,1142,4020,0,0,12,1142,0,0,29.631185,0.011625000000002217,785892,0
"172.16.133.116",53235,"172.16.139.250",5440,12,1142,4021,0,0,12,1142,0,0,29.643225,0.015727999999999298,580874,0
"65.55.71.123",443,"172.16.133.26",53924,8,504,4022,0,0,4,240,4,264,29.649572,241.16307500000002,7,8
"172.16.133.49",55734,"172.16.139.250",5440,10,1022,4023,0,0,10,1022,0,0,29.66475,0.005579999999998364,1465232,0
"172.16.133.95",56934,"172.16.139.250",5440,12,1142,4024,0,0,12,1142,0,0,29.70035,0.015395999999999077,593400,0
"172.16.133.48",60429,"69.174.248.254",80,16,9029,4025,0,0,8,1466,8,7563,29.703447,0.7040919999999993,16656,85931
"172.16.133.48",60430,"69.174.248.254",80,19,11672,4026,0,0,9,1545,10,10127,29.704193,0.7036070000000016,17566,115143
"172.16.133.48",60431,"69.174.248.254",80,20,13108,4027,0,0,9,1539,11,11569,29.707106,0.7290850000000013,16886,126942
"172.16.133.48",60432,"69.174.248.254",80,43,35797,4028,0,0,17,1996,26,33801,29.707108,0.954030999999997,16737,283437
"172.16.133.92",57650,"172.16.139.250",5440,10,1022,4029,0,0,10,1022,0,0,29.729715,0.005566000000001736,1468918,0
"172.16.133.29",60852,"172.16.139.250",5440,10,1022,4030,0,0,10,1022,0,0,29.746916,0.005295000000000272,1544098,0
"172.16.133.44",64745,"172.16.139.250",5440,12,1142,4031,0,0,12,1142,0,0,29.752883,0.015536999999998358,588015,0
"172.16.133.87",60152,"96.43.146.22",443,17,1417,4032,0,0,9,808,8,609,29.764956,225.436927,28,21
"172.16.133.37",49399,"172.16.139.250",5447,10,1400,4033,0,0,10,1400,0,0,29.777212,211.549104,52,0
"172.16.133.207",55902,"172.16.139.250",5440,12,1142,4034,0,0,12,1142,0,0,29.777836,0.017309000000000907,527817,0
"172.16.133.83",57058,"172.16.139.250",5440,12,1142,4035,0,0,12,1142,0,0,29.786504,0.004521000000000441,"",""
"172.16.133.12",59419,"173.194.43.32",80,6,366,4036,0,0,3,180,3,186,29.788014,18.48705,77,80
"172.16.133.48",60433,"69.174.248.254",80,13,3254,4037,0,0,7,1419,6,1835,29.798201,0.6094360000000023,18627,24087
"172.16.133.93",60628,"172.16.139.250",5440,10,1022,4038,0,0,10,1022,0,0,29.804704,0.0048040000000000305,"",""
"172.16.133.48",60434,"69.174.248.254",80,11,2055,4039,0,0,6,1360,5,695,29.807101,0.6222980000000007,17483,8934
"172.16.133.11",55111,"172.16.139.250",5440,10,1022,4040,0,0,10,1022,0,0,29.820237,0.005634000000000583,1451189,0
"172.16.133.55",57548,"172.16.139.250",5440,12,1142,4041,0,0,12,1142,0,0,29.824199,0.015630000000001587,584516,0
"172.16.133.36",65009,"132.245.2.22",443,20,12464,4042,0,0,9,5026,11,7438,29.845663000000002,0.7405589999999975,54294,80350
"172.16.133.73",60594,"172.16.139.250",5440,12,1142,4043,0,0,12,1142,0,0,29.848971,0.020286999999999722,450337,0
"172.16.133.95",55596,"216.52.242.80",80,6,360,4044,0,0,5,300,1,60,29.851549,125.981651,19,3
"172.16.133.53",54068,"172.16.139.250",5440,12,1142,4045,0,0,12,1142,0,0,29.851985,0.006323000000001855,1444883,0
"172.16.133.21",53142,"172.16.139.250",5440,10,1022,4046,0,0,10,1022,0,0,29.853815,0.019342999999999222,422685,0
"172.16.133.30",62581,"172.16.139.250",5440,10,1022,4047,0,0,10,1022,0,0,29.858391,0.006256999999997959,1306696,0
"172.16.133.35",49668,"96.43.146.48",443,15,917,4048,0,0,7,420,8,497,29.85974,214.46418100000002,15,18
"172.16.133.25",63405,"172.16.139.250",5440,12,1142,4049,0,0,12,1142,0,0,29.865578,0.010873000000000133,840246,0
"172.16.133.34",50408,"172.16.139.250",5440,10,1022,4050,0,0,10,1022,0,0,29.873083,0.015692999999998847,520996,0
"172.16.133.11",54654,"96.43.146.22",443,39,19494,4051,0,0,23,17026,16,2468,29.879464,235.08014000000003,579,83
"172.16.133.97",59338,"172.16.139.250",5440,12,1142,4052,0,0,12,1142,0,0,29.885006,0.01630000000000109,560490,0
"172.16.133.48",60435,"74.125.226.6",80,10,2089,4053,0,0,6,1473,4,616,29.893547,91.267053,129,53
"172.16.133.73",60595,"63.241.108.124",80,11,5391,4054,0,0,6,2849,5,2542,29.909537,0.19967300000000066,114146,101846
"172.16.133.24",57534,"23.32.182.35",443,6,413,4055,0,0,3,180,3,233,29.911636,36.007008,39,51
"172.16.133.48",60436,"67.69.174.137",80,8,504,4056,0,0,5,312,3,192,29.915044,5.496853999999999,454,279
"172.16.133.48",60437,"66.235.155.28",80,9,3386,4057,0,0,5,2180,4,1206,29.915773,8.269295,2109,1166
"172.16.133.33",57850,"172.16.139.250",5440,12,1142,4058,0,0,12,1142,0,0,29.960755,0.00656500000000193,1391622,0
"172.16.133.43",57442,"96.43.146.22",443,35,15253,4059,0,0,20,12845,15,2408,29.982987,240.40406299999998,427,80
"172.16.133.26",52785,"216.52.242.80",80,33,23457,4060,0,0,16,6425,17,17032,29.988276,244.94615500000003,209,556
"172.16.133.68",60693,"172.16.139.250",5440,10,1022,4061,0,0,10,1022,0,0,29.990972,0.015444999999999709,529362,0
"172.16.133.12",59701,"172.16.139.250",5440,10,1022,4062,0,0,10,1022,0,0,30.005098,0.005478000000000094,1492515,0
"172.16.133.48",60438,"69.174.248.254",80,7,438,4063,0,0,5,312,2,126,30.005171,8.377633999999997,297,120
"172.16.133.48",60439,"69.174.248.254",80,7,438,4064,0,0,5,312,2,126,30.007687,8.376001999999996,297,120
"172.16.133.48",60440,"69.174.248.254",80,7,438,4065,0,0,5,312,2,126,30.008267,8.376203999999998,297,120
"172.16.133.63",53846,"172.16.139.250",5440,10,1022,4066,0,0,10,1022,0,0,30.013725,0.00596299999999772,1371121,0
"172.16.133.12",59421,"173.194.43.60",80,5,300,4067,0,0,3,180,2,120,30.016016,18.258944,78,52
"172.16.133.66",53818,"172.16.139.250",5440,10,1022,4068,0,0,10,1022,0,0,30.029491,0.0054160000000003095,1509601,0
"172.16.133.82",61290,"172.16.139.250",5440,12,1142,4069,0,0,12,1142,0,0,30.041969,0.006889999999998508,1325979,0
"172.16.133.35",58018,"96.43.146.176",443,19,4938,4070,0,0,11,4130,8,808,30.050262,225.447893,146,28
"172.16.133.37",60574,"172.16.139.250",5440,10,1022,4071,0,0,10,1022,0,0,30.056665,0.005764000000002767,1418459,0
"172.16.133.48",60441,"69.174.248.254",80,10,2039,4072,0,0,5,1306,5,733,30.072261,0.3185489999999973,32798,18408
"172.16.133.35",49824,"96.43.146.22",443,15,917,4073,0,0,7,420,8,497,30.149556,214.14920600000002,15,18
"172.16.133.35",49825,"96.43.146.22",443,15,917,4074,0,0,7,420,8,497,30.150073,214.150067,15,18
"172.16.133.126",59261,"96.43.146.22",443,35,16310,4075,0,0,20,13902,15,2408,30.172032,234.64896800000002,473,82
"172.16.133.78",59070,"172.16.139.250",5440,12,1142,4076,0,0,12,1142,0,0,30.211653,0.006320000000002324,1445569,0
"172.16.133.67",54403,"23.33.47.100",80,25,10502,4077,0,0,12,4296,13,6206,30.247759,243.440931,141,203
"172.16.133.67",55953,"172.16.139.250",5440,10,1022,4078,0,0,10,1022,0,0,30.266578,0.005562000000001177,1469974,0
"172.16.133.153",35048,"64.17.236.31",80,129,102978,4079,0,0,62,4578,67,98400,30.277947,0.5210819999999998,70284,1510702
"172.16.133.12",59098,"74.125.226.90",80,6,366,4080,0,0,3,180,3,186,30.28005,18.016774,79,82
"172.16.133.56",61379,"172.16.139.250",5440,10,1022,4081,0,0,10,1022,0,0,30.289167,0.10895599999999916,75039,0
"172.16.133.48",60442,"69.174.248.254",80,10,2529,4082,0,0,5,1300,5,1229,30.292112,0.3691980000000008,28169,26630
"172.16.133.42",57034,"172.16.139.250",5440,12,1142,4083,0,0,12,1142,0,0,30.30544,0.10464199999999835,87307,0
"172.16.133.48",60443,"174.37.29.148",80,9,2388,4084,0,0,5,1692,4,696,30.309478,0.9009800000000006,15023,6179
"108.160.161.162",80,"172.16.133.96",52652,20,4085,4085,0,0,10,1555,10,2530,30.31109,222.69276399999998,55,90
"172.16.133.48",60444,"69.174.248.253",80,16,9408,4086,0,0,7,1417,9,7991,30.311093,0.4018189999999997,28211,159096
"172.16.133.48",60445,"69.174.248.253",80,10,2269,4087,0,0,5,1305,5,964,30.311449,0.3494339999999987,29876,22069
"172.16.133.48",60446,"69.174.248.253",80,13,5610,4088,0,0,6,1355,7,4255,30.312168,0.4339429999999993,24980,78443
"172.16.133.48",60447,"69.174.248.254",80,12,2771,4089,0,0,6,1505,6,1266,30.321088,0.34015099999999876,35396,29775
"172.16.133.48",60448,"31.13.74.7",443,10,1126,4090,0,0,5,693,5,433,30.3261,0.1075090000000003,51567,32220
"172.16.133.48",60449,"107.21.241.184",80,11,2320,4091,0,0,6,1187,5,1133,30.332203,60.126697,157,150
"172.16.133.48",60450,"208.47.254.90",80,12,1617,4092,0,0,6,961,6,656,30.332613,0.09907300000000063,77599,52971
"172.16.128.169",8014,"172.16.133.84",58326,5,446,4093,0,0,3,326,2,120,30.339045,0.10324400000000011,25260,9298
"172.16.128.169",8014,"172.16.133.30",62209,5,446,4094,0,0,3,326,2,120,30.339154,0.10586800000000096,24634,9067
"172.16.128.169",8014,"172.16.133.67",55484,5,446,4095,0,0,3,326,2,120,30.339439,0.10662300000000258,24460,9003
"172.16.128.169",8014,"172.16.133.39",64115,5,446,4096,0,0,3,326,2,120,30.339633,0.11352199999999968,22973,8456
"172.16.128.169",8014,"172.16.133.29",60375,5,446,4097,0,0,3,326,2,120,30.339851,0.10638799999999904,24514,9023
"172.16.128.169",8014,"172.16.133.116",52117,5,446,4098,0,0,3,326,2,120,30.339968,0.10637600000000091,24516,9024
"172.16.128.169",8014,"172.16.133.85",51862,5,446,4099,0,0,3,326,2,120,30.340367,0.106069999999999,24587,9050
"172.16.128.169",8014,"172.16.133.13",52599,5,446,4100,0,0,3,326,2,120,30.340595,0.11250499999999874,23181,8532
"172.16.128.169",8014,"172.16.133.14",63140,5,446,4101,0,0,3,326,2,120,30.340718,0.1127280000000006,23135,8516
"172.16.128.169",8014,"172.16.133.23",54963,5,446,4102,0,0,3,326,2,120,30.341198,0.11204900000000251,23275,8567
"172.16.128.169",8014,"172.16.133.24",57500,5,446,4103,0,0,3,326,2,120,30.341347,0.11221100000000206,23241,8555
"172.16.128.169",8014,"172.16.133.73",60113,5,446,4104,0,0,3,326,2,120,30.341409,0.11224600000000251,23234,8552
"172.16.133.75",50918,"172.16.139.250",5440,12,1142,4105,0,0,12,1142,0,0,30.343751,0.0419029999999978,218027,0
"172.16.133.41",52762,"172.16.139.250",5440,12,1142,4106,0,0,12,1142,0,0,30.345117,0.04401600000000272,207560,0
"172.16.128.169",8014,"172.16.133.54",64278,5,446,4107,0,0,3,326,2,120,30.347247,0.1098719999999993,23736,8737
"172.16.128.169",8014,"172.16.133.44",64321,5,446,4108,0,0,3,326,2,120,30.347611,0.10910699999999807,23903,8798
"172.16.128.169",8014,"172.16.133.97",58989,5,446,4109,0,0,3,326,2,120,30.347817,0.10918799999999962,23885,8792
"172.16.128.169",8014,"172.16.133.63",53382,5,446,4110,0,0,3,326,2,120,30.348021,0.10920100000000232,23882,8791
"172.16.128.169",8014,"172.16.133.115",53560,5,446,4111,0,0,3,326,2,120,30.348335,0.10906300000000257,23912,8802
"172.16.133.85",52215,"172.16.139.250",5440,12,1142,4112,0,0,12,1142,0,0,30.361527,0.041119000000001904,222184,0
"172.16.133.48",60451,"67.228.168.216",80,42,3550,4113,0,0,20,2083,22,1467,30.36926,93.068133,179,126
"172.16.133.48",60452,"69.164.34.128",80,8,492,4114,0,0,4,246,4,246,30.373045,5.9848079999999975,328,328
"172.16.133.48",60453,"107.21.241.184",80,7,432,4115,0,0,4,246,3,186,30.373047,5.9760300000000015,329,248
"172.16.133.48",60454,"174.37.29.148",80,9,3416,4116,0,0,5,1652,4,1764,30.373391,1.2217719999999979,10817,11550
"172.16.133.48",60455,"69.164.34.128",80,13,2786,4117,0,0,6,796,7,1990,30.373393,3.987774999999999,1596,3992
"172.16.133.48",60456,"31.13.74.7",443,28,4248,4118,0,0,12,2242,16,2006,30.388048,90.778568,197,176
"172.16.133.12",59423,"173.194.43.45",80,6,366,4119,0,0,3,180,3,186,30.407065,17.86106,80,83
"172.16.133.43",57732,"172.16.139.250",5440,12,1142,4120,0,0,12,1142,0,0,30.41788,0.007104999999999251,1285855,0
"172.16.133.13",53007,"172.16.139.250",5440,10,1022,4121,0,0,10,1022,0,0,30.444074,0.005434999999998524,1504323,0
"172.16.133.20",62347,"172.16.139.250",5440,10,1022,4122,0,0,10,1022,0,0,30.482676,0.014239999999997366,574157,0
"172.16.133.28",65332,"172.16.139.250",5440,10,1022,4124,0,0,10,1022,0,0,30.51434,0.006288999999998879,1300047,0
"172.16.133.60",61919,"96.43.146.176",443,22,6588,4125,0,0,12,5372,10,1216,30.525748,225.69657300000003,190,43
"172.16.133.12",59207,"173.194.43.32",80,6,366,4126,0,0,3,180,3,186,30.52808,17.746447999999997,81,83
"172.16.133.128",55431,"173.194.68.125",5222,14,907,4127,0,0,7,420,7,487,30.531891,227.72818600000002,14,17
"172.16.133.116",52784,"96.43.146.48",443,4,240,4128,0,0,2,120,2,120,30.534563,0.05823400000000234,16485,16485
"172.16.133.116",53236,"96.43.146.48",443,16,2509,4129,0,0,9,1595,7,914,30.534971,69.815681,182,104
"172.16.133.99",56012,"172.16.139.250",5440,10,1022,4130,0,0,10,1022,0,0,30.540568,0.014870999999999412,549794,0
"172.16.133.29",60494,"173.194.43.60",80,6,366,4131,0,0,3,180,3,186,30.540705,19.118503999999998,75,77
"172.16.133.75",57919,"172.16.139.250",5447,10,1390,4132,0,0,10,1390,0,0,30.547632,215.836355,51,0
"172.16.133.48",60457,"75.101.129.242",80,11,2000,4133,0,0,6,1590,5,410,30.56145,60.111552999999994,211,54
"172.16.133.87",60153,"172.16.139.250",5440,12,1142,4134,0,0,12,1142,0,0,30.56213,0.006323000000001855,1444883,0
"172.16.133.48",60458,"23.60.241.224",443,22,7637,4135,0,0,10,2243,12,5394,30.564827,60.800688,295,709
"172.16.133.48",60459,"208.47.254.56",80,6,372,4136,0,0,4,246,2,126,30.564828,5.780663000000004,340,174
"172.16.133.48",60460,"23.59.225.224",80,10,2233,4137,0,0,6,1588,4,645,30.565159,90.573253,140,56
"172.16.133.48",60461,"23.46.20.251",80,34,26485,4138,0,0,14,1449,20,25036,30.568084,90.577989,127,2211
"172.16.133.48",60462,"205.234.225.224",80,11,3351,4139,0,0,6,984,5,2367,30.568452,90.602835,86,209
"172.16.133.48",60463,"12.130.81.225",80,7,1337,4140,0,0,4,630,3,707,30.568898,8.344970999999997,603,677
"172.16.133.35",49940,"172.16.139.250",5440,12,1142,4141,0,0,12,1142,0,0,30.575577,0.007860000000000866,1162340,0
"172.16.133.116",53237,"172.16.139.250",5440,12,1142,4142,0,0,12,1142,0,0,30.579912,0.016031999999999158,569860,0
"172.16.133.48",60464,"23.59.225.224",80,12,2921,4143,0,0,7,2216,5,705,30.587408,90.557013,195,62
"172.16.133.48",60465,"23.59.225.224",80,6,372,4144,0,0,4,246,2,126,30.594995,5.750494999999997,342,175
"172.16.133.116",53238,"172.16.139.250",5440,10,1022,4145,0,0,10,1022,0,0,30.596395,0.014735999999999194,554831,0
"172.16.133.48",60466,"208.47.254.81",80,522,526779,4146,0,0,177,11062,345,515717,30.599307,57.77770700000001,1531,71407
"172.16.133.48",60467,"23.59.225.224",80,6,372,4147,0,0,4,246,2,126,30.599309,5.745840999999995,342,175
"172.16.133.84",58760,"172.16.139.250",5440,10,1022,4148,0,0,10,1022,0,0,30.599685,0.005375999999998271,1520833,0
"172.16.133.116",53239,"172.16.139.250",5440,10,1022,4149,0,0,10,1022,0,0,30.612591,0.005885000000002805,1389294,0
"172.16.133.48",60468,"69.174.248.254",80,21,14603,4150,0,0,9,1613,12,12990,30.674065,0.5778640000000017,22330,179834
"172.16.133.48",60469,"67.69.196.147",80,12,2126,4151,0,0,7,1214,5,912,30.674414,90.492513,107,80
"172.16.133.49",55735,"172.16.139.250",5440,12,1142,4152,0,0,12,1142,0,0,30.679844,0.006472999999999729,1411401,0
"172.16.133.95",56935,"172.16.139.250",5440,10,1022,4153,0,0,10,1022,0,0,30.71437,0.005150000000000432,1587572,0
"172.16.133.92",57651,"172.16.139.250",5440,10,1022,4154,0,0,10,1022,0,0,30.750117,0.005793000000000603,1411358,0
"172.16.133.48",60470,"23.60.158.251",80,6,372,4155,0,0,4,246,2,126,30.751468,5.610814999999999,350,179
"172.16.133.48",60471,"12.129.199.104",80,5,312,4156,0,0,3,186,2,126,30.752667,5.661398000000002,262,178
"172.16.133.48",60472,"67.69.174.131",80,6,372,4157,0,0,4,246,2,126,30.759126,5.609359000000001,350,179
"172.16.133.29",60853,"172.16.139.250",5440,10,1022,4158,0,0,10,1022,0,0,30.759983,0.005535000000001844,1477145,0
"172.16.133.153",55568,"23.33.83.78",80,63,44917,4159,0,0,31,2152,32,42765,30.763298,0.16429400000000172,104787,2082364
"172.16.133.44",64746,"172.16.139.250",5440,12,1142,4160,0,0,12,1142,0,0,30.766516,0.005891000000001867,1550840,0
"172.16.133.207",55903,"172.16.139.250",5440,10,1022,4161,0,0,10,1022,0,0,30.793251,0.01416099999999787,577360,0
"172.16.133.73",59919,"96.43.146.22",443,35,15392,4162,0,0,20,12985,15,2407,30.798976,233.99862899999997,443,82
"172.16.133.83",57059,"172.16.139.250",5440,12,1142,4163,0,0,12,1142,0,0,30.800649,0.016325999999999397,559598,0
"172.16.133.48",60474,"67.69.174.115",80,6,372,4164,0,0,4,246,2,126,30.806593,5.562601999999998,353,181
"172.16.133.63",53696,"96.43.146.22",443,31,14004,4165,0,0,18,12054,13,1950,30.813593,241.36753000000002,399,64
"172.16.133.93",60629,"172.16.139.250",5440,12,1142,4166,0,0,12,1142,0,0,30.818655,0.005079000000002054,1798779,0
"172.16.133.11",55112,"172.16.139.250",5440,10,1022,4167,0,0,10,1022,0,0,30.834739,0.015603000000002254,524001,0
"172.16.133.55",57549,"172.16.139.250",5440,10,1022,4168,0,0,10,1022,0,0,30.838466,0.016258999999998025,502859,0
"172.16.133.12",59425,"173.194.43.41",80,6,366,4169,0,0,3,180,3,186,30.855074,17.418383000000002,82,85
"172.16.133.73",60596,"172.16.139.250",5440,12,1142,4170,0,0,12,1142,0,0,30.862417,0.08321899999999971,109782,0
"172.16.133.53",54069,"172.16.139.250",5440,10,1022,4171,0,0,10,1022,0,0,30.864984,0.08352299999999957,97889,0
"172.16.133.21",53143,"172.16.139.250",5440,12,1142,4172,0,0,12,1142,0,0,30.866824,0.08600500000000011,106226,0
"172.16.133.30",62582,"172.16.139.250",5440,10,1022,4173,0,0,10,1022,0,0,30.872139,0.09894800000000004,82629,0
"172.16.133.24",56521,"96.43.146.22",443,48,26380,4174,0,0,27,21444,21,4936,30.873693,249.56687,687,158
"172.16.133.25",63406,"172.16.139.250",5440,10,1022,4175,0,0,10,1022,0,0,30.878473,0.08745500000000206,93488,0
"172.16.133.34",50409,"172.16.139.250",5440,10,1022,4176,0,0,10,1022,0,0,30.887676,0.08193999999999946,99780,0
"172.16.133.97",59339,"172.16.139.250",5440,10,1022,4177,0,0,10,1022,0,0,30.898936,0.039678999999999576,206053,0
"172.16.133.153",53939,"23.33.83.78",80,120,102884,4178,0,0,51,3507,69,99377,30.89958,0.2749699999999997,102032,2891282
"172.16.133.35",51215,"96.43.146.176",443,26,8075,4179,0,0,15,5010,11,3065,30.917408000000002,240.390812,166,102
"172.16.133.23",56441,"172.16.139.250",5500,10,6140,4180,0,0,10,6140,0,0,30.925099,76.985563,638,0
"172.16.133.126",61241,"96.43.146.22",443,9,557,4181,0,0,4,240,5,317,30.958491,75.865277,25,33
"172.16.133.126",61240,"96.43.146.22",443,9,557,4182,0,0,4,240,5,317,30.963605,75.85693,25,33
"172.16.133.126",61238,"96.43.146.22",443,9,557,4183,0,0,4,240,5,317,30.963606,75.860161,25,33
"172.16.133.33",57851,"172.16.139.250",5440,10,1022,4184,0,0,10,1022,0,0,30.973609,0.014835000000001486,551129,0
"172.16.133.12",59702,"172.16.139.250",5440,10,1022,4185,0,0,10,1022,0,0,30.977146,0.005320999999998577,1536553,0
"172.16.133.132",32926,"208.47.254.26",80,22,11689,4186,0,0,12,1195,10,10494,30.992,4.695294999999998,2036,17880
"172.16.133.68",60694,"172.16.139.250",5440,10,1022,4187,0,0,10,1022,0,0,31.004365,0.01521200000000178,537470,0
"172.16.133.12",59703,"172.16.139.250",5440,12,1142,4188,0,0,12,1142,0,0,31.019077,0.006723000000000923,1358917,0
"172.16.133.132",49442,"23.33.82.110",443,32,14559,4189,0,0,18,1885,14,12674,31.020551,4.665851,3231,21730
"172.16.133.63",53847,"172.16.139.250",5440,10,1022,4190,0,0,10,1022,0,0,31.026598,0.005268000000000939,1552012,0
"172.16.133.132",56338,"173.252.110.27",443,27,5788,4191,0,0,14,1947,13,3841,31.028903,4.663207,3340,6589
"172.16.133.12",59646,"96.43.146.48",443,86,42260,4192,0,0,50,30313,36,11947,31.035423,241.81414900000001,1002,395
"172.16.133.66",53819,"172.16.139.250",5440,12,1142,4193,0,0,12,1142,0,0,31.042617,0.006340999999999042,1440782,0
"172.16.133.132",53742,"204.93.223.148",80,11,1320,4194,0,0,6,807,5,513,31.051328,4.640972999999999,1391,884
"172.16.133.41",52070,"151.193.254.39",443,6,360,4195,0,0,3,180,3,180,31.053345,30.937576999999997,46,46
"172.16.133.41",52074,"151.193.254.39",443,6,360,4196,0,0,3,180,3,180,31.053347,30.933277,46,46
"172.16.133.41",52076,"151.193.254.39",443,7,420,4197,0,0,4,240,3,180,31.053348,30.936591,62,46
"172.16.133.82",61291,"172.16.139.250",5440,10,1022,4198,0,0,10,1022,0,0,31.055805,0.005668000000000006,1442484,0
"172.16.133.37",60575,"172.16.139.250",5440,10,1022,4199,0,0,10,1022,0,0,31.068794,0.0055960000000006005,1461043,0
"172.16.133.41",52097,"23.33.44.150",443,6,413,4200,0,0,3,180,3,233,31.125359,30.808764,46,60
"172.16.133.40",50046,"216.52.242.80",80,4,240,4201,0,0,3,180,1,60,31.127581,30.089176000000002,47,15
"172.16.133.41",52072,"151.193.254.39",443,6,360,4202,0,0,3,180,3,180,31.133329,30.856666,46,46
"172.16.133.35",49686,"96.43.146.178",443,11,677,4203,0,0,5,300,6,377,31.135293,123.20584000000001,19,24
"172.16.133.35",49685,"96.43.146.178",443,11,677,4204,0,0,5,300,6,377,31.140183,123.200783,19,24
"172.16.133.41",52073,"151.193.254.39",443,6,360,4205,0,0,3,180,3,180,31.143323,30.846744000000005,46,46
"172.16.133.153",47404,"205.153.84.114",80,8,771,4206,0,0,4,403,4,368,31.151419,0.08699499999999816,37059,33841
"172.16.133.41",52147,"66.235.132.118",443,6,360,4207,0,0,3,180,3,180,31.160273,30.845096,46,46
"172.16.133.28",49491,"96.43.146.176",443,26,8115,4208,0,0,15,5010,11,3105,31.168845,240.36491299999997,166,103
"172.16.133.113",55599,"172.16.139.250",135,8,492,4209,0,0,8,492,0,0,31.19682,0.017638000000001597,223154,0
"172.16.133.153",37134,"184.84.3.78",80,238,216397,4210,0,0,95,6386,143,210011,31.210649,0.428723999999999,119162,3918810
"172.16.133.73",60597,"63.208.138.234",443,24,12181,4211,0,0,12,5985,12,6196,31.212396,0.527546000000001,90759,93959
"172.16.133.78",59071,"172.16.139.250",5440,10,1022,4212,0,0,10,1022,0,0,31.225616,0.005714000000001107,1430871,0
"172.16.133.113",55600,"172.16.139.250",5462,12,816,4213,0,0,12,816,0,0,31.230679,0.5258870000000009,12413,0
"172.16.133.87",59868,"64.56.203.22",443,10,600,4214,0,0,5,300,5,300,31.251932,124.778949,19,19
"172.16.133.78",58602,"74.121.134.211",80,5,300,4215,0,0,4,240,1,60,31.253768,83.873378,22,5
"172.16.133.67",55954,"172.16.139.250",5440,10,1022,4216,0,0,10,1022,0,0,31.280485,0.005395000000000039,1515477,0
"172.16.133.48",60475,"173.192.42.178",80,9,2168,4217,0,0,5,1716,4,452,31.299049,0.28662900000000135,47894,12615
"172.16.133.48",60476,"67.228.168.217",80,10,2114,4218,0,0,5,1716,5,398,31.300229,0.2855599999999967,48073,11150
"172.16.133.56",61380,"172.16.139.250",5440,10,1022,4219,0,0,10,1022,0,0,31.303082,0.006246000000000862,1308997,0
"172.16.133.42",57035,"172.16.139.250",5440,12,1142,4220,0,0,12,1142,0,0,31.326214,0.015228000000000463,599947,0
"172.16.133.75",50919,"172.16.139.250",5440,10,1022,4221,0,0,10,1022,0,0,31.357338,0.014451000000001102,565773,0
"172.16.133.41",52763,"172.16.139.250",5440,10,1022,4222,0,0,10,1022,0,0,31.359264,0.00667100000000076,1225603,0
"172.16.133.40",49992,"96.43.146.48",443,2,120,4223,0,0,1,60,1,60,31.362027,8.79999999980896e-05,"",""
"172.16.133.40",50086,"96.43.146.48",443,29,11037,4224,0,0,15,2983,14,8054,31.362671,81.24344300000001,293,793
"172.16.133.85",52216,"172.16.139.250",5440,10,1022,4225,0,0,10,1022,0,0,31.376549,0.005396000000001067,1515196,0
"172.16.133.48",60477,"67.228.168.217",80,10,2039,4226,0,0,5,1641,5,398,31.398012,0.3217529999999975,40801,9895
"172.16.133.43",57733,"172.16.139.250",5440,12,1142,4227,0,0,12,1142,0,0,31.430748,0.006170999999998372,1480473,0
"172.16.133.48",60478,"69.174.248.254",80,25,18955,4228,0,0,10,1622,15,17333,31.443567,0.6409809999999965,20243,216330
"172.16.133.48",60479,"208.47.254.50",80,6,372,4229,0,0,4,246,2,126,31.445257,5.884716000000001,334,171
"172.16.133.48",60480,"72.21.91.19",80,6,372,4230,0,0,4,246,2,126,31.446773,5.881343999999999,334,171
"172.16.133.13",53008,"172.16.139.250",5440,10,1022,4231,0,0,10,1022,0,0,31.448058,0.0056250000000019895,1453511,0
"172.16.133.48",60481,"199.127.194.80",80,10,1635,4232,0,0,5,744,5,891,31.448892,0.1248749999999994,47663,57081
"172.16.133.48",60482,"216.151.187.131",80,6,372,4233,0,0,4,246,2,126,31.449322,5.880254000000004,334,171
"172.16.133.48",60483,"205.203.131.32",80,10,2427,4234,0,0,6,1119,4,1308,31.449323,89.707269,99,116
"172.16.133.48",60484,"69.174.248.254",80,6,372,4235,0,0,4,246,2,126,31.451315,5.948651999999996,330,169
"172.16.133.48",60485,"199.127.194.80",80,25,17650,4236,0,0,10,1103,15,16547,31.476678,0.2277079999999998,38751,581341
"172.16.133.48",60486,"69.174.248.254",80,6,372,4237,0,0,4,246,2,126,31.477764,5.921300000000002,332,170
"172.16.133.48",60487,"69.174.248.254",80,6,372,4238,0,0,4,246,2,126,31.483212,5.915155999999996,332,170
"172.16.133.20",62348,"172.16.139.250",5440,12,1142,4239,0,0,12,1142,0,0,31.496815,0.005500999999998868,1660788,0
"172.16.133.28",65333,"172.16.139.250",5440,10,1022,4240,0,0,10,1022,0,0,31.532395,0.006271999999999167,1303571,0
"172.16.133.35",49689,"64.56.203.22",443,10,600,4241,0,0,5,300,5,300,31.537004,122.838381,19,19
"172.16.133.12",59418,"173.194.43.37",80,6,366,4242,0,0,3,180,3,186,31.539067,16.735670000000002,86,88
"172.16.133.48",60488,"50.16.236.32",80,10,1620,4243,0,0,5,1141,5,479,31.541515,0.47334600000000293,19283,8095
"172.16.133.35",55387,"172.16.139.250",5447,10,1400,4244,0,0,10,1400,0,0,31.549681,240.02383899999998,46,0
"172.16.133.99",56013,"172.16.139.250",5440,12,1142,4245,0,0,12,1142,0,0,31.553255,0.01543399999999906,591939,0
"172.16.133.48",60489,"174.37.29.148",80,18,12198,4246,0,0,8,1911,10,10287,31.553764,0.32843799999999845,46547,250567
"172.16.133.48",60490,"173.192.42.178",80,9,2093,4247,0,0,5,1641,4,452,31.554265,0.26167999999999836,50168,13818
"172.16.133.87",60154,"172.16.139.250",5440,12,1142,4248,0,0,12,1142,0,0,31.576022000000002,0.01542699999999897,592208,0
"172.16.133.35",49941,"172.16.139.250",5440,12,1142,4249,0,0,12,1142,0,0,31.590849,0.015457000000001386,591059,0
"172.16.133.116",53240,"172.16.139.250",5440,10,1022,4250,0,0,10,1022,0,0,31.59292,0.005162000000002109,1583882,0
"172.16.133.48",60491,"173.192.42.178",80,6,553,4251,0,0,4,246,2,307,31.597825,5.788817999999999,339,424
"172.16.133.48",60492,"174.37.29.148",80,6,554,4252,0,0,4,246,2,308,31.598234,5.782101999999998,340,426
"172.16.133.116",53241,"172.16.139.250",5440,10,1022,4253,0,0,10,1022,0,0,31.598882,0.006730000000001013,1214858,0
"172.16.133.116",53242,"172.16.139.250",5440,10,1022,4254,0,0,10,1022,0,0,31.606252,0.00675499999999829,1210362,0
"172.16.133.84",58761,"172.16.139.250",5440,12,1142,4255,0,0,12,1142,0,0,31.614658,0.015355000000003116,594985,0
"172.16.133.35",49697,"64.56.203.22",443,10,600,4256,0,0,5,300,5,300,31.619916,122.756457,19,19
"172.16.133.48",60493,"107.22.214.3",80,14,3728,4257,0,0,7,2122,7,1606,31.632911,59.311710999999995,286,216
"172.16.133.37",60334,"173.194.75.147",80,8,492,4258,0,0,4,240,4,252,31.689826,68.16417,28,29
"172.16.133.49",55736,"172.16.139.250",5440,10,1022,4259,0,0,10,1022,0,0,31.693393,0.015743999999997982,519308,0
"172.16.133.73",60598,"173.194.31.174",80,12,3813,4260,0,0,6,2483,6,1330,31.699082,0.1275449999999978,155741,83421
"172.16.133.73",60599,"74.125.226.38",80,69,32480,4261,0,0,41,26589,28,5891,31.706283,258.475723,822,182
"172.16.133.95",56936,"172.16.139.250",5440,10,1022,4262,0,0,10,1022,0,0,31.728603,0.005331999999999226,1533383,0
"172.16.133.12",59222,"173.194.43.37",80,6,366,4263,0,0,3,180,3,186,31.729118,16.538845000000002,87,89
"172.16.133.35",49623,"96.43.146.22",443,9,557,4264,0,0,4,240,5,317,31.74454,82.535266,23,30
"172.16.133.48",60494,"74.205.80.2",80,10,1557,4265,0,0,6,871,4,686,31.750071,89.444739,77,61
"172.16.133.48",60495,"208.47.254.32",80,6,372,4266,0,0,4,246,2,126,31.751021,5.581516000000001,352,180
"172.16.133.126",61239,"96.43.146.22",443,9,557,4267,0,0,4,240,5,317,31.752191,75.071484,25,33
"172.16.133.37",60336,"173.194.75.147",80,8,492,4268,0,0,4,240,4,252,31.753836,68.09878,28,29
"172.16.133.48",60496,"205.251.242.128",80,9,1513,4269,0,0,6,1047,3,466,31.756366,89.394773,93,41
"172.16.133.48",60497,"208.47.254.89",80,12,2196,4270,0,0,7,800,5,1396,31.757071,89.38641,71,124
"172.16.133.92",57652,"172.16.139.250",5440,10,1022,4271,0,0,10,1022,0,0,31.758683,0.015547999999999007,525855,0
"172.16.133.114",53723,"67.195.187.234",5050,8,584,4272,0,0,4,344,4,240,31.76007,221.424445,12,8
"172.16.133.29",60854,"172.16.139.250",5440,10,1022,4273,0,0,10,1022,0,0,31.773867,0.005096999999999241,1604080,0
"172.16.133.48",60498,"205.251.242.128",80,10,1748,4274,0,0,6,1017,4,731,31.781673,89.37921,91,65
"172.16.133.48",60499,"208.47.254.89",80,6,372,4275,0,0,4,246,2,126,31.781963,5.552060000000001,354,181
"172.16.133.44",64747,"172.16.139.250",5440,12,1142,4276,0,0,12,1142,0,0,31.782436,0.01570999999999856,581540,0
"172.16.133.12",59305,"173.194.43.32",80,6,366,4277,0,0,3,180,3,186,31.789129,16.479553,87,90
"172.16.133.207",55904,"172.16.139.250",5440,12,1142,4278,0,0,12,1142,0,0,31.805844,0.014621999999999247,624811,0
"172.16.133.83",57060,"172.16.139.250",5440,10,1022,4279,0,0,10,1022,0,0,31.814928,0.014704000000001827,556039,0
"172.16.133.93",60630,"172.16.139.250",5440,12,1142,4280,0,0,12,1142,0,0,31.832056,0.004864999999998787,"",""
"172.16.133.66",53524,"216.52.242.97",80,6,360,4281,0,0,5,300,1,60,31.842656,125.35166100000001,19,3
"172.16.133.11",55113,"172.16.139.250",5440,10,1022,4282,0,0,10,1022,0,0,31.848819,0.00544800000000123,1500734,0
"172.16.133.55",57550,"172.16.139.250",5440,12,1142,4283,0,0,12,1142,0,0,31.853076,0.015944999999998544,572969,0
"172.16.133.73",60600,"184.84.43.32",443,28,9220,4284,0,0,15,6224,13,2996,31.866225,225.471546,220,106
"172.16.133.73",60601,"172.16.139.250",5440,10,1022,4285,0,0,10,1022,0,0,31.877034,0.005531000000001285,1478213,0
"172.16.133.53",54070,"172.16.139.250",5440,10,1022,4286,0,0,10,1022,0,0,31.879375,0.007065000000000765,1157254,0
"172.16.133.21",53144,"172.16.139.250",5440,12,1142,4287,0,0,12,1142,0,0,31.881766,0.009199999999999875,993043,0
"172.16.133.30",62584,"172.16.139.250",5440,10,1022,4288,0,0,10,1022,0,0,31.885037,0.009270000000000778,881984,0
"172.16.133.12",59433,"173.194.43.38",80,6,366,4289,0,0,3,180,3,186,31.885102,16.383242999999997,87,90
"172.16.133.25",63407,"172.16.139.250",5440,12,1142,4290,0,0,12,1142,0,0,31.892514,0.005887000000001308,1551894,0
"172.16.133.34",50410,"172.16.139.250",5440,10,1022,4291,0,0,10,1022,0,0,31.901787,0.015133000000002284,540276,0
"172.16.133.53",50871,"172.16.139.250",5447,10,1390,4292,0,0,10,1390,0,0,31.910118,239.998627,46,0
"172.16.133.97",59340,"172.16.139.250",5440,10,1022,4293,0,0,10,1022,0,0,31.912403,0.015298999999998841,534414,0
"172.16.133.41",52093,"23.33.44.150",443,4,287,4294,0,0,2,120,2,167,31.91549,0.02043000000000106,46989,65394
"172.16.133.18",50146,"157.56.238.6",443,2,120,4295,0,0,1,60,1,60,31.916922,0.0001600000000010482,"",""
"172.16.133.18",50280,"157.56.238.6",443,174,77579,4296,0,0,80,32021,94,45558,31.917529000000002,247.803944,1033,1470
"172.16.133.12",59427,"173.194.43.40",80,6,366,4297,0,0,3,180,3,186,31.945108,16.323838999999996,88,91
"172.16.133.126",61128,"96.43.146.48",443,9,557,4298,0,0,4,240,5,317,31.949683,84.82908599999999,22,29
"172.16.133.73",60602,"173.194.31.178",80,685,799266,4299,0,0,152,11474,533,787792,31.962955,1.6158220000000014,56808,3900390
"172.16.133.41",52361,"173.194.75.103",443,16,1074,4300,0,0,8,480,8,594,31.973332,159.97237,24,29
"172.16.133.41",52366,"173.194.75.103",443,16,1074,4301,0,0,8,480,8,594,31.973333,159.971388,24,29
"172.16.133.12",59430,"173.194.43.40",80,6,366,4302,0,0,3,180,3,186,31.979083,16.289154999999997,88,91
"172.16.133.41",52364,"173.194.75.103",443,15,1014,4303,0,0,7,420,8,594,31.983362,159.965891,21,29
"172.16.133.48",60500,"208.47.254.82",80,31,22779,4304,0,0,13,1561,18,21218,31.987729,89.157588,140,1903
"172.16.133.33",57852,"172.16.139.250",5440,10,1022,4305,0,0,10,1022,0,0,31.988161,0.005627999999997968,1452736,0
"172.16.133.12",59428,"173.194.43.38",80,6,366,4306,0,0,3,180,3,186,31.98909,16.279461,88,91
"172.16.133.41",52363,"173.194.75.103",443,16,1074,4307,0,0,8,480,8,594,31.993361,159.95715,24,29
"172.16.133.41",52365,"173.194.75.103",443,16,1074,4308,0,0,8,480,8,594,31.993362,159.95694400000002,24,29
"172.16.133.12",59431,"173.194.43.40",80,6,366,4309,0,0,3,180,3,186,31.999061,16.269738999999998,88,91
"172.16.133.48",60501,"199.127.194.206",443,23,7367,4310,0,0,11,2030,12,5337,32.007645,89.151312,182,478
"172.16.133.68",60695,"172.16.139.250",5440,10,1022,4311,0,0,10,1022,0,0,32.017973,0.005507000000001483,1484655,0
"172.16.133.87",60086,"96.43.146.22",443,17,1037,4312,0,0,8,480,9,557,32.025076,263.949617,14,16
"172.16.133.12",59704,"172.16.139.250",5440,10,1022,4313,0,0,10,1022,0,0,32.032005,0.0061090000000021405,1338353,0
"157.56.244.214",443,"172.16.133.115",49480,302,259025,4314,0,0,211,253559,91,5466,32.032815,240.37964000000002,8438,181
"172.16.133.63",53848,"172.16.139.250",5440,10,1022,4315,0,0,10,1022,0,0,32.040167,0.014591000000002907,560345,0
"172.16.133.13",52962,"74.125.226.226",443,16,1080,4316,0,0,7,420,9,660,32.042802,195.021879,17,27
"172.16.133.87",59880,"96.43.146.22",443,11,677,4317,0,0,5,300,6,377,32.051071,123.93256399999999,19,24
"172.16.133.87",59882,"96.43.146.22",443,11,677,4318,0,0,5,300,6,377,32.056082,123.92755199999999,19,24
"172.16.133.66",53820,"172.16.139.250",5440,10,1022,4319,0,0,10,1022,0,0,32.05675,0.015389999999996462,531254,0
"172.16.133.82",61292,"172.16.139.250",5440,10,1022,4320,0,0,10,1022,0,0,32.06884,0.007182000000000244,1138401,0
"172.16.133.87",59881,"96.43.146.22",443,11,677,4321,0,0,5,300,6,377,32.072041,123.91159499999999,19,24
"172.16.133.87",59883,"96.43.146.22",443,11,677,4322,0,0,5,300,6,377,32.075043,123.906658,19,24
"172.16.133.12",58672,"173.194.43.46",443,87,28501,4323,0,0,44,17579,43,10922,32.082726,267.240291,526,326
"172.16.133.37",60576,"172.16.139.250",5440,10,1022,4324,0,0,10,1022,0,0,32.082998,0.005802999999993119,1408926,0
"172.16.133.41",52764,"199.102.234.31",80,29,22106,4325,0,0,9,2738,20,19368,32.089897,0.5651310000000009,38759,274173
"172.16.133.25",61585,"173.194.74.189",443,13,888,4326,0,0,5,300,8,588,32.09054,104.96276599999999,22,44
"172.16.133.75",50835,"96.43.146.48",443,17,1037,4327,0,0,8,480,9,557,32.09648,263.945438,14,16
"172.16.133.78",58389,"216.246.75.64",80,7,432,4328,0,0,4,240,3,192,32.123804,82.93529000000001,23,18
"172.16.133.48",60502,"208.47.254.80",80,7,432,4329,0,0,4,246,3,186,32.165225,5.168374,380,287
"172.16.133.48",60503,"74.205.80.2",80,10,1204,4330,0,0,6,724,4,480,32.16672,89.025822,65,43
"172.16.133.75",50830,"96.43.146.48",443,17,1037,4331,0,0,8,480,9,557,32.171484,263.873962,14,16
"172.16.133.48",60504,"74.205.80.2",80,8,504,4332,0,0,4,252,4,252,32.189733,6.174259000000006,326,326
"172.16.133.75",50836,"96.43.146.48",443,17,1037,4333,0,0,8,480,9,557,32.203502,263.84027699999996,14,16
"172.16.133.48",60505,"74.205.80.2",80,6,372,4334,0,0,3,186,3,186,32.20984,6.153736000000002,241,241
"172.16.133.78",49314,"157.56.241.150",443,10,775,4335,0,0,5,475,5,300,32.227,240.015821,15,9
"172.16.133.75",50850,"96.43.146.48",443,17,1037,4336,0,0,8,480,9,557,32.233458,263.809384,14,16
"172.16.133.78",59072,"172.16.139.250",5440,10,1022,4337,0,0,10,1022,0,0,32.240325,0.005774000000002388,1416002,0
"157.56.242.198",443,"172.16.133.12",50690,10,795,4338,0,0,5,495,5,300,32.265564,239.996059,16,10
"172.16.133.67",55955,"172.16.139.250",5440,10,1022,4339,0,0,10,1022,0,0,32.294805,0.00547400000000664,1493606,0
"172.16.133.56",61381,"172.16.139.250",5440,12,1142,4340,0,0,12,1142,0,0,32.31571,0.005516000000000076,1656272,0
"172.16.133.13",52963,"173.194.43.41",443,17,1140,4341,0,0,8,480,9,660,32.340806,195.017356,19,27
"172.16.133.42",57036,"172.16.139.250",5440,12,1142,4342,0,0,12,1142,0,0,32.341559,0.06207000000000562,147188,0
"172.16.133.126",61237,"173.194.43.33",443,9,636,4343,0,0,4,240,5,396,32.350259,14.835954999999998,129,213
"172.16.133.75",50920,"172.16.139.250",5440,10,1022,4344,0,0,10,1022,0,0,32.37159,0.005358000000001084,1525942,0
"172.16.133.41",52765,"172.16.139.250",5440,12,1142,4345,0,0,12,1142,0,0,32.373129,0.01538200000000245,593940,0
"172.16.133.85",52217,"172.16.139.250",5440,12,1142,4346,0,0,12,1142,0,0,32.389892,0.006751999999998759,1353080,0
"172.16.133.75",50829,"96.43.146.48",443,16,977,4347,0,0,8,480,8,497,32.421511,263.622326,14,15
"172.16.133.43",57734,"172.16.139.250",5440,10,1022,4348,0,0,10,1022,0,0,32.444278,0.005504000000001952,1485465,0
"172.16.133.13",53009,"172.16.139.250",5440,12,1142,4349,0,0,12,1142,0,0,32.460824,0.0162469999999999,562319,0
"172.16.133.93",60321,"216.52.242.80",80,7,420,4350,0,0,6,360,1,60,32.493805,165.08873499999999,17,2
"172.16.133.20",62349,"172.16.139.250",5440,12,1142,4351,0,0,12,1142,0,0,32.511014,0.020901999999999532,437087,0
"172.16.133.28",65334,"172.16.139.250",5440,12,1142,4352,0,0,12,1142,0,0,32.541541,0.00640099999999677,1427276,0
"172.16.133.99",56014,"172.16.139.250",5440,12,1142,4353,0,0,12,1142,0,0,32.568853,0.005137000000004832,1778469,0
"172.16.133.87",60155,"172.16.139.250",5440,10,1022,4354,0,0,10,1022,0,0,32.594518,0.005169999999999675,1581431,0
"172.16.133.35",49942,"172.16.139.250",5440,12,1142,4355,0,0,12,1142,0,0,32.602837,0.016618000000001132,549765,0
"172.16.133.116",53243,"172.16.139.250",5440,10,1022,4356,0,0,10,1022,0,0,32.607671,0.006367999999994822,1283919,0
"172.16.133.116",53244,"172.16.139.250",5440,10,1022,4357,0,0,10,1022,0,0,32.614914,0.0061549999999996885,1328350,0
"172.16.133.116",53245,"172.16.139.250",5440,10,1022,4358,0,0,10,1022,0,0,32.622627,0.0064799999999962665,1261728,0
"172.16.133.84",58762,"172.16.139.250",5440,10,1022,4359,0,0,10,1022,0,0,32.628405,0.014819000000002802,551724,0
"172.16.133.103",63434,"157.56.240.137",443,6,374,4360,0,0,3,194,3,180,32.658061000000004,1.101149999999997,1409,1307
"172.16.133.68",58657,"208.47.254.10",80,16,4986,4361,0,0,8,1662,8,3324,32.670737,225.133362,59,118
"172.16.133.13",52632,"96.43.146.22",443,5,317,4362,0,0,2,120,3,197,32.697925,0.046784999999999854,20519,33686
"172.16.133.49",55737,"172.16.139.250",5440,10,1022,4363,0,0,10,1022,0,0,32.707401,0.015683000000002778,521328,0
"172.16.133.37",60577,"216.115.223.200",443,6,366,4364,0,0,4,246,2,120,32.711827,0.10859899999999811,18121,8839
"172.16.133.37",60578,"216.219.113.250",443,6,366,4365,0,0,4,246,2,120,32.712717,0.24457000000000306,8046,3925
"172.16.133.37",60579,"67.217.64.244",443,6,366,4366,0,0,4,246,2,120,32.713638,0.07461299999999937,26376,12866
"172.16.133.66",53767,"173.194.75.103",443,26,4267,4367,0,0,12,2399,14,1868,32.71465,266.962321,71,55
"172.16.133.37",60580,"66.151.150.190",443,6,366,4368,0,0,4,246,2,120,32.714879,0.23888799999999577,8238,4018
"172.16.133.13",52633,"96.43.146.22",443,5,317,4369,0,0,2,120,3,197,32.724391,0.04907599999999945,19561,32113
"172.16.133.35",49705,"173.194.43.30",443,11,762,4370,0,0,5,300,6,462,32.733585,59.887015,40,61
"172.16.133.13",52641,"96.43.146.178",443,5,317,4371,0,0,2,120,3,197,32.740148,0.04356700000000302,22035,36174
"172.16.133.95",56937,"172.16.139.250",5440,10,1022,4372,0,0,10,1022,0,0,32.742681,0.015076000000000533,542318,0
"172.16.133.68",60530,"173.194.43.1",443,13,888,4373,0,0,6,360,7,528,32.750741,104.97383399999998,27,40
"172.16.133.13",52643,"96.43.146.178",443,5,317,4374,0,0,2,120,3,197,32.751712,0.04309299999999894,22277,36572
"172.16.133.13",52642,"96.43.146.178",443,5,317,4375,0,0,2,120,3,197,32.751975,0.05035999999999774,19062,31294
"172.16.133.13",52617,"96.43.146.176",443,5,317,4376,0,0,2,120,3,197,32.752195,0.05019999999999669,19123,31394
"172.16.133.13",52640,"96.43.146.22",443,5,317,4377,0,0,2,120,3,197,32.752422,0.05002799999999752,19189,31502
"172.16.133.92",57653,"172.16.139.250",5440,10,1022,4378,0,0,10,1022,0,0,32.77189,0.005490000000001771,1489253,0
"172.16.133.66",53766,"173.194.75.103",80,18,6038,4379,0,0,8,1714,10,4324,32.772663,231.31229700000003,59,149
"172.16.133.29",60855,"172.16.139.250",5440,10,1022,4380,0,0,10,1022,0,0,32.788018,0.016531000000000518,494585,0
"172.16.133.84",57583,"96.43.146.178",443,12,720,4381,0,0,6,360,6,360,32.788856,225.348947,12,12
"172.16.133.44",64748,"172.16.139.250",5440,10,1022,4382,0,0,10,1022,0,0,32.795477,0.005442999999999643,1502112,0
"172.16.133.66",53769,"173.194.43.47",80,20,1909,4383,0,0,10,1059,10,850,32.801549,254.31547400000002,33,26
"172.16.133.75",50589,"173.194.43.34",443,9,636,4384,0,0,4,240,5,396,32.813554,15.212049999999998,126,208
"172.16.133.207",55905,"172.16.139.250",5440,10,1022,4385,0,0,10,1022,0,0,32.81981,0.009848000000005186,830219,0
"172.16.133.83",57061,"172.16.139.250",5440,12,1142,4386,0,0,12,1142,0,0,32.828594,0.0060439999999957195,1511581,0
"172.16.133.93",60631,"172.16.139.250",5440,12,1142,4387,0,0,12,1142,0,0,32.846709,0.014562000000005071,627386,0
"172.16.133.68",59757,"74.125.142.125",5222,16,2199,4388,0,0,8,1652,8,547,32.84777,243.44382399999998,54,17
"172.16.133.41",52766,"216.52.121.204",80,11,4485,4389,0,0,6,2952,5,1533,32.858445,0.1120689999999982,210727,109432
"172.16.133.41",52767,"216.52.121.204",80,64,66566,4390,0,0,17,3611,47,62955,32.85857,0.46656099999999867,61916,1079472
"172.16.133.114",52593,"67.221.174.61",443,10,600,4391,0,0,5,300,5,300,32.860364,235.52274999999997,10,10
"157.56.240.102",443,"172.16.133.99",52171,10,775,4392,0,0,5,475,5,300,32.862425,240.321879,15,9
"172.16.133.11",55114,"172.16.139.250",5440,12,1142,4393,0,0,12,1142,0,0,32.862513,0.016443999999999903,555582,0
"172.16.133.55",57551,"172.16.139.250",5440,10,1022,4394,0,0,10,1022,0,0,32.866629,0.005477999999996541,1492515,0
"172.16.133.73",60603,"172.16.139.250",5440,12,1142,4395,0,0,12,1142,0,0,32.889918,0.006112000000001672,1494764,0
"172.16.133.53",54071,"172.16.139.250",5440,12,1142,4396,0,0,12,1142,0,0,32.893155,0.006884999999996921,1326942,0
"172.16.133.21",53145,"172.16.139.250",5440,12,1142,4397,0,0,12,1142,0,0,32.894708,0.009447000000001538,967079,0
"172.16.133.30",62585,"172.16.139.250",5440,12,1142,4398,0,0,12,1142,0,0,32.899241,0.008027999999995927,1138016,0
"172.16.133.66",53770,"173.194.74.95",80,14,870,4399,0,0,7,420,7,450,32.902618,204.24243800000002,16,17
"172.16.133.25",63408,"172.16.139.250",5440,12,1142,4400,0,0,12,1142,0,0,32.907942,0.1418170000000032,64421,0
"172.16.133.34",50411,"172.16.139.250",5440,12,1142,4401,0,0,12,1142,0,0,32.91535,0.13779200000000458,66302,0
"172.16.133.97",59341,"172.16.139.250",5440,12,1142,4402,0,0,12,1142,0,0,32.925902,0.13083400000000012,69828,0
"172.16.133.41",52768,"216.52.121.204",80,15,7996,4403,0,0,8,3388,7,4608,32.936479,1.600828,16931,23028
"172.16.133.163",3518,"74.125.226.207",443,130,79424,4404,0,0,49,3725,81,75699,32.948225,240.170354,124,2521
"172.16.133.25",51023,"208.85.40.20",80,17,2967,4405,0,0,9,2147,8,820,32.975483,254.97281800000002,67,25
"172.16.133.33",57853,"172.16.139.250",5440,10,1022,4406,0,0,10,1022,0,0,33.003794,0.05650200000000183,144702,0
"172.16.133.73",60604,"74.125.226.59",80,48,14848,4407,0,0,28,8788,20,6060,33.013763,264.692899,265,183
"172.16.133.68",60696,"172.16.139.250",5440,10,1022,4408,0,0,10,1022,0,0,33.032754,0.03142200000000628,260199,0
"172.16.133.12",59705,"172.16.139.250",5440,12,1142,4409,0,0,12,1142,0,0,33.046186,0.022638000000000602,403569,0
"172.16.133.63",53849,"172.16.139.250",5440,12,1142,4410,0,0,12,1142,0,0,33.05596,0.016592000000002827,550626,0
"172.16.133.75",50603,"23.33.44.168",80,7,432,4411,0,0,4,240,3,192,33.066511,77.186148,24,19
"172.16.133.75",50605,"23.33.44.168",80,7,432,4412,0,0,4,240,3,192,33.066512,77.187134,24,19
"172.16.133.66",53821,"172.16.139.250",5440,12,1142,4413,0,0,12,1142,0,0,33.071362,0.006448999999996374,1416653,0
"172.16.133.82",61293,"172.16.139.250",5440,12,1142,4414,0,0,12,1142,0,0,33.083051,0.016252000000001487,562146,0
"172.16.133.18",49999,"172.16.139.250",5447,24,9048,4415,0,0,24,9048,0,0,33.083317,250.10930900000002,289,0
"172.16.133.37",60581,"172.16.139.250",5440,10,1022,4416,0,0,10,1022,0,0,33.097999,0.0056730000000015934,1441212,0
"132.245.1.150",443,"172.16.133.39",49311,4683,4720032,4417,0,0,3278,4635684,1405,84348,33.10051,248.360299,149321,2716
"172.16.133.75",50604,"23.33.44.168",80,7,432,4418,0,0,4,240,3,192,33.111522,77.14199500000001,24,19
"172.16.133.87",59855,"96.43.146.50",443,17,1037,4419,0,0,8,480,9,557,33.136274,262.838477,14,16
"172.16.133.41",52769,"23.45.65.57",80,76,55237,4420,0,0,38,26439,38,28798,33.195277,231.633164,913,994
"172.16.133.41",52770,"23.45.65.57",80,252,291158,4421,0,0,55,11511,197,279647,33.226846,226.55619500000003,406,9874
"172.16.133.41",52771,"23.45.65.57",80,75,69636,4422,0,0,25,11200,50,58436,33.231187,226.572911,395,2063
"172.16.133.41",52772,"23.45.65.57",80,53,31295,4423,0,0,27,16129,26,15166,33.231818,266.739005,483,454
"172.16.133.41",52773,"23.45.65.57",80,28,13096,4424,0,0,14,5661,14,7435,33.23224,226.51072600000003,199,262
"172.16.133.41",52774,"23.45.65.57",80,57,40145,4425,0,0,27,18544,30,21601,33.232612,221.98461300000002,668,778
"172.16.133.114",55247,"98.129.93.186",443,12,720,4426,0,0,6,360,6,360,33.252102,164.82285099999999,17,17
"172.16.133.78",59073,"172.16.139.250",5440,10,1022,4427,0,0,10,1022,0,0,33.253793,0.005652999999995245,1446311,0
"172.16.133.121",56499,"74.125.226.207",443,14,4028,4428,0,0,8,958,6,3070,33.285063,9.821666,780,2500
"172.16.133.67",55956,"172.16.139.250",5440,12,1142,4429,0,0,12,1142,0,0,33.308509,0.007517999999997471,1215216,0
"172.16.133.43",63359,"172.16.139.250",5447,10,1390,4430,0,0,10,1390,0,0,33.317168,240.00400599999998,46,0
"172.16.133.56",61382,"172.16.139.250",5440,12,1142,4431,0,0,12,1142,0,0,33.330263,0.005694999999995787,1604214,0
"157.56.240.102",443,"172.16.133.92",50017,47,7531,4432,0,0,29,6451,18,1080,33.335839,240.11491400000003,214,35
"172.16.133.87",60090,"69.28.187.152",443,6,360,4433,0,0,3,180,3,180,33.347077,22.603386999999998,63,63
"172.16.133.42",57037,"172.16.139.250",5440,12,1142,4434,0,0,12,1142,0,0,33.360732,0.0664160000000038,137557,0
"172.16.133.75",50921,"172.16.139.250",5440,12,1142,4435,0,0,12,1142,0,0,33.385405,0.006407000000002938,1425940,0
"172.16.133.41",52775,"172.16.139.250",5440,12,1142,4436,0,0,12,1142,0,0,33.387719,0.01602600000000365,570073,0
"172.16.133.75",50594,"23.67.242.11",80,7,432,4437,0,0,4,240,3,192,33.401512,76.852006,24,19
"172.16.133.85",52218,"172.16.139.250",5440,12,1142,4438,0,0,12,1142,0,0,33.404356,0.014615999999996632,625068,0
"172.16.133.75",50597,"23.67.242.11",80,7,432,4439,0,0,4,240,3,192,33.406525,76.84718,24,19
"172.16.133.75",50595,"23.67.242.11",80,7,432,4440,0,0,4,240,3,192,33.406527,76.847177,24,19
"172.16.133.25",62124,"216.52.242.80",80,13,3059,4441,0,0,9,2089,4,970,33.414584,258.490978,64,30
"172.16.133.43",57735,"172.16.139.250",5440,12,1142,4442,0,0,12,1142,0,0,33.458816,0.005592000000000041,1633762,0
"172.16.133.13",53010,"172.16.139.250",5440,12,1142,4443,0,0,12,1142,0,0,33.474862,0.01573499999999939,580616,0
"172.16.133.20",62350,"172.16.139.250",5440,12,1142,4444,0,0,12,1142,0,0,33.524678,0.011649999999995941,784206,0
"172.16.133.54",64315,"173.194.43.34",443,9,1037,4445,0,0,5,664,4,373,33.531473,0.10438500000000062,50888,28586
"172.16.133.87",60091,"64.56.203.22",443,15,900,4446,0,0,8,480,7,420,33.544114,262.479198,14,12
"172.16.133.51",52983,"157.56.232.214",443,14,1205,4447,0,0,7,785,7,420,33.544713,241.01000499999998,26,13
"172.16.133.28",65335,"172.16.139.250",5440,12,1142,4448,0,0,12,1142,0,0,33.556268,0.015425000000000466,592285,0
"172.16.133.25",63409,"173.194.76.125",5222,24,6059,4449,0,0,12,2193,12,3866,33.579985,0.3704880000000017,47353,83479
"172.16.133.99",56015,"172.16.139.250",5440,10,1022,4450,0,0,10,1022,0,0,33.581333,0.014819000000002802,551724,0
"172.16.133.87",60156,"172.16.139.250",5440,10,1022,4451,0,0,10,1022,0,0,33.604086,0.01604199999999878,509662,0
"172.16.133.75",50854,"96.43.146.22",443,17,1037,4452,0,0,8,480,9,557,33.613522,262.429372,14,16
"172.16.133.35",49943,"172.16.139.250",5440,12,1142,4453,0,0,12,1142,0,0,33.621608,0.08981800000000106,101716,0
"172.16.133.116",53246,"172.16.139.250",5440,10,1022,4454,0,0,10,1022,0,0,33.622244,0.00700899999999649,1166500,0
"172.16.133.66",53772,"173.194.43.43",80,14,870,4455,0,0,7,420,7,450,33.624617,203.515418,16,17
"172.16.133.66",53773,"173.194.43.43",80,14,870,4456,0,0,7,420,7,450,33.624619,203.51632800000002,16,17
"172.16.133.116",53247,"172.16.139.250",5440,12,1142,4457,0,0,12,1142,0,0,33.630082,0.006205999999998824,1472123,0
"172.16.133.75",50590,"23.67.242.11",80,7,432,4458,0,0,4,240,3,192,33.636542,76.617964,25,20
"172.16.133.116",53248,"172.16.139.250",5440,8,902,4459,0,0,8,902,0,0,33.637192,0.005645000000001232,1278299,0
"172.16.133.84",58763,"172.16.139.250",5440,12,1142,4460,0,0,12,1142,0,0,33.641653,0.007395999999999958,1235262,0
"157.56.236.102",443,"172.16.133.56",60942,21,3104,4461,0,0,12,2564,9,540,33.644811,240.145709,85,17
"172.16.133.75",50855,"96.43.146.22",443,17,1037,4462,0,0,8,480,9,557,33.646538,262.379933,14,16
"172.16.133.66",53774,"173.194.43.43",80,14,870,4463,0,0,7,420,7,450,33.652611,203.48823099999998,16,17
"172.16.133.54",64316,"173.194.43.39",443,67,21655,4464,0,0,33,10710,34,10945,33.652816,234.744047,364,373
"172.16.133.67",55742,"96.43.146.22",443,11,677,4465,0,0,5,300,6,377,33.657855,120.44909700000001,19,25
"172.16.133.66",53775,"173.194.43.34",80,34,12875,4466,0,0,20,9051,14,3824,33.681582,232.689341,311,131
"172.16.133.49",55738,"172.16.139.250",5440,10,1022,4467,0,0,10,1022,0,0,33.720358,0.015539000000003966,526159,0
"172.16.133.95",56938,"172.16.139.250",5440,12,1142,4468,0,0,12,1142,0,0,33.756157,0.01578800000000058,578667,0
"172.16.133.103",63435,"157.56.244.217",443,6,374,4469,0,0,3,194,3,180,33.759686,1.2150959999999955,1277,1185
"172.16.133.66",53768,"173.194.75.103",80,18,4320,4470,0,0,9,2977,9,1343,33.761608,230.275456,103,46
"172.16.133.41",52776,"199.102.234.31",80,11,4394,4471,0,0,6,2807,5,1587,33.76194,0.12826199999999943,175079,98984
"172.16.133.18",50281,"157.56.238.6",443,34,16699,4472,0,0,18,6780,16,9919,33.777061,214.000837,253,370
"172.16.133.42",57038,"96.43.146.48",443,33,9094,4473,0,0,19,7195,14,1899,33.783421,254.30399200000002,226,59
"172.16.133.92",57654,"172.16.139.250",5440,10,1022,4474,0,0,10,1022,0,0,33.786169,0.0057169999999970855,1430120,0
"172.16.133.75",50857,"96.43.146.22",443,17,1037,4475,0,0,8,480,9,557,33.796553,262.232831,14,16
"172.16.133.29",60856,"172.16.139.250",5440,10,1022,4476,0,0,10,1022,0,0,33.801651,0.005515000000002601,1482502,0
"172.16.133.75",50596,"23.67.242.11",80,7,432,4477,0,0,4,240,3,192,33.803523,76.45098,25,20
"172.16.133.44",64749,"172.16.139.250",5440,12,1142,4478,0,0,12,1142,0,0,33.808912,0.015328000000003783,596033,0
"172.16.133.75",50593,"23.67.242.11",80,7,432,4479,0,0,4,240,3,192,33.811505,76.443,25,20
"172.16.133.207",55906,"172.16.139.250",5440,10,1022,4480,0,0,10,1022,0,0,33.835054,0.00476499999999902,"",""
"172.16.133.83",57062,"172.16.139.250",5440,12,1142,4481,0,0,12,1142,0,0,33.842655,0.004711999999997829,"",""
"172.16.133.93",60632,"172.16.139.250",5440,12,1142,4482,0,0,12,1142,0,0,33.860834,0.014876000000001,614143,0
"172.16.133.41",52777,"199.102.234.31",80,12,4727,4483,0,0,6,2759,6,1968,33.862498,0.11119099999999804,198505,141594
"172.16.133.11",55115,"172.16.139.250",5440,10,1022,4484,0,0,10,1022,0,0,33.876691,0.005680999999995606,1439183,0
"172.16.133.55",57552,"172.16.139.250",5440,12,1142,4485,0,0,12,1142,0,0,33.88051,0.015098999999999307,605073,0
"172.16.133.73",60605,"172.16.139.250",5440,12,1142,4486,0,0,12,1142,0,0,33.903752,0.006514000000002795,1402517,0
"172.16.133.53",54072,"172.16.139.250",5440,12,1142,4487,0,0,12,1142,0,0,33.906755,0.01544600000000429,591479,0
"172.16.133.21",53146,"172.16.139.250",5440,10,1022,4488,0,0,10,1022,0,0,33.908819,0.005850000000002353,1397606,0
"172.16.133.30",62586,"172.16.139.250",5440,12,1142,4489,0,0,12,1142,0,0,33.912946,0.01654600000000528,552157,0
"172.16.133.25",63410,"172.16.139.250",5440,12,1142,4490,0,0,12,1142,0,0,33.92061,0.005062999999999818,1804463,0
"172.16.133.34",50412,"172.16.139.250",5440,10,1022,4491,0,0,10,1022,0,0,33.929654,0.004936999999998193,"",""
"172.16.133.41",52778,"199.204.31.83",80,39,34511,4492,0,0,12,2463,27,32048,33.938138,1.7483299999999957,11270,146645
"172.16.133.97",59342,"172.16.139.250",5440,12,1142,4493,0,0,12,1142,0,0,33.941119,0.015821000000002527,577460,0
"172.16.133.121",56500,"173.194.41.111",443,39,6449,4494,0,0,19,2662,20,3787,33.953492,245.543628,86,123
"172.16.133.73",57022,"173.194.68.125",443,14,1817,4495,0,0,7,1336,7,481,33.973019,250.202098,42,15
"172.16.133.41",52075,"151.193.254.39",443,10,600,4496,0,0,5,300,5,300,33.98237,128.0014,18,18
"172.16.133.33",57854,"172.16.139.250",5440,10,1022,4497,0,0,10,1022,0,0,34.016725,0.005795999999996582,1410628,0
"172.16.133.75",49802,"96.43.146.176",443,17,3354,4498,0,0,9,2566,8,788,34.036522,225.404692,91,27
"172.16.133.68",60697,"172.16.139.250",5440,12,1142,4499,0,0,12,1142,0,0,34.046632,0.07133999999999929,128062,0
"172.16.133.82",54104,"157.56.232.214",443,20,2122,4500,0,0,10,1522,10,600,34.047916,227.379393,53,21
"172.16.133.12",59706,"172.16.139.250",5440,12,1142,4501,0,0,12,1142,0,0,34.060478,0.06328800000000001,144355,0
"172.16.133.67",55561,"96.43.146.178",443,5,317,4502,0,0,2,120,3,197,34.060968,0.045015999999996836,21325,35009
"172.16.133.67",55562,"96.43.146.178",443,5,317,4503,0,0,2,120,3,197,34.061075,0.04659099999999938,20604,33826
"172.16.133.67",55566,"96.43.146.178",443,5,317,4504,0,0,2,120,3,197,34.061185,0.04648199999999747,20653,33905
"172.16.133.67",55563,"96.43.146.178",443,5,317,4505,0,0,2,120,3,197,34.061292,0.04908799999999758,19556,32105
"172.16.133.67",55565,"96.43.146.178",443,5,317,4506,0,0,2,120,3,197,34.061346,0.04463599999999701,21507,35307
"172.16.133.67",55564,"96.43.146.178",443,5,317,4507,0,0,2,120,3,197,34.061464,0.043616999999997574,22009,36132
"172.16.133.63",53850,"172.16.139.250",5440,12,1142,4508,0,0,12,1142,0,0,34.06976,0.057580999999998994,158663,0
"172.16.133.66",53822,"172.16.139.250",5440,10,1022,4509,0,0,10,1022,0,0,34.084451,0.04717099999999874,173326,0
"172.16.133.82",61294,"172.16.139.250",5440,10,1022,4510,0,0,10,1022,0,0,34.096452,0.042819000000001495,190943,0
"172.16.133.37",60582,"172.16.139.250",5440,12,1142,4511,0,0,12,1142,0,0,34.129023,0.012216000000002225,747871,0
"172.16.133.116",53249,"8.27.243.253",80,16,4184,4512,0,0,8,922,8,3262,34.146748,15.499001999999997,475,1683
"172.16.133.116",53250,"8.27.243.253",80,18,8129,4513,0,0,8,1358,10,6771,34.146962,15.499125999999997,700,3494
"172.16.133.116",53251,"8.27.243.253",80,21,7797,4514,0,0,10,1478,11,6319,34.147081,15.499122999999997,762,3261
"172.16.133.116",53252,"8.27.243.253",80,18,4837,4515,0,0,9,988,9,3849,34.14727,15.499035,509,1986
"172.16.133.116",53253,"8.27.243.253",80,30,11607,4516,0,0,14,2154,16,9453,34.147417,15.499171000000004,1111,4879
"172.16.133.116",53254,"8.27.243.253",80,18,5233,4517,0,0,9,988,9,4245,34.147567,15.498933000000001,509,2191
"172.16.133.66",58185,"173.194.76.125",5222,14,907,4518,0,0,7,420,7,487,34.152646,257.676016,13,15
"172.16.133.78",59074,"172.16.139.250",5440,12,1142,4519,0,0,12,1142,0,0,34.268011,0.005710999999998023,1599719,0
"172.16.133.67",55957,"172.16.139.250",5440,10,1022,4520,0,0,10,1022,0,0,34.322815,0.006281000000001313,1301703,0
"172.16.133.56",61383,"172.16.139.250",5440,12,1142,4521,0,0,12,1142,0,0,34.34365,0.015115000000001544,604432,0
"172.16.133.42",57039,"172.16.139.250",5440,12,1142,4522,0,0,12,1142,0,0,34.370477,0.13472799999999552,67810,0
"172.16.133.126",61252,"96.43.146.22",443,9,557,4523,0,0,4,240,5,317,34.371951,82.40053599999999,23,30
"172.16.133.41",52779,"74.119.118.84",80,4,252,4524,0,0,2,126,2,126,34.392866,15.541022000000005,64,64
"172.16.133.41",52780,"74.119.118.84",80,15,9680,4525,0,0,7,4686,8,4994,34.392992,18.381634,2039,2173
"172.16.133.41",52781,"74.119.118.84",80,4,252,4526,0,0,2,126,2,126,34.3931,12.036724,83,83
"172.16.133.41",52782,"199.102.234.31",80,15,7174,4527,0,0,7,3095,8,4079,34.393453,2.5479759999999985,9717,12807
"172.16.133.41",52783,"199.102.234.31",80,36,30036,4528,0,0,11,2741,25,27295,34.393561,5.5661210000000025,3939,39230
"172.16.133.41",52784,"199.102.234.31",80,16,7606,4529,0,0,7,2550,9,5056,34.39362,5.742738000000003,3552,7043
"172.16.133.41",52785,"199.102.234.31",80,13,4915,4530,0,0,6,2631,7,2284,34.393737,5.673665,3709,3220
"172.16.133.41",52786,"199.102.234.31",80,14,4509,4531,0,0,7,2631,7,1878,34.393834,5.694032,3696,2638
"172.16.133.41",52787,"199.102.234.31",80,15,6754,4532,0,0,7,2721,8,4033,34.393942,7.776899,2799,4148
"172.16.133.41",52788,"173.194.43.59",80,6,372,4533,0,0,4,246,2,126,34.398607,15.613478999999998,126,64
"172.16.133.41",52789,"173.194.43.59",80,6,372,4534,0,0,4,246,2,126,34.398755,15.613281,126,64
"172.16.133.41",52790,"74.125.226.91",80,6,372,4535,0,0,4,246,2,126,34.398871,15.633477,125,64
"172.16.133.41",52791,"74.125.226.91",80,38,13458,4536,0,0,19,9943,19,3515,34.398965,259.925071,306,108
"172.16.133.41",52792,"208.47.254.27",80,6,372,4537,0,0,4,246,2,126,34.399109,15.614781999999998,126,64
"172.16.133.41",52793,"208.47.254.27",80,6,372,4538,0,0,4,246,2,126,34.399207,15.614683000000007,126,64
"172.16.133.41",52794,"208.47.254.27",80,6,372,4539,0,0,4,246,2,126,34.39932,15.613757999999997,126,64
"172.16.133.41",52795,"208.47.254.27",80,6,372,4540,0,0,4,246,2,126,34.399404,15.614535000000004,126,64
"172.16.133.75",50922,"172.16.139.250",5440,10,1022,4541,0,0,10,1022,0,0,34.399477,0.05841099999999955,139973,0
"172.16.133.41",52796,"23.33.82.110",443,16,3255,4542,0,0,8,891,8,2364,34.399612,27.533698,258,686
"172.16.133.41",52797,"23.33.82.110",443,16,3255,4543,0,0,8,891,8,2364,34.3997,27.533932999999998,258,686
"172.16.133.41",52798,"23.33.82.110",443,16,3255,4544,0,0,8,891,8,2364,34.399788,27.533307,258,686
"172.16.133.41",52799,"173.194.43.41",80,6,372,4545,0,0,4,246,2,126,34.400204,15.611882999999999,126,64
"172.16.133.41",52800,"173.194.43.41",80,6,372,4546,0,0,4,246,2,126,34.400467,15.611697,126,64
"172.16.133.41",52801,"173.194.43.41",80,31,8751,4547,0,0,17,6395,14,2356,34.400575,259.838126,196,72
"172.16.133.41",52802,"172.16.139.250",5440,10,1022,4548,0,0,10,1022,0,0,34.401793,0.060710000000000264,134673,0
"172.16.133.85",52219,"172.16.139.250",5440,12,1142,4549,0,0,12,1142,0,0,34.417288,0.04735600000000062,192921,0
"172.16.133.43",57736,"172.16.139.250",5440,12,1142,4550,0,0,12,1142,0,0,34.472966,0.006529999999997926,1399081,0
"172.16.133.13",53011,"172.16.139.250",5440,12,1142,4551,0,0,12,1142,0,0,34.48893,0.0063299999999983925,1443285,0
"172.16.133.41",52803,"216.52.121.204",80,13,5783,4552,0,0,7,3328,6,2455,34.509281,0.2145229999999998,124107,91551
"172.16.133.66",53359,"96.43.146.22",443,5,317,4553,0,0,2,120,3,197,34.510716,0.04436799999999863,21637,35521
"172.16.133.66",53358,"96.43.146.22",443,5,317,4554,0,0,2,120,3,197,34.510996,0.04414200000000079,21747,35702
"172.16.133.66",53357,"96.43.146.22",443,5,317,4555,0,0,2,120,3,197,34.511185,0.04721100000000433,20334,33382
"172.16.133.66",53360,"96.43.146.22",443,5,317,4556,0,0,2,120,3,197,34.51138,0.04602899999999721,20856,34239
"172.16.133.20",60387,"96.43.146.22",443,27,12474,4557,0,0,15,10683,12,1791,34.513791,111.345158,767,128
"172.16.133.20",62351,"172.16.139.250",5440,12,1142,4558,0,0,12,1142,0,0,34.538753,0.005552999999999031,1645236,0
"172.16.133.28",65336,"172.16.139.250",5440,12,1142,4559,0,0,12,1142,0,0,34.570597,0.016012000000003468,570572,0
"172.16.133.87",60103,"96.43.146.22",443,17,1037,4560,0,0,8,480,9,557,34.586203,261.38842,14,17
"172.16.133.92",57467,"96.43.146.22",443,13,797,4561,0,0,6,360,7,437,34.589713,166.07089100000002,17,21
"172.16.133.113",52918,"50.17.253.124",80,15,5000,4562,0,0,10,2580,5,2420,34.593033,244.74456000000004,84,79
"172.16.133.99",56016,"172.16.139.250",5440,12,1142,4563,0,0,12,1142,0,0,34.595445,0.005352000000002022,1707025,0
"172.16.133.87",60104,"96.43.146.22",443,18,3724,4564,0,0,10,2956,8,768,34.604226,245.36830000000003,96,25
"172.16.133.87",60157,"172.16.139.250",5440,12,1142,4565,0,0,12,1142,0,0,34.618398,0.006432000000003768,1420398,0
"172.16.133.35",49944,"172.16.139.250",5440,12,1142,4566,0,0,12,1142,0,0,34.631878,0.027250000000002217,335266,0
"172.16.133.116",53255,"172.16.139.250",5440,10,1022,4567,0,0,10,1022,0,0,34.636241,0.005814999999998349,1406018,0
"172.16.133.116",53256,"172.16.139.250",5440,12,1142,4568,0,0,12,1142,0,0,34.645023,0.0081869999999995,1115915,0
"172.16.133.116",53257,"172.16.139.250",5440,12,1142,4569,0,0,12,1142,0,0,34.653875,0.006709000000000742,1361752,0
"172.16.133.84",58764,"172.16.139.250",5440,10,1022,4570,0,0,10,1022,0,0,34.655657,0.007840000000001623,1042857,0
"172.16.133.75",64262,"96.43.146.22",443,34,15762,4571,0,0,20,13395,14,2367,34.658527,255.53277100000003,419,74
"172.16.133.75",50856,"96.43.146.22",443,35,15890,4572,0,0,20,13480,15,2410,34.663549,233.991237,460,82
"172.16.133.126",61253,"96.43.146.22",443,9,557,4573,0,0,4,240,5,317,34.671805,82.103744,23,30
"172.16.133.41",52804,"96.43.146.22",443,23,4406,4574,0,0,13,3389,10,1017,34.672159,225.33624799999998,120,36
"172.16.133.36",64793,"132.245.2.22",443,2,120,4575,0,0,1,60,1,60,34.696754,8.600000000313912e-05,"",""
"172.16.133.36",65075,"132.245.2.22",443,182,79117,4576,0,0,84,34164,98,44953,34.697296,242.40767900000003,1127,1483
"172.16.133.41",52805,"216.52.121.204",80,16,7633,4577,0,0,8,3388,8,4245,34.713425,0.9711280000000002,27909,34969
"172.16.133.114",55261,"173.194.43.39",80,10,618,4578,0,0,5,300,5,318,34.730046,113.423152,21,22
"172.16.133.49",55739,"172.16.139.250",5440,10,1022,4579,0,0,10,1022,0,0,34.734539,0.005515000000002601,1482502,0
"172.16.133.41",52806,"216.52.121.204",80,12,3874,4580,0,0,7,3317,5,557,34.736696,0.1505549999999971,176254,29597
"172.16.133.41",52807,"216.52.121.204",80,12,3874,4581,0,0,7,3317,5,557,34.74195,0.15065299999999837,176139,29577
"172.16.133.41",52808,"216.52.121.204",80,12,3874,4582,0,0,7,3317,5,557,34.744737,0.14657199999999904,181044,30401
"172.16.133.41",52809,"216.52.121.204",80,12,3874,4583,0,0,7,3317,5,557,34.748746,0.14632500000000448,181349,30452
"172.16.133.41",52810,"216.52.121.204",80,12,3874,4584,0,0,7,3317,5,557,34.753267,0.13914700000000124,190704,32023
"172.16.133.37",60583,"67.217.64.244",443,6,366,4585,0,0,4,246,2,120,34.755503,0.05509500000000145,35720,17424
"172.16.133.37",60584,"216.115.223.200",443,6,366,4586,0,0,4,246,2,120,34.766363,0.08465300000000298,23247,11340
"172.16.133.95",56939,"172.16.139.250",5440,12,1142,4587,0,0,12,1142,0,0,34.769594,0.0068310000000053606,1337432,0
"172.16.133.92",57655,"172.16.139.250",5440,10,1022,4588,0,0,10,1022,0,0,34.798814,0.01546199999999942,528780,0
"172.16.133.34",61119,"96.43.146.48",443,255,184177,4589,0,0,120,67360,135,116817,34.809345,264.242692,2039,3536
"172.16.133.29",60857,"172.16.139.250",5440,10,1022,4590,0,0,10,1022,0,0,34.815849,0.01720900000000114,475100,0
"172.16.133.44",64750,"172.16.139.250",5440,10,1022,4591,0,0,10,1022,0,0,34.82381,0.019655999999997675,415954,0
"172.16.133.37",60585,"66.151.150.190",443,6,366,4592,0,0,4,246,2,120,34.829349,0.21840100000000007,9010,4395
"172.16.133.37",60586,"216.219.113.250",443,6,366,4593,0,0,4,246,2,120,34.831135,0.22008299999999537,8942,4361
"172.16.133.207",55907,"172.16.139.250",5440,12,1142,4594,0,0,12,1142,0,0,34.848019,0.0187790000000021,486500,0
"172.16.133.83",57063,"172.16.139.250",5440,10,1022,4595,0,0,10,1022,0,0,34.856764,0.005953000000005204,1373425,0
"172.16.133.93",60633,"172.16.139.250",5440,12,1142,4596,0,0,12,1142,0,0,34.873599,0.004907000000002881,"",""
"172.16.133.87",60102,"96.43.146.22",443,71,38662,4597,0,0,40,32651,31,6011,34.874148,222.07554900000002,1176,216
"172.16.133.11",55116,"172.16.139.250",5440,12,1142,4598,0,0,12,1142,0,0,34.891243,0.014868999999997357,614432,0
"172.16.133.55",57553,"172.16.139.250",5440,12,1142,4599,0,0,12,1142,0,0,34.894386,0.0059820000000030404,1527248,0
"172.16.133.73",60606,"172.16.139.250",5440,12,1142,4600,0,0,12,1142,0,0,34.918936,0.006163999999998282,1482154,0
"172.16.133.53",54073,"172.16.139.250",5440,12,1142,4601,0,0,12,1142,0,0,34.919864,0.018516000000005306,493411,0
"172.16.133.21",53147,"172.16.139.250",5440,12,1142,4602,0,0,12,1142,0,0,34.924056,0.006410000000002469,1425273,0
"172.16.133.30",62587,"172.16.139.250",5440,10,1022,4603,0,0,10,1022,0,0,34.927554,0.006146000000001095,1330296,0
"172.16.133.25",63411,"172.16.139.250",5440,12,1142,4604,0,0,12,1142,0,0,34.935525,0.006025000000001057,1516348,0
"172.16.133.85",61904,"96.43.146.178",443,12,720,4605,0,0,6,360,6,360,34.937564,225.276902,12,12
"172.16.133.34",50413,"172.16.139.250",5440,12,1142,4606,0,0,12,1142,0,0,34.943663,0.014389000000001317,634929,0
"172.16.133.97",59343,"172.16.139.250",5440,10,1022,4607,0,0,10,1022,0,0,34.955285,0.015380999999997869,531564,0
"172.16.133.103",63436,"157.56.234.137",443,6,374,4608,0,0,3,194,3,180,34.975285,1.2874809999999997,1205,1118
"172.16.133.12",59707,"172.16.139.250",5440,10,1022,4609,0,0,10,1022,0,0,35.0123,0.015978999999994414,511671,0
"172.16.133.33",57855,"172.16.139.250",5440,12,1142,4610,0,0,12,1142,0,0,35.030942,0.006325999999994281,1444198,0
"172.16.133.24",55887,"157.56.242.198",443,10,795,4611,0,0,5,495,5,300,35.031945,240.016546,16,9
"172.16.133.68",60698,"172.16.139.250",5440,12,1142,4612,0,0,12,1142,0,0,35.06083,0.0067430000000001655,1354886,0
"172.16.133.12",59708,"172.16.139.250",5440,12,1142,4613,0,0,12,1142,0,0,35.07391,0.006292999999999438,1451771,0
"172.16.133.40",50025,"173.252.110.27",443,8,532,4614,0,0,3,180,5,352,35.077706,29.717907000000004,48,94
"172.16.133.63",53851,"172.16.139.250",5440,10,1022,4615,0,0,10,1022,0,0,35.083492,0.005147999999998376,1588189,0
"172.16.133.66",53823,"172.16.139.250",5440,12,1142,4616,0,0,12,1142,0,0,35.098782,0.006188000000001637,1476405,0
"172.16.133.24",57595,"96.43.146.22",443,15,3891,4617,0,0,8,2958,7,933,35.103808,225.230837,105,33
"172.16.133.82",61295,"172.16.139.250",5440,12,1142,4618,0,0,12,1142,0,0,35.110956,0.016404999999998893,556903,0
"172.16.133.35",57171,"96.43.146.22",443,37,16360,4619,0,0,21,13566,16,2794,35.124471,255.71422399999997,424,87
"172.16.133.37",60587,"172.16.139.250",5440,10,1022,4620,0,0,10,1022,0,0,35.124864,0.00728600000000057,1122152,0
"172.16.133.48",60506,"184.173.190.13",80,22,11303,4621,0,0,12,8315,10,2988,35.152747,85.998651,773,277
"172.16.133.56",53119,"173.194.76.125",443,14,907,4622,0,0,7,420,7,487,35.203954,257.485913,13,15
"172.16.133.78",59075,"172.16.139.250",5440,10,1022,4623,0,0,10,1022,0,0,35.282037,0.005561000000000149,1470239,0
"172.16.133.36",65076,"132.245.2.22",443,33,16487,4624,0,0,18,6784,15,9703,35.319415,0.6517979999999994,83265,119092
"172.16.133.83",65169,"96.43.146.176",443,25,8055,4625,0,0,15,5010,10,3045,35.324493,240.35274,166,101
"172.16.133.67",55958,"172.16.139.250",5440,10,1022,4626,0,0,10,1022,0,0,35.336629,0.0057929999999970505,1411358,0
"172.16.133.41",52811,"199.204.31.83",80,12,4656,4627,0,0,6,2125,6,2531,35.344881,0.2557770000000019,66464,79162
"172.16.133.56",61384,"172.16.139.250",5440,10,1022,4628,0,0,10,1022,0,0,35.359609,0.015140999999999849,539990,0
"172.16.133.41",52812,"208.47.254.26",80,41,26635,4629,0,0,17,3478,24,23157,35.37216,225.923427,123,819
"172.16.133.41",52813,"208.47.254.26",80,33,15717,4630,0,0,15,3372,18,12345,35.372399,226.40760400000002,119,436
"172.16.133.41",52814,"208.47.254.24",80,70,60448,4631,0,0,25,4919,45,55529,35.372802,226.309355,173,1962
"172.16.133.41",52815,"208.47.254.32",80,82,79669,4632,0,0,24,3115,58,76554,35.375949,225.48083100000002,110,2716
"172.16.133.41",52816,"208.47.254.32",80,25,13037,4633,0,0,10,1438,15,11599,35.376153,225.209087,51,412
"172.16.133.42",57040,"172.16.139.250",5440,12,1142,4634,0,0,12,1142,0,0,35.382882,0.014772999999998149,618425,0
"172.16.133.41",52817,"208.47.254.9",80,30,17909,4635,0,0,12,2380,18,15529,35.401671,225.391269,84,551
"172.16.133.41",52818,"208.47.254.9",80,58,48662,4636,0,0,20,2860,38,45802,35.401854,225.54848199999998,101,1624
"172.16.133.75",50923,"172.16.139.250",5440,10,1022,4637,0,0,10,1022,0,0,35.413533,0.006341999999996517,1289183,0
"172.16.133.41",52819,"172.16.139.250",5440,10,1022,4638,0,0,10,1022,0,0,35.415278,0.009448999999996488,865276,0
"157.56.236.102",443,"172.16.133.56",60946,10,775,4639,0,0,5,475,5,300,35.418286,239.768245,15,10
"172.16.133.85",52220,"172.16.139.250",5440,10,1022,4640,0,0,10,1022,0,0,35.432752,0.005355999999999028,1526512,0
"172.16.133.73",60607,"74.125.226.8",80,24,3178,4641,0,0,13,1983,11,1195,35.43917,263.179357,60,36
"172.16.133.41",52820,"216.137.33.133",80,44,36976,4642,0,0,14,1670,30,35306,35.439621,124.601792,107,2266
"172.16.133.99",55880,"173.194.43.3",443,12,828,4643,0,0,5,300,7,528,35.465554,104.92448999999999,22,40
"172.16.133.43",57737,"172.16.139.250",5440,12,1142,4644,0,0,12,1142,0,0,35.487267,0.01659999999999684,550361,0
"172.16.133.13",53012,"172.16.139.250",5440,12,1142,4645,0,0,12,1142,0,0,35.503017,0.006281000000001313,1454545,0
"172.16.133.35",55407,"74.125.142.125",443,14,907,4646,0,0,7,420,7,487,35.528237,256.584422,13,15
"172.16.133.20",62352,"172.16.139.250",5440,10,1022,4647,0,0,10,1022,0,0,35.552596,0.01445900000000222,565460,0
"172.16.133.87",59810,"96.43.146.22",443,30,12448,4648,0,0,17,10448,13,2000,35.554206,255.27420200000003,327,62
"172.16.133.41",52821,"208.47.254.9",80,30,19677,4649,0,0,11,1512,19,18165,35.571407,225.42579600000002,53,644
"172.16.133.41",52822,"208.47.254.9",80,22,9180,4650,0,0,10,1436,12,7744,35.572582,225.283973,50,274
"172.16.133.41",52823,"208.47.254.9",80,67,65619,4651,0,0,18,1933,49,63686,35.572862,225.44411300000002,68,2259
"172.16.133.29",60096,"173.194.43.60",80,61,33168,4652,0,0,29,18276,32,14892,35.573864,259.228569,564,459
"172.16.133.28",65337,"172.16.139.250",5440,10,1022,4653,0,0,10,1022,0,0,35.583646,0.005378000000000327,1520267,0
"172.16.133.41",52824,"23.67.242.27",80,25,11118,4654,0,0,13,5019,12,6099,35.591752,225.38960300000002,178,216
"172.16.133.41",52825,"23.67.242.27",80,31,11932,4655,0,0,16,5197,15,6735,35.591902,226.90564,183,237
"172.16.133.41",52826,"23.67.242.27",80,28,13183,4656,0,0,14,4224,14,8959,35.592003,225.38625799999997,149,317
"172.16.133.41",52827,"23.67.242.27",80,30,13517,4657,0,0,16,6035,14,7482,35.592269,227.13827000000003,212,263
"172.16.133.41",52828,"23.67.242.27",80,21,7415,4658,0,0,11,3210,10,4205,35.592362,225.39003599999998,113,149
"172.16.133.41",52829,"23.67.242.27",80,19,4810,4659,0,0,10,2290,9,2520,35.592564,225.38668599999997,81,89
"172.16.133.20",61376,"96.43.146.22",443,42,19145,4660,0,0,25,16180,17,2965,35.592782,256.774488,504,92
"172.16.133.41",52830,"66.114.52.25",80,16,4449,4661,0,0,7,1220,9,3229,35.593238,14.423307999999999,676,1790
"172.16.133.41",52831,"174.35.22.77",80,30,14224,4662,0,0,11,2295,19,11929,35.60407,14.409345000000002,1274,6622
"172.16.133.41",52832,"173.194.74.95",80,48,35187,4663,0,0,16,1821,32,33366,35.604698,244.404651,59,1092
"172.16.133.99",56017,"172.16.139.250",5440,10,1022,4664,0,0,10,1022,0,0,35.609798,0.014493000000001643,564134,0
"172.16.133.41",52833,"216.52.121.204",80,14,5194,4665,0,0,8,3390,6,1804,35.620262,0.2069050000000061,131074,69751
"172.16.133.120",53418,"173.194.43.34",80,6,366,4666,0,0,3,180,3,186,35.628552,24.837935,57,59
"172.16.133.87",60159,"172.16.139.250",5440,10,1022,4667,0,0,10,1022,0,0,35.632248,0.006304000000000087,1296954,0
"172.16.133.35",49945,"172.16.139.250",5440,12,1142,4668,0,0,12,1142,0,0,35.646127,0.014479999999998938,630939,0
"172.16.133.116",53258,"172.16.139.250",5440,10,1022,4669,0,0,10,1022,0,0,35.648498000000004,0.0051749999999941565,1579903,0
"172.16.133.41",52834,"216.52.121.204",80,12,3876,4670,0,0,7,3319,5,557,35.648668,0.18548599999999738,143148,24023
"172.16.133.116",53259,"172.16.139.250",5440,10,1022,4671,0,0,10,1022,0,0,35.654316,0.00712199999999541,1147992,0
"172.16.133.41",52835,"216.52.121.204",80,12,3876,4672,0,0,7,3319,5,557,35.654644,0.16953800000000285,156613,26283
"172.16.133.41",52836,"216.52.121.204",80,12,3876,4673,0,0,7,3319,5,557,35.65712,0.1770350000000036,149981,25170
"172.16.133.41",52837,"216.52.121.204",80,12,3876,4674,0,0,7,3319,5,557,35.659775,0.16429899999999975,161607,27121
"172.16.133.116",53260,"172.16.139.250",5440,10,1022,4675,0,0,10,1022,0,0,35.662056,0.00672800000000251,1215219,0
"172.16.133.84",58765,"172.16.139.250",5440,10,1022,4676,0,0,10,1022,0,0,35.66988,0.015401000000004217,530874,0
"172.16.133.78",59077,"67.69.174.9",80,148,151647,4677,0,0,39,4610,109,147037,35.691692,227.068493,162,5180
"172.16.133.103",61730,"172.16.139.250",5447,12,1680,4678,0,0,12,1680,0,0,35.693791,234.884512,57,0
"172.16.133.78",59078,"67.69.174.9",80,163,179793,4679,0,0,39,3606,124,176187,35.739125,226.910915,127,6211
"172.16.133.49",55740,"172.16.139.250",5440,10,1022,4680,0,0,10,1022,0,0,35.747185,0.015352000000000032,532569,0
"172.16.133.63",53398,"173.194.43.60",80,12,744,4681,0,0,6,360,6,384,35.756739,151.965507,18,20
"172.16.133.113",55601,"172.16.139.250",135,8,492,4682,0,0,8,492,0,0,35.759371,0.006233000000001709,631477,0
"172.16.133.113",55602,"172.16.139.250",5462,12,816,4683,0,0,12,816,0,0,35.770135,0.5118279999999942,12754,0
"172.16.133.95",56940,"172.16.139.250",5440,12,1142,4684,0,0,12,1142,0,0,35.784483,0.01642299999999608,556293,0
"172.16.133.41",52838,"70.42.13.101",80,17,7203,4685,0,0,8,2429,9,4774,35.796977,14.214269999999999,1367,2686
"172.16.133.101",50448,"96.43.146.22",443,30,18271,4686,0,0,20,16145,10,2126,35.812054,240.561267,536,70
"172.16.133.41",52839,"216.52.121.204",80,13,5061,4687,0,0,7,3330,6,1731,35.813401999999996,6.396947000000004,4164,2164
"172.16.133.92",57656,"172.16.139.250",5440,10,1022,4688,0,0,10,1022,0,0,35.81445,0.005546000000002493,1474215,0
"172.16.133.29",60858,"172.16.139.250",5440,12,1142,4689,0,0,12,1142,0,0,35.830602999999996,0.10268000000000654,88975,0
"172.16.133.44",64751,"172.16.139.250",5440,10,1022,4690,0,0,10,1022,0,0,35.837083,0.10336699999999865,79096,0
"172.16.133.207",55908,"172.16.139.250",5440,12,1142,4691,0,0,12,1142,0,0,35.863099,0.07366499999999832,124020,0
"172.16.133.83",57064,"172.16.139.250",5440,10,1022,4692,0,0,10,1022,0,0,35.870953,0.07477800000000201,109336,0
"172.16.133.41",52840,"199.204.31.123",80,12,3797,4693,0,0,7,3245,5,552,35.879431,0.2967820000000003,87471,14879
"172.16.133.41",52841,"199.204.29.117",80,27,13657,4694,0,0,14,8222,13,5435,35.880238,4.175909000000004,15751,10412
"172.16.133.93",60634,"172.16.139.250",5440,12,1142,4695,0,0,12,1142,0,0,35.887853,0.060951000000002864,149890,0
"172.16.133.11",55117,"172.16.139.250",5440,12,1142,4696,0,0,12,1142,0,0,35.905382,0.04926499999999834,185446,0
"172.16.133.55",57554,"172.16.139.250",5440,12,1142,4697,0,0,12,1142,0,0,35.908364,0.05030100000000459,181626,0
"172.16.133.29",60114,"208.44.23.59",80,60,27285,4698,0,0,39,21596,21,5689,35.910931,261.541074,660,174
"172.16.133.73",60608,"172.16.139.250",5440,12,1142,4699,0,0,12,1142,0,0,35.932597,0.02985400000000027,306022,0
"172.16.133.53",54074,"172.16.139.250",5440,10,1022,4700,0,0,10,1022,0,0,35.934155,0.031285000000004004,261339,0
"172.16.133.128",64954,"96.43.146.22",443,35,15880,4701,0,0,20,13470,15,2410,35.937025,234.010493,460,82
"172.16.133.21",53148,"172.16.139.250",5440,10,1022,4702,0,0,10,1022,0,0,35.938039,0.03237699999999677,252524,0
"172.16.133.30",62588,"172.16.139.250",5440,12,1142,4703,0,0,12,1142,0,0,35.941154,0.03668400000000105,249045,0
"172.16.133.25",63412,"172.16.139.250",5440,12,1142,4704,0,0,12,1142,0,0,35.949485,0.024839000000000055,367808,0
"172.16.133.34",50414,"172.16.139.250",5440,12,1142,4705,0,0,12,1142,0,0,35.95771,0.024087000000001524,379291,0
"172.16.133.97",59344,"172.16.139.250",5440,10,1022,4706,0,0,10,1022,0,0,35.969009,0.01619099999999918,504971,0
"172.16.133.120",53420,"173.194.43.47",443,11,762,4707,0,0,5,300,6,462,35.986591,59.96703300000001,40,61
"172.16.133.26",49486,"96.43.146.176",443,26,8115,4708,0,0,15,5010,11,3105,36.004959,240.345511,166,103
"172.16.133.67",53011,"96.43.146.48",443,245,187231,4709,0,0,117,96257,128,90974,36.035922,220.59859400000002,3490,3299
"172.16.133.33",57856,"172.16.139.250",5440,10,1022,4710,0,0,10,1022,0,0,36.043587,0.0064869999999999095,1260366,0
"172.16.133.68",60699,"172.16.139.250",5440,10,1022,4711,0,0,10,1022,0,0,36.075,0.01725799999999822,473751,0
"172.16.133.12",59709,"172.16.139.250",5440,12,1142,4712,0,0,12,1142,0,0,36.088102,0.008009000000001265,1140716,0
"172.16.133.63",53852,"172.16.139.250",5440,10,1022,4713,0,0,10,1022,0,0,36.09793,0.005290000000002237,1545557,0
"172.16.133.66",53824,"172.16.139.250",5440,10,1022,4714,0,0,10,1022,0,0,36.113368,0.007213999999997611,1133351,0
"172.16.133.82",61296,"172.16.139.250",5440,10,1022,4715,0,0,10,1022,0,0,36.12467,0.015191999999998984,538177,0
"172.16.133.116",54533,"157.56.245.198",443,15,1360,4716,0,0,8,940,7,420,36.124947,239.028264,31,14
"172.16.133.37",60588,"172.16.139.250",5440,10,1022,4717,0,0,10,1022,0,0,36.138702,0.005832999999995536,1401680,0
"172.16.133.28",49243,"172.16.139.250",5500,568,280116,4718,0,0,568,280116,0,0,36.148632,258.33181199999996,8674,0
"172.16.133.120",53415,"173.194.75.106",443,9,636,4719,0,0,4,240,5,396,36.194615,14.813346000000003,129,213
"172.16.133.78",59079,"67.69.174.9",80,148,151520,4720,0,0,39,5080,109,146440,36.208829,226.47856299999998,179,5172
"172.16.133.78",59080,"67.69.174.9",80,96,88549,4721,0,0,28,4589,68,83960,36.209188,226.55132600000002,162,2964
"172.16.133.78",59081,"67.69.174.9",80,84,66605,4722,0,0,33,5675,51,60930,36.209499,226.441707,200,2152
"172.16.133.28",65338,"74.125.226.229",443,38,5289,4723,0,0,20,2907,18,2382,36.231099,236.877741,98,80
"172.16.133.103",63437,"157.56.236.89",80,8,884,4724,0,0,5,532,3,352,36.265424,0.26783899999999505,15890,10513
"172.16.133.78",59082,"172.16.139.250",5440,10,1022,4725,0,0,10,1022,0,0,36.296985,0.009371000000001573,872478,0
"172.16.133.78",59083,"67.69.174.9",80,148,154967,4726,0,0,39,3569,109,151398,36.314606,226.416708,126,5349
"172.16.133.24",57688,"172.16.128.169",8014,15,6178,4727,0,0,8,3226,7,2952,36.344969,2.5840999999999994,9987,9138
"172.16.133.67",55959,"172.16.139.250",5440,10,1022,4728,0,0,10,1022,0,0,36.350079,0.006168999999999869,1325336,0
"172.16.133.85",52221,"172.16.128.169",8014,12,5413,4729,0,0,6,2653,6,2760,36.35499,2.2336489999999998,9501,9885
"172.16.133.116",53261,"172.16.128.169",8014,12,5434,4730,0,0,6,2674,6,2760,36.358983,2.4825019999999967,8617,8894
"172.16.133.78",59084,"23.60.238.131",443,117,100293,4731,0,0,41,9076,76,91217,36.359865,248.53148699999997,292,2936
"172.16.133.73",60609,"172.16.128.169",8014,15,6145,4732,0,0,8,3193,7,2952,36.362627,2.665393999999999,9583,8860
"172.16.133.39",64251,"172.16.128.169",8014,10,4606,4733,0,0,5,1906,5,2700,36.363475,2.163286999999997,7048,9984
"172.16.133.84",58766,"172.16.128.169",8014,12,5434,4734,0,0,6,2674,6,2760,36.364654,2.2859569999999962,9358,9658
"172.16.133.76",62350,"96.43.146.22",443,13,797,4735,0,0,6,360,7,437,36.364971,165.598535,17,21
"172.16.133.28",65339,"173.194.43.40",443,53,17104,4736,0,0,25,2934,28,14170,36.366698,240.193734,97,471
"172.16.133.29",60859,"172.16.128.169",8014,10,4584,4737,0,0,5,1884,5,2700,36.368998,2.1575460000000035,6985,10011
"172.16.133.56",61385,"172.16.139.250",5440,12,1142,4738,0,0,12,1142,0,0,36.372131,0.005094999999997185,1793130,0
"172.16.133.87",65530,"157.56.240.102",443,10,775,4739,0,0,5,475,5,300,36.382376,240.02606,15,9
"172.16.133.42",57041,"172.16.139.250",5440,12,1142,4740,0,0,12,1142,0,0,36.389471,0.010626999999999498,859696,0
"172.16.133.44",64752,"172.16.128.169",8014,12,5414,4741,0,0,6,2654,6,2760,36.389613,2.2736540000000005,9338,9711
"172.16.133.78",59085,"67.69.174.18",80,34,20140,4742,0,0,14,1877,20,18263,36.392799,228.20861399999998,65,640
"172.16.133.78",59086,"12.129.199.104",80,7,1164,4743,0,0,4,639,3,525,36.426223,10.270090000000003,497,408
"172.16.133.78",59087,"67.69.174.122",80,45,38022,4744,0,0,14,1236,31,36786,36.426486,225.652468,43,1304
"172.16.133.75",50924,"172.16.139.250",5440,12,1142,4745,0,0,12,1142,0,0,36.427624,0.005649999999995714,1616991,0
"172.16.133.41",52842,"172.16.139.250",5440,12,1142,4746,0,0,12,1142,0,0,36.428214,0.015424000000002991,592323,0
"172.16.133.132",37936,"76.13.6.174",80,7,482,4747,0,0,4,272,3,210,36.439389,0.0705950000000044,30823,23797
"172.16.133.85",52222,"172.16.139.250",5440,12,1142,4748,0,0,12,1142,0,0,36.44538,0.015225000000000932,600065,0
"172.16.133.103",63438,"132.245.1.166",443,24,9707,4749,0,0,11,2959,13,6748,36.454331,1.6805099999999982,14086,32123
"172.16.133.41",52843,"208.47.254.24",80,22,4343,4750,0,0,12,2427,10,1916,36.475519,225.90870100000004,85,67
"172.16.133.41",52844,"208.47.254.24",80,6,372,4751,0,0,4,246,2,126,36.475983,13.536178999999997,145,74
"157.56.234.118",443,"172.16.133.28",49296,12,936,4752,0,0,6,570,6,366,36.478632,240.28722499999998,18,12
"172.16.133.78",59088,"205.234.225.137",80,40,29621,4753,0,0,14,1339,26,28282,36.487485,225.553354,47,1003
"172.16.133.43",57738,"172.16.139.250",5440,12,1142,4754,0,0,12,1142,0,0,36.499864,0.006368999999999403,1434448,0
"172.16.133.13",53013,"172.16.139.250",5440,12,1142,4755,0,0,12,1142,0,0,36.516904,0.024282000000006576,376245,0
"172.16.133.45",61325,"172.16.139.250",5440,12,1142,4756,0,0,12,1142,0,0,36.518074,0.0064640000000011355,1413366,0
"172.16.133.14",63142,"172.16.128.169",8014,12,5446,4757,0,0,6,2686,6,2760,36.548384,2.370311000000001,9065,9315
"172.16.133.132",54013,"23.33.95.139",80,6,412,4758,0,0,4,272,2,140,36.550028,0.05762599999999907,37760,19435
"172.16.133.20",62353,"172.16.139.250",5440,10,1022,4759,0,0,10,1022,0,0,36.56714,0.014193999999996265,576018,0
"172.16.133.92",49664,"96.43.146.48",443,26,8075,4760,0,0,15,5010,11,3065,36.567828,240.33098700000002,166,102
"172.16.133.28",65340,"172.16.139.250",5440,12,1142,4761,0,0,12,1142,0,0,36.598371,0.006157000000001744,1483839,0
"172.16.133.41",52845,"23.62.105.231",80,6,372,4762,0,0,4,246,2,126,36.610533,13.430029000000005,146,75
"172.16.133.41",52846,"174.129.245.199",80,13,3943,4763,0,0,7,3078,6,865,36.611941,13.404491999999998,1836,516
"172.16.133.41",52847,"174.129.245.199",80,6,372,4764,0,0,4,246,2,126,36.612037,13.405251,146,75
"172.16.133.41",52848,"208.47.254.8",80,7,432,4765,0,0,4,246,3,186,36.612185,13.400843000000002,146,111
"172.16.133.41",52849,"23.21.215.52",80,16,3621,4766,0,0,8,3039,8,582,36.612339,63.394399,383,73
"172.16.133.41",52850,"23.21.215.52",80,7,432,4767,0,0,4,246,3,186,36.61245,13.405679,146,110
"172.16.133.99",56018,"172.16.139.250",5440,12,1142,4768,0,0,12,1142,0,0,36.623388,0.0050950000000042905,1793130,0
"172.16.133.132",49215,"98.139.161.29",80,7,478,4769,0,0,4,272,3,206,36.643173,0.14669100000000412,14833,11234
"172.16.133.87",60160,"172.16.139.250",5440,10,1022,4770,0,0,10,1022,0,0,36.64525,0.0056550000000044065,1445800,0
"172.16.133.35",49946,"172.16.139.250",5440,12,1142,4771,0,0,12,1142,0,0,36.659661,0.008000000000002672,1141999,0
"172.16.133.116",53262,"172.16.139.250",5440,10,1022,4772,0,0,10,1022,0,0,36.664343,0.005465000000000941,1496065,0
"172.16.133.116",53263,"172.16.139.250",5440,10,1022,4773,0,0,10,1022,0,0,36.670347,0.013911000000000229,587736,0
"172.16.133.116",53264,"172.16.139.250",5440,10,1022,4774,0,0,10,1022,0,0,36.685423,0.005248999999999171,1557630,0
"172.16.133.84",58767,"172.16.139.250",5440,12,1142,4775,0,0,12,1142,0,0,36.685965,0.00939099999999371,972846,0
"172.16.133.40",52698,"172.16.139.250",5447,12,1668,4776,0,0,12,1668,0,0,36.698199,252.898915,52,0
"172.16.133.56",49621,"96.43.146.48",443,27,9271,4777,0,0,17,6226,10,3045,36.730424,240.360128,207,101
"172.16.133.41",52851,"199.204.31.89",80,10,3507,4778,0,0,5,1383,5,2124,36.738763,0.24704499999999996,44785,68780
"132.245.1.150",443,"172.16.133.17",54476,32,5491,4779,0,0,19,4705,13,786,36.741469,260.274481,144,24
"172.16.133.49",55741,"172.16.139.250",5440,10,1022,4780,0,0,10,1022,0,0,36.762403,0.03321199999999891,246176,0
"172.16.133.48",60507,"173.194.43.54",443,9,1037,4781,0,0,5,664,4,373,36.768702,0.04802100000000564,110618,62139
"172.16.133.37",60589,"67.217.64.244",443,6,366,4782,0,0,4,246,2,120,36.784171,0.04774400000000156,41219,20107
"172.16.133.58",53908,"65.55.71.195",443,7,578,4783,0,0,4,316,3,262,36.792195,240.44167600000003,10,8
"172.16.133.132",42473,"206.190.56.191",80,6,376,4784,0,0,4,254,2,122,36.793773,0.05085499999999854,39956,19191
"172.16.133.48",60508,"173.194.43.54",443,30,5532,4785,0,0,17,4168,13,1364,36.795044,84.357621,395,129
"172.16.133.95",56941,"172.16.139.250",5440,12,1142,4786,0,0,12,1142,0,0,36.797829,0.007367000000002122,1240124,0
"172.16.133.37",60590,"216.115.223.200",443,6,366,4787,0,0,4,246,2,120,36.814189999999996,0.09569100000000219,20566,10032
"172.16.133.92",57657,"172.16.139.250",5440,12,1142,4788,0,0,12,1142,0,0,36.826276,0.015846000000003357,576549,0
"172.16.133.29",60860,"172.16.139.250",5440,12,1142,4789,0,0,12,1142,0,0,36.843804,0.007747999999999422,1179143,0
"172.16.133.44",64753,"172.16.139.250",5440,12,1142,4790,0,0,12,1142,0,0,36.851049,0.005575999999997805,1638450,0
"172.16.133.36",63681,"96.43.146.22",443,27,17722,4791,0,0,17,15294,10,2428,36.856465,241.760244,506,80
"172.16.133.78",59089,"173.194.43.59",80,54,42856,4792,0,0,18,1442,36,41414,36.872107,248.187355,46,1334
"172.16.133.78",59090,"173.194.43.59",80,85,76021,4793,0,0,27,2668,58,73353,36.872229,248.18638099999998,85,2364
"172.16.133.207",55909,"172.16.139.250",5440,12,1142,4794,0,0,12,1142,0,0,36.876098,0.004998999999997977,"",""
"172.16.133.83",57065,"172.16.139.250",5440,10,1022,4795,0,0,10,1022,0,0,36.88492,0.014744000000000312,554530,0
"157.56.236.102",443,"172.16.133.42",56894,10,775,4796,0,0,5,475,5,300,36.893661,240.299715,15,9
"172.16.133.132",41380,"23.67.242.10",80,6,412,4797,0,0,4,272,2,140,36.89704,0.04352100000000547,49998,25734
"172.16.133.90",51432,"173.194.68.125",5222,14,907,4798,0,0,7,420,7,487,36.899072,258.25702,13,15
"172.16.133.88",51449,"172.16.139.250",5500,20,1740,4799,0,0,20,1740,0,0,36.901583,240.198686,57,0
"172.16.133.93",60635,"172.16.139.250",5440,12,1142,4800,0,0,12,1142,0,0,36.902092,0.014238999999996338,641618,0
"172.16.133.78",59091,"23.60.238.131",443,46,25109,4801,0,0,21,5255,25,19854,36.910861,226.62485399999997,185,700
"172.16.133.78",59092,"23.60.238.131",443,123,111873,4802,0,0,40,7018,83,104855,36.913215,226.62017999999998,247,3701
"172.16.133.78",59093,"23.60.238.131",443,48,24823,4803,0,0,22,5379,26,19444,36.913844,226.619977,189,686
"172.16.133.78",59094,"23.60.238.131",443,39,14664,4804,0,0,19,4151,20,10513,36.914075,226.618735,146,371
"172.16.133.11",55118,"172.16.139.250",5440,10,1022,4805,0,0,10,1022,0,0,36.918723,0.005732999999999322,1426129,0
"172.16.133.55",57555,"172.16.139.250",5440,12,1142,4806,0,0,12,1142,0,0,36.922752,0.006377999999997996,1432423,0
"172.16.133.84",56200,"96.43.146.176",443,17,3237,4807,0,0,9,2449,8,788,36.925955,225.44273400000003,86,27
"172.16.133.73",60610,"172.16.139.250",5440,12,1142,4808,0,0,12,1142,0,0,36.946238,0.02045400000000086,446660,0
"172.16.133.53",54075,"172.16.139.250",5440,12,1142,4809,0,0,12,1142,0,0,36.947866,0.0065170000000023265,1401872,0
"172.16.133.132",49624,"98.139.240.22",80,10,614,4810,0,0,9,554,1,60,36.948235,189.029741,23,2
"172.16.133.21",53149,"172.16.139.250",5440,10,1022,4811,0,0,10,1022,0,0,36.952297,0.00669099999999645,1221939,0
"172.16.133.37",60591,"66.151.150.190",443,6,366,4812,0,0,4,246,2,120,36.953478,0.19373200000000423,10158,4955
"172.16.133.30",62589,"172.16.139.250",5440,10,1022,4813,0,0,10,1022,0,0,36.954845,0.007328999999998587,1115568,0
"172.16.133.37",60592,"216.219.113.250",443,6,366,4814,0,0,4,246,2,120,36.956322,0.2084120000000027,9442,4606
"172.16.133.25",63413,"172.16.139.250",5440,12,1142,4815,0,0,12,1142,0,0,36.963826,0.005908000000005131,1546377,0
"172.16.133.78",59095,"67.69.174.9",80,86,79909,4816,0,0,27,3823,59,76086,36.970395,225.78999800000003,135,2695
"172.16.133.34",50415,"172.16.139.250",5440,10,1022,4817,0,0,10,1022,0,0,36.970397,0.00489199999999812,"",""
"172.16.133.78",59096,"74.125.226.25",80,21,1846,4818,0,0,11,1053,10,793,36.975287,248.096394,33,25
"172.16.133.78",59097,"74.125.226.25",80,32,11200,4819,0,0,16,2851,16,8349,36.975421,248.096381,91,269
"172.16.133.97",59345,"172.16.139.250",5440,10,1022,4820,0,0,10,1022,0,0,36.983081,0.005966999999998279,1370202,0
"172.16.133.23",61948,"157.56.236.102",443,15,1300,4821,0,0,8,880,7,420,36.998034,240.10309700000002,29,13
"172.16.133.78",59098,"138.108.7.20",80,8,1527,4822,0,0,4,869,4,658,37.014014,11.768757999999998,590,447
"172.16.133.78",59099,"23.60.225.169",80,31,21063,4823,0,0,11,1070,20,19993,37.034294,225.41979300000003,37,709
"172.16.133.132",50020,"98.139.134.187",80,7,478,4824,0,0,4,272,3,206,37.037724,0.07313700000000267,29752,22533
"172.16.133.33",57857,"172.16.139.250",5440,10,1022,4825,0,0,10,1022,0,0,37.058676,0.015256000000000824,535920,0
"172.16.133.68",60701,"172.16.139.250",5440,10,1022,4826,0,0,10,1022,0,0,37.088664,0.005476000000001591,1493060,0
"172.16.133.126",61265,"96.43.146.22",443,9,557,4827,0,0,4,240,5,317,37.091904,79.621308,24,31
"172.16.133.126",61268,"96.43.146.22",443,9,557,4828,0,0,4,240,5,317,37.099801,79.673779,24,31
"172.16.133.78",59100,"138.108.7.20",80,4,252,4829,0,0,2,126,2,126,37.100135,9.346682000000001,107,107
"172.16.133.12",59710,"172.16.139.250",5440,10,1022,4830,0,0,10,1022,0,0,37.101009,0.005408000000002744,1511834,0
"172.16.133.118",57826,"173.194.68.125",5222,14,1817,4831,0,0,7,1336,7,481,37.105532,257.182677,41,14
"172.16.133.126",61267,"96.43.146.22",443,9,557,4832,0,0,4,240,5,317,37.10668,79.660786,24,31
"172.16.133.126",61266,"96.43.146.22",443,9,557,4833,0,0,4,240,5,317,37.107594,79.660729,24,31
"172.16.133.63",53853,"172.16.139.250",5440,10,1022,4834,0,0,10,1022,0,0,37.11072,0.0053849999999968645,1518291,0
"172.16.133.132",53564,"216.185.152.144",80,6,380,4835,0,0,4,254,2,126,37.11757,0.15623000000000076,13006,6452
"172.16.133.120",53429,"96.43.146.22",443,11,677,4836,0,0,5,300,6,377,37.119454,128.384356,18,23
"172.16.133.60",55365,"172.16.139.250",5447,10,1400,4837,0,0,10,1400,0,0,37.12125,239.98287000000002,46,0
"172.16.133.66",53825,"172.16.139.250",5440,10,1022,4838,0,0,10,1022,0,0,37.127518,0.005569999999998743,1467863,0
"172.16.133.78",59101,"74.120.148.5",443,15,6234,4839,0,0,8,1801,7,4433,37.129755,0.19022700000000015,75741,186429
"172.16.133.78",59102,"184.169.133.107",80,18,7839,4840,0,0,8,1132,10,6707,37.129922,67.998998,133,789
"172.16.133.82",61297,"172.16.139.250",5440,10,1022,4841,0,0,10,1022,0,0,37.139147,0.005519999999997083,1481159,0
"172.16.133.37",60593,"172.16.139.250",5440,10,1022,4842,0,0,10,1022,0,0,37.152778,0.005535000000001844,1477145,0
"172.16.133.78",59103,"184.169.133.107",80,6,372,4843,0,0,4,246,2,126,37.202359,17.935625,109,56
"172.16.133.41",52852,"199.204.31.89",80,24,20109,4844,0,0,8,1595,16,18514,37.22063,0.43016999999999683,29662,344310
"172.16.133.41",52853,"199.204.31.89",80,24,20183,4845,0,0,8,1535,16,18648,37.220793,0.7962920000000011,15421,187348
"172.16.133.41",52854,"66.235.133.14",80,21,13791,4846,0,0,12,9743,9,4048,37.241322,12.774944000000005,6101,2534
"172.16.133.78",59104,"67.69.174.9",80,96,95413,4847,0,0,27,4052,69,91361,37.251208,227.407144,142,3214
"172.16.133.41",52855,"199.204.31.83",80,12,4601,4848,0,0,6,2234,6,2367,37.274658,0.3107569999999953,57511,60935
"172.16.133.41",52856,"50.16.233.105",80,16,4534,4849,0,0,8,1982,8,2552,37.28808,62.719334999999994,252,325
"172.16.133.78",59105,"172.16.139.250",5440,10,1022,4850,0,0,10,1022,0,0,37.309961,0.006507999999996628,1256299,0
"172.16.133.67",55437,"96.43.146.48",443,121,93292,4851,0,0,58,48927,63,44365,37.349931,256.79094999999995,1524,1382
"172.16.133.67",55960,"172.16.128.169",8014,11,5374,4852,0,0,6,2674,5,2700,37.3512,2.480178000000002,8625,8709
"172.16.133.97",59346,"172.16.128.169",8014,10,4606,4853,0,0,5,1906,5,2700,37.353889,2.0789240000000007,7334,10389
"172.16.133.23",55043,"172.16.128.169",8014,10,4598,4854,0,0,5,1898,5,2700,37.35457,2.276964999999997,6668,9486
"172.16.133.30",62590,"172.16.128.169",8014,10,4584,4855,0,0,5,1884,5,2700,37.356602,2.174875,6930,9931
"172.16.133.13",53014,"172.16.128.169",8014,10,4584,4856,0,0,5,1884,5,2700,37.359769,2.600299999999997,5796,8306
"172.16.133.63",53854,"172.16.128.169",8014,10,4616,4857,0,0,5,1916,5,2700,37.362097,2.1695509999999985,7065,9955
"172.16.133.54",64317,"172.16.128.169",8014,10,4638,4858,0,0,5,1938,5,2700,37.363773,2.269051999999995,6832,9519
"172.16.133.87",65484,"172.16.139.250",5500,20,1740,4859,0,0,20,1740,0,0,37.364428,240.209646,57,0
"172.16.133.67",55961,"172.16.139.250",5440,10,1022,4860,0,0,10,1022,0,0,37.365098,0.015481999999998663,528097,0
"172.16.133.115",53782,"172.16.128.169",8014,17,8502,4861,0,0,10,5549,7,2953,37.366877,2.868165999999995,15477,8236
"172.16.133.23",54486,"96.43.146.48",443,27,8449,4862,0,0,16,5344,11,3105,37.381305,240.64541200000002,177,103
"172.16.133.56",61386,"172.16.139.250",5440,12,1142,4863,0,0,12,1142,0,0,37.385865,0.005144999999998845,1775704,0
"172.16.133.42",57042,"172.16.139.250",5440,12,1142,4864,0,0,12,1142,0,0,37.40823,0.012763999999997111,715763,0
"172.16.133.67",55436,"96.43.146.48",443,28,15047,4865,0,0,14,7819,14,7228,37.429955,234.362034,266,246
"172.16.133.75",50925,"172.16.139.250",5440,10,1022,4866,0,0,10,1022,0,0,37.441448,0.006332999999997924,1291015,0
"172.16.133.41",52857,"172.16.139.250",5440,12,1142,4867,0,0,12,1142,0,0,37.443355,0.015238000000003638,599553,0
"172.16.133.85",52223,"172.16.139.250",5440,12,1142,4868,0,0,12,1142,0,0,37.468028,0.005669000000004587,1611571,0
"172.16.133.43",57739,"172.16.139.250",5440,10,1022,4869,0,0,10,1022,0,0,37.514918,0.014624999999995225,559042,0
"172.16.133.13",53015,"172.16.139.250",5440,10,1022,4870,0,0,10,1022,0,0,37.532532,0.009461999999999193,864087,0
"172.16.133.20",62354,"172.16.139.250",5440,12,1142,4871,0,0,12,1142,0,0,37.580778,0.015236999999999057,599593,0
"172.16.133.78",59106,"67.69.174.138",80,12,1525,4872,0,0,6,869,6,656,37.584793,7.497876000000005,927,699
"172.16.133.78",59107,"107.22.223.184",80,13,2840,4873,0,0,7,1121,6,1719,37.585582,67.479467,132,203
"172.16.133.78",59108,"174.129.236.22",80,13,1861,4874,0,0,7,1385,6,476,37.58652,67.47820999999999,164,56
"172.16.133.28",65341,"172.16.139.250",5440,10,1022,4875,0,0,10,1022,0,0,37.611164,0.005665000000000475,1443248,0
"172.16.133.99",56019,"172.16.139.250",5440,10,1022,4876,0,0,10,1022,0,0,37.638511,0.015104000000000894,541313,0
"172.16.133.87",60161,"172.16.139.250",5440,12,1142,4877,0,0,12,1142,0,0,37.659234,0.017205000000004134,531008,0
"172.16.133.13",54395,"172.16.139.250",5447,10,1400,4878,0,0,10,1400,0,0,37.667254,240.01593199999996,46,0
"172.16.133.35",49947,"172.16.139.250",5440,12,1142,4879,0,0,12,1142,0,0,37.674094,0.021956000000002973,416104,0
"172.16.133.116",53265,"172.16.139.250",5440,10,1022,4880,0,0,10,1022,0,0,37.678247999999996,0.005774000000002388,1416002,0
"172.16.133.116",53266,"172.16.139.250",5440,12,1142,4881,0,0,12,1142,0,0,37.684949,0.016435999999998785,555853,0
"172.16.133.84",58768,"172.16.139.250",5440,10,1022,4882,0,0,10,1022,0,0,37.697847,0.006643999999994321,1230583,0
"172.16.133.116",53267,"172.16.139.250",5440,10,1022,4883,0,0,10,1022,0,0,37.702629,0.015569999999996753,525112,0
"172.16.133.63",53413,"23.33.81.244",80,3,180,4884,0,0,2,120,1,60,37.702868,0.07612400000000008,12611,6305
"172.16.133.48",60509,"107.20.161.243",443,17,5459,4885,0,0,9,2021,8,3438,37.734213,13.950873000000001,1158,1971
"172.16.133.41",52858,"173.194.41.111",80,23,4098,4886,0,0,12,3193,11,905,37.743709,242.321067,105,29
"172.16.133.49",55742,"172.16.139.250",5440,12,1142,4887,0,0,12,1142,0,0,37.775161,0.006351000000002216,1438513,0
"172.16.133.24",56743,"96.43.146.22",443,42,19340,4888,0,0,23,16263,19,3077,37.784937,219.76549799999998,592,112
"172.16.133.43",50356,"172.16.139.250",5500,20,1740,4889,0,0,20,1740,0,0,37.788178,240.191531,57,0
"172.16.133.103",63193,"216.52.242.80",80,7,420,4890,0,0,6,360,1,60,37.790418,170.78205300000002,16,2
"172.16.133.72",51759,"96.43.146.22",443,35,15545,4891,0,0,20,13135,15,2410,37.80196,234.250386,448,82
"172.16.133.95",56942,"172.16.139.250",5440,10,1022,4892,0,0,10,1022,0,0,37.812725,0.00515800000000155,1585110,0
"172.16.133.92",57658,"172.16.139.250",5440,12,1142,4893,0,0,12,1142,0,0,37.840759,0.006233000000001709,1465746,0
"172.16.133.29",60861,"172.16.139.250",5440,12,1142,4894,0,0,12,1142,0,0,37.857823,0.0061709999999948195,1480473,0
"172.16.133.78",59109,"74.120.148.2",443,14,5092,4895,0,0,8,1659,6,3433,37.862779,0.14099599999999413,94130,194785
"172.16.133.44",64754,"172.16.139.250",5440,12,1142,4896,0,0,12,1142,0,0,37.864649,0.015745000000002563,580247,0
"172.16.133.207",55910,"172.16.139.250",5440,12,1142,4897,0,0,12,1142,0,0,37.890023,0.017716000000000065,515692,0
"172.16.133.83",57066,"172.16.139.250",5440,12,1142,4898,0,0,12,1142,0,0,37.898797,0.004834999999999923,"",""
"172.16.133.78",59110,"23.60.238.131",443,30,9253,4899,0,0,15,3266,15,5987,37.913088,225.622502,115,212
"172.16.133.78",59111,"74.120.148.2",443,15,5152,4900,0,0,8,1659,7,3493,37.913638,0.13728100000000154,96677,203553
"172.16.133.78",59112,"74.120.148.2",443,14,5092,4901,0,0,8,1659,6,3433,37.913914,0.1371030000000033,96803,200316
"172.16.133.78",59113,"74.120.148.2",443,14,5092,4902,0,0,8,1659,6,3433,37.914075,0.13707600000000042,96822,200356
"172.16.133.78",59114,"74.120.148.2",443,14,5188,4903,0,0,8,1755,6,3433,37.91442,0.1369189999999989,102542,200585
"172.16.133.93",60636,"172.16.139.250",5440,12,1142,4904,0,0,12,1142,0,0,37.916911,0.005037999999998988,1813418,0
"172.16.133.78",59115,"69.25.24.24",80,23,9701,4905,0,0,12,6000,11,3701,37.929335,225.31635099999997,213,131
"172.16.133.78",59116,"69.25.24.24",80,24,9806,4906,0,0,12,6000,12,3806,37.929609,225.31483899999998,213,135
"172.16.133.78",59117,"74.120.148.5",443,13,4558,4907,0,0,7,1698,6,2860,37.932095,0.10490900000000636,129483,218093
"172.16.133.11",55119,"172.16.139.250",5440,12,1142,4908,0,0,12,1142,0,0,37.932944,0.0059820000000030404,1527248,0
"172.16.133.55",57556,"172.16.139.250",5440,10,1022,4909,0,0,10,1022,0,0,37.93689,0.005707999999998492,1432375,0
"172.16.133.78",59118,"66.235.142.49",80,15,7686,4910,0,0,8,4451,7,3235,37.937621,11.557938999999998,3080,2239
"157.56.237.150",443,"172.16.133.29",49266,12,936,4911,0,0,6,570,6,366,37.946723,241.103083,18,12
"172.16.133.78",59119,"50.18.47.197",80,11,1622,4912,0,0,6,803,5,819,37.9574,129.120546,49,50
"172.16.133.41",52859,"199.204.31.89",80,9,2764,4913,0,0,5,1356,4,1408,37.958811,0.22794100000000128,47591,49416
"172.16.133.78",59120,"74.125.226.26",80,24,5648,4914,0,0,12,2608,12,3040,37.959954,247.112155,84,98
"172.16.133.41",52860,"199.204.31.89",80,10,4408,4915,0,0,5,1571,5,2837,37.960889,0.23925399999999541,52529,94861
"172.16.133.73",60611,"172.16.139.250",5440,10,1022,4916,0,0,10,1022,0,0,37.961257,0.00566499999999337,1443248,0
"172.16.133.41",52861,"199.204.31.89",80,11,4559,4917,0,0,6,1630,5,2929,37.961601,0.23758499999999572,54885,98625
"172.16.133.53",54076,"172.16.139.250",5440,12,1142,4918,0,0,12,1142,0,0,37.961782,0.015757999999998162,579769,0
"172.16.133.41",52862,"199.204.31.89",80,9,2214,4919,0,0,5,1483,4,731,37.962199,0.22328300000000212,53134,26190
"172.16.133.41",52863,"199.204.31.83",80,10,2540,4920,0,0,5,632,5,1908,37.963358,0.26425700000000063,19132,57761
"172.16.133.21",53150,"172.16.139.250",5440,12,1142,4921,0,0,12,1142,0,0,37.966094,0.020171000000004824,452927,0
"172.16.133.30",62591,"172.16.139.250",5440,10,1022,4922,0,0,10,1022,0,0,37.96803,0.02149599999999907,380349,0
"172.16.133.78",59121,"66.235.142.49",80,4,252,4923,0,0,2,126,2,126,37.97634,7.454096999999997,135,135
"172.16.133.25",63414,"172.16.139.250",5440,12,1142,4924,0,0,12,1142,0,0,37.97642,0.005407000000005269,1689661,0
"172.16.133.78",59122,"173.194.43.57",80,23,5752,4925,0,0,12,2790,11,2962,37.979116,247.08046299999998,90,95
"172.16.133.34",50416,"172.16.139.250",5440,10,1022,4926,0,0,10,1022,0,0,37.984927,0.008437000000000694,969064,0
"172.16.133.78",59123,"173.194.43.57",80,21,3467,4927,0,0,11,1698,10,1769,37.991229,247.067752,54,57
"172.16.133.78",59124,"173.194.43.57",80,21,3467,4928,0,0,11,1698,10,1769,37.991517,247.068265,54,57
"172.16.133.78",59125,"173.194.43.57",80,20,3401,4929,0,0,11,1698,9,1703,37.99281,247.06638999999998,54,55
"172.16.133.78",59126,"173.194.43.57",80,20,3401,4930,0,0,11,1698,9,1703,37.993164,247.066161,54,55
"172.16.133.78",59127,"74.120.148.2",443,12,2140,4931,0,0,7,1364,5,776,37.993916,0.1134270000000015,96202,54731
"172.16.133.78",59128,"74.120.148.2",443,12,2140,4932,0,0,7,1364,5,776,37.994125,0.09648500000000126,113095,64341
"172.16.133.97",59347,"172.16.139.250",5440,10,1022,4933,0,0,10,1022,0,0,37.997239,0.005395000000000039,1515477,0
"172.16.133.78",59129,"50.18.47.197",80,5,312,4934,0,0,3,186,2,126,38.009142,17.133453000000003,86,58
"172.16.133.78",59130,"74.125.226.13",80,28,12411,4935,0,0,12,2416,16,9995,38.041771,247.02896600000003,78,323
"172.16.133.78",59131,"23.61.18.110",443,16,3255,4936,0,0,8,891,8,2364,38.053572,21.377823999999997,333,884
"172.16.133.78",59132,"23.61.18.110",443,16,3255,4937,0,0,8,891,8,2364,38.053727,21.377863999999995,333,884
"172.16.133.33",57858,"172.16.139.250",5440,12,1142,4938,0,0,12,1142,0,0,38.072975,0.016244999999997844,562388,0
"172.16.133.78",59133,"67.69.174.18",80,6,372,4939,0,0,4,246,2,126,38.087496,17.010351,115,59
"172.16.133.78",59134,"67.69.174.18",80,6,372,4940,0,0,4,246,2,126,38.087621,17.012643000000004,115,59
"172.16.133.68",60702,"172.16.139.250",5440,10,1022,4941,0,0,10,1022,0,0,38.101921,0.005481000000003178,1491698,0
"172.16.133.78",59135,"74.125.226.13",80,26,6212,4942,0,0,14,4346,12,1866,38.107652,246.964256,140,60
"172.16.133.78",59136,"74.125.226.13",80,23,3787,4943,0,0,12,2536,11,1251,38.108057,246.96395099999998,82,40
"172.16.133.78",59137,"74.125.226.13",80,26,6212,4944,0,0,14,4346,12,1866,38.108961,246.96325199999998,140,60
"172.16.133.78",59138,"74.125.226.13",80,26,6212,4945,0,0,14,4346,12,1866,38.109439,246.961115,140,60
"172.16.133.12",59711,"172.16.139.250",5440,10,1022,4946,0,0,10,1022,0,0,38.115965,0.005507999999998958,1484386,0
"172.16.133.78",59139,"67.69.196.41",80,23,7310,4947,0,0,12,1866,11,5444,38.117555,225.47464799999997,66,193
"172.16.133.63",53855,"172.16.139.250",5440,10,1022,4948,0,0,10,1022,0,0,38.125417,0.0051339999999981956,1592520,0
"172.16.133.78",59140,"74.120.148.5",443,18,9330,4949,0,0,9,1909,9,7421,38.128613,0.17339199999999977,88077,342391
"172.16.133.41",52864,"199.204.31.89",80,10,3068,4950,0,0,5,1388,5,1680,38.134492,0.22961600000000004,48358,58532
"172.16.133.41",52865,"199.204.31.89",80,10,3833,4951,0,0,5,1402,5,2431,38.135854,0.22802699999999732,49187,85288
"172.16.133.11",49360,"172.16.139.250",5447,10,1390,4952,0,0,10,1390,0,0,38.140292,239.997343,46,0
"172.16.133.41",52866,"199.204.31.89",80,9,2997,4953,0,0,5,1384,4,1613,38.140638,0.23959499999999423,46211,53857
"172.16.133.103",63439,"132.245.1.150",443,18,8447,4954,0,0,8,1868,10,6579,38.141175,0.18061500000000308,82739,291404
"172.16.133.66",53826,"172.16.139.250",5440,10,1022,4955,0,0,10,1022,0,0,38.141627,0.005462999999998885,1496613,0
"172.16.133.41",52867,"199.204.31.89",80,10,3852,4956,0,0,5,1398,5,2454,38.141825,0.2290130000000019,48835,85724
"172.16.133.82",61298,"172.16.139.250",5440,10,1022,4957,0,0,10,1022,0,0,38.153029,0.015570000000003859,525112,0
"172.16.133.37",60594,"172.16.139.250",5440,10,1022,4958,0,0,10,1022,0,0,38.166876,0.006324999999996805,1292648,0
"172.16.133.42",56893,"157.56.236.102",443,10,775,4959,0,0,5,475,5,300,38.204054,240.24634200000003,15,9
"172.16.133.78",59141,"23.60.241.224",80,12,2710,4960,0,0,6,1404,6,1306,38.219544,46.880123,239,222
"172.16.133.78",59142,"23.60.241.224",80,13,2723,4961,0,0,7,1459,6,1264,38.261573,36.820593,316,274
"172.16.133.75",50926,"216.115.208.199",443,363,148330,4962,0,0,156,59428,207,88902,38.271266,259.42059300000005,1832,2741
"172.16.133.78",59143,"31.13.74.7",443,37,8458,4963,0,0,17,3023,20,5435,38.275384,121.057929,199,359
"172.16.133.41",52868,"199.204.31.89",80,13,6074,4964,0,0,6,1436,7,4638,38.291749,0.246972999999997,46515,150235
"172.16.133.41",52869,"199.204.31.89",80,9,2735,4965,0,0,5,1393,4,1342,38.292284,0.2555270000000007,43611,42015
"172.16.133.78",59144,"67.69.174.123",80,36,25611,4966,0,0,13,1231,23,24380,38.318419,225.50824,43,864
"172.16.133.78",59145,"172.16.139.250",5440,10,1022,4967,0,0,10,1022,0,0,38.323693,0.005777999999999395,1415022,0
"172.16.133.37",60389,"216.115.208.203",443,13,780,4968,0,0,7,420,6,360,38.325956,210.00023000000002,15,13
"172.16.133.41",52870,"199.204.31.89",80,9,2731,4969,0,0,5,1396,4,1335,38.331576,0.2560660000000041,43613,41707
"172.16.133.72",51609,"96.43.146.48",443,26,5922,4970,0,0,14,4586,12,1336,38.339247,236.414942,155,45
"157.56.240.102",443,"172.16.133.25",49363,26,3745,4971,0,0,15,3085,11,660,38.357073,240.186105,102,21
"172.16.133.78",59146,"23.60.241.224",80,13,2607,4972,0,0,7,1836,6,771,38.362461,96.72491600000001,151,63
"172.16.133.78",59147,"23.60.241.224",80,13,3006,4973,0,0,7,1842,6,1164,38.362691,46.737218,315,199
"172.16.133.78",59148,"199.59.148.86",443,32,8825,4974,0,0,13,3219,19,5606,38.36399,30.491991,844,1470
"172.16.133.78",59149,"199.59.148.86",443,19,5809,4975,0,0,9,1284,10,4525,38.364109,31.113893000000004,330,1163
"172.16.133.78",59150,"23.60.241.224",80,11,3092,4976,0,0,6,1366,5,1726,38.369419,36.712646,297,376
"172.16.133.78",59151,"199.59.148.86",443,19,5809,4977,0,0,9,1284,10,4525,38.370058,31.113300999999993,330,1163
"172.16.133.78",59152,"23.60.241.224",80,17,2653,4978,0,0,9,1750,8,903,38.370559,146.703934,95,49
"172.16.133.78",59153,"173.194.43.59",80,23,5832,4979,0,0,11,2032,12,3800,38.37691,246.677052,65,123
"172.16.133.78",59154,"173.194.43.59",80,23,5821,4980,0,0,11,2026,12,3795,38.377137,246.67655000000002,65,123
"172.16.133.78",59155,"173.194.43.59",80,23,5836,4981,0,0,11,2032,12,3804,38.377836,246.67563,65,123
"172.16.133.67",55962,"172.16.139.250",5440,12,1142,4982,0,0,12,1142,0,0,38.378691,0.0185379999999995,492825,0
"172.16.133.56",61387,"172.16.139.250",5440,10,1022,4983,0,0,10,1022,0,0,38.399887,0.004733999999999128,"",""
"172.16.133.55",50551,"96.43.146.176",443,26,8115,4984,0,0,15,5010,11,3105,38.40543,240.34831699999998,166,103
"172.16.133.42",57043,"172.16.139.250",5440,12,1142,4985,0,0,12,1142,0,0,38.42017,0.013097999999999388,697511,0
"172.16.133.78",59156,"74.120.148.2",443,12,2140,4986,0,0,7,1364,5,776,38.439394,0.1271640000000005,85810,48818
"172.16.133.75",50927,"172.16.139.250",5440,12,1142,4987,0,0,12,1142,0,0,38.455668,0.016197999999995716,564020,0
"172.16.133.41",52871,"172.16.139.250",5440,12,1142,4988,0,0,12,1142,0,0,38.457618,0.00614500000000362,1486737,0
"172.16.133.85",52224,"172.16.139.250",5440,10,1022,4989,0,0,10,1022,0,0,38.473725,0.006059999999997956,1349174,0
"172.16.133.41",52872,"199.204.31.89",80,9,2917,4990,0,0,5,1384,4,1533,38.485366,0.21556400000000053,51362,56892
"172.16.133.41",52873,"199.204.31.89",80,11,3501,4991,0,0,6,1999,5,1502,38.495019,0.22951799999999878,69676,52353
"172.16.133.41",52874,"199.204.31.123",80,11,2709,4992,0,0,6,2157,5,552,38.496044,0.2684950000000015,64269,16447
"172.16.133.41",52875,"199.204.31.89",80,7,2117,4993,0,0,4,1879,3,238,38.496269,4.741524000000005,3170,401
"172.16.133.85",60708,"172.16.139.250",5447,10,1380,4994,0,0,10,1380,0,0,38.49675,203.705873,54,0
"172.16.133.41",52876,"199.204.31.89",80,12,3792,4995,0,0,6,2003,6,1789,38.499232,0.2158540000000002,74235,66304
"172.16.133.41",52877,"199.204.31.89",80,12,3791,4996,0,0,6,2003,6,1788,38.500857,0.22394399999999592,71553,63873
"172.16.133.41",52878,"199.204.31.123",80,11,2709,4997,0,0,6,2157,5,552,38.501289,0.26924100000000095,64091,16401
"172.16.133.41",52879,"199.204.31.89",80,59,59015,4998,0,0,15,1969,44,57046,38.509944,0.6988940000000028,22538,652986
"172.16.133.78",59157,"8.18.45.80",80,10,2880,4999,0,0,6,1501,4,1379,38.527364,16.547812999999998,725,666
"172.16.133.43",57740,"172.16.139.250",5440,10,1022,5000,0,0,10,1022,0,0,38.528684,0.0054450000000016985,1501561,0
"172.16.133.13",53016,"172.16.139.250",5440,12,1142,5001,0,0,12,1142,0,0,38.544883,0.01457500000000067,626826,0
"172.16.133.78",59158,"31.13.74.7",80,54,32864,5002,0,0,18,6615,36,26249,38.570446,132.302689,399,1587
"172.16.133.78",59159,"31.13.74.7",80,43,22845,5003,0,0,16,5153,27,17692,38.570945,135.140108,305,1047
"172.16.133.20",62355,"172.16.139.250",5440,10,1022,5004,0,0,10,1022,0,0,38.595068,0.004846000000000572,"",""
"172.16.133.28",65342,"172.16.139.250",5440,12,1142,5005,0,0,12,1142,0,0,38.626657,0.016290999999995392,560800,0
"172.16.133.41",52880,"199.204.31.89",80,9,2342,5006,0,0,5,1611,4,731,38.634515,0.27986299999999886,46051,20895
"172.16.133.41",52881,"199.204.31.89",80,9,2215,5007,0,0,5,1615,4,600,38.648647,0.2661590000000018,48542,18034
"172.16.133.99",56020,"172.16.139.250",5440,12,1142,5008,0,0,12,1142,0,0,38.652833,0.00544800000000123,1676945,0
"172.16.133.78",59160,"67.69.174.115",80,6,372,5009,0,0,4,246,2,126,38.667629,16.432431,119,61
"172.16.133.87",60162,"172.16.139.250",5440,12,1142,5010,0,0,12,1142,0,0,38.674887,0.00841400000000192,1085809,0
"172.16.133.35",49948,"172.16.139.250",5440,12,1142,5011,0,0,12,1142,0,0,38.689003,0.010522999999999172,868193,0
"172.16.133.116",53268,"172.16.139.250",5440,12,1142,5012,0,0,12,1142,0,0,38.690082,0.009544000000005326,957250,0
"172.16.133.53",49605,"157.56.234.118",443,10,775,5013,0,0,5,475,5,300,38.69223,240.06646999999998,15,9
"172.16.133.116",53269,"172.16.139.250",5440,10,1022,5014,0,0,10,1022,0,0,38.700417,0.006726999999997929,1215400,0
"172.16.133.116",53270,"172.16.139.250",5440,10,1022,5015,0,0,10,1022,0,0,38.708084,0.006064000000002068,1348284,0
"172.16.133.78",59161,"23.21.250.167",80,47,33811,5016,0,0,24,26957,23,6854,38.708326,66.356964,3249,826
"172.16.133.78",59162,"23.21.250.167",80,47,33809,5017,0,0,24,26957,23,6852,38.708485,66.356358,3249,826
"172.16.133.78",59163,"23.21.250.167",80,50,35091,5018,0,0,25,27023,25,8068,38.708629,66.357627,3257,972
"172.16.133.68",59414,"96.43.146.22",443,36,15536,5019,0,0,20,13060,16,2476,38.711929,234.14804300000003,446,84
"172.16.133.84",58769,"172.16.139.250",5440,12,1142,5020,0,0,12,1142,0,0,38.712091,0.006205000000001348,1472360,0
"172.16.133.78",59164,"174.35.24.67",80,26,12716,5021,0,0,11,6161,15,6555,38.720427,16.368046,3011,3203
"172.16.133.78",59165,"174.35.24.67",80,63,32091,5022,0,0,26,16700,37,15391,38.720577,16.368906000000003,8161,7522
"172.16.133.78",59166,"174.35.24.67",80,112,79759,5023,0,0,40,23201,72,56558,38.720696,16.372883,11336,27634
"172.16.133.24",57265,"96.43.146.50",443,17,1037,5024,0,0,8,480,9,557,38.739927,257.17538199999996,14,17
"172.16.133.78",59167,"173.194.43.59",80,6,372,5025,0,0,4,246,2,126,38.74266,16.330745,120,61
"172.16.133.49",55743,"172.16.139.250",5440,12,1142,5026,0,0,12,1142,0,0,38.789362,0.006308000000004199,1448319,0
"172.16.133.37",60595,"67.217.64.244",443,6,366,5027,0,0,4,246,2,120,38.805682,0.10984600000000455,17915,8739
"172.16.133.24",57613,"96.43.146.178",443,17,1037,5028,0,0,8,480,9,557,38.819928,257.103969,14,17
"172.16.133.24",57612,"96.43.146.178",443,17,1037,5029,0,0,8,480,9,557,38.824928,257.100817,14,17
"172.16.133.84",49347,"132.245.2.22",443,24,2992,5030,0,0,12,2272,12,720,38.825165,240.031575,75,23
"172.16.133.95",56943,"172.16.139.250",5440,12,1142,5031,0,0,12,1142,0,0,38.825804,0.005510000000001014,1658076,0
"172.16.133.24",57611,"96.43.146.178",443,17,1037,5032,0,0,8,480,9,557,38.829921,257.094857,14,17
"172.16.133.24",57615,"96.43.146.178",443,17,1037,5033,0,0,8,480,9,557,38.829923,257.093117,14,17
"172.16.133.24",57616,"96.43.146.178",443,17,1037,5034,0,0,8,480,9,557,38.829924,257.094912,14,17
"172.16.133.41",49876,"96.43.146.22",443,32,12840,5035,0,0,18,10480,14,2360,38.844449,250.858408,334,75
"172.16.133.24",57618,"96.43.146.50",443,17,1037,5036,0,0,8,480,9,557,38.844935,257.07213099999996,14,17
"172.16.133.24",57622,"75.101.140.131",443,8,517,5037,0,0,4,240,4,277,38.844936,27.077925,70,81
"172.16.133.24",57620,"96.43.146.50",443,33,15716,5038,0,0,18,10976,15,4740,38.844937,236.90243999999996,370,160
"172.16.133.24",57617,"96.43.146.50",443,17,1037,5039,0,0,8,480,9,557,38.849863,257.075878,14,17
"172.16.133.24",57621,"96.43.146.50",443,17,1037,5040,0,0,8,480,9,557,38.849865,257.07505999999995,14,17
"172.16.133.24",57619,"96.43.146.50",443,17,1037,5041,0,0,8,480,9,557,38.849866,257.066196,14,17
"172.16.133.83",55713,"96.43.146.22",443,42,18415,5042,0,0,24,15807,18,2608,38.851287,221.20338899999996,571,94
"172.16.133.92",57659,"172.16.139.250",5440,12,1142,5043,0,0,12,1142,0,0,38.858136,0.04146300000000025,220341,0
"172.16.133.37",60596,"216.115.223.200",443,7,432,5044,0,0,5,312,2,120,38.865397,3.1078979999999987,803,308
"172.16.133.29",60862,"172.16.139.250",5440,10,1022,5045,0,0,10,1022,0,0,38.872098,0.032900999999995406,248503,0
"172.16.133.44",64755,"172.16.139.250",5440,12,1142,5046,0,0,12,1142,0,0,38.878879,0.03156200000000098,289462,0
"172.16.133.207",55911,"172.16.139.250",5440,10,1022,5047,0,0,10,1022,0,0,38.904777,0.01030399999999787,793478,0
"172.16.133.83",57067,"172.16.139.250",5440,10,1022,5048,0,0,10,1022,0,0,38.911978,0.006984000000002766,1170675,0
"172.16.133.24",57624,"96.43.146.22",443,17,1037,5049,0,0,8,480,9,557,38.91498,257.01167599999997,14,17
"172.16.133.56",60944,"157.56.236.102",443,10,775,5050,0,0,5,475,5,300,38.918246,240.08115399999997,15,9
"172.16.133.24",57625,"96.43.146.22",443,17,1037,5051,0,0,8,480,9,557,38.919939,257.004899,14,17
"172.16.133.93",60637,"172.16.139.250",5440,12,1142,5052,0,0,12,1142,0,0,38.929915,0.005107000000002415,1788917,0
"172.16.133.126",55744,"63.85.36.24",80,16,1894,5053,0,0,8,1136,8,758,38.931719,255.332857,35,23
"172.16.133.11",55120,"172.16.139.250",5440,10,1022,5054,0,0,10,1022,0,0,38.946909,0.010854000000001918,753270,0
"172.16.133.55",57557,"172.16.139.250",5440,10,1022,5055,0,0,10,1022,0,0,38.950743,0.011096999999999468,736775,0
"172.16.133.73",60612,"172.16.139.250",5440,10,1022,5056,0,0,10,1022,0,0,38.974538,0.005621999999995353,1454286,0
"172.16.133.53",54077,"172.16.139.250",5440,12,1142,5057,0,0,12,1142,0,0,38.975834,0.018686999999999898,488896,0
"172.16.133.21",53151,"172.16.139.250",5440,10,1022,5058,0,0,10,1022,0,0,38.979148,0.006074999999995612,1345843,0
"172.16.133.30",62592,"172.16.139.250",5440,10,1022,5059,0,0,10,1022,0,0,38.982113,0.007038999999998907,1161528,0
"172.16.133.24",57610,"64.56.203.22",443,16,960,5060,0,0,8,480,8,480,38.986914,256.984745,14,14
"172.16.133.25",63415,"172.16.139.250",5440,10,1022,5061,0,0,10,1022,0,0,38.990657,0.006838999999999373,1195496,0
"172.16.133.34",50417,"172.16.139.250",5440,10,1022,5062,0,0,10,1022,0,0,38.998667,0.004944999999999311,"",""
"172.16.133.97",59348,"172.16.139.250",5440,10,1022,5063,0,0,10,1022,0,0,39.011142,0.014693000000001177,556455,0
"172.16.133.24",57626,"75.101.140.131",443,8,517,5064,0,0,4,240,4,277,39.033917,26.890276,71,82
"172.16.133.41",52407,"23.61.31.139",80,13,810,5065,0,0,7,420,6,390,39.034487,210.99050499999998,15,14
"172.16.133.37",60597,"66.151.150.190",443,6,366,5066,0,0,4,246,2,120,39.049435,0.20615799999999496,9546,4656
"172.16.133.24",57614,"96.43.146.178",443,17,1037,5067,0,0,8,480,9,557,39.054959,256.868987,14,17
"172.16.133.37",60598,"216.219.113.250",443,6,366,5068,0,0,4,246,2,120,39.056376,0.2244489999999999,8768,4277
"172.16.133.33",57859,"172.16.139.250",5440,10,1022,5069,0,0,10,1022,0,0,39.086725,0.005482999999998128,1491154,0
"172.16.133.68",60703,"172.16.139.250",5440,10,1022,5070,0,0,10,1022,0,0,39.116965,0.040818000000001575,200303,0
"172.16.133.12",59712,"172.16.139.250",5440,12,1142,5071,0,0,12,1142,0,0,39.130198,0.03157900000000069,289306,0
"172.16.133.78",59168,"174.35.22.85",80,14,4130,5072,0,0,7,3332,7,798,39.130676,15.937677999999998,1672,400
"172.16.133.78",59169,"174.35.22.85",80,50,20776,5073,0,0,23,17291,27,3485,39.130821,15.938963000000001,8678,1749
"172.16.133.78",59170,"174.35.22.85",80,14,4130,5074,0,0,7,3332,7,798,39.131005,15.938356999999996,1672,400
"172.16.133.78",59171,"174.35.22.85",80,23,8401,5075,0,0,11,6931,12,1470,39.131123,15.938437,3478,737
"172.16.133.78",59172,"174.35.22.85",80,14,4130,5076,0,0,7,3332,7,798,39.131298,15.937275999999997,1672,400
"172.16.133.78",59173,"174.35.22.85",80,14,4130,5077,0,0,7,3332,7,798,39.13145,15.938220999999999,1672,400
"172.16.133.63",53856,"172.16.139.250",5440,10,1022,5078,0,0,10,1022,0,0,39.139029,0.025581999999999994,319599,0
"172.16.133.66",53827,"172.16.139.250",5440,10,1022,5079,0,0,10,1022,0,0,39.154447,0.015073000000001002,542426,0
"172.16.133.78",59174,"174.35.24.67",80,7,432,5080,0,0,4,246,3,186,39.164854,15.924744000000004,123,93
"172.16.133.82",61299,"172.16.139.250",5440,10,1022,5081,0,0,10,1022,0,0,39.167162,0.006426000000004706,1272331,0
"172.16.133.37",60599,"172.16.139.250",5440,10,1022,5082,0,0,10,1022,0,0,39.180617,0.014796000000004028,552581,0
"157.56.241.150",443,"172.16.133.120",49251,10,775,5083,0,0,5,475,5,300,39.186613,240.15472200000002,15,9
"69.171.246.17",443,"172.16.133.113",50530,17,6331,5084,0,0,8,1905,9,4426,39.216806,240.27719299999998,63,147
"172.16.133.78",59175,"67.69.174.18",80,6,372,5085,0,0,4,246,2,126,39.224254,15.867340999999996,124,63
"172.16.133.113",50531,"69.171.246.17",443,16,6665,5086,0,0,8,5330,8,1335,39.230224,240.092969,177,44
"172.16.133.88",51222,"216.219.118.244",443,6,366,5087,0,0,4,246,2,120,39.230893,0.2113429999999994,9311,4542
"172.16.133.88",51223,"78.108.118.250",443,6,366,5088,0,0,4,246,2,120,39.231071,0.20742800000000017,9487,4628
"172.16.133.88",51224,"68.64.24.250",443,6,366,5089,0,0,4,246,2,120,39.232667,0.10124700000000075,19437,9481
"172.16.133.88",51225,"216.115.219.126",443,6,366,5090,0,0,4,246,2,120,39.233024,0.5555710000000005,3542,1727
"172.16.133.24",57628,"75.101.140.131",443,8,517,5091,0,0,4,240,4,277,39.293971,26.630027999999996,72,83
"172.16.133.24",57623,"75.101.140.131",443,8,517,5092,0,0,4,240,4,277,39.299907,26.624658000000004,72,83
"172.16.133.78",59176,"23.60.158.239",80,60,52462,5093,0,0,21,4460,39,48002,39.336523,226.00694600000003,157,1699
"172.16.133.78",59177,"172.16.139.250",5440,10,1022,5094,0,0,10,1022,0,0,39.337434,0.0057419999999979154,1423894,0
"172.16.133.24",57646,"64.208.138.118",443,6,366,5095,0,0,3,180,3,186,39.354986,16.561778000000004,86,89
"172.16.133.24",57606,"96.43.146.22",443,17,1037,5096,0,0,8,480,9,557,39.369936,256.547022,14,17
"172.16.133.78",59178,"54.243.251.10",80,17,4756,5097,0,0,9,2210,8,2546,39.391164,65.67398899999999,269,310
"172.16.133.67",55963,"172.16.139.250",5440,10,1022,5098,0,0,10,1022,0,0,39.392827,0.005451000000000761,1499908,0
"172.16.133.24",57648,"50.19.249.172",443,8,517,5099,0,0,4,240,4,277,39.394943,26.52952400000001,72,83
"172.16.133.78",59179,"190.93.246.193",80,15,5113,5100,0,0,7,1361,8,3752,39.403944,55.661511,195,539
"172.16.133.56",61388,"172.16.139.250",5440,10,1022,5101,0,0,10,1022,0,0,39.414319,0.028457000000003063,287310,0
"172.16.133.72",50262,"172.16.139.250",5500,20,1740,5102,0,0,20,1740,0,0,39.435587,246.965888,56,0
"172.16.133.42",57044,"172.16.139.250",5440,12,1142,5103,0,0,12,1142,0,0,39.446554,0.03205700000000178,284992,0
"172.16.133.75",50928,"172.16.139.250",5440,10,1022,5104,0,0,10,1022,0,0,39.469868,0.015577000000000396,524876,0
"172.16.133.41",52882,"172.16.139.250",5440,12,1142,5105,0,0,12,1142,0,0,39.470566,0.008897000000004596,1026862,0
"172.16.133.126",57721,"208.47.254.34",80,16,1698,5106,0,0,8,917,8,781,39.473117,254.853161,28,24
"172.16.133.85",52225,"172.16.139.250",5440,10,1022,5107,0,0,10,1022,0,0,39.488443,0.006934000000001106,1179117,0
"172.16.133.24",57649,"50.19.249.172",443,7,451,5108,0,0,4,240,3,211,39.489965,26.434877999999998,72,63
"172.16.133.72",52028,"96.43.146.22",443,29,12449,5109,0,0,17,10508,12,1941,39.492072,246.88281899999998,340,62
"172.16.133.78",59180,"74.120.148.2",443,6,374,5110,0,0,4,252,2,122,39.492743,15.580726000000006,129,62
"172.16.133.78",59181,"31.13.74.7",80,9,558,5111,0,0,5,312,4,246,39.494767,22.630899,110,86
"172.16.133.28",63955,"96.43.146.176",443,2,120,5112,0,0,1,60,1,60,39.534777,0.00014200000000386126,"",""
"172.16.133.28",65343,"96.43.146.176",443,70,19808,5113,0,0,40,12507,30,7301,39.535103,252.078871,396,231
"172.16.133.43",57741,"172.16.139.250",5440,10,1022,5114,0,0,10,1022,0,0,39.542004,0.0065400000000011005,1250152,0
"172.16.133.30",49394,"172.16.139.250",5447,10,1400,5115,0,0,10,1400,0,0,39.544719,239.99960200000004,46,0
"172.16.133.13",53017,"172.16.139.250",5440,10,1022,5116,0,0,10,1022,0,0,39.559087,0.005765000000003795,1418213,0
"172.16.133.41",52883,"23.33.95.139",80,6,372,5117,0,0,4,246,2,126,39.562166,10.44903,188,96
"172.16.133.41",52884,"23.33.95.139",80,6,372,5118,0,0,4,246,2,126,39.562405,10.447690999999999,188,96
"172.16.133.53",53843,"96.43.146.22",443,9,557,5119,0,0,4,240,5,317,39.581176,82.330456,23,30
"172.16.133.53",53840,"96.43.146.22",443,9,557,5120,0,0,4,240,5,317,39.591117,82.320616,23,30
"157.56.241.150",443,"172.16.133.113",61328,29,5398,5121,0,0,18,4738,11,660,39.599947,240.22118800000004,157,21
"172.16.133.20",62356,"172.16.139.250",5440,12,1142,5122,0,0,12,1142,0,0,39.608072,0.014518000000002473,629287,0
"172.16.133.28",65344,"172.16.139.250",5440,10,1022,5123,0,0,10,1022,0,0,39.639522,0.005817000000000405,1405535,0
"172.16.133.99",56021,"172.16.139.250",5440,10,1022,5124,0,0,10,1022,0,0,39.666481,0.004966000000003135,"",""
"172.16.133.87",60163,"172.16.139.250",5440,10,1022,5125,0,0,10,1022,0,0,39.687788,0.0150030000000001,544957,0
"172.16.133.35",49949,"172.16.139.250",5440,12,1142,5126,0,0,12,1142,0,0,39.701911,0.030872999999999706,295922,0
"172.16.133.116",53271,"172.16.139.250",5440,12,1142,5127,0,0,12,1142,0,0,39.705059,0.005364000000000146,1703206,0
"172.16.133.116",53272,"172.16.139.250",5440,10,1022,5128,0,0,10,1022,0,0,39.710953,0.005252999999996177,1556443,0
"172.16.133.116",53273,"172.16.139.250",5440,10,1022,5129,0,0,10,1022,0,0,39.716723,0.015251999999996713,536060,0
"172.16.133.84",58770,"172.16.139.250",5440,12,1142,5130,0,0,12,1142,0,0,39.725861,0.016388999999996656,557447,0
"172.16.133.78",59182,"74.120.148.2",443,12,2188,5131,0,0,7,1412,5,776,39.742454,0.09416399999999925,119960,65927
"172.16.133.24",57655,"64.56.203.22",443,16,960,5132,0,0,8,480,8,480,39.743951,256.22682000000003,14,14
"172.16.133.24",57654,"64.56.203.22",443,16,960,5133,0,0,8,480,8,480,39.744923,256.22678699999994,14,14
"172.16.133.24",57657,"64.56.203.22",443,16,960,5134,0,0,8,480,8,480,39.764975,256.206685,14,14
"172.16.133.35",49199,"173.194.43.36",443,15,1014,5135,0,0,7,420,8,594,39.798515,150.034289,22,31
"172.16.133.49",55744,"172.16.139.250",5440,12,1142,5136,0,0,12,1142,0,0,39.803689,0.015937000000000978,573257,0
"172.16.133.95",56944,"172.16.139.250",5440,10,1022,5137,0,0,10,1022,0,0,39.84005,0.015529000000000792,526498,0
"172.16.133.126",61359,"173.194.43.46",80,8,492,5138,0,0,4,240,4,252,39.846017,66.911819,28,30
"172.16.133.67",53214,"216.52.242.80",80,9,540,5139,0,0,8,480,1,60,39.852015,256.260985,14,1
"172.16.133.92",57660,"172.16.139.250",5440,12,1142,5140,0,0,12,1142,0,0,39.869424,0.015758999999995638,579732,0
"172.16.133.29",60863,"172.16.139.250",5440,12,1142,5141,0,0,12,1142,0,0,39.886065,0.015337999999999852,595644,0
"172.16.133.44",64756,"172.16.139.250",5440,10,1022,5142,0,0,10,1022,0,0,39.894855,0.014906000000003417,548503,0
"172.16.133.207",55912,"172.16.139.250",5440,12,1142,5143,0,0,12,1142,0,0,39.918290999999996,0.015986000000005163,571500,0
"172.16.133.83",57068,"172.16.139.250",5440,12,1142,5144,0,0,12,1142,0,0,39.925871,0.004694000000000642,"",""
"172.16.133.93",60638,"172.16.139.250",5440,10,1022,5145,0,0,10,1022,0,0,39.944911,0.00465000000000515,"",""
"172.16.133.56",61330,"173.194.43.57",80,13,804,5146,0,0,7,420,6,384,39.952143,201.81942899999999,16,15
"172.16.133.11",55121,"172.16.139.250",5440,12,1142,5147,0,0,12,1142,0,0,39.962049,0.006481000000000847,1409659,0
"172.16.133.55",57558,"172.16.139.250",5440,10,1022,5148,0,0,10,1022,0,0,39.964967,0.006541999999996051,1249770,0
"157.56.238.6",443,"172.16.133.88",64806,10,839,5149,0,0,5,539,5,300,39.973394,240.857916,17,9
"172.16.133.56",61331,"23.32.180.174",80,11,690,5150,0,0,6,360,5,330,39.981102,225.09203599999998,12,11
"172.16.133.121",55710,"173.194.68.125",443,15,998,5151,0,0,8,486,7,512,39.986556,258.109685,15,15
"172.16.133.73",60613,"172.16.139.250",5440,10,1022,5152,0,0,10,1022,0,0,39.989728,0.005872000000003652,1392370,0
"172.16.133.53",54078,"172.16.139.250",5440,12,1142,5153,0,0,12,1142,0,0,39.989935,0.009591999999997824,952460,0
"172.16.133.37",57197,"216.52.242.80",80,12,2961,5154,0,0,9,2047,3,914,39.991017,235.360094,69,31
"172.16.133.21",53152,"172.16.139.250",5440,12,1142,5155,0,0,12,1142,0,0,39.994342,0.009373999999993998,974610,0
"172.16.133.30",62593,"172.16.139.250",5440,10,1022,5156,0,0,10,1022,0,0,39.996244,0.010727000000002818,762188,0
"172.16.133.56",61334,"23.6.20.174",80,6,366,5157,0,0,3,180,3,186,40.002124,21.776061999999996,66,68
"172.16.133.25",63416,"172.16.139.250",5440,10,1022,5158,0,0,10,1022,0,0,40.005536,0.005479000000001122,1492243,0
"172.16.133.34",50418,"172.16.139.250",5440,12,1142,5159,0,0,12,1142,0,0,40.012749,0.005046999999997581,1810184,0
"172.16.133.97",59349,"172.16.139.250",5440,12,1142,5160,0,0,12,1142,0,0,40.025451,0.0061850000000021055,1477122,0
"172.16.133.121",56469,"96.43.146.176",443,12,720,5161,0,0,6,360,6,360,40.09752,225.310031,12,12
"172.16.133.33",57860,"172.16.139.250",5440,10,1022,5162,0,0,10,1022,0,0,40.099867,0.005643999999996652,1448618,0
"172.16.133.121",56468,"96.43.146.176",443,12,720,5163,0,0,6,360,6,360,40.110592,225.300908,12,12
"172.16.133.121",56467,"96.43.146.176",443,12,720,5164,0,0,6,360,6,360,40.117502,225.34544699999998,12,12
"172.16.133.72",52216,"157.56.241.150",443,27,14127,5165,0,0,12,2094,15,12033,40.124102,2.0343420000000023,8234,47319
"172.16.133.68",60704,"172.16.139.250",5440,12,1142,5166,0,0,12,1142,0,0,40.129794,0.015489000000002306,589837,0
"172.16.133.121",56253,"96.43.146.48",443,12,720,5167,0,0,6,360,6,360,40.13749,225.32566299999996,12,12
"172.16.133.12",59713,"172.16.139.250",5440,12,1142,5168,0,0,12,1142,0,0,40.145513,0.006081999999999255,1502137,0
"172.16.133.121",56470,"96.43.146.176",443,43,15203,5169,0,0,25,12854,18,2349,40.146536,255.63713600000003,402,73
"172.16.133.63",53857,"172.16.139.250",5440,12,1142,5170,0,0,12,1142,0,0,40.152967,0.006279000000006363,1455008,0
"172.16.133.66",53828,"172.16.139.250",5440,12,1142,5171,0,0,12,1142,0,0,40.168763,0.006199999999999761,1473548,0
"172.16.133.24",57537,"96.43.146.22",443,12,3534,5172,0,0,6,2855,6,679,40.174962,45.61099599999999,500,119
"172.16.133.82",61300,"172.16.139.250",5440,12,1142,5173,0,0,12,1142,0,0,40.181131,0.016362000000000876,558366,0
"172.16.133.37",60600,"172.16.139.250",5440,12,1142,5174,0,0,12,1142,0,0,40.195762,0.005530999999997732,1651780,0
"172.16.133.16",59331,"173.194.43.39",443,37,6486,5175,0,0,19,4132,18,2354,40.203889,240.23145699999998,137,78
"172.16.133.78",59183,"74.120.148.2",443,12,2252,5176,0,0,7,1476,5,776,40.21183,0.0936230000000009,126122,66308
"172.16.133.20",62357,"216.52.242.80",80,69,57440,5177,0,0,28,9082,41,48358,40.252577,240.884923,301,1606
"172.16.133.113",55603,"172.16.139.250",135,8,492,5178,0,0,8,492,0,0,40.286711,0.00995900000000205,395220,0
"172.16.133.113",55604,"172.16.139.250",5462,10,696,5179,0,0,10,696,0,0,40.297924,0.505431999999999,11016,0
"172.16.133.78",59184,"172.16.139.250",5440,10,1022,5180,0,0,10,1022,0,0,40.351971,0.00614699999999857,1330079,0
"172.16.133.121",56482,"96.43.146.22",443,12,720,5181,0,0,6,360,6,360,40.387501,225.27132800000004,12,12
"172.16.133.67",55964,"172.16.139.250",5440,10,1022,5182,0,0,10,1022,0,0,40.405785,0.014668999999997823,557365,0
"172.16.133.56",61389,"172.16.139.250",5440,10,1022,5183,0,0,10,1022,0,0,40.427913,0.014659000000001754,557746,0
"172.16.133.49",53313,"96.43.146.176",443,11,677,5184,0,0,5,300,6,377,40.435393,128.188968,18,23
"172.16.133.42",57045,"172.16.139.250",5440,12,1142,5185,0,0,12,1142,0,0,40.459586,0.02528499999999667,361320,0
"172.16.133.75",50929,"172.16.139.250",5440,12,1142,5186,0,0,12,1142,0,0,40.483842,0.006290999999997382,1452233,0
"172.16.133.41",52885,"172.16.139.250",5440,12,1142,5187,0,0,12,1142,0,0,40.484401,0.009722000000003561,939724,0
"172.16.133.48",60510,"157.56.245.198",443,24,10517,5188,0,0,11,2386,13,8131,40.50003,1.5694429999999997,12162,41446
"172.16.133.85",52226,"172.16.139.250",5440,10,1022,5189,0,0,10,1022,0,0,40.501449,0.005417999999998813,1509043,0
"172.16.133.43",57742,"172.16.139.250",5440,10,1022,5190,0,0,10,1022,0,0,40.555942,0.006378999999995472,1281705,0
"172.16.133.13",53018,"172.16.139.250",5440,10,1022,5191,0,0,10,1022,0,0,40.572744,0.005097999999996716,1603766,0
"172.16.133.12",59424,"173.194.43.40",80,6,366,5192,0,0,3,180,3,186,40.620375,17.649296999999997,81,84
"172.16.133.20",62358,"172.16.139.250",5440,12,1142,5193,0,0,12,1142,0,0,40.622097,0.004867000000004396,"",""
"172.16.133.114",55323,"184.73.225.104",443,22,7276,5194,0,0,11,1982,11,5294,40.636013,5.360713000000004,2957,7900
"172.16.133.126",61242,"96.43.146.22",443,9,557,5195,0,0,4,240,5,317,40.645069,76.12016,25,33
"172.16.133.28",65345,"172.16.139.250",5440,10,1022,5196,0,0,10,1022,0,0,40.653482,0.006302000000005137,1297365,0
"172.16.133.78",59185,"50.19.208.49",80,13,1879,5197,0,0,7,1327,6,552,40.665352,64.400754,164,68
"172.16.133.78",59186,"50.19.208.49",80,6,366,5198,0,0,4,246,2,120,40.665662,14.413885,136,66
"172.16.133.99",56022,"172.16.139.250",5440,12,1142,5199,0,0,12,1142,0,0,40.679498,0.015418999999994298,592515,0
"108.160.161.163",80,"172.16.133.71",55162,24,4392,5200,0,0,12,1878,12,2514,40.682803,223.819035,67,89
"172.16.133.87",60164,"172.16.139.250",5440,10,1022,5201,0,0,10,1022,0,0,40.701309,0.005649999999995714,1447079,0
"172.16.133.35",49950,"172.16.139.250",5440,12,1142,5202,0,0,12,1142,0,0,40.714207,0.007585999999996318,1204323,0
"172.16.133.116",53274,"172.16.139.250",5440,10,1022,5203,0,0,10,1022,0,0,40.719926,0.006211000000000411,1316374,0
"172.16.133.25",63417,"170.173.0.16",56093,3,194,5204,0,0,3,194,0,0,40.720636,8.998358000000003,172,0
"172.16.133.116",53275,"172.16.139.250",5440,10,1022,5205,0,0,10,1022,0,0,40.726649,0.0055369999999967945,1476611,0
"172.16.133.92",57518,"96.43.146.22",443,35,15769,5206,0,0,20,13360,15,2409,40.731807,234.009529,456,82
"172.16.133.116",53276,"172.16.139.250",5440,10,1022,5207,0,0,10,1022,0,0,40.732771,0.00757899999999978,1078770,0
"172.16.133.92",57592,"96.43.146.22",443,12,720,5208,0,0,6,360,6,360,40.736834,225.25170500000002,12,12
"172.16.133.84",58771,"172.16.139.250",5440,10,1022,5209,0,0,10,1022,0,0,40.740013,0.015423000000005516,530117,0
"172.16.133.54",64178,"157.56.245.198",443,18,1395,5210,0,0,9,855,9,540,40.79304,240.042208,28,17
"172.16.133.49",55745,"172.16.139.250",5440,12,1142,5211,0,0,12,1142,0,0,40.818852,0.015920000000001266,573869,0
"172.16.133.37",60601,"67.217.64.244",443,6,366,5212,0,0,4,246,2,120,40.843527,0.057328999999995744,34328,16745
"172.16.133.95",56945,"172.16.139.250",5440,12,1142,5213,0,0,12,1142,0,0,40.853939,0.0073400000000063415,1244686,0
"172.16.133.40",50049,"96.43.146.22",443,9,557,5214,0,0,4,240,5,317,40.860892,84.4486,22,30
"172.16.133.24",57664,"74.125.226.222",443,16,1080,5215,0,0,7,420,9,660,40.873991,195.01844300000002,17,27
"172.16.133.92",57661,"172.16.139.250",5440,10,1022,5216,0,0,10,1022,0,0,40.883204,0.005557000000003143,1471297,0
"172.16.133.29",60864,"172.16.139.250",5440,10,1022,5217,0,0,10,1022,0,0,40.900281,0.005428999999999462,1505986,0
"172.16.133.44",64757,"172.16.139.250",5440,10,1022,5218,0,0,10,1022,0,0,40.906806,0.005319000000000074,1537131,0
"172.16.133.207",55913,"172.16.139.250",5440,10,1022,5219,0,0,10,1022,0,0,40.933393,0.015384999999994875,531426,0
"172.16.133.83",57069,"172.16.139.250",5440,12,1142,5220,0,0,12,1142,0,0,40.940098,0.0048040000000000305,"",""
"172.16.133.93",60639,"172.16.139.250",5440,12,1142,5221,0,0,12,1142,0,0,40.95957,0.004818000000000211,"",""
"172.16.133.11",55122,"172.16.139.250",5440,10,1022,5222,0,0,10,1022,0,0,40.973897,0.015427999999999997,529945,0
"172.16.133.55",57559,"172.16.139.250",5440,12,1142,5223,0,0,12,1142,0,0,40.978828,0.00627399999999767,1456168,0
"172.16.133.73",60614,"172.16.139.250",5440,10,1022,5224,0,0,10,1022,0,0,41.002656,0.005544999999997913,1474481,0
"172.16.133.53",54079,"172.16.139.250",5440,10,1022,5225,0,0,10,1022,0,0,41.004073,0.008023000000001446,1019070,0
"172.16.133.21",53153,"172.16.139.250",5440,10,1022,5226,0,0,10,1022,0,0,41.007118,0.008867000000002179,922070,0
"172.16.133.30",62594,"172.16.139.250",5440,10,1022,5227,0,0,10,1022,0,0,41.009946,0.010006000000004178,817109,0
"172.16.133.25",63418,"172.16.139.250",5440,10,1022,5228,0,0,10,1022,0,0,41.019118,0.016252999999998963,503045,0
"199.47.218.150",80,"172.16.133.48",49232,17,3426,5229,0,0,14,2828,3,598,41.022245,150.270941,150,31
"172.16.133.34",50419,"172.16.139.250",5440,10,1022,5230,0,0,10,1022,0,0,41.026888,0.00481500000000068,"",""
"172.16.133.97",59350,"172.16.139.250",5440,10,1022,5231,0,0,10,1022,0,0,41.039441,0.015445000000006814,529362,0
"172.16.133.207",50006,"96.43.146.176",443,25,8055,5232,0,0,15,5010,10,3045,41.056695,240.347445,166,101
"172.16.133.33",57861,"172.16.139.250",5440,12,1142,5233,0,0,12,1142,0,0,41.113811,0.006360999999998285,1436252,0
"172.16.133.68",60706,"172.16.139.250",5440,10,1022,5234,0,0,10,1022,0,0,41.144177,0.005523000000003719,1480354,0
"172.16.133.12",59714,"172.16.139.250",5440,12,1142,5235,0,0,12,1142,0,0,41.158178,0.006185999999999581,1476883,0
"172.16.133.37",60602,"66.151.150.190",443,7,426,5236,0,0,4,246,3,180,41.158504,0.19568100000000044,10057,7358
"172.16.133.63",53858,"172.16.139.250",5440,10,1022,5237,0,0,10,1022,0,0,41.166568,0.014620000000000744,559233,0
"172.16.133.37",60603,"216.219.113.250",443,6,366,5238,0,0,4,246,2,120,41.176517,0.21064900000000364,9342,4557
"172.16.133.114",55324,"157.56.244.217",443,6,374,5239,0,0,3,194,3,180,41.180308,1.1353650000000002,1366,1268
"172.16.133.66",53829,"172.16.139.250",5440,10,1022,5240,0,0,10,1022,0,0,41.182609,0.005231999999999459,1562691,0
"172.16.133.82",61301,"172.16.139.250",5440,10,1022,5241,0,0,10,1022,0,0,41.195036,0.005521999999999139,1480622,0
"172.16.133.37",60604,"172.16.139.250",5440,12,1142,5242,0,0,12,1142,0,0,41.209068,0.006068999999996549,1505355,0
"172.16.133.56",61390,"96.43.146.176",443,182,152563,5243,0,0,78,47346,104,105217,41.219649,236.83873999999997,1599,3554
"172.16.133.56",61391,"96.43.146.176",443,213,178333,5244,0,0,87,51059,126,127274,41.227562,239.791576,1703,4246
"199.47.216.146",80,"172.16.133.68",49248,15,2820,5245,0,0,10,1465,5,1355,41.270286,221.783161,52,48
"172.16.133.50",50681,"96.43.146.22",443,16,977,5246,0,0,8,480,8,497,41.286275,255.099532,15,15
"172.16.133.50",50677,"96.43.146.22",443,16,977,5247,0,0,8,480,8,497,41.28675,255.09864800000003,15,15
"172.16.133.88",51226,"68.64.24.250",443,6,366,5248,0,0,4,246,2,120,41.289073,0.12521399999999971,15717,7666
"172.16.133.50",50682,"96.43.146.22",443,16,977,5249,0,0,8,480,8,497,41.297172,255.102279,15,15
"172.16.133.88",51227,"78.108.118.250",443,6,366,5250,0,0,4,246,2,120,41.341013,0.23423300000000324,8401,4098
"172.16.133.88",51228,"216.219.118.244",443,6,366,5251,0,0,4,246,2,120,41.341969,0.23415299999999917,8404,4099
"172.16.133.50",50680,"96.43.146.48",443,12,720,5252,0,0,6,360,6,360,41.344213,225.361657,12,12
"172.16.133.50",50679,"96.43.146.48",443,12,720,5253,0,0,6,360,6,360,41.347135,225.34703499999998,12,12
"172.16.133.78",59187,"172.16.139.250",5440,10,1022,5254,0,0,10,1022,0,0,41.365955,0.005428999999999462,1505986,0
"157.56.238.6",443,"172.16.133.21",61260,10,795,5255,0,0,5,495,5,300,41.368503,239.84437,16,10
"172.16.133.34",49728,"96.43.146.48",443,12,737,5256,0,0,6,360,6,377,41.37654,164.914086,17,18
"172.16.133.33",57525,"23.15.128.239",80,7,432,5257,0,0,4,240,3,192,41.412856,80.42324200000002,23,19
"172.16.133.67",55965,"172.16.139.250",5440,12,1142,5258,0,0,12,1142,0,0,41.420768,0.006076999999997668,1503373,0
"172.16.133.56",61392,"172.16.139.250",5440,10,1022,5259,0,0,10,1022,0,0,41.442259,0.006202999999999292,1318071,0
"172.16.133.42",57046,"172.16.139.250",5440,12,1142,5260,0,0,12,1142,0,0,41.463245,0.011384999999997092,802459,0
"172.16.133.33",57413,"173.194.43.35",443,8,576,5261,0,0,3,180,5,396,41.469833,14.932302,96,212
"172.16.133.88",51229,"216.115.219.126",443,6,366,5262,0,0,4,246,2,120,41.486055,0.48810900000000146,4031,1966
"172.16.133.75",50930,"172.16.139.250",5440,10,1022,5263,0,0,10,1022,0,0,41.497554,0.005760000000002208,1419444,0
"172.16.133.41",52886,"172.16.139.250",5440,10,1022,5264,0,0,10,1022,0,0,41.498307,0.008650000000002933,945202,0
"172.16.133.85",52227,"172.16.139.250",5440,10,1022,5265,0,0,10,1022,0,0,41.51591,0.005327999999998667,1534534,0
"172.16.133.29",49809,"172.16.139.250",5500,20,1740,5266,0,0,20,1740,0,0,41.529186,240.20136399999998,57,0
"172.16.133.43",57743,"172.16.139.250",5440,10,1022,5267,0,0,10,1022,0,0,41.571172,0.005349999999999966,1528224,0
"172.16.133.13",53019,"172.16.139.250",5440,10,1022,5268,0,0,10,1022,0,0,41.586993,0.0051819999999977995,1577769,0
"172.16.133.20",62359,"8.27.243.253",80,15,2679,5269,0,0,8,908,7,1771,41.611183,14.528101000000007,499,975
"172.16.133.20",62360,"8.27.243.253",80,15,2630,5270,0,0,8,908,7,1722,41.611387,14.527800999999997,500,948
"172.16.133.20",62361,"8.27.243.253",80,26,6612,5271,0,0,12,1576,14,5036,41.611501,14.527601000000004,867,2773
"172.16.133.20",62362,"8.27.243.253",80,24,6771,5272,0,0,11,1510,13,5261,41.61161,14.527763999999998,831,2897
"172.16.133.20",62363,"8.27.243.253",80,36,14971,5273,0,0,15,2163,21,12808,41.611709,14.527342000000004,1191,7053
"172.16.133.20",62364,"8.27.243.253",80,24,7498,5274,0,0,11,1932,13,5566,41.611815,14.527650000000001,1063,3065
"172.16.133.20",62365,"172.16.139.250",5440,10,1022,5275,0,0,10,1022,0,0,41.636192,0.005167999999997619,1582043,0
"172.16.133.60",61931,"96.43.146.22",443,35,15490,5276,0,0,20,13080,15,2410,41.641992,240.484417,435,80
"172.16.133.28",65346,"172.16.139.250",5440,12,1142,5277,0,0,12,1142,0,0,41.667569,0.006377999999997996,1432423,0
"172.16.133.99",56023,"172.16.139.250",5440,12,1142,5278,0,0,12,1142,0,0,41.694937,0.01453799999999461,628422,0
"172.16.133.87",60165,"172.16.139.250",5440,10,1022,5279,0,0,10,1022,0,0,41.715462,0.005510000000001014,1483847,0
"172.16.133.35",49951,"172.16.139.250",5440,12,1142,5280,0,0,12,1142,0,0,41.730041,0.013536999999999466,674891,0
"172.16.133.116",53277,"172.16.139.250",5440,12,1142,5281,0,0,12,1142,0,0,41.75207,0.007677999999998519,1189893,0
"172.16.133.84",58772,"172.16.139.250",5440,10,1022,5282,0,0,10,1022,0,0,41.754072,0.008823999999997056,926563,0
"172.16.133.20",62366,"216.52.242.80",80,6,372,5283,0,0,4,246,2,126,41.755063,14.445768000000001,136,69
"172.16.133.116",53278,"172.16.139.250",5440,10,1022,5284,0,0,10,1022,0,0,41.76039,0.006788000000000238,1204478,0
"172.16.133.20",62367,"173.194.43.60",80,21,3044,5285,0,0,11,1662,10,1382,41.763613,244.318026,54,45
"172.16.133.116",53279,"172.16.139.250",5440,10,1022,5286,0,0,10,1022,0,0,41.768045,0.005122999999997546,1595939,0
"172.16.133.49",55746,"172.16.139.250",5440,10,1022,5287,0,0,10,1022,0,0,41.832172,0.005440999999997587,1502664,0
"172.16.133.95",56946,"172.16.139.250",5440,10,1022,5288,0,0,10,1022,0,0,41.867795,0.014569999999999084,561153,0
"172.16.133.20",62368,"208.111.160.6",80,8,492,5289,0,0,4,246,4,246,41.890426,14.25423,138,138
"172.16.133.92",57662,"172.16.139.250",5440,10,1022,5290,0,0,10,1022,0,0,41.895983,0.015409999999995705,530564,0
"172.16.133.72",52213,"173.194.43.61",443,15,1014,5291,0,0,7,420,8,594,41.89972,148.233089,22,32
"172.16.133.29",60865,"172.16.139.250",5440,10,1022,5292,0,0,10,1022,0,0,41.914533,0.0061019999999984975,1339888,0
"172.16.133.44",64758,"172.16.139.250",5440,12,1142,5293,0,0,12,1142,0,0,41.920244,0.015489000000002306,589837,0
"172.16.133.20",62369,"23.0.49.244",80,6,372,5294,0,0,4,246,2,126,41.938385,14.201609000000005,138,70
"172.16.133.20",62370,"23.0.49.244",80,7,432,5295,0,0,4,246,3,186,41.938495,14.201501999999998,138,104
"172.16.133.35",49676,"96.43.146.22",443,38,18645,5296,0,0,22,16176,16,2469,41.940222,234.629123,551,84
"172.16.133.20",62371,"23.0.49.244",80,7,432,5297,0,0,4,246,3,186,41.942628,14.202341000000004,138,104
"172.16.133.207",55914,"172.16.139.250",5440,10,1022,5298,0,0,10,1022,0,0,41.946161000000004,0.016241999999998313,503386,0
"172.16.133.83",57071,"172.16.139.250",5440,12,1142,5299,0,0,12,1142,0,0,41.953897,0.004750000000001364,"",""
"172.16.133.93",60640,"172.16.139.250",5440,10,1022,5300,0,0,10,1022,0,0,41.972309,0.014116999999998825,579159,0
"172.16.133.11",55123,"172.16.139.250",5440,10,1022,5301,0,0,10,1022,0,0,41.988848,0.005593000000004622,1461827,0
"172.16.133.55",57560,"172.16.139.250",5440,10,1022,5302,0,0,10,1022,0,0,41.991519,0.014778000000006841,553254,0
"172.16.133.78",51837,"96.43.146.176",443,25,8055,5303,0,0,15,5010,10,3045,42.004267,240.34712299999998,166,101
"172.16.133.75",59506,"96.43.146.50",443,17,1037,5304,0,0,8,480,9,557,42.004764,234.051957,16,19
"172.16.133.73",60615,"172.16.139.250",5440,10,1022,5305,0,0,10,1022,0,0,42.015855,0.08050399999999769,101560,0
"172.16.133.53",54080,"172.16.139.250",5440,12,1142,5306,0,0,12,1142,0,0,42.018155,0.103316999999997,88426,0
"172.16.133.21",53154,"172.16.139.250",5440,12,1142,5307,0,0,12,1142,0,0,42.022376,0.10724499999999892,85188,0
"172.16.133.30",62595,"172.16.139.250",5440,10,1022,5308,0,0,10,1022,0,0,42.024436,0.10091599999999801,81017,0
"172.16.133.25",63419,"172.16.139.250",5440,12,1142,5309,0,0,12,1142,0,0,42.034177,0.09898299999999693,92298,0
"172.16.133.34",50420,"172.16.139.250",5440,12,1142,5310,0,0,12,1142,0,0,42.040643,0.03925199999999762,232752,0
"172.16.133.97",59351,"172.16.139.250",5440,10,1022,5311,0,0,10,1022,0,0,42.052222,0.14881400000000156,54941,0
"172.16.133.84",58773,"64.90.204.229",443,17,2863,5312,0,0,8,1788,9,1075,42.055489,9.117804,1568,943
"172.16.133.56",61324,"54.243.97.145",80,6,366,5313,0,0,3,180,3,186,42.081147,19.698050000000002,73,75
"172.16.133.28",51313,"172.16.139.250",5500,20,10868,5314,0,0,20,10868,0,0,42.122083,62.57777999999999,1389,0
"172.16.133.47",56555,"65.54.80.208",80,16,2273,5315,0,0,8,1277,8,996,42.125198,4.304235000000006,2373,1851
"172.16.133.33",57862,"172.16.139.250",5440,10,1022,5316,0,0,10,1022,0,0,42.12869,0.08860100000000415,92278,0
"172.16.133.68",60707,"172.16.139.250",5440,12,1142,5317,0,0,12,1142,0,0,42.158039,0.06716699999999776,136019,0
"172.16.133.56",61326,"173.194.43.60",80,14,870,5318,0,0,7,420,7,450,42.162147,199.609203,16,18
"172.16.133.103",63008,"96.43.146.48",443,25,8055,5319,0,0,15,5010,10,3045,42.174825,240.35387200000002,166,101
"172.16.133.41",52887,"69.2.103.57",80,6,372,5320,0,0,4,246,2,126,42.175612,17.828654,110,56
"172.16.133.41",52888,"69.2.103.57",80,6,372,5321,0,0,4,246,2,126,42.175986,17.827385,110,56
"172.16.133.41",52889,"69.2.103.57",80,6,372,5322,0,0,4,246,2,126,42.17628,17.833046000000003,110,56
"172.16.133.41",52890,"69.2.103.57",80,6,372,5323,0,0,4,246,2,126,42.176506,17.827758999999993,110,56
"172.16.133.41",52891,"69.2.103.57",80,6,372,5324,0,0,4,246,2,126,42.17677,17.832487,110,56
"172.16.133.41",52892,"69.2.103.57",80,6,372,5325,0,0,4,246,2,126,42.176934,17.832324999999997,110,56
"172.16.133.41",52893,"74.119.118.94",80,11,4995,5326,0,0,6,4546,5,449,42.177224,16.363616999999998,2222,219
"172.16.133.41",52894,"74.119.118.94",80,17,9940,5327,0,0,9,8808,8,1132,42.177419,12.230272,5761,740
"172.16.133.41",52895,"74.119.118.94",80,4,252,5328,0,0,2,126,2,126,42.177694,13.325033999999995,75,75
"172.16.133.20",62372,"138.108.6.20",80,8,1537,5329,0,0,4,879,4,658,42.177958,13.564571,518,388
"172.16.133.41",52896,"173.194.43.57",80,6,372,5330,0,0,4,246,2,126,42.177959,17.829606,110,56
"172.16.133.41",52897,"173.194.43.57",80,6,372,5331,0,0,4,246,2,126,42.178154,17.829411999999998,110,56
"172.16.133.41",52898,"208.71.125.72",80,6,366,5332,0,0,4,246,2,120,42.178546,17.833167000000003,110,53
"172.16.133.41",52899,"208.71.125.72",80,6,366,5333,0,0,4,246,2,120,42.178755,17.83296,110,53
"172.16.133.41",52900,"208.71.125.72",80,6,366,5334,0,0,4,246,2,120,42.178974,17.831913,110,53
"172.16.133.41",52901,"173.194.43.45",80,6,372,5335,0,0,4,246,2,126,42.179346,17.826535,110,56
"172.16.133.41",52902,"173.194.43.45",80,6,372,5336,0,0,4,246,2,126,42.179544,17.828887,110,56
"172.16.133.63",53859,"172.16.139.250",5440,10,1022,5337,0,0,10,1022,0,0,42.180856,0.04711199999999849,173543,0
"172.16.133.41",52903,"74.125.226.26",80,6,372,5338,0,0,4,246,2,126,42.184248,17.840130000000002,110,56
"172.16.133.41",52904,"74.125.226.26",80,7,432,5339,0,0,4,246,3,186,42.184451,17.841679,110,83
"172.16.133.20",62373,"64.94.107.18",80,8,1511,5340,0,0,5,1048,3,463,42.187902,0.07685299999999984,109091,48195
"172.16.133.66",53830,"172.16.139.250",5440,10,1022,5341,0,0,10,1022,0,0,42.197476,0.035344999999999516,231319,0
"172.16.133.24",57645,"216.137.33.45",443,9,569,5342,0,0,4,240,5,329,42.203991,83.699558,22,31
"172.16.133.12",59715,"172.16.139.250",5440,12,1142,5343,0,0,12,1142,0,0,42.204051,0.03513900000000092,259996,0
"172.16.133.82",61302,"172.16.139.250",5440,12,1142,5344,0,0,12,1142,0,0,42.209336,0.03506900000000002,260514,0
"172.16.133.41",52905,"68.67.159.201",80,44,28764,5345,0,0,20,17171,24,11593,42.212846,17.794102000000002,7719,5212
"172.16.133.41",52906,"68.67.159.201",80,21,11234,5346,0,0,10,5866,11,5368,42.213011,17.793630999999998,2637,2413
"172.16.133.41",52907,"68.67.159.201",80,7,432,5347,0,0,4,246,3,186,42.21316,17.793900999999998,110,83
"172.16.133.41",52908,"68.67.159.201",80,7,432,5348,0,0,4,246,3,186,42.21329,17.793138,110,83
"172.16.133.126",51068,"96.43.146.48",443,17,3364,5349,0,0,9,2576,8,788,42.214141,225.38607000000002,91,27
"172.16.133.37",60605,"172.16.139.250",5440,12,1142,5350,0,0,12,1142,0,0,42.222703,0.025548999999998045,357587,0
"172.16.133.82",61230,"173.194.43.40",443,51,19342,5351,0,0,29,14881,22,4461,42.230134,226.56047700000002,525,157
"172.16.133.56",61399,"96.43.146.176",443,17,1411,5352,0,0,9,802,8,609,42.233495,225.344475,28,21
"172.16.133.56",61400,"96.43.146.22",443,17,1415,5353,0,0,9,806,8,609,42.233763,225.34547499999996,28,21
"172.16.133.56",61401,"96.43.146.22",443,17,1415,5354,0,0,9,806,8,609,42.233916,225.345431,28,21
"172.16.133.56",61402,"96.43.146.22",443,17,1415,5355,0,0,9,806,8,609,42.234048,225.344996,28,21
"172.16.133.56",61403,"96.43.146.22",443,23,4437,5356,0,0,13,3420,10,1017,42.243657,228.20304900000002,119,35
"172.16.133.56",61404,"96.43.146.22",443,22,4615,5357,0,0,12,3377,10,1238,42.243773,228.265413,118,43
"172.16.133.50",50698,"96.43.146.22",443,31,12839,5358,0,0,18,10863,13,1976,42.248191,18.878176000000003,4603,837
"172.16.133.56",61337,"173.194.43.59",80,14,870,5359,0,0,7,420,7,450,42.261147,199.50921200000002,16,18
"172.16.133.47",56556,"208.47.254.34",80,12,2181,5360,0,0,7,1213,5,968,42.282719,171.29753499999998,56,45
"157.56.245.198",443,"172.16.133.207",49661,10,775,5361,0,0,5,475,5,300,42.287464,240.026722,15,9
"172.16.133.45",61260,"96.43.146.178",443,12,720,5362,0,0,6,360,6,360,42.302115,225.27140099999997,12,12
"172.16.133.114",55325,"157.56.234.137",443,6,374,5363,0,0,3,194,3,180,42.324577,1.2418049999999994,1249,1159
"172.16.133.41",52909,"74.125.226.230",443,33,3810,5364,0,0,17,2238,16,1572,42.335441,240.13327700000002,74,52
"172.16.133.41",52910,"206.188.4.2",80,13,4879,5365,0,0,7,3525,6,1354,42.342314,0.11479500000000087,245655,94359
"172.16.133.41",52911,"184.173.89.4",80,10,1645,5366,0,0,5,1025,5,620,42.344165,0.23848200000000475,34384,20798
"172.16.133.56",61405,"96.43.146.22",443,15,3703,5367,0,0,8,3137,7,566,42.363499,1.489518000000004,16848,3039
"172.16.133.56",61406,"96.43.146.22",443,50,22179,5368,0,0,30,19100,20,3079,42.364214,226.885137,673,108
"172.16.133.41",52912,"98.139.225.43",80,28,11599,5369,0,0,14,7537,14,4062,42.373799,17.641179,3417,1842
"172.16.133.41",52913,"63.135.90.139",80,20,3088,5370,0,0,11,1822,9,1266,42.377045,254.22605799999997,57,39
"172.16.133.41",52914,"69.20.31.45",80,30,14430,5371,0,0,15,7324,15,7106,42.377771,254.149497,230,223
"172.16.133.78",59188,"172.16.139.250",5440,12,1142,5372,0,0,12,1142,0,0,42.379997,0.006591999999997711,1385922,0
"157.56.236.102",443,"172.16.133.41",65163,23,6653,5373,0,0,13,6053,10,600,42.422544,240.122774,201,19
"172.16.133.67",55966,"172.16.139.250",5440,12,1142,5374,0,0,12,1142,0,0,42.434923,0.04387600000000447,208223,0
"172.16.133.56",61407,"172.16.139.250",5440,12,1142,5375,0,0,12,1142,0,0,42.455896,0.025577999999995882,357181,0
"172.16.133.41",52915,"173.241.242.12",80,8,1493,5376,0,0,5,869,3,624,42.473399,0.09327499999999844,74532,53519
"172.16.133.41",52916,"63.135.90.138",80,22,3598,5377,0,0,11,1946,11,1652,42.479738,254.047663,61,52
"172.16.133.42",57047,"172.16.139.250",5440,12,1142,5378,0,0,12,1142,0,0,42.484165,0.0568010000000001,160842,0
"157.56.236.102",443,"172.16.133.43",63428,10,775,5379,0,0,5,475,5,300,42.487392,240.81036899999998,15,9
"172.16.133.75",50931,"172.16.139.250",5440,12,1142,5380,0,0,12,1142,0,0,42.511769,0.031067999999997653,294064,0
"172.16.133.41",52917,"172.16.139.250",5440,10,1022,5381,0,0,10,1022,0,0,42.513029,0.00883400000000023,925515,0
"172.16.133.41",52918,"184.173.89.4",80,10,1648,5382,0,0,5,1028,5,620,42.515041,0.2159640000000067,38080,22966
"172.16.133.41",52919,"23.45.65.74",80,22,5125,5383,0,0,12,3985,10,1140,42.528307,225.3567,141,40
"172.16.133.85",52228,"172.16.139.250",5440,12,1142,5384,0,0,12,1142,0,0,42.529609,0.018195999999996104,502088,0
"172.16.133.41",52920,"173.241.242.12",80,8,1616,5385,0,0,5,938,3,678,42.535764,0.08477299999999843,88518,63982
"172.16.133.43",57744,"172.16.139.250",5440,12,1142,5386,0,0,12,1142,0,0,42.583893,0.006218999999994423,1469046,0
"172.16.133.13",53020,"172.16.139.250",5440,10,1022,5387,0,0,10,1022,0,0,42.601003,0.006244000000002359,1309417,0
"172.16.133.41",52921,"173.241.242.153",80,8,1855,5388,0,0,5,1178,3,677,42.623868,0.08627099999999643,109237,62778
"172.16.133.11",49412,"96.43.146.48",443,25,8055,5389,0,0,15,5010,10,3045,42.642306,240.349778,166,101
"172.16.133.20",62374,"172.16.139.250",5440,12,1142,5390,0,0,12,1142,0,0,42.649995,0.014773000000005254,618425,0
"172.16.133.28",65347,"172.16.139.250",5440,10,1022,5391,0,0,10,1022,0,0,42.681585,0.0054500000000032855,1500183,0
"172.16.133.41",52922,"173.241.242.12",80,8,1676,5392,0,0,5,988,3,688,42.693588,0.10307900000000103,76679,53395
"172.16.133.18",50282,"174.129.20.55",443,26,9590,5393,0,0,13,2336,13,7254,42.699577,10.370132000000005,1802,5596
"172.16.133.93",60453,"208.47.254.81",80,10,618,5394,0,0,5,300,5,318,42.702063,134.804923,17,18
"172.16.133.99",56024,"172.16.139.250",5440,12,1142,5395,0,0,12,1142,0,0,42.707875,0.014397999999999911,634532,0
"172.16.133.16",59332,"107.20.231.134",80,9,1638,5396,0,0,5,985,4,653,42.718117,0.1000009999999989,78799,52239
"172.16.133.93",60439,"173.194.43.59",80,14,870,5397,0,0,7,420,7,450,42.727036,204.776013,16,17
"172.16.133.87",60166,"172.16.139.250",5440,10,1022,5398,0,0,10,1022,0,0,42.729513,0.015312000000001547,533960,0
"172.16.133.13",52618,"96.43.146.176",443,26,8179,5399,0,0,15,6903,11,1276,42.730146,226.043403,244,45
"172.16.133.35",49952,"172.16.139.250",5440,12,1142,5400,0,0,12,1142,0,0,42.744114,0.012861999999998375,710309,0
"172.16.133.116",53280,"172.16.139.250",5440,10,1022,5401,0,0,10,1022,0,0,42.746251,0.008518999999999721,959737,0
"172.16.133.16",59333,"208.92.52.90",80,10,1775,5402,0,0,5,965,5,810,42.750695,0.11858999999999753,65098,54642
"172.16.133.93",60583,"23.67.242.11",80,11,690,5403,0,0,6,360,5,330,42.752047,225.13043699999997,12,11
"172.16.133.116",53281,"172.16.139.250",5440,12,1142,5404,0,0,12,1142,0,0,42.755398,0.005543000000002962,1648204,0
"172.16.133.116",53282,"172.16.139.250",5440,12,1142,5405,0,0,12,1142,0,0,42.761523,0.005967000000005385,1531087,0
"172.16.133.68",49815,"96.43.146.48",443,26,8075,5406,0,0,15,5010,11,3065,42.765663,240.331122,166,102
"172.16.133.84",58774,"172.16.139.250",5440,10,1022,5407,0,0,10,1022,0,0,42.768101,0.015310999999996966,533995,0
"172.16.133.93",60543,"74.217.78.146",80,12,720,5408,0,0,6,360,6,360,42.77705,225.70459000000002,12,12
"172.16.133.49",55747,"172.16.139.250",5440,12,1142,5409,0,0,12,1142,0,0,42.846008,0.005859000000000947,1559310,0
"172.16.133.95",56947,"172.16.139.250",5440,12,1142,5410,0,0,12,1142,0,0,42.882301,0.01601399999999842,570500,0
"172.16.133.92",57663,"172.16.139.250",5440,12,1142,5411,0,0,12,1142,0,0,42.91107,0.016202999999997303,563846,0
"172.16.133.29",60866,"172.16.139.250",5440,12,1142,5412,0,0,12,1142,0,0,42.927885,0.006238999999993666,1464337,0
"172.16.133.44",64759,"172.16.139.250",5440,12,1142,5413,0,0,12,1142,0,0,42.936757,0.006039999999998713,1512582,0
"172.16.133.68",59452,"96.43.146.22",443,35,15410,5414,0,0,20,12980,15,2430,42.954019,255.44523899999996,406,76
"172.16.133.207",55915,"172.16.139.250",5440,12,1142,5415,0,0,12,1142,0,0,42.960391,0.005201999999997042,1756247,0
"172.16.133.83",57072,"172.16.139.250",5440,10,1022,5416,0,0,10,1022,0,0,42.968029,0.0048019999999979746,"",""
"172.16.133.93",60641,"172.16.139.250",5440,10,1022,5417,0,0,10,1022,0,0,42.995142,0.02121700000000004,385351,0
"172.16.133.11",55124,"172.16.139.250",5440,12,1142,5418,0,0,12,1142,0,0,43.002769,0.006934000000001106,1317565,0
"172.16.133.55",57561,"172.16.139.250",5440,12,1142,5419,0,0,12,1142,0,0,43.005608,0.007946999999994375,1149616,0
"172.16.133.132",39335,"63.116.244.114",80,1525,1468462,5420,0,0,533,53853,992,1414609,43.025192,15.288260000000001,28180,740232
"172.16.133.73",60616,"172.16.139.250",5440,12,1142,5421,0,0,12,1142,0,0,43.031355,0.04042800000000568,225981,0
"172.16.133.53",54081,"172.16.139.250",5440,12,1142,5422,0,0,12,1142,0,0,43.032535,0.05795999999999424,157625,0
"172.16.133.21",53155,"172.16.139.250",5440,12,1142,5423,0,0,12,1142,0,0,43.035901,0.028404999999999347,321633,0
"172.16.133.30",62596,"172.16.139.250",5440,10,1022,5424,0,0,10,1022,0,0,43.038371,0.029605000000003656,276169,0
"172.16.133.23",55044,"172.16.139.250",5440,12,1142,5425,0,0,12,1142,0,0,43.046438,0.03282600000000002,278315,0
"172.16.133.25",63420,"172.16.139.250",5440,12,1142,5426,0,0,12,1142,0,0,43.046628,0.028390999999999167,321792,0
"172.16.133.34",50421,"172.16.139.250",5440,12,1142,5427,0,0,12,1142,0,0,43.054891,0.039245000000001085,232793,0
"172.16.133.97",59352,"172.16.139.250",5440,12,1142,5428,0,0,12,1142,0,0,43.066378,0.019263999999999726,474252,0
"172.16.133.49",54409,"96.43.146.176",443,11,677,5429,0,0,5,300,6,377,43.110352,125.513957,19,24
"172.16.133.33",57863,"172.16.139.250",5440,10,1022,5430,0,0,10,1022,0,0,43.142674,0.014792999999997392,552693,0
"172.16.133.132",39336,"63.116.244.114",80,64,51801,5431,0,0,28,3459,36,48342,43.154688,15.158436000000002,1825,25512
"172.16.133.132",39337,"63.116.244.114",80,16,5209,5432,0,0,9,1447,7,3762,43.158363,15.154434000000002,763,1985
"172.16.133.132",39338,"63.116.244.114",80,47,33120,5433,0,0,22,2625,25,30495,43.168669,15.149192999999997,1386,16103
"172.16.133.68",60708,"172.16.139.250",5440,12,1142,5434,0,0,12,1142,0,0,43.171838,0.0077390000000008285,1180514,0
"172.16.133.132",39339,"63.116.244.114",80,46,32245,5435,0,0,22,2251,24,29994,43.17201,15.145741999999998,1188,15842
"172.16.133.132",39340,"63.116.244.114",80,40,28860,5436,0,0,19,2079,21,26781,43.175273,15.142397000000003,1098,14148
"172.16.133.12",59716,"172.16.139.250",5440,12,1142,5437,0,0,12,1142,0,0,43.186097,0.006137999999999977,1488432,0
"172.16.133.29",49265,"157.56.237.150",443,11,870,5438,0,0,6,570,5,300,43.19327,240.08275100000003,18,9
"172.16.133.63",53860,"172.16.139.250",5440,10,1022,5439,0,0,10,1022,0,0,43.194895,0.005440000000000111,1502941,0
"172.16.133.93",60642,"199.48.204.30",80,15,3182,5440,0,0,8,1130,7,2052,43.202581,14.360205999999998,629,1143
"172.16.133.93",60643,"199.48.204.30",80,35,19935,5441,0,0,16,4232,19,15703,43.202874,24.368391999999993,1389,5155
"172.16.133.93",60644,"199.48.204.30",80,11,702,5442,0,0,7,444,4,258,43.203102,14.372084000000001,247,143
"172.16.133.66",53831,"172.16.139.250",5440,10,1022,5443,0,0,10,1022,0,0,43.210597,0.005319000000000074,1537131,0
"172.16.133.73",60617,"96.43.146.13",443,13,1934,5444,0,0,7,1160,6,774,43.215175,0.21417999999999893,43328,28910
"172.16.133.73",60618,"96.43.146.13",443,13,1933,5445,0,0,7,1159,6,774,43.215436,50.308338000000006,184,123
"172.16.133.82",61303,"172.16.139.250",5440,10,1022,5446,0,0,10,1022,0,0,43.223711,0.005570999999996218,1467600,0
"172.16.133.93",60645,"168.215.63.101",80,6,372,5447,0,0,3,186,3,186,43.225187,14.317741000000005,103,103
"172.16.133.93",60646,"168.215.63.101",80,6,372,5448,0,0,3,186,3,186,43.225657,14.317084000000001,103,103
"172.16.133.93",60647,"168.215.63.101",80,6,372,5449,0,0,3,186,3,186,43.225799,14.315945999999997,103,103
"172.16.133.93",60648,"199.48.204.30",80,41,34944,5450,0,0,15,3983,26,30961,43.23315,4.328347999999998,7361,57224
"172.16.133.93",60649,"199.48.204.30",80,8,504,5451,0,0,5,312,3,192,43.235051,14.321957000000005,174,107
"172.16.133.37",60606,"172.16.139.250",5440,10,1022,5452,0,0,10,1022,0,0,43.236988,0.005666000000005056,1442993,0
"172.16.133.93",60505,"54.243.98.221",80,6,366,5453,0,0,3,180,3,186,43.26201,24.255302000000007,59,61
"172.16.133.41",52923,"199.102.234.31",80,11,4118,5454,0,0,6,2698,5,1420,43.263028,0.0926550000000006,232950,122605
"172.16.133.63",53686,"96.43.146.22",443,13,797,5455,0,0,6,360,7,437,43.266053,167.249162,17,20
"172.16.133.93",60588,"54.243.98.221",80,6,366,5456,0,0,3,180,3,186,43.272029,24.245181000000002,59,61
"172.16.133.93",60585,"54.243.98.221",80,6,366,5457,0,0,3,180,3,186,43.275015,24.242089999999997,59,61
"172.16.133.93",60586,"54.243.98.221",80,6,366,5458,0,0,3,180,3,186,43.277994,24.237857999999996,59,61
"172.16.133.93",60589,"54.243.98.221",80,6,366,5459,0,0,3,180,3,186,43.277995,24.239414000000004,59,61
"172.16.133.93",60650,"173.194.75.105",443,38,5912,5460,0,0,18,3437,20,2475,43.324931,226.909579,121,87
"172.16.133.93",60587,"54.243.98.221",80,6,366,5461,0,0,3,180,3,186,43.332027,24.184927000000002,59,61
"172.16.133.30",62099,"96.43.146.22",443,14,857,5462,0,0,7,420,7,437,43.348752,172.775296,19,20
"172.16.133.88",51230,"68.64.24.250",443,6,366,5463,0,0,4,246,2,120,43.349016,0.09792300000000154,20097,9803
"172.16.133.78",59189,"172.16.139.250",5440,12,1142,5464,0,0,12,1142,0,0,43.392948,0.006495000000001028,1406620,0
"172.16.133.99",49534,"96.43.146.176",443,25,8055,5465,0,0,15,5010,10,3045,43.409255,240.405336,166,101
"172.16.133.41",65164,"157.56.236.102",443,10,775,5466,0,0,5,475,5,300,43.413673,240.138438,15,9
"172.16.133.67",55967,"172.16.139.250",5440,10,1022,5467,0,0,10,1022,0,0,43.448116,0.006331000000002973,1291423,0
"172.16.133.56",61408,"172.16.139.250",5440,10,1022,5468,0,0,10,1022,0,0,43.470115,0.00467700000000093,"",""
"172.16.133.88",51231,"78.108.118.250",443,6,366,5469,0,0,4,246,2,120,43.477099,0.22511999999999688,8742,4264
"172.16.133.88",51232,"216.219.118.244",443,6,366,5470,0,0,4,246,2,120,43.47907,0.2259650000000022,8709,4248
"172.16.133.42",57048,"172.16.139.250",5440,12,1142,5471,0,0,12,1142,0,0,43.497701,0.021959000000002504,416048,0
"172.16.133.49",54410,"96.43.146.176",443,24,6144,5472,0,0,13,4848,11,1296,43.506371,225.702972,171,45
"172.16.133.43",58851,"96.43.146.48",443,27,8175,5473,0,0,15,5010,12,3165,43.519544,240.336208,166,105
"172.16.133.75",50932,"172.16.139.250",5440,10,1022,5474,0,0,10,1022,0,0,43.525573,0.00556399999999968,1469446,0
"172.16.133.41",52924,"172.16.139.250",5440,12,1142,5475,0,0,12,1142,0,0,43.526235,0.00940400000000352,971501,0
"172.16.133.85",52229,"172.16.139.250",5440,10,1022,5476,0,0,10,1022,0,0,43.544492,0.005591000000002566,1462350,0
"172.16.133.114",55326,"157.56.236.89",443,6,374,5477,0,0,3,194,3,180,43.571126,1.3588239999999985,1142,1059
"172.16.133.93",60594,"72.21.211.130",80,12,720,5478,0,0,6,360,6,360,43.574061,225.19430000000003,12,12
"172.16.133.29",49804,"96.43.146.176",443,26,8075,5479,0,0,15,5010,11,3065,43.582609,245.91313000000002,162,99
"172.16.133.93",60592,"72.21.211.130",80,12,720,5480,0,0,6,360,6,360,43.58906,225.18798499999997,12,12
"172.16.133.132",60487,"63.116.244.144",80,24,12659,5481,0,0,13,1317,11,11342,43.594729,14.735337000000001,715,6157
"172.16.133.132",60488,"63.116.244.144",80,28,15967,5482,0,0,15,1449,13,14518,43.595219,14.735483000000002,786,7881
"172.16.133.132",60489,"63.116.244.144",80,7,478,5483,0,0,4,272,3,206,43.595677,14.734500999999995,147,111
"172.16.133.132",60490,"63.116.244.144",80,7,478,5484,0,0,4,272,3,206,43.59608,14.736145,147,111
"172.16.133.132",60491,"63.116.244.144",80,22,11183,5485,0,0,12,1251,10,9932,43.596537,14.734427000000004,679,5392
"172.16.133.132",60492,"63.116.244.144",80,22,10935,5486,0,0,12,1251,10,9684,43.59695,14.733871,679,5258
"172.16.133.43",57745,"172.16.139.250",5440,10,1022,5487,0,0,10,1022,0,0,43.597929,0.014806000000000097,552208,0
"172.16.133.132",51368,"23.67.242.17",80,20,8941,5488,0,0,11,1097,9,7844,43.604939,14.725437,595,4261
"172.16.133.132",51369,"23.67.242.17",80,22,11231,5489,0,0,12,1180,10,10051,43.605243,14.724536999999998,641,5460
"172.16.133.132",51370,"23.67.242.17",80,6,412,5490,0,0,4,272,2,140,43.605566,14.720177999999997,147,76
"172.16.133.132",51371,"23.67.242.17",80,6,412,5491,0,0,4,272,2,140,43.605843,14.725178,147,76
"172.16.133.132",51372,"23.67.242.17",80,6,412,5492,0,0,4,272,2,140,43.606134,14.724157000000005,147,76
"172.16.133.132",51373,"23.67.242.17",80,20,8988,5493,0,0,11,1094,9,7894,43.606415,14.724156,594,4289
"172.16.133.13",53021,"172.16.139.250",5440,10,1022,5494,0,0,10,1022,0,0,43.614791,0.005341000000001372,1530799,0
"172.16.133.20",62375,"172.16.139.250",5440,12,1142,5495,0,0,12,1142,0,0,43.664323,0.015162999999994042,602519,0
"172.16.133.66",61217,"96.43.146.176",443,26,8115,5496,0,0,15,5010,11,3105,43.69423,240.433894,166,103
"172.16.133.28",65348,"172.16.139.250",5440,10,1022,5497,0,0,10,1022,0,0,43.695469,0.005389999999998452,1516883,0
"172.16.133.93",60595,"72.21.211.130",80,12,720,5498,0,0,6,360,6,360,43.714021,225.17508600000002,12,12
"172.16.133.99",56025,"172.16.139.250",5440,12,1142,5499,0,0,12,1142,0,0,43.721704,0.005155999999999494,1771916,0
"172.16.133.93",60591,"207.171.163.205",80,12,720,5500,0,0,6,360,6,360,43.729034,225.15826099999998,12,12
"172.16.133.88",51233,"216.115.219.126",443,6,366,5501,0,0,4,246,2,120,43.734147,0.5305820000000026,3709,1809
"172.16.133.60",55333,"172.16.139.250",5500,20,1740,5502,0,0,20,1740,0,0,43.742187,240.194004,57,0
"172.16.133.87",60167,"172.16.139.250",5440,10,1022,5503,0,0,10,1022,0,0,43.74371,0.005747999999996978,1422407,0
"172.16.133.35",49953,"172.16.139.250",5440,12,1142,5504,0,0,12,1142,0,0,43.75833,0.013081999999997151,698364,0
"172.16.133.93",60512,"207.171.163.205",80,12,720,5505,0,0,6,360,6,360,43.759038,225.156573,12,12
"172.16.133.116",53283,"172.16.139.250",5440,10,1022,5506,0,0,10,1022,0,0,43.759614,0.004626000000001795,"",""
"172.16.133.116",53284,"172.16.139.250",5440,10,1022,5507,0,0,10,1022,0,0,43.764801,0.015514000000003136,527007,0
"172.16.133.132",58108,"208.47.254.25",80,10,1863,5508,0,0,6,871,4,992,43.769292,14.560599000000003,478,545
"172.16.133.116",53285,"172.16.139.250",5440,10,1022,5509,0,0,10,1022,0,0,43.781132,0.01706699999999728,479053,0
"172.16.133.84",58775,"172.16.139.250",5440,10,1022,5510,0,0,10,1022,0,0,43.781999,0.005302999999997837,1541768,0
"172.16.133.99",55866,"96.43.146.176",443,28,14756,5511,0,0,14,8398,14,6358,43.802826,214.24479799999997,313,237
"172.16.133.99",53423,"96.43.146.48",443,27,14681,5512,0,0,14,8398,13,6283,43.806851,214.23960599999998,313,234
"172.16.133.132",57564,"173.194.43.59",80,21,7083,5513,0,0,13,2613,8,4470,43.817587,14.495306999999997,1442,2467
"172.16.133.93",60651,"74.125.226.2",443,110,53560,5514,0,0,42,7054,68,46506,43.843638,237.16656799999998,237,1568
"172.16.133.93",60652,"74.125.226.4",80,33,12526,5515,0,0,19,8708,14,3818,43.847918,240.97292900000002,289,126
"172.16.133.49",55748,"172.16.139.250",5440,12,1142,5516,0,0,12,1142,0,0,43.859126,0.0059909999999945285,1524954,0
"172.16.133.95",56948,"172.16.139.250",5440,12,1142,5517,0,0,12,1142,0,0,43.895974,0.006062000000000012,1507093,0
"172.16.133.132",42209,"63.241.108.124",80,9,4092,5518,0,0,5,1058,4,3034,43.905276,0.09880799999999823,85661,245648
"172.16.133.93",60653,"74.125.226.40",443,37,6662,5519,0,0,19,2345,18,4317,43.909962,240.21914099999998,78,143
"172.16.133.92",57664,"172.16.139.250",5440,10,1022,5520,0,0,10,1022,0,0,43.925083,0.015546999999997979,525889,0
"172.16.133.37",60607,"216.115.223.200",443,6,366,5521,0,0,4,246,2,120,43.93155,0.1029139999999984,19122,9328
"172.16.133.29",60867,"172.16.139.250",5440,10,1022,5522,0,0,10,1022,0,0,43.941954,0.005505999999996902,1484925,0
"172.16.133.207",55266,"96.43.146.48",443,9,557,5523,0,0,4,240,5,317,43.945369,75.014093,25,33
"172.16.133.44",64760,"172.16.139.250",5440,10,1022,5524,0,0,10,1022,0,0,43.948585,0.015247999999999706,536201,0
"157.56.242.198",443,"172.16.133.12",50968,10,795,5525,0,0,5,495,5,300,43.961856,240.13203999999996,16,9
"172.16.133.93",60654,"23.60.241.224",80,9,564,5526,0,0,5,312,4,252,43.974741,13.553426000000002,184,148
"172.16.133.93",60655,"23.60.241.224",80,16,3797,5527,0,0,9,2567,7,1230,43.974863,73.574607,279,133
"172.16.133.207",55916,"172.16.139.250",5440,12,1142,5528,0,0,12,1142,0,0,43.97525,0.0049009999999967135,"",""
"172.16.133.93",60656,"23.60.241.224",80,7,432,5529,0,0,4,246,3,186,43.979924,13.548503000000004,145,109
"172.16.133.93",60657,"23.60.241.224",80,7,432,5530,0,0,4,246,3,186,43.980044,13.548672000000003,145,109
"172.16.133.83",57073,"172.16.139.250",5440,10,1022,5531,0,0,10,1022,0,0,43.982003,0.004587000000000785,"",""
"172.16.133.93",60658,"172.16.139.250",5440,12,1142,5532,0,0,12,1142,0,0,43.998582999999996,0.0047630000000040695,"",""
"172.16.133.93",60659,"199.59.150.12",443,33,8325,5533,0,0,15,2895,18,5430,44.001833,41.32939,560,1051
"172.16.133.11",55125,"172.16.139.250",5440,12,1142,5534,0,0,12,1142,0,0,44.016784,0.006180999999997994,1478077,0
"172.16.133.55",57562,"172.16.139.250",5440,10,1022,5535,0,0,10,1022,0,0,44.020129,0.01649900000000315,495545,0
"172.16.133.34",62816,"172.16.139.250",5447,10,1400,5536,0,0,10,1400,0,0,44.0405,239.22760599999998,46,0
"172.16.133.73",60619,"172.16.139.250",5440,10,1022,5537,0,0,10,1022,0,0,44.044557,0.0056480000000007635,1447592,0
"172.16.133.53",54082,"172.16.139.250",5440,12,1142,5538,0,0,12,1142,0,0,44.046113,0.016376000000001056,557889,0
"172.16.133.21",53156,"172.16.139.250",5440,10,1022,5539,0,0,10,1022,0,0,44.050088,0.015589999999995996,524438,0
"172.16.133.30",62597,"172.16.139.250",5440,10,1022,5540,0,0,10,1022,0,0,44.052302,0.005691000000005886,1436654,0
"172.16.133.25",63421,"172.16.139.250",5440,10,1022,5541,0,0,10,1022,0,0,44.061295,0.007944999999999425,1029074,0
"172.16.133.34",50422,"172.16.139.250",5440,10,1022,5542,0,0,10,1022,0,0,44.069179,0.005087000000003172,1607234,0
"172.16.133.97",59353,"172.16.139.250",5440,10,1022,5543,0,0,10,1022,0,0,44.081469,0.0154980000000009,527551,0
"172.16.133.132",55365,"208.47.254.9",80,49,29817,5544,0,0,26,3171,23,26646,44.090934,14.222748000000003,1783,14987
"172.16.133.132",55366,"208.47.254.9",80,12,4167,5545,0,0,7,948,5,3219,44.091267,14.222708999999995,533,1810
"172.16.133.132",55367,"208.47.254.9",80,84,70950,5546,0,0,36,2826,48,68124,44.091611,14.222180999999999,1589,38319
"172.16.133.54",64318,"96.43.146.22",443,18,3987,5547,0,0,10,3073,8,914,44.136335,116.06441899999999,211,62
"172.16.133.44",64762,"202.173.27.250",443,6,366,5548,0,0,4,246,2,120,44.1533,0.5479059999999976,3591,1752
"172.16.133.44",64763,"216.115.220.254",443,6,366,5549,0,0,4,246,2,120,44.154121,0.4792329999999936,4106,2003
"172.16.133.44",64764,"216.219.120.244",443,6,366,5550,0,0,4,246,2,120,44.15503,0.22090600000000649,8908,4345
"172.16.133.44",64765,"216.115.217.254",443,6,366,5551,0,0,4,246,2,120,44.155628,0.15097699999999747,13035,6358
"172.16.133.33",57864,"172.16.139.250",5440,12,1142,5552,0,0,12,1142,0,0,44.155781,0.006260000000004595,1459424,0
"172.16.133.68",60709,"172.16.139.250",5440,10,1022,5553,0,0,10,1022,0,0,44.185854,0.014800000000001035,552432,0
"172.16.133.12",59717,"172.16.139.250",5440,12,1142,5554,0,0,12,1142,0,0,44.199985,0.008850999999999942,1032199,0
"172.16.133.93",60660,"173.252.110.27",80,82,43019,5555,0,0,30,7215,52,35804,44.205542,241.26535299999998,239,1187
"172.16.133.63",53861,"172.16.139.250",5440,10,1022,5556,0,0,10,1022,0,0,44.207715,0.016848000000003083,485280,0
"172.16.133.24",57627,"75.101.140.131",443,8,517,5557,0,0,4,240,4,277,44.223043,21.701648,88,102
"172.16.133.66",53832,"172.16.139.250",5440,10,1022,5558,0,0,10,1022,0,0,44.225238,0.00822400000000556,994163,0
"172.16.133.82",61304,"172.16.139.250",5440,10,1022,5559,0,0,10,1022,0,0,44.237012,0.0055720000000007985,1467336,0
"172.16.133.37",60608,"172.16.139.250",5440,10,1022,5560,0,0,10,1022,0,0,44.250985,0.005732999999999322,1426129,0
"172.16.133.95",54541,"96.43.146.22",443,38,18532,5561,0,0,22,16062,16,2470,44.335243,234.53653500000001,547,84
"172.16.133.78",59190,"172.16.139.250",5440,12,1142,5562,0,0,12,1142,0,0,44.407106,0.006308000000004199,1448319,0
"172.16.133.235",2695,"172.16.131.10",8080,24,4283,5563,0,0,12,2439,12,1844,44.415697,18.999586,1026,776
"172.16.133.67",55968,"172.16.139.250",5440,12,1142,5564,0,0,12,1142,0,0,44.462157,0.006202000000001817,1473073,0
"172.16.133.56",61409,"172.16.139.250",5440,10,1022,5565,0,0,10,1022,0,0,44.484128,0.006332000000000448,1291219,0
"172.16.133.42",57049,"172.16.139.250",5440,12,1142,5566,0,0,12,1142,0,0,44.50725,0.03624200000000144,252083,0
"172.16.133.75",50933,"172.16.139.250",5440,10,1022,5567,0,0,10,1022,0,0,44.539688,0.005614999999998815,1456099,0
"172.16.133.41",52925,"172.16.139.250",5440,10,1022,5568,0,0,10,1022,0,0,44.54029,0.008665000000000589,943566,0
"172.16.133.85",52230,"172.16.139.250",5440,10,1022,5569,0,0,10,1022,0,0,44.557848,0.0053849999999968645,1518291,0
"172.16.133.233",50538,"172.16.125.220",80,7,420,5570,0,0,4,240,3,180,44.573484,0.1941619999999986,9888,7416
"172.16.133.233",33992,"184.73.225.104",80,74,19842,5571,0,0,41,2472,33,17370,44.574488,0.20117399999999463,98302,690745
"172.16.133.43",57746,"172.16.139.250",5440,12,1142,5572,0,0,12,1142,0,0,44.61289,0.015565999999999747,586920,0
"172.16.133.13",53022,"172.16.139.250",5440,10,1022,5573,0,0,10,1022,0,0,44.62938,0.005366999999999678,1523383,0
"172.16.133.20",62376,"172.16.139.250",5440,12,1142,5574,0,0,12,1142,0,0,44.678089,0.005206000000001154,1754898,0
"172.16.133.28",65349,"172.16.139.250",5440,10,1022,5575,0,0,10,1022,0,0,44.709834,0.005603999999998166,1458957,0
"172.16.133.99",56026,"172.16.139.250",5440,12,1142,5576,0,0,12,1142,0,0,44.735065,0.014496000000001175,630242,0
"157.56.234.118",443,"172.16.133.37",59827,10,775,5577,0,0,5,475,5,300,44.751564,240.60175999999998,15,9
"172.16.133.87",60168,"172.16.139.250",5440,10,1022,5578,0,0,10,1022,0,0,44.757749,0.015270000000001005,535428,0
"172.16.133.35",49954,"172.16.139.250",5440,12,1142,5579,0,0,12,1142,0,0,44.770057,0.01258200000000187,726116,0
"172.16.133.116",53286,"172.16.139.250",5440,10,1022,5580,0,0,10,1022,0,0,44.773256,0.007458999999997218,1096125,0
"172.16.133.116",53287,"172.16.139.250",5440,10,1022,5581,0,0,10,1022,0,0,44.78135,0.005314999999995962,1538287,0
"172.16.133.56",61410,"96.43.146.176",443,17,1411,5582,0,0,9,802,8,609,44.783708,225.38865700000002,28,21
"172.16.133.56",61411,"96.43.146.176",443,17,1411,5583,0,0,9,802,8,609,44.784015,225.387176,28,21
"172.16.133.116",53288,"172.16.139.250",5440,10,1022,5584,0,0,10,1022,0,0,44.787336,0.0048549999999991655,"",""
"172.16.133.132",42213,"63.241.108.124",80,8,1666,5585,0,0,5,921,3,745,44.787881,0.06942200000000298,106133,85851
"64.4.23.161",40036,"172.16.133.24",55795,29,1760,5586,0,0,17,1040,12,720,44.794099,207.354718,40,27
"172.16.133.84",58776,"172.16.139.250",5440,12,1142,5587,0,0,12,1142,0,0,44.796278,0.006140000000002033,1487947,0
"172.16.133.113",55605,"172.16.139.250",135,8,492,5588,0,0,8,492,0,0,44.806684,0.007558000000003062,520772,0
"108.160.161.157",80,"172.16.133.12",63285,15,2705,5589,0,0,10,1465,5,1240,44.809353,223.01324,52,44
"172.16.133.113",55606,"172.16.139.250",5462,8,576,5590,0,0,8,576,0,0,44.820382,0.5074279999999973,9081,0
"172.16.133.49",55749,"172.16.139.250",5440,10,1022,5591,0,0,10,1022,0,0,44.874364,0.005471000000000004,1494425,0
"172.16.133.95",56949,"172.16.139.250",5440,10,1022,5592,0,0,10,1022,0,0,44.910232,0.0054680000000004725,1495245,0
"172.16.133.114",55327,"157.56.240.137",443,6,374,5593,0,0,3,194,3,180,44.931427,1.1052540000000022,1404,1302
"172.16.133.92",57665,"172.16.139.250",5440,10,1022,5594,0,0,10,1022,0,0,44.939236,0.015436000000001115,529670,0
"172.16.133.29",60868,"172.16.139.250",5440,10,1022,5595,0,0,10,1022,0,0,44.956395,0.0054230000000004,1507652,0
"172.16.133.44",64766,"172.16.139.250",5440,10,1022,5596,0,0,10,1022,0,0,44.96341,0.005434999999998524,1504323,0
"172.16.133.207",55917,"172.16.139.250",5440,12,1142,5597,0,0,12,1142,0,0,44.989223,0.015840999999994665,576731,0
"172.16.133.83",57074,"172.16.139.250",5440,12,1142,5598,0,0,12,1142,0,0,44.996052,0.004730999999999597,"",""
"172.16.133.93",60661,"172.16.139.250",5440,12,1142,5599,0,0,12,1142,0,0,45.013078,0.01459899999999692,625796,0
"172.16.133.11",55126,"172.16.139.250",5440,10,1022,5600,0,0,10,1022,0,0,45.03067,0.005583000000001448,1464445,0
"172.16.133.55",57563,"172.16.139.250",5440,10,1022,5601,0,0,10,1022,0,0,45.034236,0.01567500000000166,521594,0
"172.16.133.73",60620,"172.16.139.250",5440,10,1022,5602,0,0,10,1022,0,0,45.058455,0.0055419999999983816,1475279,0
"172.16.133.53",54083,"172.16.139.250",5440,10,1022,5603,0,0,10,1022,0,0,45.06087,0.007526999999996065,1086222,0
"172.16.133.21",53157,"172.16.139.250",5440,10,1022,5604,0,0,10,1022,0,0,45.063175,0.008662000000001058,943892,0
"172.16.133.30",62598,"172.16.139.250",5440,10,1022,5605,0,0,10,1022,0,0,45.06659,0.009247000000002004,884178,0
"172.16.133.25",63422,"172.16.139.250",5440,12,1142,5606,0,0,12,1142,0,0,45.075786,0.004919999999998481,"",""
"157.56.232.214",443,"172.16.133.55",50200,10,775,5607,0,0,5,475,5,300,45.078648,240.18631900000003,15,9
"172.16.133.34",50423,"172.16.139.250",5440,10,1022,5608,0,0,10,1022,0,0,45.082958,0.014327999999999008,570630,0
"172.16.133.97",59354,"172.16.139.250",5440,10,1022,5609,0,0,10,1022,0,0,45.094306,0.006694999999993456,1221209,0
"172.16.133.66",53833,"173.194.74.95",80,6,372,5610,0,0,4,246,2,126,45.118554,12.053275999999997,163,83
"172.16.133.66",53834,"173.194.74.95",80,6,372,5611,0,0,4,246,2,126,45.118893,12.052050999999999,163,83
"172.16.133.66",53835,"173.194.43.43",80,6,372,5612,0,0,4,246,2,126,45.119335,12.061414,163,83
"172.16.133.66",53836,"173.194.43.34",80,6,372,5613,0,0,4,246,2,126,45.119521,12.061177999999998,163,83
"172.16.133.66",53837,"173.194.43.34",80,6,372,5614,0,0,4,246,2,126,45.11964,12.065544000000003,163,83
"172.16.133.66",53838,"173.194.75.103",80,6,372,5615,0,0,4,246,2,126,45.119797,12.080714,162,83
"172.16.133.66",53839,"173.194.75.103",80,6,372,5616,0,0,4,246,2,126,45.119905,12.081437999999999,162,83
"172.16.133.66",53840,"173.194.75.103",80,6,372,5617,0,0,4,246,2,126,45.120014,12.081330000000001,162,83
"172.16.133.66",53841,"173.194.43.47",80,6,372,5618,0,0,4,246,2,126,45.120399,12.063912000000002,163,83
"172.16.133.66",53842,"173.194.43.47",80,6,372,5619,0,0,4,246,2,126,45.12144,12.063685999999997,163,83
"172.16.133.33",57865,"172.16.139.250",5440,10,1022,5620,0,0,10,1022,0,0,45.169022,0.01538500000000198,531426,0
"172.16.133.68",60710,"172.16.139.250",5440,10,1022,5621,0,0,10,1022,0,0,45.200202,0.005543000000002962,1475013,0
"172.16.133.12",59718,"172.16.139.250",5440,12,1142,5622,0,0,12,1142,0,0,45.214997,0.006625000000006764,1379018,0
"172.16.133.63",53862,"172.16.139.250",5440,12,1142,5623,0,0,12,1142,0,0,45.223482,0.005506000000004008,1659280,0
"172.16.133.66",53843,"172.16.139.250",5440,12,1142,5624,0,0,12,1142,0,0,45.238626,0.0072920000000067375,1252879,0
"172.16.133.82",61305,"172.16.139.250",5440,10,1022,5625,0,0,10,1022,0,0,45.251546,0.015337000000002377,533089,0
"172.16.133.37",60609,"172.16.139.250",5440,12,1142,5626,0,0,12,1142,0,0,45.265506,0.015865999999995495,575822,0
"157.56.236.102",443,"172.16.133.43",63448,10,775,5627,0,0,5,475,5,300,45.37996,240.054819,15,9
"172.16.133.88",51234,"68.64.24.250",443,6,366,5628,0,0,4,246,2,120,45.401236,0.1034220000000019,19028,9282
"172.16.133.78",59191,"172.16.139.250",5440,12,1142,5629,0,0,12,1142,0,0,45.420965,0.006396999999999764,1428169,0
"172.16.133.67",55969,"172.16.139.250",5440,12,1142,5630,0,0,12,1142,0,0,45.476453,0.007204999999999018,1268008,0
"172.16.133.78",61668,"74.201.34.2",3158,21,2772,5631,0,0,14,1492,7,1280,45.480473,240.207064,49,42
"172.16.133.11",49561,"157.56.244.214",443,22,2213,5632,0,0,11,1553,11,660,45.494084,233.03222600000004,53,22
"172.16.133.56",61412,"172.16.139.250",5440,12,1142,5633,0,0,12,1142,0,0,45.498487,0.0051360000000002515,1778816,0
"172.16.133.132",33218,"173.194.43.60",80,10,1674,5634,0,0,6,710,4,964,45.510495,12.822316,442,601
"172.16.133.132",33219,"173.194.43.60",80,63,44576,5635,0,0,31,2450,32,42126,45.523661,12.809268000000003,1530,26309
"172.16.133.42",57050,"172.16.139.250",5440,12,1142,5636,0,0,12,1142,0,0,45.529602,0.030442000000000746,300111,0
"172.16.133.75",50934,"172.16.139.250",5440,10,1022,5637,0,0,10,1022,0,0,45.552383,0.005382000000004439,1519137,0
"172.16.133.41",52926,"172.16.139.250",5440,10,1022,5638,0,0,10,1022,0,0,45.554453,0.014592999999997858,560268,0
"172.16.133.85",52231,"172.16.139.250",5440,12,1142,5639,0,0,12,1142,0,0,45.57151,0.0062769999999972015,1455472,0
"172.16.133.88",51235,"78.108.118.250",443,6,366,5640,0,0,4,246,2,120,45.586218,0.20396299999999457,9648,4706
"172.16.133.88",51236,"216.219.118.244",443,6,366,5641,0,0,4,246,2,120,45.588143,0.20927599999999558,9403,4587
"172.16.133.25",49604,"96.43.146.48",443,29,9205,5642,0,0,17,5142,12,4063,45.621242,240.33308800000003,171,135
"172.16.133.43",57747,"172.16.139.250",5440,10,1022,5643,0,0,10,1022,0,0,45.626187,0.006225000000000591,1313413,0
"172.16.133.85",52232,"68.64.4.249",443,6,366,5644,0,0,4,246,2,120,45.632993,0.1111450000000005,17706,8637
"172.16.133.85",52233,"216.219.116.244",443,6,366,5645,0,0,4,246,2,120,45.634109,0.24416399999999783,8060,3931
"172.16.133.85",52234,"216.115.216.250",443,6,366,5646,0,0,4,246,2,120,45.63422,0.05538400000000365,35533,17333
"172.16.133.85",52235,"68.64.26.250",443,6,366,5647,0,0,4,246,2,120,45.636062,0.09935399999999817,19807,9662
"172.16.133.13",53023,"172.16.139.250",5440,10,1022,5648,0,0,10,1022,0,0,45.643254,0.015450000000001296,529190,0
"172.16.133.20",62377,"172.16.139.250",5440,12,1142,5649,0,0,12,1142,0,0,45.692397,0.005053000000003749,1808034,0
"172.16.133.28",65350,"172.16.139.250",5440,10,1022,5650,0,0,10,1022,0,0,45.723523,0.01459700000000197,560115,0
"157.56.244.214",443,"172.16.133.115",49499,10,775,5651,0,0,5,475,5,300,45.726708,240.266784,15,9
"172.16.133.99",56027,"172.16.139.250",5440,12,1142,5652,0,0,12,1142,0,0,45.748995,0.014656999999999698,623319,0
"172.16.133.87",60169,"172.16.139.250",5440,10,1022,5653,0,0,10,1022,0,0,45.771494,0.005358000000001084,1525942,0
"172.16.133.35",49955,"172.16.139.250",5440,12,1142,5654,0,0,12,1142,0,0,45.783712,0.010273999999995453,889234,0
"172.16.133.116",53289,"172.16.139.250",5440,12,1142,5655,0,0,12,1142,0,0,45.792936,0.006782000000001176,1347095,0
"172.16.133.116",53290,"172.16.139.250",5440,10,1022,5656,0,0,10,1022,0,0,45.800699,0.0056179999999983465,1455322,0
"172.16.133.116",53291,"172.16.139.250",5440,10,1022,5657,0,0,10,1022,0,0,45.807517,0.004764000000001545,"",""
"172.16.133.84",58777,"172.16.139.250",5440,10,1022,5658,0,0,10,1022,0,0,45.80997,0.005997000000000696,1363348,0
"172.16.133.49",55750,"172.16.139.250",5440,12,1142,5659,0,0,12,1142,0,0,45.887702,0.00619700000000023,1474261,0
"172.16.133.95",56950,"172.16.139.250",5440,12,1142,5660,0,0,12,1142,0,0,45.924342,0.006222999999998535,1468102,0
"172.16.133.71",55167,"74.201.34.2",3158,31,4630,5661,0,0,20,2710,11,1920,45.93323,250.08517299999997,86,61
"172.16.133.92",57666,"172.16.139.250",5440,10,1022,5662,0,0,10,1022,0,0,45.953208000000004,0.015315999999998553,533820,0
"172.16.133.29",60869,"172.16.139.250",5440,10,1022,5663,0,0,10,1022,0,0,45.970274,0.015318999999998084,533716,0
"172.16.133.44",64767,"172.16.139.250",5440,12,1142,5664,0,0,12,1142,0,0,45.976212,0.015254000000005874,598924,0
"172.16.133.88",51237,"216.115.219.126",443,6,366,5665,0,0,4,246,2,120,45.999185,0.49380400000000435,3985,1944
"172.16.133.41",52927,"199.102.234.31",80,11,3158,5666,0,0,6,2539,5,619,46.001426,0.10921799999999848,185976,45340
"172.16.133.207",55918,"172.16.139.250",5440,12,1142,5667,0,0,12,1142,0,0,46.002567,0.01619399999999871,564159,0
"172.16.133.83",57075,"172.16.139.250",5440,10,1022,5668,0,0,10,1022,0,0,46.010149,0.004674000000001399,"",""
"172.16.133.93",60662,"172.16.139.250",5440,10,1022,5669,0,0,10,1022,0,0,46.026907,0.0046219999999976835,"",""
"172.16.133.11",55127,"172.16.139.250",5440,10,1022,5670,0,0,10,1022,0,0,46.045129,0.00569099999999878,1436654,0
"172.16.133.55",57564,"172.16.139.250",5440,10,1022,5671,0,0,10,1022,0,0,46.048017,0.006498000000000559,1258233,0
"172.16.133.73",60621,"172.16.139.250",5440,12,1142,5672,0,0,12,1142,0,0,46.07324,0.005774999999999864,1581991,0
"172.16.133.53",54084,"172.16.139.250",5440,12,1142,5673,0,0,12,1142,0,0,46.07423,0.009234999999996774,989279,0
"172.16.133.21",53158,"172.16.139.250",5440,10,1022,5674,0,0,10,1022,0,0,46.076886,0.01489199999999613,549019,0
"172.16.133.30",62599,"172.16.139.250",5440,10,1022,5675,0,0,10,1022,0,0,46.080242,0.007176999999998657,1139194,0
"172.16.133.25",63423,"172.16.139.250",5440,12,1142,5676,0,0,12,1142,0,0,46.089514,0.006351999999999691,1438287,0
"172.16.133.34",50424,"172.16.139.250",5440,10,1022,5677,0,0,10,1022,0,0,46.096819,0.004944999999999311,"",""
"172.16.133.97",59355,"172.16.139.250",5440,10,1022,5678,0,0,10,1022,0,0,46.109319,0.014969000000000676,546195,0
"172.16.133.33",57866,"172.16.139.250",5440,10,1022,5679,0,0,10,1022,0,0,46.182796,0.005507999999998958,1484386,0
"157.56.238.6",443,"172.16.133.14",62973,21,3104,5680,0,0,12,2564,9,540,46.188302,240.079149,85,17
"172.16.133.41",52928,"199.102.234.31",80,11,3160,5681,0,0,6,2541,5,619,46.194863,0.2343440000000001,86744,21131
"172.16.133.68",60711,"172.16.139.250",5440,10,1022,5682,0,0,10,1022,0,0,46.214104,0.0056020000000032155,1459478,0
"157.56.232.214",443,"172.16.133.44",49427,10,775,5683,0,0,5,475,5,300,46.224001,240.018848,15,9
"172.16.133.12",59719,"172.16.139.250",5440,10,1022,5684,0,0,10,1022,0,0,46.228252,0.005548000000004549,1473684,0
"172.16.133.63",53863,"172.16.139.250",5440,10,1022,5685,0,0,10,1022,0,0,46.237163,0.005295999999994194,1543806,0
"172.16.133.66",53844,"172.16.139.250",5440,10,1022,5686,0,0,10,1022,0,0,46.251957,0.005311000000006061,1539446,0
"157.56.236.102",443,"172.16.133.41",65165,12,936,5687,0,0,6,570,6,366,46.253177,240.347258,18,12
"172.16.133.44",64768,"216.115.217.254",443,6,366,5688,0,0,4,246,2,120,46.25991,0.16997700000000293,11578,5647
"172.16.133.82",61306,"172.16.139.250",5440,10,1022,5689,0,0,10,1022,0,0,46.264056,0.014880000000005111,549462,0
"172.16.133.75",50935,"216.219.115.183",443,183,35498,5690,0,0,88,14102,95,21396,46.266251,142.608604,791,1200
"172.16.133.44",64769,"216.219.120.244",443,6,366,5691,0,0,4,246,2,120,46.273770999999996,0.24885800000000557,7908,3857
"172.16.133.37",60610,"172.16.139.250",5440,10,1022,5692,0,0,10,1022,0,0,46.279219,0.005107000000002415,1600939,0
"172.16.133.44",64770,"216.115.220.254",443,6,366,5693,0,0,4,246,2,120,46.400842,0.5118720000000039,3844,1875
"172.16.133.44",64771,"202.173.27.250",443,6,366,5694,0,0,4,246,2,120,46.431784,0.5742759999999976,3426,1671
"172.16.133.78",59192,"172.16.139.250",5440,10,1022,5695,0,0,10,1022,0,0,46.434632,0.015304999999997904,534204,0
"172.16.133.67",55970,"172.16.139.250",5440,10,1022,5696,0,0,10,1022,0,0,46.490023,0.005372000000001265,1521965,0
"172.16.133.56",61413,"172.16.139.250",5440,10,1022,5697,0,0,10,1022,0,0,46.51212,0.0048320000000003915,"",""
"172.16.133.54",64319,"68.64.4.249",443,6,366,5698,0,0,4,246,2,120,46.517716,0.10210200000000214,19274,9402
"172.16.133.54",64320,"68.64.26.250",443,6,366,5699,0,0,4,246,2,120,46.524962,0.08237599999999645,23890,11653
"172.16.133.54",64321,"216.219.116.244",443,6,366,5700,0,0,4,246,2,120,46.526095,0.23179600000000278,8490,4141
"172.16.133.54",64322,"216.115.216.250",443,6,366,5701,0,0,4,246,2,120,46.527192,0.05109999999999815,38512,18786
"172.16.133.42",57051,"172.16.139.250",5440,12,1142,5702,0,0,12,1142,0,0,46.534877,0.02520200000000017,362510,0
"172.16.133.75",50936,"172.16.139.250",5440,10,1022,5703,0,0,10,1022,0,0,46.567774,0.014431000000001859,566558,0
"172.16.133.41",52929,"172.16.139.250",5440,10,1022,5704,0,0,10,1022,0,0,46.568507,0.00531000000000148,1539736,0
"172.16.133.46",63675,"192.147.107.13",80,2,120,5705,0,0,1,60,1,60,46.572354,8.800000000519503e-05,"",""
"172.16.133.85",52236,"172.16.139.250",5440,12,1142,5706,0,0,12,1142,0,0,46.58611,0.006207000000003404,1471886,0
"172.16.133.43",57748,"172.16.139.250",5440,10,1022,5707,0,0,10,1022,0,0,46.63997,0.005738999999998384,1424638,0
"172.16.133.13",53024,"172.16.139.250",5440,12,1142,5708,0,0,12,1142,0,0,46.66457,0.017110999999999876,533925,0
"157.56.236.102",443,"172.16.133.43",63454,10,775,5709,0,0,5,475,5,300,46.695349,240.05944100000002,15,9
"172.16.133.20",62378,"172.16.139.250",5440,12,1142,5710,0,0,12,1142,0,0,46.706144,0.014621999999995694,624811,0
"172.16.133.75",50937,"64.74.80.244",443,229,22068,5711,0,0,150,11619,79,10449,46.733416,142.400388,652,587
"172.16.133.28",65351,"172.16.139.250",5440,10,1022,5712,0,0,10,1022,0,0,46.737845,0.00528500000000065,1547019,0
"172.16.133.99",56028,"172.16.139.250",5440,10,1022,5713,0,0,10,1022,0,0,46.762942,0.014477999999996882,564718,0
"172.16.133.75",50938,"216.219.115.160",443,140,20992,5714,0,0,66,8595,74,12397,46.778327,142.11963500000002,483,697
"172.16.133.87",60170,"172.16.139.250",5440,12,1142,5715,0,0,12,1142,0,0,46.785565,0.015334000000002845,595800,0
"172.16.133.35",49956,"172.16.139.250",5440,12,1142,5716,0,0,12,1142,0,0,46.798792,0.014513000000000886,629504,0
"172.16.133.116",53292,"172.16.139.250",5440,10,1022,5717,0,0,10,1022,0,0,46.800816,0.005467000000002997,1495518,0
"172.16.133.116",53293,"172.16.139.250",5440,10,1022,5718,0,0,10,1022,0,0,46.807358,0.006884999999996921,1187509,0
"172.16.133.116",53294,"172.16.139.250",5440,12,1142,5719,0,0,12,1142,0,0,46.814741,0.004654999999999632,"",""
"172.16.133.84",58778,"172.16.139.250",5440,10,1022,5720,0,0,10,1022,0,0,46.824337,0.005623999999997409,1453769,0
"172.16.133.49",55751,"172.16.139.250",5440,10,1022,5721,0,0,10,1022,0,0,46.901381,0.005789999999997519,1412089,0
"172.16.133.67",62030,"157.56.242.198",443,11,894,5722,0,0,6,594,5,300,46.90234,240.01449,19,9
"172.16.133.24",57689,"172.16.139.250",5440,12,1142,5723,0,0,12,1142,0,0,46.905299,0.015892000000000905,574880,0
"172.16.133.95",56951,"172.16.139.250",5440,10,1022,5724,0,0,10,1022,0,0,46.938592,0.005662999999998419,1443757,0
"172.16.133.71",55172,"67.195.187.214",5050,12,1083,5725,0,0,6,687,6,396,46.96416,240.14099700000003,22,13
"172.16.133.92",57667,"172.16.139.250",5440,10,1022,5726,0,0,10,1022,0,0,46.96633,0.015200000000000102,537894,0
"172.16.133.57",60592,"174.129.29.218",80,11,1453,5727,0,0,6,930,5,523,46.972061,0.09735400000000283,76422,42977
"172.16.133.29",60870,"172.16.139.250",5440,12,1142,5728,0,0,12,1142,0,0,46.984249,0.006149000000000626,1485770,0
"172.16.133.75",50939,"216.115.216.31",443,229,22099,5729,0,0,150,11650,79,10449,46.989787,142.144844,655,588
"172.16.133.44",64772,"172.16.139.250",5440,12,1142,5730,0,0,12,1142,0,0,46.990628,0.0054149999999992815,1687165,0
"172.16.133.207",55919,"172.16.139.250",5440,12,1142,5731,0,0,12,1142,0,0,47.015174,0.004773000000000138,"",""
"172.16.133.83",57076,"172.16.139.250",5440,10,1022,5732,0,0,10,1022,0,0,47.024281,0.01471199999999584,555736,0
"172.16.133.93",60663,"172.16.139.250",5440,12,1142,5733,0,0,12,1142,0,0,47.042512,0.014007999999996912,652198,0
"172.16.133.114",55328,"65.55.171.159",443,6,374,5734,0,0,3,194,3,180,47.056445,1.0681550000000044,1452,1348
"172.16.133.11",55128,"172.16.139.250",5440,10,1022,5735,0,0,10,1022,0,0,47.059385,0.01527099999999848,535393,0
"172.16.133.55",57565,"172.16.139.250",5440,10,1022,5736,0,0,10,1022,0,0,47.062261,0.016857000000001676,485021,0
"172.16.133.73",60622,"172.16.139.250",5440,12,1142,5737,0,0,12,1142,0,0,47.087084,0.006776999999999589,1348089,0
"172.16.133.53",54085,"172.16.139.250",5440,12,1142,5738,0,0,12,1142,0,0,47.087776,0.010065000000004432,907699,0
"172.16.133.21",53159,"172.16.139.250",5440,12,1142,5739,0,0,12,1142,0,0,47.090433,0.01645000000000607,555379,0
"172.16.133.30",62600,"172.16.139.250",5440,10,1022,5740,0,0,10,1022,0,0,47.094601,0.007504000000004396,1089552,0
"172.16.133.25",63424,"172.16.139.250",5440,12,1142,5741,0,0,12,1142,0,0,47.103823,0.016089000000000908,567841,0
"172.16.133.34",50425,"172.16.139.250",5440,10,1022,5742,0,0,10,1022,0,0,47.111063,0.005032999999997401,1624478,0
"172.16.133.97",59356,"172.16.139.250",5440,10,1022,5743,0,0,10,1022,0,0,47.12374,0.0055740000000028544,1466810,0
"172.16.133.24",56058,"96.43.146.176",443,25,8055,5744,0,0,15,5010,10,3045,47.132815,240.33894800000002,166,101
"172.16.133.97",51962,"172.16.139.250",5447,18,2040,5745,0,0,18,2040,0,0,47.176282,245.564934,66,0
"172.16.133.41",52930,"199.102.234.31",80,11,3189,5746,0,0,6,2595,5,594,47.196421,0.12675800000000237,163776,37488
"172.16.133.33",57867,"172.16.139.250",5440,12,1142,5747,0,0,12,1142,0,0,47.198068,0.032265999999999906,283146,0
"172.16.133.68",60712,"172.16.139.250",5440,10,1022,5748,0,0,10,1022,0,0,47.228026,0.014629999999996812,558851,0
"172.16.133.75",50940,"216.219.115.183",443,229,22099,5749,0,0,150,11650,79,10449,47.250988,141.883644,656,589
"172.16.133.12",59720,"172.16.139.250",5440,12,1142,5750,0,0,12,1142,0,0,47.250991,0.005918999999998675,1543503,0
"172.16.133.63",53864,"172.16.139.250",5440,12,1142,5751,0,0,12,1142,0,0,47.251099,0.009726999999998043,939241,0
"172.16.133.66",53845,"172.16.139.250",5440,10,1022,5752,0,0,10,1022,0,0,47.266068,0.00573900000000549,1424638,0
"172.16.133.21",51047,"157.56.238.6",443,10,795,5753,0,0,5,495,5,300,47.269404,240.08671599999997,16,9
"172.16.133.82",61307,"172.16.139.250",5440,12,1142,5754,0,0,12,1142,0,0,47.278392,0.006304000000000087,1449238,0
"172.16.133.37",60611,"172.16.139.250",5440,12,1142,5755,0,0,12,1142,0,0,47.294445,0.006639999999997315,1375903,0
"172.16.133.78",59193,"172.16.139.250",5440,12,1142,5756,0,0,12,1142,0,0,47.450383,0.006878999999997859,1328100,0
"172.16.133.88",51238,"68.64.24.250",443,6,366,5757,0,0,4,246,2,120,47.455306,0.11535800000000052,17059,8321
"172.16.133.75",50941,"216.115.217.225",443,230,22159,5758,0,0,151,11710,79,10449,47.476284,141.658398,661,590
"157.56.238.6",443,"172.16.133.14",63127,12,960,5759,0,0,6,594,6,366,47.482613,240.50079,19,12
"172.16.133.67",55971,"172.16.139.250",5440,12,1142,5760,0,0,12,1142,0,0,47.502962,0.006358000000005859,1436929,0
"172.16.133.56",61414,"172.16.139.250",5440,12,1142,5761,0,0,12,1142,0,0,47.526179,0.006804000000002475,1342739,0
"172.16.133.42",57052,"172.16.139.250",5440,12,1142,5762,0,0,12,1142,0,0,47.554524,0.09683100000000167,94349,0
"172.16.133.75",50942,"172.16.139.250",5440,10,1022,5763,0,0,10,1022,0,0,47.580528,0.004708000000000823,"",""
"172.16.133.41",52931,"172.16.139.250",5440,12,1142,5764,0,0,12,1142,0,0,47.582529,0.007252999999998622,1259616,0
"172.16.133.85",52237,"172.16.139.250",5440,10,1022,5765,0,0,10,1022,0,0,47.6001,0.005382000000004439,1519137,0
"172.16.133.43",57749,"172.16.139.250",5440,10,1022,5766,0,0,10,1022,0,0,47.654408,0.0063190000000048485,1293875,0
"172.16.133.49",49510,"157.55.235.144",40021,33,3355,5767,0,0,15,2259,18,1096,47.658596,199.45682,90,43
"172.16.133.56",50523,"172.16.139.250",5447,12,1680,5768,0,0,12,1680,0,0,47.662655,223.607384,60,0
"172.16.133.13",53025,"172.16.139.250",5440,10,1022,5769,0,0,10,1022,0,0,47.671106,0.008223999999998455,994163,0
"172.16.133.85",52238,"216.115.216.250",443,7,426,5770,0,0,5,306,2,120,47.672339,0.36789199999999767,6654,2609
"172.16.133.85",52239,"68.64.26.250",443,7,432,5771,0,0,5,312,2,120,47.693388,3.136665999999998,795,306
"172.16.133.85",52240,"68.64.4.249",443,7,432,5772,0,0,5,312,2,120,47.696201,3.1094340000000003,802,308
"172.16.133.88",51239,"78.108.118.250",443,7,432,5773,0,0,5,312,2,120,47.697235,3.2673750000000013,763,293
"172.16.133.88",51240,"216.219.118.244",443,7,432,5774,0,0,5,312,2,120,47.701204,3.2650310000000005,764,294
"172.16.133.49",49586,"96.43.146.176",443,27,8409,5775,0,0,16,5344,11,3065,47.712946,240.41365100000002,177,101
"172.16.133.20",62379,"172.16.139.250",5440,10,1022,5776,0,0,10,1022,0,0,47.720303,0.00497999999999621,"",""
"172.16.133.97",59357,"172.16.139.250",5440,10,1022,5777,0,0,10,1022,0,0,47.7487,0.0056939999999983115,1435897,0
"172.16.133.28",65352,"172.16.139.250",5440,12,1142,5778,0,0,12,1142,0,0,47.751601,0.006509000000001208,1403595,0
"172.16.133.85",52241,"216.219.116.244",443,6,366,5779,0,0,4,246,2,120,47.761359,0.261257999999998,7532,3674
"172.16.133.99",56029,"172.16.139.250",5440,12,1142,5780,0,0,12,1142,0,0,47.777219,0.005147000000000901,1775014,0
"172.16.133.97",59245,"96.43.146.176",443,4,240,5781,0,0,2,120,2,120,47.77918,0.04446100000000541,21591,21591
"172.16.133.97",59358,"96.43.146.176",443,25,5596,5782,0,0,14,3546,11,2050,47.779413,79.640976,356,205
"172.16.133.87",60171,"172.16.139.250",5440,12,1142,5783,0,0,12,1142,0,0,47.800194,0.016265000000004193,561696,0
"96.43.146.22",443,"172.16.133.18",50274,29,13739,5784,0,0,14,2464,15,11275,47.804591,224.078823,87,402
"172.16.133.35",49957,"172.16.139.250",5440,12,1142,5785,0,0,12,1142,0,0,47.811677,0.05768699999999427,158371,0
"172.16.133.13",53643,"172.16.139.250",5500,20,1740,5786,0,0,20,1740,0,0,47.813354,240.205717,57,0
"172.16.133.116",53295,"172.16.139.250",5440,12,1142,5787,0,0,12,1142,0,0,47.815041,0.005890999999998314,1550840,0
"172.16.133.116",53296,"172.16.139.250",5440,10,1022,5788,0,0,10,1022,0,0,47.821488,0.007697000000000287,1062232,0
"172.16.133.116",53297,"172.16.139.250",5440,10,1022,5789,0,0,10,1022,0,0,47.829729,0.00655100000000175,1248053,0
"172.16.133.84",58779,"172.16.139.250",5440,10,1022,5790,0,0,10,1022,0,0,47.838075,0.005900999999994383,1385527,0
"172.16.133.14",63126,"157.56.238.6",443,10,795,5791,0,0,5,495,5,300,47.849147,240.09191099999998,16,9
"172.16.133.49",55752,"172.16.139.250",5440,10,1022,5792,0,0,10,1022,0,0,47.916304,0.0051250000000067075,1595317,0
"172.16.133.95",56952,"172.16.139.250",5440,12,1142,5793,0,0,12,1142,0,0,47.952307,0.015328000000003783,596033,0
"172.16.133.92",57668,"172.16.139.250",5440,10,1022,5794,0,0,10,1022,0,0,47.981599,0.015124999999997613,540561,0
"172.16.133.29",60871,"172.16.139.250",5440,12,1142,5795,0,0,12,1142,0,0,47.998391,0.006235000000003765,1465276,0
"172.16.133.44",64773,"172.16.139.250",5440,10,1022,5796,0,0,10,1022,0,0,48.00529,0.014610999999995045,559578,0
"172.16.133.207",55920,"172.16.139.250",5440,12,1142,5797,0,0,12,1142,0,0,48.030269,0.005325000000006241,1715680,0
"172.16.133.83",57077,"172.16.139.250",5440,10,1022,5798,0,0,10,1022,0,0,48.038201,0.00470099999999718,"",""
"172.16.133.93",60664,"172.16.139.250",5440,12,1142,5799,0,0,12,1142,0,0,48.055262,0.014450000000003627,632249,0
"172.16.133.55",57566,"172.16.139.250",5440,10,1022,5800,0,0,10,1022,0,0,48.076236,0.0055669999999992115,1468654,0
"172.16.133.11",55129,"172.16.139.250",5440,10,1022,5801,0,0,10,1022,0,0,48.094465,0.005405000000003213,1512673,0
"172.16.133.73",60623,"172.16.139.250",5440,10,1022,5802,0,0,10,1022,0,0,48.100868,0.005608000000002278,1457917,0
"172.16.133.53",54086,"172.16.139.250",5440,10,1022,5803,0,0,10,1022,0,0,48.102624,0.0075360000000017635,1084925,0
"172.16.133.21",53160,"172.16.139.250",5440,10,1022,5804,0,0,10,1022,0,0,48.104185,0.014792999999997392,552693,0
"172.16.133.30",62601,"172.16.139.250",5440,10,1022,5805,0,0,10,1022,0,0,48.108564,0.006099999999996442,1340327,0
"172.16.133.25",63425,"172.16.139.250",5440,10,1022,5806,0,0,10,1022,0,0,48.117042,0.005895999999999901,1386702,0
"172.16.133.34",50426,"172.16.139.250",5440,10,1022,5807,0,0,10,1022,0,0,48.124904,0.004947000000001367,"",""
"172.16.133.97",59359,"172.16.139.250",5440,12,1142,5808,0,0,12,1142,0,0,48.136404,0.01529400000000436,597358,0
"172.16.133.132",43727,"23.62.105.231",80,10,1837,5809,0,0,6,702,4,1135,48.145363,10.216650999999999,549,888
"172.16.133.132",54941,"184.73.187.64",80,10,1063,5810,0,0,6,740,4,323,48.151873,10.173592,581,253
"172.16.133.114",55329,"157.56.244.217",80,8,884,5811,0,0,5,532,3,352,48.154689,0.17281100000000293,24628,16295
"172.16.133.37",59841,"157.56.234.118",443,32,3584,5812,0,0,16,2624,16,960,48.167351,195.067033,107,39
"172.16.133.33",57868,"172.16.139.250",5440,10,1022,5813,0,0,10,1022,0,0,48.211734,0.005983999999997991,1366310,0
"172.16.133.68",60713,"172.16.139.250",5440,12,1142,5814,0,0,12,1142,0,0,48.242484,0.005670000000002062,1611287,0
"172.16.133.88",51241,"216.115.219.126",443,6,366,5815,0,0,4,246,2,120,48.249286,0.5427840000000046,3625,1768
"172.16.133.12",59721,"172.16.139.250",5440,12,1142,5816,0,0,12,1142,0,0,48.255375,0.006202999999999292,1472835,0
"172.16.133.63",53866,"172.16.139.250",5440,12,1142,5817,0,0,12,1142,0,0,48.265411,0.005955000000000155,1534172,0
"96.43.146.22",443,"172.16.133.36",65042,30,15410,5818,0,0,15,2530,15,12880,48.27527,224.04126699999998,90,459
"172.16.133.66",53846,"172.16.139.250",5440,10,1022,5819,0,0,10,1022,0,0,48.280526,0.005561999999997624,1469974,0
"172.16.133.82",61308,"172.16.139.250",5440,10,1022,5820,0,0,10,1022,0,0,48.292662,0.015186999999997397,538355,0
"172.16.133.37",60612,"172.16.139.250",5440,12,1142,5821,0,0,12,1142,0,0,48.307344,0.014615999999996632,625068,0
"172.16.133.114",55330,"132.245.1.134",443,24,9491,5822,0,0,11,2743,13,6748,48.321549,1.719729000000001,12760,31390
"172.16.133.132",56510,"208.47.254.35",80,16,6174,5823,0,0,9,1000,7,5174,48.336918,9.976306000000001,801,4149
"157.56.244.214",443,"172.16.133.126",51612,10,775,5824,0,0,5,475,5,300,48.339704,240.79673100000002,15,9
"172.16.133.132",56511,"208.47.254.35",80,14,5105,5825,0,0,8,933,6,4172,48.351214,9.961745,749,3350
"172.16.133.44",64774,"216.115.217.254",443,6,366,5826,0,0,4,246,2,120,48.353046,0.060307000000001665,32633,15918
"172.16.133.132",56512,"208.47.254.35",80,16,7259,5827,0,0,9,1000,7,6259,48.354202,9.959702,803,5027
"172.16.133.44",64775,"216.219.120.244",443,6,366,5828,0,0,4,246,2,120,48.43383,0.20783600000000035,9469,4619
"172.16.133.30",59916,"157.56.237.150",443,14,1161,5829,0,0,7,741,7,420,48.441088,233.546842,25,14
"172.16.133.39",64253,"174.129.24.9",443,231,233957,5830,0,0,71,7832,160,226125,48.451792,6.406739000000002,9779,282358
"172.16.133.78",59194,"172.16.139.250",5440,12,1142,5831,0,0,12,1142,0,0,48.464001,0.006208999999998355,1471412,0
"172.16.133.67",55972,"172.16.139.250",5440,10,1022,5832,0,0,10,1022,0,0,48.517962,0.005387000000006026,1517727,0
"172.16.133.56",61415,"172.16.139.250",5440,10,1022,5833,0,0,10,1022,0,0,48.540668,0.004797000000003493,"",""
"172.16.133.54",64323,"216.115.216.250",443,6,366,5834,0,0,4,246,2,120,48.548594,0.0723339999999979,27207,13271
"172.16.133.54",64324,"68.64.26.250",443,6,366,5835,0,0,4,246,2,120,48.564628,0.09943799999999925,19791,9654
"172.16.133.54",64325,"68.64.4.249",443,6,366,5836,0,0,4,246,2,120,48.567815,0.13458999999999577,14622,7132
"172.16.133.42",57053,"172.16.139.250",5440,12,1142,5837,0,0,12,1142,0,0,48.570367,0.06463899999999967,141338,0
"172.16.133.49",49674,"172.16.139.250",5500,20,1740,5838,0,0,20,1740,0,0,48.590618,240.19496800000002,57,0
"172.16.133.75",50943,"172.16.139.250",5440,12,1142,5839,0,0,12,1142,0,0,48.594867,0.00632399999999933,1444655,0
"172.16.133.41",52932,"172.16.139.250",5440,10,1022,5840,0,0,10,1022,0,0,48.596648,0.007601999999998554,1075506,0
"172.16.133.24",57602,"23.67.242.67",80,1,60,5841,0,0,1,60,0,0,48.609269,0,"",""
"172.16.133.85",52242,"172.16.139.250",5440,10,1022,5842,0,0,10,1022,0,0,48.613724,0.005425000000002456,1507096,0
"172.16.133.54",64326,"216.219.116.244",443,6,366,5843,0,0,4,246,2,120,48.643492,0.24635399999999663,7988,3896
"172.16.133.43",57750,"172.16.139.250",5440,10,1022,5844,0,0,10,1022,0,0,48.668047,0.00577899999999687,1414777,0
"172.16.133.44",64776,"216.115.220.254",443,7,426,5845,0,0,5,306,2,120,48.673999,1.1718979999999988,2088,819
"172.16.133.13",53026,"172.16.139.250",5440,10,1022,5846,0,0,10,1022,0,0,48.685335,0.015391000000001043,531219,0
"172.16.133.44",64777,"202.173.27.250",443,6,366,5847,0,0,4,246,2,120,48.72091,0.5800159999999934,3393,1655
"172.16.133.20",62380,"172.16.139.250",5440,12,1142,5848,0,0,12,1142,0,0,48.734191,0.014924999999998079,612127,0
"172.16.133.28",65353,"172.16.139.250",5440,10,1022,5849,0,0,10,1022,0,0,48.765771,0.006115000000001203,1337040,0
"172.16.133.99",56030,"172.16.139.250",5440,10,1022,5850,0,0,10,1022,0,0,48.791783,0.004883999999997002,"",""
"172.16.133.87",60172,"172.16.139.250",5440,12,1142,5851,0,0,12,1142,0,0,48.813704,0.006700999999999624,1363378,0
"172.16.133.116",53298,"172.16.139.250",5440,10,1022,5852,0,0,10,1022,0,0,48.829046,0.0052190000000038594,1566583,0
"172.16.133.116",53299,"172.16.139.250",5440,10,1022,5853,0,0,10,1022,0,0,48.834847,0.006494999999993922,1258814,0
"172.16.133.35",49958,"172.16.139.250",5440,12,1142,5854,0,0,12,1142,0,0,48.839584,0.010331000000000756,884328,0
"172.16.133.116",53300,"172.16.139.250",5440,10,1022,5855,0,0,10,1022,0,0,48.841814,0.00935299999999728,874158,0
"172.16.133.84",58780,"172.16.139.250",5440,12,1142,5856,0,0,12,1142,0,0,48.851055,0.006169999999997344,1480713,0
"172.16.133.45",61326,"64.90.204.229",443,88,66998,5857,0,0,30,7906,58,59092,48.867301,6.924534000000001,9133,68269
"172.16.133.49",55753,"172.16.139.250",5440,12,1142,5858,0,0,12,1142,0,0,48.929633,0.006315999999998212,1446485,0
"172.16.133.95",56953,"172.16.139.250",5440,10,1022,5859,0,0,10,1022,0,0,48.967378,0.014342000000006294,570073,0
"172.16.133.92",57669,"172.16.139.250",5440,10,1022,5860,0,0,10,1022,0,0,48.99554,0.01526900000000353,535464,0
"172.16.133.29",60872,"172.16.139.250",5440,10,1022,5861,0,0,10,1022,0,0,49.012871,0.01765200000000533,463176,0
"172.16.133.44",64778,"172.16.139.250",5440,10,1022,5862,0,0,10,1022,0,0,49.018505,0.015897000000002492,514310,0
"172.16.133.207",55921,"172.16.139.250",5440,10,1022,5863,0,0,10,1022,0,0,49.044322,0.004885999999999058,"",""
"172.16.133.83",57078,"172.16.139.250",5440,10,1022,5864,0,0,10,1022,0,0,49.052275,0.004897999999997182,"",""
"172.16.133.36",64928,"132.245.2.22",443,3,180,5865,0,0,2,120,1,60,49.061679,0.07194300000000453,13343,6671
"172.16.133.36",65077,"132.245.2.22",443,106,42665,5866,0,0,53,19823,53,22842,49.062233,121.429833,1305,1504
"172.16.133.93",60665,"172.16.139.250",5440,12,1142,5867,0,0,12,1142,0,0,49.069955,0.005355000000001553,1706069,0
"172.16.133.11",55130,"172.16.139.250",5440,10,1022,5868,0,0,10,1022,0,0,49.086066,0.007681999999995526,1064306,0
"172.16.133.55",57567,"172.16.139.250",5440,10,1022,5869,0,0,10,1022,0,0,49.090205,0.00875400000000326,933973,0
"172.16.133.73",60624,"172.16.139.250",5440,10,1022,5870,0,0,10,1022,0,0,49.113732,0.005631999999998527,1451704,0
"172.16.133.53",54087,"172.16.139.250",5440,10,1022,5871,0,0,10,1022,0,0,49.11625,0.006686000000001968,1222853,0
"172.16.133.21",53161,"172.16.139.250",5440,10,1022,5872,0,0,10,1022,0,0,49.11806,0.014971000000002732,546122,0
"172.16.133.30",62602,"172.16.139.250",5440,10,1022,5873,0,0,10,1022,0,0,49.123001,0.01805399999999935,452863,0
"172.16.133.25",63426,"172.16.139.250",5440,10,1022,5874,0,0,10,1022,0,0,49.130834,0.005867000000002065,1393557,0
"172.16.133.34",50427,"172.16.139.250",5440,10,1022,5875,0,0,10,1022,0,0,49.139072,0.005909000000002607,1383652,0
"172.16.133.97",59360,"172.16.139.250",5440,12,1142,5876,0,0,12,1142,0,0,49.150288,0.015431999999997004,592016,0
"172.16.133.33",57869,"172.16.139.250",5440,12,1142,5877,0,0,12,1142,0,0,49.224751,0.006421000000003119,1422831,0
"172.16.133.68",60714,"172.16.139.250",5440,10,1022,5878,0,0,10,1022,0,0,49.256027,0.005629999999996471,1452220,0
"172.16.133.12",59722,"172.16.139.250",5440,10,1022,5879,0,0,10,1022,0,0,49.269732,0.0056480000000007635,1447592,0
"172.16.133.63",53867,"172.16.139.250",5440,10,1022,5880,0,0,10,1022,0,0,49.279199,0.005378000000000327,1520267,0
"172.16.133.66",53847,"172.16.139.250",5440,10,1022,5881,0,0,10,1022,0,0,49.294804,0.005482000000000653,1491426,0
"172.16.133.82",61309,"172.16.139.250",5440,10,1022,5882,0,0,10,1022,0,0,49.306353,0.005417000000001337,1509322,0
"172.16.133.37",60613,"172.16.139.250",5440,10,1022,5883,0,0,10,1022,0,0,49.321281,0.04885800000000273,167342,0
"172.16.133.113",55607,"172.16.139.250",135,8,492,5884,0,0,8,492,0,0,49.330939,0.0044010000000014315,"",""
"172.16.133.113",55608,"172.16.139.250",5462,12,816,5885,0,0,12,816,0,0,49.337766,0.5089119999999951,12827,0
"172.16.133.36",65078,"132.245.2.22",443,35,15774,5886,0,0,18,5638,17,10136,49.440711,120.434021,374,673
"172.16.133.78",59195,"172.16.139.250",5440,10,1022,5887,0,0,10,1022,0,0,49.478184,0.00612199999999774,1335511,0
"172.16.133.67",55973,"172.16.139.250",5440,10,1022,5888,0,0,10,1022,0,0,49.531157,0.014760000000002549,553929,0
"172.16.133.56",61416,"172.16.139.250",5440,10,1022,5889,0,0,10,1022,0,0,49.554134,0.004795000000001437,"",""
"172.16.133.42",57054,"172.16.139.250",5440,12,1142,5890,0,0,12,1142,0,0,49.584958,0.05874399999999724,155522,0
"96.43.146.149",443,"172.16.133.101",50749,35,18665,5891,0,0,15,2410,20,16255,49.587577,224.10600799999997,86,580
"172.16.133.75",50944,"172.16.139.250",5440,10,1022,5892,0,0,10,1022,0,0,49.608843,0.006062999999997487,1348507,0
"172.16.133.116",53301,"8.27.243.253",80,97,55534,5893,0,0,38,7803,59,47731,49.608896,32.550726,1917,11730
"172.16.133.41",52933,"172.16.139.250",5440,10,1022,5894,0,0,10,1022,0,0,49.610584,0.015678999999998666,521461,0
"172.16.133.85",52243,"172.16.139.250",5440,10,1022,5895,0,0,10,1022,0,0,49.627342,0.015114000000004069,540955,0
"172.16.133.29",60873,"23.0.52.46",80,7,432,5896,0,0,4,246,3,186,49.634599,11.466133999999997,171,129
"172.16.133.29",60874,"23.0.52.46",80,6,372,5897,0,0,4,246,2,126,49.634764,11.465052,171,87
"172.16.133.29",60875,"23.62.105.231",80,6,372,5898,0,0,4,246,2,126,49.637551,11.485929999999996,171,87
"172.16.133.29",60876,"23.62.105.231",80,6,372,5899,0,0,4,246,2,126,49.637692,11.484814,171,87
"172.16.133.29",60877,"184.73.187.64",80,6,366,5900,0,0,4,246,2,120,49.637838,11.467991999999995,171,83
"172.16.133.29",60878,"184.73.187.64",80,6,366,5901,0,0,4,246,2,120,49.637992,11.466887,171,83
"172.16.133.24",57690,"208.44.23.162",80,28,22837,5902,0,0,10,2039,18,20798,49.666698,2.7026460000000014,6035,61563
"172.16.133.29",60879,"107.21.110.186",80,6,366,5903,0,0,4,246,2,120,49.66887,11.431795999999999,172,83
"172.16.133.29",60880,"107.21.110.186",80,6,366,5904,0,0,4,246,2,120,49.669086,11.428753,172,83
"172.16.133.43",57751,"172.16.139.250",5440,12,1142,5905,0,0,12,1142,0,0,49.681962,0.006356000000003803,1437382,0
"172.16.133.13",53027,"172.16.139.250",5440,12,1142,5906,0,0,12,1142,0,0,49.698935,0.0058300000000031105,1567066,0
"157.56.244.214",443,"172.16.133.126",61085,21,3543,5907,0,0,13,3063,8,480,49.712994,249.573025,98,15
"172.16.133.85",52244,"216.115.216.250",443,6,366,5908,0,0,4,246,2,120,49.720405,0.059221000000000856,33231,16210
"172.16.133.20",62381,"172.16.139.250",5440,12,1142,5909,0,0,12,1142,0,0,49.748146,0.004922999999998012,"",""
"172.16.133.29",60881,"206.33.41.253",80,6,372,5910,0,0,4,246,2,126,49.754875,11.346754000000004,173,88
"172.16.133.29",60882,"206.33.41.253",80,6,372,5911,0,0,4,246,2,126,49.75512,11.348883,173,88
"172.16.133.29",60883,"206.33.41.253",80,7,432,5912,0,0,4,246,3,186,49.755284,11.348720999999998,173,131
"172.16.133.29",60884,"206.33.41.253",80,6,372,5913,0,0,4,246,2,126,49.755438,11.346103,173,88
"172.16.133.29",60885,"206.33.41.253",80,6,372,5914,0,0,4,246,2,126,49.755614,11.347575999999997,173,88
"172.16.133.29",60886,"216.52.242.80",80,6,372,5915,0,0,4,246,2,126,49.756196,11.418371,172,88
"172.16.133.29",60887,"216.52.242.80",80,6,372,5916,0,0,4,246,2,126,49.75637,11.416604000000007,172,88
"172.16.133.29",60888,"64.94.107.46",80,7,428,5917,0,0,4,246,3,182,49.760211,11.338914000000003,173,128
"172.16.133.29",60889,"64.94.107.46",80,7,428,5918,0,0,4,246,3,182,49.760502,11.338718999999998,173,128
"172.16.133.29",60890,"64.94.107.46",80,7,428,5919,0,0,4,246,3,182,49.760647,11.338666000000003,173,128
"172.16.133.29",60891,"64.94.107.11",80,7,428,5920,0,0,4,246,3,182,49.760916,11.338097999999995,173,128
"172.16.133.29",60892,"64.94.107.11",80,7,428,5921,0,0,4,246,3,182,49.761057,11.337767,173,128
"172.16.133.29",60893,"173.194.43.58",80,6,372,5922,0,0,4,246,2,126,49.76127,11.338497999999994,173,88
"172.16.133.29",60894,"23.0.49.244",80,6,372,5923,0,0,4,246,2,126,49.761905,11.342977000000005,173,88
"172.16.133.29",60895,"23.0.49.244",80,6,372,5924,0,0,4,246,2,126,49.76206,11.342893000000004,173,88
"172.16.133.29",60896,"23.0.49.244",80,6,372,5925,0,0,4,246,2,126,49.762188,11.342763999999995,173,88
"172.16.133.29",60897,"208.111.161.254",80,8,492,5926,0,0,4,246,4,246,49.762362,11.344322999999996,173,173
"172.16.133.28",65354,"172.16.139.250",5440,12,1142,5927,0,0,12,1142,0,0,49.779687,0.0065099999999986835,1403379,0
"172.16.133.29",60898,"208.47.254.83",80,6,372,5928,0,0,4,246,2,126,49.783782,11.310671,173,89
"172.16.133.29",60899,"208.47.254.83",80,6,372,5929,0,0,4,246,2,126,49.783927,11.309567000000001,174,89
"172.16.133.29",60900,"138.108.7.20",80,6,372,5930,0,0,4,246,2,126,49.792668,11.388455,172,88
"172.16.133.29",60901,"138.108.7.20",80,6,372,5931,0,0,4,246,2,126,49.792852,11.386562999999995,172,88
"172.16.133.99",56031,"172.16.139.250",5440,12,1142,5932,0,0,12,1142,0,0,49.805303,0.005244999999995059,1741849,0
"172.16.133.87",60173,"172.16.139.250",5440,10,1022,5933,0,0,10,1022,0,0,49.827947,0.01599199999999712,511255,0
"172.16.133.116",53302,"172.16.139.250",5440,10,1022,5934,0,0,10,1022,0,0,49.844242,0.0061479999999960455,1329863,0
"172.16.133.35",49959,"172.16.139.250",5440,12,1142,5935,0,0,12,1142,0,0,49.845623,0.03922599999999932,232906,0
"172.16.133.116",53303,"172.16.139.250",5440,12,1142,5936,0,0,12,1142,0,0,49.85104,0.005872000000003652,1555858,0
"172.16.133.116",53304,"172.16.139.250",5440,10,1022,5937,0,0,10,1022,0,0,49.857487,0.006830999999998255,1196896,0
"172.16.133.84",58781,"172.16.139.250",5440,12,1142,5938,0,0,12,1142,0,0,49.865164,0.006099999999996442,1497704,0
"172.16.133.85",52245,"216.219.116.244",443,6,366,5939,0,0,4,246,2,120,49.90437,0.2486030000000028,7916,3861
"172.16.133.49",55754,"172.16.139.250",5440,12,1142,5940,0,0,12,1142,0,0,49.94466,0.006348000000002685,1439193,0
"172.16.133.95",56954,"172.16.139.250",5440,12,1142,5941,0,0,12,1142,0,0,49.981278,0.006353999999994642,1437834,0
"172.16.133.92",57670,"172.16.139.250",5440,10,1022,5942,0,0,10,1022,0,0,50.008213,0.015495999999998844,527620,0
"172.16.133.29",60902,"172.16.139.250",5440,10,1022,5943,0,0,10,1022,0,0,50.028702,0.007828999999993869,1044322,0
"172.16.133.44",64779,"172.16.139.250",5440,12,1142,5944,0,0,12,1142,0,0,50.033944,0.00681700000000518,1340178,0
"172.16.133.43",57752,"216.219.118.244",443,6,366,5945,0,0,4,246,2,120,50.046386,0.2016090000000048,9761,4761
"172.16.133.43",57753,"68.64.24.250",443,6,366,5946,0,0,4,246,2,120,50.046723,0.09358600000000195,21028,10257
"172.16.133.43",57754,"78.108.118.250",443,6,366,5947,0,0,4,246,2,120,50.04729,0.1940490000000068,10141,4947
"172.16.133.43",57755,"216.115.219.126",443,6,366,5948,0,0,4,246,2,120,50.049793,0.4871399999999966,4039,1970
"172.16.133.207",55922,"172.16.139.250",5440,12,1142,5949,0,0,12,1142,0,0,50.057391,0.005190999999996393,1759969,0
"172.16.133.114",55331,"157.56.238.6",443,27,15646,5950,0,0,12,2004,15,13642,50.059323,1.166915000000003,13738,93525
"172.16.133.24",57691,"208.44.23.162",80,299,361179,5951,0,0,60,4579,239,356600,50.061683,2.422471999999999,15121,1177640
"172.16.133.83",57079,"172.16.139.250",5440,12,1142,5952,0,0,12,1142,0,0,50.066204,0.00475200000000342,"",""
"172.16.133.24",57692,"208.44.23.162",80,19,6469,5953,0,0,10,1607,9,4862,50.083689,2.2856570000000005,5624,17017
"172.16.133.93",60666,"172.16.139.250",5440,12,1142,5954,0,0,12,1142,0,0,50.084045,0.004798999999998443,"",""
"172.16.133.24",57693,"208.44.23.162",80,14,2447,5955,0,0,8,1229,6,1218,50.097326,2.2720219999999998,4327,4288
"172.16.133.11",55131,"172.16.139.250",5440,12,1142,5956,0,0,12,1142,0,0,50.101156,0.006356999999994173,1437155,0
"172.16.133.55",57568,"172.16.139.250",5440,10,1022,5957,0,0,10,1022,0,0,50.10449,0.015399000000002161,530943,0
"172.16.133.73",60625,"172.16.139.250",5440,12,1142,5958,0,0,12,1142,0,0,50.1287,0.00788499999999459,1158655,0
"172.16.133.53",54088,"172.16.139.250",5440,12,1142,5959,0,0,12,1142,0,0,50.130238,0.013564999999999827,673497,0
"172.16.133.21",53162,"172.16.139.250",5440,10,1022,5960,0,0,10,1022,0,0,50.132673,0.006936000000003162,1178777,0
"172.16.133.30",62603,"172.16.139.250",5440,10,1022,5961,0,0,10,1022,0,0,50.13666,0.010789000000002602,757808,0
"172.16.133.25",63427,"172.16.139.250",5440,12,1142,5962,0,0,12,1142,0,0,50.144351,0.006821999999999662,1339196,0
"172.16.133.34",50428,"172.16.139.250",5440,10,1022,5963,0,0,10,1022,0,0,50.153174,0.006503999999999621,1257072,0
"172.16.133.97",59361,"172.16.139.250",5440,10,1022,5964,0,0,10,1022,0,0,50.163511,0.005415999999996757,1509601,0
"96.43.146.22",443,"172.16.133.101",50832,35,18628,5965,0,0,15,2408,20,16220,50.194024,224.140854,85,578
"172.16.133.33",57870,"172.16.139.250",5440,10,1022,5966,0,0,10,1022,0,0,50.240063,0.005456000000002348,1498533,0
"172.16.133.68",60716,"172.16.139.250",5440,10,1022,5967,0,0,10,1022,0,0,50.270152,0.005509999999993909,1483847,0
"172.16.133.12",59723,"172.16.139.250",5440,12,1142,5968,0,0,12,1142,0,0,50.283548,0.006183999999997525,1477360,0
"172.16.133.63",53868,"172.16.139.250",5440,12,1142,5969,0,0,12,1142,0,0,50.293926,0.006698999999997568,1363785,0
"172.16.133.66",53848,"172.16.139.250",5440,10,1022,5970,0,0,10,1022,0,0,50.308292,0.004964999999998554,"",""
"172.16.133.82",61310,"172.16.139.250",5440,10,1022,5971,0,0,10,1022,0,0,50.32017,0.005466000000005522,1495792,0
"172.16.133.37",60614,"172.16.139.250",5440,10,1022,5972,0,0,10,1022,0,0,50.334946,0.005545999999995388,1474215,0
"172.16.133.44",64780,"216.115.217.254",443,6,366,5973,0,0,4,246,2,120,50.384025,0.06259299999999968,31441,15337
"172.16.133.92",49623,"172.16.139.250",5447,12,1520,5974,0,0,12,1520,0,0,50.474523,229.335946,53,0
"172.16.133.78",59196,"172.16.139.250",5440,12,1142,5975,0,0,12,1142,0,0,50.49307,0.016749999999994714,545432,0
"172.16.133.67",55974,"172.16.139.250",5440,12,1142,5976,0,0,12,1142,0,0,50.544957,0.015682000000005303,582578,0
"172.16.133.44",64781,"216.219.120.244",443,6,366,5977,0,0,4,246,2,120,50.549068,0.24835099999999954,7924,3865
"172.16.133.41",52934,"199.102.234.31",80,31,22181,5978,0,0,11,2935,20,19246,50.558806,0.4304860000000019,54543,357660
"157.56.241.150",443,"172.16.133.60",55331,81,12376,5979,0,0,52,10636,29,1740,50.56382,248.129554,342,56
"172.16.133.56",61417,"172.16.139.250",5440,12,1142,5980,0,0,12,1142,0,0,50.568219,0.004980000000003315,"",""
"172.16.133.54",64327,"216.115.216.250",443,6,366,5981,0,0,4,246,2,120,50.590663,0.13026700000000346,15107,7369
"172.16.133.42",57055,"172.16.139.250",5440,12,1142,5982,0,0,12,1142,0,0,50.595072,0.014458999999995115,631855,0
"172.16.133.54",64328,"68.64.26.250",443,6,366,5983,0,0,4,246,2,120,50.622775,0.15216400000000618,12933,6308
"172.16.133.75",50945,"172.16.139.250",5440,10,1022,5984,0,0,10,1022,0,0,50.62292,0.015489999999999782,527824,0
"172.16.133.41",52935,"172.16.139.250",5440,10,1022,5985,0,0,10,1022,0,0,50.624551,0.0054040000000057375,1512953,0
"172.16.133.85",52246,"172.16.139.250",5440,10,1022,5986,0,0,10,1022,0,0,50.642267,0.015278999999999598,535113,0
"172.16.133.54",64329,"68.64.4.249",443,6,366,5987,0,0,4,246,2,120,50.647493,0.12643500000000074,15565,7592
"172.16.133.84",49325,"172.16.139.250",5447,10,1390,5988,0,0,10,1390,0,0,50.662359,240.000215,46,0
"172.16.133.43",57756,"172.16.139.250",5440,12,1142,5989,0,0,12,1142,0,0,50.697112,0.006256000000000483,1460358,0
"172.16.133.13",53028,"172.16.139.250",5440,10,1022,5990,0,0,10,1022,0,0,50.713222,0.005378000000000327,1520267,0
"172.16.133.20",62382,"172.16.139.250",5440,12,1142,5991,0,0,12,1142,0,0,50.76227,0.004992999999998915,"",""
"172.16.133.54",64330,"216.219.116.244",443,6,366,5992,0,0,4,246,2,120,50.781652,0.24520599999999604,8025,3915
"172.16.133.28",65355,"172.16.139.250",5440,10,1022,5993,0,0,10,1022,0,0,50.793753,0.005339999999996792,1531086,0
"172.16.133.99",56032,"172.16.139.250",5440,10,1022,5994,0,0,10,1022,0,0,50.819667,0.004927999999999599,"",""
"172.16.133.87",60174,"172.16.139.250",5440,12,1142,5995,0,0,12,1142,0,0,50.84213,0.0061140000000037276,1494275,0
"172.16.133.116",53305,"172.16.139.250",5440,10,1022,5996,0,0,10,1022,0,0,50.85878,0.005903999999993914,1384823,0
"172.16.133.35",49960,"172.16.139.250",5440,12,1142,5997,0,0,12,1142,0,0,50.861134,0.04370099999999866,209057,0
"172.16.133.116",53306,"172.16.139.250",5440,10,1022,5998,0,0,10,1022,0,0,50.865436,0.004964999999998554,"",""
"172.16.133.116",53307,"172.16.139.250",5440,10,1022,5999,0,0,10,1022,0,0,50.871534,0.006811000000006118,1200411,0
"172.16.133.84",58782,"172.16.139.250",5440,10,1022,6000,0,0,10,1022,0,0,50.879371,0.0053690000000017335,1522816,0
"172.16.133.44",64782,"216.115.220.254",443,6,366,6001,0,0,4,246,2,120,50.913121,0.4857560000000021,4051,1976
"172.16.133.54",64253,"96.43.146.22",443,25,14268,6002,0,0,15,12140,10,2128,50.95408,240.479,403,70
"172.16.133.49",55755,"172.16.139.250",5440,12,1142,6003,0,0,12,1142,0,0,50.957422,0.00637400000000099,1433322,0
"172.16.133.27",60742,"173.194.43.53",443,168,96131,6004,0,0,86,21048,82,75083,50.982582,240.24445799999998,700,2500
"172.16.133.95",56955,"172.16.139.250",5440,10,1022,6005,0,0,10,1022,0,0,50.995298,0.08263800000000288,98937,0
"172.16.133.44",64783,"202.173.27.250",443,6,366,6006,0,0,4,246,2,120,51.010055,0.578797999999999,3400,1658
"172.16.133.28",49455,"172.16.139.250",5447,10,1360,6007,0,0,10,1360,0,0,51.016645,201.167756,54,0
"172.16.133.92",57671,"172.16.139.250",5440,10,1022,6008,0,0,10,1022,0,0,51.022423,0.03693199999999308,221379,0
"172.16.133.29",60903,"172.16.139.250",5440,10,1022,6009,0,0,10,1022,0,0,51.039873,0.023268999999999096,351368,0
"172.16.133.44",64784,"172.16.139.250",5440,10,1022,6010,0,0,10,1022,0,0,51.048846,0.03559800000000024,229675,0
"172.16.133.207",55923,"172.16.139.250",5440,10,1022,6011,0,0,10,1022,0,0,51.072374,0.01640099999999478,498506,0
"172.16.133.83",57080,"172.16.139.250",5440,12,1142,6012,0,0,12,1142,0,0,51.080452,0.016598999999999364,550394,0
"172.16.133.93",60667,"172.16.139.250",5440,12,1142,6013,0,0,12,1142,0,0,51.098343,0.014361000000000956,636167,0
"172.16.133.11",55132,"172.16.139.250",5440,12,1142,6014,0,0,12,1142,0,0,51.11771,0.015116999999996494,604352,0
"172.16.133.55",57569,"172.16.139.250",5440,10,1022,6015,0,0,10,1022,0,0,51.1183,0.005755000000000621,1420677,0
"172.16.133.87",60175,"96.43.146.48",443,23,6197,6016,0,0,12,1249,11,4948,51.132355,225.380481,44,175
"172.16.133.87",60176,"96.43.146.48",443,46,26705,6017,0,0,24,15016,22,11689,51.132472,227.300322,528,411
"172.16.133.87",60177,"96.43.146.48",443,22,6137,6018,0,0,11,1189,11,4948,51.132574,225.39207000000002,42,175
"172.16.133.73",60626,"172.16.139.250",5440,10,1022,6019,0,0,10,1022,0,0,51.141266,0.00560199999999611,1459478,0
"172.16.133.53",54089,"172.16.139.250",5440,10,1022,6020,0,0,10,1022,0,0,51.144125,0.0161549999999977,506097,0
"172.16.133.21",53163,"172.16.139.250",5440,10,1022,6021,0,0,10,1022,0,0,51.146436,0.017679999999998586,462443,0
"172.16.133.30",62604,"172.16.139.250",5440,12,1142,6022,0,0,12,1142,0,0,51.150666,0.0056730000000015934,1610435,0
"172.16.133.25",63428,"172.16.139.250",5440,12,1142,6023,0,0,12,1142,0,0,51.158943,0.01738799999999685,525419,0
"172.16.133.34",50429,"172.16.139.250",5440,12,1142,6024,0,0,12,1142,0,0,51.166998,0.005344999999998379,1709260,0
"172.16.133.97",59362,"172.16.139.250",5440,10,1022,6025,0,0,10,1022,0,0,51.178393,0.005302000000000362,1542059,0
"172.16.133.33",57871,"172.16.139.250",5440,12,1142,6026,0,0,12,1142,0,0,51.253796,0.006333999999995399,1442374,0
"172.16.133.68",60717,"172.16.139.250",5440,12,1142,6027,0,0,12,1142,0,0,51.282875,0.005988000000002103,1525718,0
"172.16.133.12",59724,"172.16.139.250",5440,12,1142,6028,0,0,12,1142,0,0,51.298781,0.006818000000002655,1339982,0
"172.16.133.63",53869,"172.16.139.250",5440,10,1022,6029,0,0,10,1022,0,0,51.306464,0.015543000000000973,526024,0
"172.16.133.66",53849,"172.16.139.250",5440,10,1022,6030,0,0,10,1022,0,0,51.32266,0.005364000000000146,1524235,0
"172.16.133.39",49361,"132.245.1.150",443,10,795,6031,0,0,5,495,5,300,51.327805,243.217914,16,9
"172.16.133.82",61311,"172.16.139.250",5440,10,1022,6032,0,0,10,1022,0,0,51.334548,0.01539600000000263,531047,0
"172.16.133.41",52936,"216.52.121.204",80,16,7893,6033,0,0,8,3476,8,4417,51.342926,4.823534000000002,5765,7325
"172.16.133.41",52937,"216.52.121.204",80,12,4804,6034,0,0,7,3271,5,1533,51.34308,0.12980400000000003,201596,94480
"172.16.133.41",52938,"216.52.121.204",80,15,8064,6035,0,0,8,3467,7,4597,51.34317,0.6533119999999997,42454,56291
"172.16.133.41",52939,"216.52.121.204",80,68,67106,6036,0,0,21,4110,47,62996,51.343289,0.3893419999999992,84450,1294409
"172.16.133.41",52940,"216.52.121.204",80,13,4165,6037,0,0,7,3407,6,758,51.343365,1.747281000000001,15599,3470
"172.16.133.41",52941,"216.52.121.204",80,18,8507,6038,0,0,9,3529,9,4978,51.344968,3.3768519999999995,8360,11793
"172.16.133.41",52942,"173.194.43.59",80,6,372,6039,0,0,4,246,2,126,51.345232,18.660357999999995,105,54
"172.16.133.41",52943,"173.194.43.41",80,6,372,6040,0,0,4,246,2,126,51.345399,18.660189000000003,105,54
"172.16.133.41",52944,"199.102.234.31",80,7,432,6041,0,0,4,246,3,186,51.345536,18.666282000000002,105,79
"172.16.133.41",52945,"199.102.234.31",80,15,7165,6042,0,0,7,3084,8,4081,51.345647,2.7636030000000034,8927,11813
"172.16.133.41",52946,"199.102.234.31",80,7,432,6043,0,0,4,246,3,186,51.345805,18.664292000000003,105,79
"172.16.133.41",52947,"199.102.234.31",80,7,432,6044,0,0,4,246,3,186,51.345896,18.665072000000002,105,79
"172.16.133.37",60615,"172.16.139.250",5440,12,1142,6045,0,0,12,1142,0,0,51.34803,0.014885999999997068,613731,0
"172.16.133.41",52948,"173.194.74.95",80,7,432,6046,0,0,4,246,3,186,51.349476,18.664771999999992,105,79
"172.16.133.41",52949,"173.194.74.95",80,6,372,6047,0,0,4,246,2,126,51.349586,18.665497000000002,105,54
"172.16.133.41",52950,"173.194.74.95",80,6,372,6048,0,0,4,246,2,126,51.350357,18.664727999999997,105,54
"172.16.133.46",64544,"68.64.4.249",443,6,366,6049,0,0,4,246,2,120,51.361137,0.10225100000000253,19246,9388
"172.16.133.46",64545,"216.219.116.244",443,6,366,6050,0,0,4,246,2,120,51.361138,0.2187330000000003,8997,4388
"172.16.133.46",64546,"216.115.216.250",443,6,366,6051,0,0,4,246,2,120,51.362324,0.05485199999999679,35878,17501
"172.16.133.78",59197,"172.16.139.250",5440,12,1142,6052,0,0,12,1142,0,0,51.50517,0.01644600000000196,555515,0
"172.16.133.21",61259,"157.56.238.6",443,10,795,6053,0,0,5,495,5,300,51.522631,240.083099,16,9
"172.16.133.67",55975,"172.16.139.250",5440,10,1022,6054,0,0,10,1022,0,0,51.560067,0.005122000000000071,1596251,0
"172.16.133.95",56956,"74.125.226.231",443,37,7203,6055,0,0,19,2438,18,4765,51.57267,240.15925499999997,81,158
"172.16.133.56",61418,"172.16.139.250",5440,12,1142,6056,0,0,12,1142,0,0,51.582848,0.014183000000002721,644151,0
"172.16.133.42",57056,"172.16.139.250",5440,12,1142,6057,0,0,12,1142,0,0,51.611419,0.01034100000000393,883473,0
"172.16.133.28",65356,"172.16.139.250",5440,12,1142,6058,0,0,12,1142,0,0,51.620961,0.006050000000001887,1510082,0
"172.16.133.75",50946,"172.16.139.250",5440,10,1022,6059,0,0,10,1022,0,0,51.636895,0.0058159999999958245,1405777,0
"172.16.133.41",52951,"172.16.139.250",5440,12,1142,6060,0,0,12,1142,0,0,51.640404,0.0074550000000002115,1225486,0
"172.16.133.85",52247,"172.16.139.250",5440,10,1022,6061,0,0,10,1022,0,0,51.654928,0.005400999999999101,1513793,0
"172.16.133.95",56957,"173.194.43.37",443,52,17038,6062,0,0,25,2934,27,14104,51.692547,240.237575,97,469
"172.16.133.43",57757,"172.16.139.250",5440,10,1022,6063,0,0,10,1022,0,0,51.71014,0.0054839999999956035,1490882,0
"172.16.133.13",53029,"172.16.139.250",5440,10,1022,6064,0,0,10,1022,0,0,51.727615,0.006109999999999616,1338134,0
"172.16.133.85",52248,"216.115.216.250",443,6,366,6065,0,0,4,246,2,120,51.753424,0.06120899999999807,32152,15683
"172.16.133.20",62383,"172.16.139.250",5440,12,1142,6066,0,0,12,1142,0,0,51.776314,0.004758999999999958,"",""
"172.16.133.28",65357,"172.16.139.250",5440,10,1022,6067,0,0,10,1022,0,0,51.808262,0.005093000000002235,1605340,0
"172.16.133.126",61491,"157.56.244.214",443,1,60,6068,0,0,1,60,0,0,51.811221,0,"",""
"172.16.133.48",60511,"184.73.197.44",443,19,8185,6069,0,0,9,2282,10,5903,51.821874,13.993033000000004,1304,3374
"172.16.133.99",56033,"172.16.139.250",5440,12,1142,6070,0,0,12,1142,0,0,51.832953,0.014824999999994759,616256,0
"172.16.133.87",60178,"172.16.139.250",5440,10,1022,6071,0,0,10,1022,0,0,51.855892,0.004986999999999853,"",""
"172.16.133.41",52952,"74.125.226.91",80,6,372,6072,0,0,4,246,2,126,51.866672,18.15206,108,55
"172.16.133.41",52953,"23.33.95.139",80,6,372,6073,0,0,4,246,2,126,51.866893,18.137814,108,55
"172.16.133.41",52954,"74.119.118.84",80,4,252,6074,0,0,2,126,2,126,51.867036,14.093930999999998,71,71
"172.16.133.41",52955,"74.119.118.84",80,4,252,6075,0,0,2,126,2,126,51.867142,14.164852999999994,71,71
"172.16.133.41",52956,"208.47.254.27",80,6,372,6076,0,0,4,246,2,126,51.867323,18.138315000000006,108,55
"172.16.133.41",52957,"208.47.254.27",80,6,372,6077,0,0,4,246,2,126,51.867432,18.138276999999995,108,55
"172.16.133.41",52958,"208.47.254.27",80,6,372,6078,0,0,4,246,2,126,51.86753,18.139077999999998,108,55
"172.16.133.41",52959,"199.102.234.31",80,7,432,6079,0,0,4,246,3,186,51.867691,18.143227000000003,108,82
"172.16.133.41",52960,"199.102.234.31",80,7,432,6080,0,0,4,246,3,186,51.867791,18.143129000000002,108,82
"172.16.133.35",49961,"172.16.139.250",5440,12,1142,6081,0,0,12,1142,0,0,51.868222,0.027068999999997345,337507,0
"172.16.133.116",53308,"172.16.139.250",5440,10,1022,6082,0,0,10,1022,0,0,51.874725,0.00737500000000324,1108610,0
"172.16.133.116",53309,"172.16.139.250",5440,10,1022,6083,0,0,10,1022,0,0,51.883552,0.005085000000001116,1607866,0
"172.16.133.116",53310,"172.16.139.250",5440,12,1142,6084,0,0,12,1142,0,0,51.889637,0.016714999999997815,546574,0
"172.16.133.84",58783,"172.16.139.250",5440,10,1022,6085,0,0,10,1022,0,0,51.893137,0.016067999999997085,508837,0
"172.16.133.49",55756,"172.16.139.250",5440,10,1022,6086,0,0,10,1022,0,0,51.97162,0.005733999999996797,1425880,0
"172.16.133.95",56958,"172.16.139.250",5440,12,1142,6087,0,0,12,1142,0,0,52.008442,0.006315999999998212,1446485,0
"172.16.133.85",52249,"216.219.116.244",443,6,366,6088,0,0,4,246,2,120,52.029398,0.22563099999999991,8722,4254
"172.16.133.82",58585,"157.56.232.214",443,26,3267,6089,0,0,14,2547,12,720,52.036421,223.01774200000003,91,25
"172.16.133.92",57672,"172.16.139.250",5440,10,1022,6090,0,0,10,1022,0,0,52.036777,0.005569999999998743,1467863,0
"172.16.133.29",60904,"172.16.139.250",5440,10,1022,6091,0,0,10,1022,0,0,52.053601,0.0060489999999973065,1351628,0
"172.16.133.44",64785,"172.16.139.250",5440,10,1022,6092,0,0,10,1022,0,0,52.060863,0.0055499999999995,1473153,0
"172.16.133.207",55924,"172.16.139.250",5440,12,1142,6093,0,0,12,1142,0,0,52.085581,0.014517000000004998,629331,0
"172.16.133.83",57081,"172.16.139.250",5440,12,1142,6094,0,0,12,1142,0,0,52.094362,0.016053000000006534,569114,0
"172.16.133.43",57758,"68.64.24.250",443,6,366,6095,0,0,4,246,2,120,52.100739,0.10576200000000568,18607,9076
"172.16.133.93",60668,"172.16.139.250",5440,12,1142,6096,0,0,12,1142,0,0,52.111301,0.014594000000002438,626010,0
"172.16.133.11",55133,"172.16.139.250",5440,10,1022,6097,0,0,10,1022,0,0,52.128318,0.015360999999998626,532257,0
"172.16.133.55",57570,"172.16.139.250",5440,10,1022,6098,0,0,10,1022,0,0,52.132165,0.006115000000001203,1337040,0
"172.16.133.43",57759,"78.108.118.250",443,6,366,6099,0,0,4,246,2,120,52.144568,0.23127900000000068,8509,4150
"172.16.133.43",57760,"216.219.118.244",443,6,366,6100,0,0,4,246,2,120,52.146518,0.21196199999999976,9284,4529
"172.16.133.53",54090,"172.16.139.250",5440,10,1022,6101,0,0,10,1022,0,0,52.158597,0.005608999999999753,1457657,0
"172.16.133.21",53164,"172.16.139.250",5440,12,1142,6102,0,0,12,1142,0,0,52.160502,0.01796600000000126,508516,0
"172.16.133.73",60627,"172.16.139.250",5440,10,1022,6103,0,0,10,1022,0,0,52.164301,0.00937799999999811,871827,0
"172.16.133.30",62605,"172.16.139.250",5440,10,1022,6104,0,0,10,1022,0,0,52.164553,0.005717000000004191,1430120,0
"172.16.133.25",63429,"172.16.139.250",5440,10,1022,6105,0,0,10,1022,0,0,52.173053,0.008454000000000406,967116,0
"172.16.133.34",50430,"172.16.139.250",5440,12,1142,6106,0,0,12,1142,0,0,52.181145,0.005012999999998158,1822461,0
"172.16.133.97",59363,"172.16.139.250",5440,10,1022,6107,0,0,10,1022,0,0,52.192538,0.005662999999998419,1443757,0
"96.43.146.22",443,"172.16.133.113",53520,14,6784,6108,0,0,7,1930,7,4854,52.194809,227.10072399999999,67,170
"172.16.133.113",55540,"96.43.146.48",443,5,317,6109,0,0,2,120,3,197,52.19661,0.04539799999999872,21146,34715
"172.16.133.113",55541,"96.43.146.48",443,1,60,6110,0,0,1,60,0,0,52.197145,0,"",""
"172.16.133.43",62630,"157.56.236.102",443,29,5464,6111,0,0,15,4624,14,840,52.240354,239.075889,154,28
"172.16.133.33",57872,"172.16.139.250",5440,12,1142,6112,0,0,12,1142,0,0,52.266731,0.006444999999999368,1417532,0
"172.16.133.68",60718,"172.16.139.250",5440,10,1022,6113,0,0,10,1022,0,0,52.297156,0.0055210000000016635,1480891,0
"172.16.133.43",57761,"216.115.219.126",443,6,366,6114,0,0,4,246,2,120,52.29864,0.5744180000000014,3426,1671
"172.16.133.12",59725,"172.16.139.250",5440,12,1142,6115,0,0,12,1142,0,0,52.311409,0.006176000000003512,1479274,0
"172.16.133.63",53870,"172.16.139.250",5440,12,1142,6116,0,0,12,1142,0,0,52.321438,0.005490000000001771,1664116,0
"157.56.234.118",443,"172.16.133.28",49252,12,974,6117,0,0,6,614,6,360,52.330357,240.44280700000002,20,11
"172.16.133.45",61327,"64.90.204.229",443,21,4935,6118,0,0,10,2952,11,1983,52.331297,3.4603329999999985,6824,4584
"172.16.133.66",53850,"172.16.139.250",5440,10,1022,6119,0,0,10,1022,0,0,52.335718,0.005401999999996576,1513513,0
"172.16.133.82",61312,"172.16.139.250",5440,10,1022,6120,0,0,10,1022,0,0,52.348601,0.006211999999997886,1316162,0
"172.16.133.37",60616,"172.16.139.250",5440,12,1142,6121,0,0,12,1142,0,0,52.362404,0.005935000000000912,1539342,0
"172.16.133.44",64786,"216.115.217.254",443,6,366,6122,0,0,4,246,2,120,52.41612,0.06759999999999877,29112,14201
"157.56.234.118",443,"172.16.133.37",59842,21,4215,6123,0,0,12,3675,9,540,52.431769,240.24570400000002,122,17
"199.47.219.147",80,"172.16.133.57",59163,23,3762,6124,0,0,11,1800,12,1962,52.454509,223.815707,64,70
"157.56.245.198",443,"172.16.133.33",49378,10,775,6125,0,0,5,475,5,300,52.45951,240.12832799999998,15,9
"172.16.133.60",55315,"157.56.241.150",443,396,301817,6126,0,0,230,291857,166,9960,52.477473,247.228309,9444,322
"172.16.133.43",63449,"157.56.236.102",443,10,775,6127,0,0,5,475,5,300,52.510344,240.07950300000002,15,9
"172.16.133.78",59198,"172.16.139.250",5440,10,1022,6128,0,0,10,1022,0,0,52.519388,0.00568900000000383,1437159,0
"172.16.133.67",55976,"172.16.139.250",5440,10,1022,6129,0,0,10,1022,0,0,52.573281,0.014671999999997354,557251,0
"172.16.133.56",61419,"172.16.139.250",5440,10,1022,6130,0,0,10,1022,0,0,52.595539,0.005168999999995094,1581737,0
"172.16.133.54",64331,"216.115.216.250",443,6,366,6131,0,0,4,246,2,120,52.623681,0.061078000000001964,32221,15717
"172.16.133.42",57057,"172.16.139.250",5440,12,1142,6132,0,0,12,1142,0,0,52.638073,0.016415999999999542,556530,0
"172.16.133.41",52961,"172.16.139.250",5440,12,1142,6133,0,0,12,1142,0,0,52.652632,0.006350000000004741,1438740,0
"172.16.133.75",50947,"172.16.139.250",5440,10,1022,6134,0,0,10,1022,0,0,52.658395,0.00551200000000307,1483309,0
"172.16.133.44",64787,"216.219.120.244",443,6,366,6135,0,0,4,246,2,120,52.660151,0.2198709999999977,8950,4366
"172.16.133.85",52250,"172.16.139.250",5440,10,1022,6136,0,0,10,1022,0,0,52.669728,0.005350999999997441,1527938,0
"172.16.133.60",55458,"157.56.241.150",443,10,775,6137,0,0,5,475,5,300,52.68771,240.01992899999996,15,9
"172.16.133.43",57762,"172.16.139.250",5440,12,1142,6138,0,0,12,1142,0,0,52.723982,0.006233999999999185,1465511,0
"172.16.133.54",64332,"68.64.26.250",443,6,366,6139,0,0,4,246,2,120,52.732715,0.1787130000000019,11012,5371
"172.16.133.54",64333,"68.64.4.249",443,6,366,6140,0,0,4,246,2,120,52.733377,0.17824800000000351,11040,5385
"172.16.133.13",53030,"172.16.139.250",5440,10,1022,6141,0,0,10,1022,0,0,52.739988,0.014637000000000455,558584,0
"172.16.133.85",52251,"68.64.4.249",443,6,366,6142,0,0,4,246,2,120,52.766306,0.15756600000000276,12490,6092
"172.16.133.44",50499,"172.16.139.250",5500,20,1740,6143,0,0,20,1740,0,0,52.774696,240.19942400000002,57,0
"172.16.133.87",60180,"54.240.160.134",443,18,7326,6144,0,0,8,860,10,6466,52.775085,33.18269800000001,207,1558
"172.16.133.87",60181,"54.240.160.134",443,19,7386,6145,0,0,9,920,10,6466,52.775236,33.184853999999994,221,1558
"172.16.133.87",60182,"54.240.160.134",443,19,7386,6146,0,0,9,920,10,6466,52.775351,33.183667,221,1558
"172.16.133.87",60183,"54.240.160.134",443,19,7636,6147,0,0,8,866,11,6770,52.775453,33.183372000000006,208,1632
"172.16.133.87",60184,"54.240.160.134",443,21,7756,6148,0,0,10,986,11,6770,52.775571,33.184658,237,1632
"172.16.133.87",60185,"54.240.160.134",443,18,7326,6149,0,0,8,860,10,6466,52.77567,33.18345300000001,207,1558
"172.16.133.85",52252,"68.64.26.250",443,6,366,6150,0,0,4,246,2,120,52.777199,0.1733639999999994,11351,5537
"172.16.133.20",62384,"172.16.139.250",5440,10,1022,6151,0,0,10,1022,0,0,52.790219,0.014449999999996521,565813,0
"172.16.133.28",65358,"172.16.139.250",5440,12,1142,6152,0,0,12,1142,0,0,52.820771,0.0053690000000017335,1701620,0
"172.16.133.99",56034,"172.16.139.250",5440,12,1142,6153,0,0,12,1142,0,0,52.847073,0.014845999999998583,615384,0
"172.16.128.233",55229,"172.16.133.233",22,164,19404,6154,0,0,47,4000,117,15404,52.849824,8.030113,3984,15346
"172.16.133.39",49304,"65.55.71.43",1863,17,1038,6155,0,0,11,666,6,372,52.85601,240.28893200000002,22,12
"172.16.133.87",60186,"64.56.203.22",443,20,8046,6156,0,0,11,3397,9,4649,52.858031,13.159374,2065,2826
"172.16.133.87",60187,"64.56.203.22",443,17,1403,6157,0,0,9,801,8,602,52.858206,225.78866499999998,28,21
"172.16.133.68",49417,"172.16.139.250",5447,10,1400,6158,0,0,10,1400,0,0,52.862907,189.245769,59,0
"172.16.133.87",60188,"172.16.139.250",5440,10,1022,6159,0,0,10,1022,0,0,52.870036,0.01610300000000109,507731,0
"172.16.133.35",49962,"172.16.139.250",5440,12,1142,6160,0,0,12,1142,0,0,52.881867,0.012326999999999089,741137,0
"172.16.133.116",53311,"172.16.139.250",5440,10,1022,6161,0,0,10,1022,0,0,52.885276,0.008015000000000327,1020087,0
"172.16.133.116",53312,"172.16.139.250",5440,12,1142,6162,0,0,12,1142,0,0,52.894133,0.006072000000003186,1504611,0
"172.16.133.116",53313,"172.16.139.250",5440,12,1142,6163,0,0,12,1142,0,0,52.900959,0.006583999999996593,1387606,0
"172.16.133.84",58784,"172.16.139.250",5440,12,1142,6164,0,0,12,1142,0,0,52.908795,0.005430000000004043,1682504,0
"172.16.133.54",64334,"216.219.116.244",443,6,366,6165,0,0,4,246,2,120,52.909678,0.25494299999999726,7719,3765
"172.16.133.113",53367,"96.43.146.22",443,17,10480,6166,0,0,10,9456,7,1024,52.916691,226.14853899999997,334,36
"157.56.238.6",443,"172.16.133.21",54061,19,2921,6167,0,0,11,2441,8,480,52.980534,239.84172800000002,81,16
"172.16.133.49",55757,"172.16.139.250",5440,10,1022,6168,0,0,10,1022,0,0,52.985427,0.014690999999999121,556531,0
"172.16.133.95",56959,"172.16.139.250",5440,12,1142,6169,0,0,12,1142,0,0,53.025156,0.005936999999995862,1538824,0
"172.16.133.92",57673,"172.16.139.250",5440,12,1142,6170,0,0,12,1142,0,0,53.051713,0.013600000000003831,671764,0
"172.16.133.29",60905,"172.16.139.250",5440,12,1142,6171,0,0,12,1142,0,0,53.067249,0.1059540000000041,86226,0
"172.16.133.44",64788,"172.16.139.250",5440,12,1142,6172,0,0,12,1142,0,0,53.075974,0.08240699999999634,110864,0
"172.16.133.207",55925,"172.16.139.250",5440,12,1142,6173,0,0,12,1142,0,0,53.100406,0.06097400000000164,149834,0
"172.16.133.83",57082,"172.16.139.250",5440,10,1022,6174,0,0,10,1022,0,0,53.108367,0.056837999999999056,143847,0
"172.16.133.93",60669,"172.16.139.250",5440,10,1022,6175,0,0,10,1022,0,0,53.126266,0.04266499999999951,191632,0
"172.16.133.11",55134,"172.16.139.250",5440,10,1022,6176,0,0,10,1022,0,0,53.143334,0.03757999999999839,217562,0
"172.16.133.44",59969,"172.16.139.250",5447,10,1400,6177,0,0,10,1400,0,0,53.145552,240.034402,46,0
"172.16.133.55",57571,"172.16.139.250",5440,12,1142,6178,0,0,12,1142,0,0,53.14636,0.030581999999995446,298737,0
"172.16.133.44",64789,"216.115.220.254",443,6,366,6179,0,0,4,246,2,120,53.151213,0.47435399999999817,4148,2023
"172.16.133.73",60628,"172.16.139.250",5440,10,1022,6180,0,0,10,1022,0,0,53.170884,0.017572000000001253,465285,0
"172.16.133.53",54091,"172.16.139.250",5440,12,1142,6181,0,0,12,1142,0,0,53.172321,0.013068000000004076,699112,0
"172.16.133.21",53165,"172.16.139.250",5440,12,1142,6182,0,0,12,1142,0,0,53.17462,0.02599900000000588,351398,0
"172.16.133.30",62607,"172.16.139.250",5440,10,1022,6183,0,0,10,1022,0,0,53.178177,0.014140000000004704,578217,0
"172.16.133.25",63430,"172.16.139.250",5440,10,1022,6184,0,0,10,1022,0,0,53.18722,0.008845999999998355,924259,0
"172.16.133.132",60592,"23.46.16.170",80,34,15467,6185,0,0,19,3347,15,12120,53.190623,5.132883,5216,18889
"172.16.133.132",60593,"23.46.16.170",80,12,2633,6186,0,0,7,781,5,1852,53.190957,5.132818,1217,2886
"172.16.133.132",60594,"23.46.16.170",80,6,412,6187,0,0,4,272,2,140,53.19125,5.132145000000001,423,218
"172.16.133.34",50431,"172.16.139.250",5440,10,1022,6188,0,0,10,1022,0,0,53.195258,0.01736599999999555,470805,0
"172.16.133.97",59364,"172.16.139.250",5440,10,1022,6189,0,0,10,1022,0,0,53.207008,0.02070499999999953,394880,0
"172.16.133.33",57873,"172.16.139.250",5440,10,1022,6190,0,0,10,1022,0,0,53.280879,0.0055210000000016635,1480891,0
"172.16.133.68",60719,"172.16.139.250",5440,10,1022,6191,0,0,10,1022,0,0,53.311335,0.01548400000000072,528028,0
"172.16.133.44",64790,"202.173.27.250",443,6,366,6192,0,0,4,246,2,120,53.312097,0.586157,3357,1637
"172.16.133.12",59726,"172.16.139.250",5440,10,1022,6193,0,0,10,1022,0,0,53.325418,0.005786000000000513,1413066,0
"172.16.133.63",53871,"172.16.139.250",5440,12,1142,6194,0,0,12,1142,0,0,53.334387,0.01741400000000226,524635,0
"172.16.128.169",1439,"172.16.139.250",21,8,505,6195,0,0,4,242,4,263,53.344073,0.29001699999999886,6675,7254
"172.16.133.66",53851,"172.16.139.250",5440,10,1022,6196,0,0,10,1022,0,0,53.349809,0.006047000000002356,1352075,0
"172.16.133.82",61313,"172.16.139.250",5440,10,1022,6197,0,0,10,1022,0,0,53.362532,0.005791999999999575,1411602,0
"172.16.133.37",60617,"172.16.139.250",5440,10,1022,6198,0,0,10,1022,0,0,53.376681,0.016341000000004158,500336,0
"172.16.133.46",64548,"216.115.216.250",443,6,366,6199,0,0,4,246,2,120,53.39803,0.04077099999999945,48269,23546
"172.16.133.46",64550,"68.64.4.249",443,6,366,6200,0,0,4,246,2,120,53.414834,0.0932770000000005,21098,10291
"172.16.133.132",41507,"66.235.143.121",80,13,5178,6201,0,0,8,2689,5,2489,53.446148,4.917630000000003,4374,4049
"172.16.133.46",64551,"216.219.116.244",443,6,366,6202,0,0,4,246,2,120,53.473904,0.2520600000000002,7807,3808
"172.16.133.132",32966,"64.94.107.47",80,9,3566,6203,0,0,5,608,4,2958,53.477075,0.06541700000000361,74353,361740
"172.16.133.132",52007,"23.62.104.251",80,50,32624,6204,0,0,26,2033,24,30591,53.49296,4.853034000000001,3351,50427
"172.16.133.78",59199,"172.16.139.250",5440,12,1142,6205,0,0,12,1142,0,0,53.532964,0.015506000000002018,589191,0
"172.16.133.132",53392,"64.94.107.34",80,7,1820,6206,0,0,4,1170,3,650,53.566408,0.0778269999999992,120266,66814
"172.16.133.132",40557,"208.47.254.81",80,18,5113,6207,0,0,11,2169,7,2944,53.574306,4.7392579999999995,3661,4969
"172.16.133.67",55977,"172.16.139.250",5440,12,1142,6208,0,0,12,1142,0,0,53.586989,0.00599399999999406,1524190,0
"172.16.133.56",61420,"172.16.139.250",5440,10,1022,6209,0,0,10,1022,0,0,53.609299,0.005398999999997045,1514354,0
"172.16.133.42",57058,"172.16.139.250",5440,12,1142,6210,0,0,12,1142,0,0,53.638801,0.019641999999997495,465125,0
"172.16.133.132",59662,"138.108.7.20",80,10,1928,6211,0,0,5,726,5,1202,53.656933,0.348433,16668,27597
"172.16.133.41",52962,"172.16.139.250",5440,10,1022,6212,0,0,10,1022,0,0,53.666642,0.019499999999993634,419282,0
"172.16.133.85",52253,"172.16.139.250",5440,10,1022,6213,0,0,10,1022,0,0,53.682902,0.016280999999999324,502180,0
"172.16.133.75",50948,"172.16.139.250",5440,10,1022,6214,0,0,10,1022,0,0,53.716454,0.0055949999999995725,1461304,0
"172.16.133.43",57763,"172.16.139.250",5440,10,1022,6215,0,0,10,1022,0,0,53.738373,0.005409000000000219,1511554,0
"172.16.133.13",53031,"172.16.139.250",5440,10,1022,6216,0,0,10,1022,0,0,53.754395,0.005320999999995024,1536553,0
"172.16.133.87",60189,"204.232.250.57",443,16,4529,6217,0,0,9,3549,7,980,53.754758,12.196195999999993,2327,642
"172.16.133.85",52254,"216.115.216.250",443,6,366,6218,0,0,4,246,2,120,53.788332,0.104885000000003,18763,9152
"172.16.133.20",62385,"172.16.139.250",5440,12,1142,6219,0,0,12,1142,0,0,53.804234,0.004978000000001259,"",""
"172.16.133.163",3520,"15.193.0.234",80,795,687199,6220,0,0,281,34403,514,652796,53.811159,139.502027,1972,37435
"172.16.133.163",3521,"15.193.0.234",80,1068,926433,6221,0,0,375,37009,693,889424,53.811513,139.501673,2122,51005
"172.16.133.45",61328,"204.14.235.124",443,23,5236,6222,0,0,12,1804,11,3432,53.816944,227.373186,63,120
"172.16.133.45",61329,"204.14.235.124",443,22,5169,6223,0,0,12,1797,10,3372,53.817195,225.889781,63,119
"172.16.133.45",61330,"204.14.235.124",443,22,5174,6224,0,0,12,1802,10,3372,53.81744,225.88871099999997,63,119
"172.16.133.45",61331,"204.14.235.124",443,58,45021,6225,0,0,20,2251,38,42770,53.817674,226.31819000000002,79,1511
"172.16.133.28",65359,"172.16.139.250",5440,10,1022,6226,0,0,10,1022,0,0,53.834833,0.015475999999999601,528301,0
"172.16.133.113",55609,"172.16.139.250",135,8,492,6227,0,0,8,492,0,0,53.848603,0.00637400000000099,617508,0
"172.16.133.113",55610,"172.16.139.250",5462,10,696,6228,0,0,10,696,0,0,53.85565,0.5132800000000017,10847,0
"172.16.133.99",56035,"172.16.139.250",5440,12,1142,6229,0,0,12,1142,0,0,53.862273,0.005330000000000723,1714071,0
"172.16.133.45",61332,"204.14.235.124",443,7,432,6230,0,0,4,246,3,186,53.872084,17.007289,115,87
"172.16.133.87",60190,"172.16.139.250",5440,10,1022,6231,0,0,10,1022,0,0,53.884373,0.005396000000004619,1515196,0
"172.16.133.35",49963,"172.16.139.250",5440,12,1142,6232,0,0,12,1142,0,0,53.899163,0.06868699999999706,133009,0
"172.16.133.116",53314,"172.16.139.250",5440,10,1022,6233,0,0,10,1022,0,0,53.899715,0.0046820000000025175,"",""
"172.16.133.116",53315,"172.16.139.250",5440,10,1022,6234,0,0,10,1022,0,0,53.904901,0.004457999999999629,"",""
"172.16.133.84",58785,"172.16.139.250",5440,12,1142,6235,0,0,12,1142,0,0,53.921458,0.01586199999999849,575967,0
"172.16.133.132",59663,"138.108.7.20",80,10,1539,6236,0,0,5,812,5,727,53.923251,0.3177430000000001,20444,18304
"172.16.133.116",53316,"172.16.139.250",5440,10,1022,6237,0,0,10,1022,0,0,53.9234,0.0051339999999981956,1592520,0
"172.16.133.49",55758,"172.16.139.250",5440,12,1142,6238,0,0,12,1142,0,0,54.007571,0.006263000000004126,1458725,0
"172.16.133.95",56960,"172.16.139.250",5440,10,1022,6239,0,0,10,1022,0,0,54.036183,0.004843999999998516,"",""
"172.16.133.92",57674,"172.16.139.250",5440,10,1022,6240,0,0,10,1022,0,0,54.064859,0.016124000000004912,507070,0
"172.16.133.29",60906,"172.16.139.250",5440,10,1022,6241,0,0,10,1022,0,0,54.081499,0.015633000000001118,522996,0
"172.16.133.44",64791,"172.16.139.250",5440,10,1022,6242,0,0,10,1022,0,0,54.088601,0.015416000000001873,530358,0
"172.16.133.163",3522,"15.193.0.234",80,263,207876,6243,0,0,105,23711,158,184165,54.101995,234.32957600000003,809,6287
"172.16.133.163",3523,"15.193.0.234",80,311,249538,6244,0,0,123,31198,188,218340,54.1022,229.37997699999997,1088,7614
"172.16.133.163",3524,"15.193.0.234",80,178,125943,6245,0,0,79,27000,99,98943,54.102356,189.20729999999998,1141,4183
"172.16.133.163",3525,"15.193.0.234",80,1142,980012,6246,0,0,407,52328,735,927684,54.102508,229.37966799999998,1825,32354
"172.16.133.207",55926,"172.16.139.250",5440,10,1022,6247,0,0,10,1022,0,0,54.114428,0.004695000000005223,"",""
"172.16.133.83",57083,"172.16.139.250",5440,12,1142,6248,0,0,12,1142,0,0,54.122432,0.013823999999999614,660879,0
"172.16.133.163",3526,"4.23.40.126",80,27,13148,6249,0,0,13,2589,14,10559,54.139621,10.10868,2048,8356
"172.16.133.93",60670,"172.16.139.250",5440,10,1022,6250,0,0,10,1022,0,0,54.140367,0.0047509999999988395,"",""
"172.16.133.85",52255,"216.219.116.244",443,6,366,6251,0,0,4,246,2,120,54.149438,0.2484619999999964,7920,3863
"172.16.133.11",55135,"172.16.139.250",5440,10,1022,6252,0,0,10,1022,0,0,54.156875,0.014910000000000423,548356,0
"172.16.133.43",57764,"68.64.24.250",443,6,366,6253,0,0,4,246,2,120,54.158943,0.08554300000000126,23005,11222
"172.16.133.55",57572,"172.16.139.250",5440,10,1022,6254,0,0,10,1022,0,0,54.160416,0.005580999999999392,1464970,0
"172.16.133.163",3527,"63.116.244.155",80,45,28224,6255,0,0,18,1795,27,26429,54.184018,225.229789,63,938
"172.16.133.73",60629,"172.16.139.250",5440,10,1022,6256,0,0,10,1022,0,0,54.184858,0.005473999999999535,1493606,0
"172.16.133.53",54092,"172.16.139.250",5440,10,1022,6257,0,0,10,1022,0,0,54.185609,0.015546999999997979,525889,0
"172.16.133.21",53166,"172.16.139.250",5440,10,1022,6258,0,0,10,1022,0,0,54.188408,0.006011000000000877,1360173,0
"172.16.133.30",62608,"172.16.139.250",5440,10,1022,6259,0,0,10,1022,0,0,54.193217,0.015663000000003535,521994,0
"172.16.133.25",63431,"172.16.139.250",5440,12,1142,6260,0,0,12,1142,0,0,54.200037,0.005164999999998088,1768828,0
"172.16.133.34",50432,"172.16.139.250",5440,10,1022,6261,0,0,10,1022,0,0,54.209506,0.015123000000002662,540633,0
"172.16.133.97",59365,"172.16.139.250",5440,10,1022,6262,0,0,10,1022,0,0,54.220657,0.014638999999995406,558508,0
"172.16.133.43",57765,"216.219.118.244",443,6,366,6263,0,0,4,246,2,120,54.251834,0.22214999999999918,8858,4321
"172.16.133.43",57766,"78.108.118.250",443,6,366,6264,0,0,4,246,2,120,54.25455,0.2194329999999951,8968,4374
"172.16.133.33",57874,"172.16.139.250",5440,10,1022,6265,0,0,10,1022,0,0,54.294801,0.005772000000000332,1416493,0
"172.16.133.68",60720,"172.16.139.250",5440,10,1022,6266,0,0,10,1022,0,0,54.325142,0.014633000000003449,558737,0
"172.16.133.12",59727,"172.16.139.250",5440,10,1022,6267,0,0,10,1022,0,0,54.339772,0.005674999999996544,1440704,0
"172.16.133.63",53872,"172.16.139.250",5440,10,1022,6268,0,0,10,1022,0,0,54.348507,0.006101000000001022,1340108,0
"172.16.133.66",53852,"172.16.139.250",5440,10,1022,6269,0,0,10,1022,0,0,54.363914,0.006199999999999761,1318709,0
"172.16.133.82",61314,"172.16.139.250",5440,10,1022,6270,0,0,10,1022,0,0,54.376907,0.015063999999995303,542750,0
"172.16.133.37",60618,"172.16.139.250",5440,10,1022,6271,0,0,10,1022,0,0,54.390095,0.006510999999996159,1255721,0
"172.16.133.132",40581,"184.173.189.190",80,22,3469,6272,0,0,13,1675,9,1794,54.410213,3.9255989999999983,3413,3656
"172.16.133.13",61353,"96.43.146.48",443,27,8095,6273,0,0,15,5010,12,3085,54.440868,240.34039500000003,166,102
"172.16.133.96",53342,"74.125.226.231",443,29,7067,6274,0,0,16,2396,13,4671,54.499672,240.238121,79,155
"172.16.133.163",3528,"15.216.110.140",80,55,41414,6275,0,0,22,3173,33,38241,54.506525,9.797632999999998,2590,31224
"172.16.133.78",59200,"172.16.139.250",5440,10,1022,6276,0,0,10,1022,0,0,54.547084,0.007955000000002599,1027781,0
"172.16.133.43",57767,"216.115.219.126",443,6,366,6277,0,0,4,246,2,120,54.54769,0.5147909999999953,3822,1864
"172.16.133.60",55674,"96.43.146.48",443,25,8055,6278,0,0,15,5010,10,3045,54.571812,240.34142900000003,166,101
"172.16.133.33",49466,"96.43.146.176",443,26,8075,6279,0,0,15,5010,11,3065,54.59129,240.34259099999997,166,102
"172.16.133.67",55978,"172.16.139.250",5440,12,1142,6280,0,0,12,1142,0,0,54.6011,0.00612199999999774,1492322,0
"172.16.133.56",61421,"172.16.139.250",5440,10,1022,6281,0,0,10,1022,0,0,54.623476,0.014376000000005718,568725,0
"172.16.133.96",53343,"173.194.43.37",443,65,24042,6282,0,0,35,3946,30,20096,54.628992,240.529579,131,668
"172.16.133.54",64335,"216.115.216.250",443,6,366,6283,0,0,4,246,2,120,54.660598,0.06096199999999641,32282,15747
"172.16.133.42",57059,"172.16.139.250",5440,12,1142,6284,0,0,12,1142,0,0,54.660752,0.02708499999999958,337308,0
"172.16.133.41",52963,"172.16.139.250",5440,10,1022,6285,0,0,10,1022,0,0,54.680732,0.01652899999999846,494645,0
"172.16.133.207",49630,"172.16.139.250",5447,10,1400,6286,0,0,10,1400,0,0,54.694145,217.67301600000002,51,0
"172.16.133.85",52256,"172.16.139.250",5440,10,1022,6287,0,0,10,1022,0,0,54.697735,0.014836999999999989,551054,0
"172.16.133.43",57768,"172.16.139.250",5440,12,1142,6288,0,0,12,1142,0,0,54.752071,0.00637400000000099,1433322,0
"172.16.133.41",52964,"216.52.121.204",80,12,3962,6289,0,0,7,3405,5,557,54.7676,0.2732559999999964,99686,16307
"172.16.133.13",53032,"172.16.139.250",5440,10,1022,6290,0,0,10,1022,0,0,54.769018,0.005520999999994558,1480891,0
"172.16.133.41",52965,"216.52.121.204",80,12,3962,6291,0,0,7,3405,5,557,54.772254,0.2691640000000035,101202,16554
"172.16.133.41",52966,"216.52.121.204",80,12,3962,6292,0,0,7,3405,5,557,54.776432,0.2652229999999989,102706,16800
"172.16.133.41",52967,"216.52.121.204",80,12,3962,6293,0,0,7,3405,5,557,54.779868,0.2615509999999972,104147,17036
"172.16.133.41",52968,"216.52.121.204",80,12,3951,6294,0,0,7,3394,5,557,54.783961,0.2577440000000024,105344,17288
"172.16.133.20",62386,"172.16.139.250",5440,12,1142,6295,0,0,12,1142,0,0,54.818629,0.005577999999999861,1637863,0
"172.16.133.24",56620,"157.56.242.198",443,11,894,6296,0,0,6,594,5,300,54.826621,240.107751,19,9
"172.16.133.54",64336,"68.64.4.249",443,6,366,6297,0,0,4,246,2,120,54.845788,0.1965849999999989,10010,4883
"172.16.133.54",64337,"68.64.26.250",443,6,366,6298,0,0,4,246,2,120,54.84579,0.19696899999999573,9991,4873
"172.16.133.28",65360,"172.16.139.250",5440,10,1022,6299,0,0,10,1022,0,0,54.848548,0.017632999999996457,463676,0
"172.16.133.85",52257,"68.64.4.249",443,6,366,6300,0,0,4,246,2,120,54.862333,0.18068600000000146,10891,5313
"172.16.133.99",56036,"172.16.139.250",5440,10,1022,6301,0,0,10,1022,0,0,54.875111,0.014707000000001358,555925,0
"172.16.133.87",60191,"172.16.139.250",5440,10,1022,6302,0,0,10,1022,0,0,54.898346,0.015237000000006162,536588,0
"172.16.133.85",52258,"68.64.26.250",443,6,366,6303,0,0,4,246,2,120,54.90865,0.19232600000000133,10232,4991
"172.16.133.35",49964,"172.16.139.250",5440,12,1142,6304,0,0,12,1142,0,0,54.91148,0.008259000000002459,1106187,0
"172.16.133.116",53317,"172.16.139.250",5440,10,1022,6305,0,0,10,1022,0,0,54.913927,0.00808500000000123,1011255,0
"172.16.133.116",53318,"172.16.139.250",5440,10,1022,6306,0,0,10,1022,0,0,54.923488,0.005268000000000939,1552012,0
"172.16.133.116",53319,"172.16.139.250",5440,12,1142,6307,0,0,12,1142,0,0,54.92961,0.006883000000001971,1327328,0
"172.16.133.84",58786,"172.16.139.250",5440,10,1022,6308,0,0,10,1022,0,0,54.935227,0.01439500000000038,567974,0
"172.16.133.28",49295,"157.56.234.118",443,10,775,6309,0,0,5,475,5,300,54.942977,240.0949,15,9
"96.43.146.22",443,"172.16.133.89",56402,3,784,6310,0,0,3,784,0,0,54.950919999999996,127.94094799999999,49,0
"172.16.133.41",52969,"216.52.121.204",80,12,3951,6311,0,0,7,3394,5,557,54.952924,0.2042809999999946,132914,21813
"172.16.133.41",52970,"216.52.121.204",80,12,3951,6312,0,0,7,3394,5,557,54.963862,0.19733099999999837,137596,22581
"172.16.133.132",44800,"66.77.124.68",80,10,1677,6313,0,0,6,816,4,861,54.981359,3.4191670000000016,1909,2014
"172.16.133.49",55759,"172.16.139.250",5440,10,1022,6314,0,0,10,1022,0,0,55.012813,0.0057879999999954634,1412577,0
"172.16.133.93",60671,"67.69.174.18",80,6,372,6315,0,0,4,246,2,126,55.037843,12.500416999999992,157,80
"172.16.133.93",60672,"199.48.206.68",443,27,10668,6316,0,0,14,3014,13,7654,55.040013,25.971302999999992,928,2357
"172.16.133.93",60673,"199.48.206.68",443,22,8652,6317,0,0,11,1978,11,6674,55.04018,25.970148000000002,609,2055
"172.16.133.93",60674,"199.48.206.210",443,31,15979,6318,0,0,13,3163,18,12816,55.040416,86.981121,290,1178
"172.16.133.93",60675,"199.48.206.210",443,46,27167,6319,0,0,19,4385,27,22782,55.04062,25.981192,1350,7014
"172.16.133.93",60676,"199.48.206.210",443,39,22449,6320,0,0,18,5441,21,17008,55.040742,91.242962,477,1491
"172.16.133.93",60677,"199.48.206.210",443,30,17583,6321,0,0,13,3814,17,13769,55.040902,1.2924849999999992,23607,85224
"172.16.133.93",60678,"199.48.206.210",443,24,6780,6322,0,0,12,1229,12,5551,55.041056,225.85513799999998,43,196
"172.16.133.93",60679,"199.48.206.210",443,52,28001,6323,0,0,22,5569,30,22432,55.041177,115.97792899999999,384,1547
"172.16.133.132",35592,"50.17.246.106",80,10,1538,6324,0,0,6,801,4,737,55.041478,3.2915300000000016,1946,1791
"172.16.133.54",64338,"216.219.116.244",443,6,366,6325,0,0,4,246,2,120,55.0437,0.23968099999999737,8210,4005
"172.16.133.95",56961,"172.16.139.250",5440,12,1142,6326,0,0,12,1142,0,0,55.050552,0.012902999999994336,708052,0
"172.16.133.132",38811,"75.98.35.10",80,10,1579,6327,0,0,5,656,5,923,55.06352,0.06611800000000301,79373,111679
"172.16.133.92",57675,"172.16.139.250",5440,12,1142,6328,0,0,12,1142,0,0,55.079708,0.006840000000003954,1335672,0
"172.16.133.93",60680,"199.48.206.78",443,25,11082,6329,0,0,12,1622,13,9460,55.084461,55.984675,231,1351
"172.16.133.93",60681,"199.48.206.78",443,24,6977,6330,0,0,12,1106,12,5871,55.084577,225.983671,39,207
"172.16.133.93",60682,"199.48.206.78",443,24,6977,6331,0,0,12,1106,12,5871,55.084688,225.969975,39,207
"172.16.133.93",60683,"199.48.206.78",443,24,6977,6332,0,0,12,1106,12,5871,55.084791,225.983947,39,207
"172.16.133.29",60907,"172.16.139.250",5440,10,1022,6333,0,0,10,1022,0,0,55.095398,0.016636999999995794,491434,0
"172.16.133.44",64792,"172.16.139.250",5440,10,1022,6334,0,0,10,1022,0,0,55.102702,0.005383999999999389,1518573,0
"172.16.133.75",50949,"172.16.139.250",5440,10,1022,6335,0,0,10,1022,0,0,55.111542,0.015036999999999523,543725,0
"172.16.133.207",55927,"172.16.139.250",5440,10,1022,6336,0,0,10,1022,0,0,55.128035,0.01690600000000586,483615,0
"172.16.133.163",3529,"4.23.40.126",80,9,1388,6337,0,0,5,306,4,1082,55.133084,19.124938,128,452
"172.16.133.83",57084,"172.16.139.250",5440,10,1022,6338,0,0,10,1022,0,0,55.136492,0.0046110000000041396,"",""
"172.16.133.93",60684,"172.16.139.250",5440,12,1142,6339,0,0,12,1142,0,0,55.152793,0.004694000000000642,"",""
"172.16.133.11",55136,"172.16.139.250",5440,10,1022,6340,0,0,10,1022,0,0,55.170053,0.0058039999999977,1408683,0
"172.16.133.163",3530,"15.193.0.234",80,138,106762,6341,0,0,54,12155,84,94607,55.171799,228.31037899999998,425,3315
"172.16.133.55",57573,"172.16.139.250",5440,10,1022,6342,0,0,10,1022,0,0,55.174601,0.005656999999999357,1445289,0
"172.16.133.132",49875,"74.217.1.83",80,16,5000,6343,0,0,9,918,7,4082,55.19512,3.150743999999996,2330,10364
"172.16.133.53",54093,"172.16.139.250",5440,10,1022,6344,0,0,10,1022,0,0,55.199542,0.017795999999997036,459429,0
"172.16.133.73",60630,"172.16.139.250",5440,10,1022,6345,0,0,10,1022,0,0,55.200262,0.005299999999998306,1542641,0
"172.16.133.21",53167,"172.16.139.250",5440,10,1022,6346,0,0,10,1022,0,0,55.202767,0.01914899999999875,426967,0
"172.16.133.30",62609,"172.16.139.250",5440,10,1022,6347,0,0,10,1022,0,0,55.206606,0.006244999999999834,1309207,0
"172.16.133.25",63432,"172.16.139.250",5440,10,1022,6348,0,0,10,1022,0,0,55.214914,0.01685499999999962,485078,0
"172.16.133.34",50433,"172.16.139.250",5440,10,1022,6349,0,0,10,1022,0,0,55.223235,0.004937999999995668,"",""
"172.16.133.97",59366,"172.16.139.250",5440,10,1022,6350,0,0,10,1022,0,0,55.233576,0.015633999999998593,522962,0
"172.16.133.50",50699,"96.43.146.50",443,17,1416,6351,0,0,9,807,8,609,55.251472,226.874656,28,21
"172.16.133.50",50700,"64.56.203.22",443,37,22209,6352,0,0,18,5707,19,16502,55.251778,11.096756999999997,4114,11896
"172.16.133.33",57875,"172.16.139.250",5440,10,1022,6353,0,0,10,1022,0,0,55.308961,0.0059360000000054924,1377358,0
"172.16.133.68",60721,"172.16.139.250",5440,10,1022,6354,0,0,10,1022,0,0,55.33921,0.00552499999999867,1479819,0
"172.16.133.12",59728,"172.16.139.250",5440,10,1022,6355,0,0,10,1022,0,0,55.354132,0.005532000000002313,1477946,0
"172.16.133.63",53873,"172.16.139.250",5440,10,1022,6356,0,0,10,1022,0,0,55.362671,0.0054750000000041155,1493333,0
"172.16.133.66",53853,"172.16.139.250",5440,10,1022,6357,0,0,10,1022,0,0,55.378856,0.0053109999999989554,1539446,0
"172.16.133.66",53854,"180.153.30.250",443,6,366,6358,0,0,4,246,2,120,55.380231,0.7322959999999981,2687,1310
"172.16.133.82",61315,"172.16.139.250",5440,10,1022,6359,0,0,10,1022,0,0,55.39063,0.005418999999996288,1508765,0
"172.16.133.37",60619,"172.16.139.250",5440,10,1022,6360,0,0,10,1022,0,0,55.405046,0.014904999999998836,548540,0
"172.16.133.46",64552,"216.115.216.250",443,6,366,6361,0,0,4,246,2,120,55.420999,0.04885399999999862,40283,19650
"172.16.133.132",53401,"64.94.107.34",80,7,1213,6362,0,0,4,714,3,499,55.433178,0.07588700000000159,75269,52604
"172.16.133.132",49877,"74.217.1.83",80,12,3613,6363,0,0,7,1074,5,2539,55.44295,2.908120999999994,2954,6984
"172.16.133.46",64553,"68.64.4.249",443,6,366,6364,0,0,4,246,2,120,55.469002,0.09730299999999659,20225,9866
"172.16.133.93",60685,"199.48.206.108",443,23,9220,6365,0,0,11,2499,12,6721,55.481609,0.8305739999999986,24070,64735
"172.16.133.93",60686,"199.48.206.108",443,22,8390,6366,0,0,11,2214,11,6176,55.481846,25.539741,693,1934
"172.16.133.132",37166,"208.71.125.135",80,9,1705,6367,0,0,6,738,3,967,55.490295,2.842143,2077,2721
"172.16.133.132",34123,"107.21.214.225",80,11,3172,6368,0,0,7,2304,4,868,55.53439,2.788699000000001,6609,2490
"172.16.133.132",34124,"107.21.214.225",80,10,1617,6369,0,0,6,749,4,868,55.552771,2.7709180000000018,2162,2506
"172.16.133.78",59201,"172.16.139.250",5440,10,1022,6370,0,0,10,1022,0,0,55.562341,0.005604999999995641,1458697,0
"172.16.133.46",64555,"216.219.116.244",443,6,366,6371,0,0,4,246,2,120,55.594008,0.2444670000000002,8050,3926
"172.16.133.67",55979,"172.16.139.250",5440,12,1142,6372,0,0,12,1142,0,0,55.615261,0.006188000000001637,1476405,0
"172.16.133.56",61422,"172.16.139.250",5440,12,1142,6373,0,0,12,1142,0,0,55.63702,0.0055260000000032505,1653275,0
"172.16.133.42",57060,"172.16.139.250",5440,12,1142,6374,0,0,12,1142,0,0,55.668529,0.0281179999999992,324916,0
"172.16.133.41",52971,"172.16.139.250",5440,12,1142,6375,0,0,12,1142,0,0,55.69492,0.016147999999994056,565766,0
"172.16.133.85",52259,"172.16.139.250",5440,10,1022,6376,0,0,10,1022,0,0,55.712117,0.016204000000001884,504566,0
"172.16.133.45",61333,"64.90.204.229",443,27,10133,6377,0,0,12,2912,15,7221,55.712667,10.303412000000002,2260,5606
"172.16.133.45",61334,"64.90.204.229",443,27,9386,6378,0,0,12,2905,15,6481,55.713346,10.303060000000002,2255,5032
"172.16.133.45",61335,"64.90.204.229",443,26,10120,6379,0,0,11,2858,15,7262,55.714886,10.300092999999997,2219,5640
"172.16.133.45",61336,"64.90.204.229",443,23,7541,6380,0,0,10,1799,13,5742,55.715512,10.297272,1397,4460
"172.16.133.45",61337,"64.90.204.229",443,34,11495,6381,0,0,14,4066,20,7429,55.722801,10.29349700000001,3160,5773
"172.16.133.50",50701,"96.43.146.22",443,54,24619,6382,0,0,32,20911,22,3708,55.72739,230.199746,726,128
"172.16.133.132",38678,"74.217.1.80",80,10,2927,6383,0,0,6,1630,4,1297,55.754345,2.5884560000000008,5037,4008
"172.16.133.50",50702,"216.137.33.57",443,21,7980,6384,0,0,10,1210,11,6770,55.75749,30.513821,317,1774
"172.16.133.50",50703,"216.137.33.57",443,21,7980,6385,0,0,10,1210,11,6770,55.757896,30.513706999999997,317,1774
"172.16.133.50",50704,"216.137.33.57",443,21,7980,6386,0,0,10,1210,11,6770,55.757897,30.513520999999997,317,1774
"172.16.133.50",50705,"64.56.203.22",443,20,7782,6387,0,0,11,3133,9,4649,55.758225,10.591514999999994,2366,3511
"172.16.133.43",57769,"172.16.139.250",5440,10,1022,6388,0,0,10,1022,0,0,55.766114,0.005583000000001448,1464445,0
"172.16.133.13",53033,"172.16.139.250",5440,10,1022,6389,0,0,10,1022,0,0,55.782189,0.014530000000000598,562697,0
"172.16.133.20",55278,"96.43.146.48",443,25,8055,6390,0,0,15,5010,10,3045,55.784865,240.35502799999998,166,101
"172.16.133.45",61338,"64.90.204.229",443,21,4859,6391,0,0,10,2895,11,1964,55.797036,10.219468999999997,2266,1537
"172.16.133.20",62387,"172.16.139.250",5440,12,1142,6392,0,0,12,1142,0,0,55.832533,0.014278000000004454,639865,0
"172.16.133.75",50950,"172.16.139.250",5440,12,1142,6393,0,0,12,1142,0,0,55.84903,0.005544999999997913,1647610,0
"172.16.133.28",65361,"172.16.139.250",5440,10,1022,6394,0,0,10,1022,0,0,55.86275,0.005419000000003393,1508765,0
"172.16.133.132",55620,"98.139.225.42",80,17,3151,6395,0,0,10,1386,7,1765,55.885265,2.455928,4514,5749
"172.16.133.99",56037,"172.16.139.250",5440,10,1022,6396,0,0,10,1022,0,0,55.888986,0.014822999999999809,551575,0
"172.16.133.87",60192,"172.16.139.250",5440,10,1022,6397,0,0,10,1022,0,0,55.912333,0.005707000000001017,1432626,0
"172.16.133.116",53321,"172.16.139.250",5440,10,1022,6398,0,0,10,1022,0,0,55.927758,0.005735000000001378,1425632,0
"172.16.133.116",53322,"172.16.139.250",5440,12,1142,6399,0,0,12,1142,0,0,55.93454,0.005774999999999864,1581991,0
"172.16.133.116",53323,"172.16.139.250",5440,10,1022,6400,0,0,10,1022,0,0,55.941232,0.00514400000000137,1589424,0
"172.16.133.84",58787,"172.16.139.250",5440,10,1022,6401,0,0,10,1022,0,0,55.948752,0.005228999999999928,1563587,0
"172.16.133.35",49965,"172.16.139.250",5440,12,1142,6402,0,0,12,1142,0,0,55.963321,0.04299999999999926,212465,0
"172.16.133.116",53324,"8.27.243.253",80,57,24583,6403,0,0,25,4772,32,19811,56.019559,26.139809,1460,6063
"172.16.133.116",53325,"8.27.243.253",80,48,18172,6404,0,0,21,4060,27,14112,56.019805,26.139981999999996,1242,4318
"172.16.133.116",53326,"8.27.243.253",80,50,18693,6405,0,0,22,4120,28,14573,56.020036,26.139203000000002,1260,4460
"172.16.133.116",53327,"8.27.243.253",80,75,33403,6406,0,0,33,6242,42,27161,56.020274,26.137596000000002,1910,8313
"172.16.133.116",53328,"8.27.243.253",80,39,14409,6407,0,0,18,2970,21,11439,56.020499,26.139820999999998,908,3500
"172.16.133.49",55760,"172.16.139.250",5440,12,1142,6408,0,0,12,1142,0,0,56.026425,0.006310999999996625,1447631,0
"172.16.133.95",56962,"172.16.139.250",5440,10,1022,6409,0,0,10,1022,0,0,56.064771,0.005501999999999896,1486005,0
"172.16.133.92",57676,"172.16.139.250",5440,10,1022,6410,0,0,10,1022,0,0,56.091443,0.015602999999998701,524001,0
"172.16.133.29",60908,"172.16.139.250",5440,10,1022,6411,0,0,10,1022,0,0,56.109839,0.005898000000001957,1386232,0
"172.16.133.44",64793,"172.16.139.250",5440,10,1022,6412,0,0,10,1022,0,0,56.117042,0.005593000000004622,1461827,0
"172.16.133.207",55928,"172.16.139.250",5440,10,1022,6413,0,0,10,1022,0,0,56.141525,0.004795999999998912,"",""
"172.16.133.83",57085,"172.16.139.250",5440,12,1142,6414,0,0,12,1142,0,0,56.150576,0.004682999999999993,"",""
"172.16.133.20",62388,"23.0.49.244",80,22,8911,6415,0,0,10,1010,12,7901,56.150822,159.914291,50,395
"172.16.133.121",56501,"96.43.148.26",443,26,8136,6416,0,0,14,2072,12,6064,56.151785,10.394803000000003,1594,4666
"172.16.133.41",52972,"216.52.121.204",80,14,5437,6417,0,0,7,3405,7,2032,56.157334,0.6639580000000009,41026,24483
"172.16.133.93",60687,"172.16.139.250",5440,10,1022,6418,0,0,10,1022,0,0,56.167241,0.004699999999999704,"",""
"172.16.133.41",52973,"216.52.121.204",80,12,3951,6419,0,0,7,3394,5,557,56.17194,0.16234099999999785,167252,27448
"172.16.133.41",52974,"216.52.121.204",80,12,3951,6420,0,0,7,3394,5,557,56.175526,0.15859600000000285,171202,28096
"172.16.133.41",52975,"216.52.121.204",80,12,3951,6421,0,0,7,3394,5,557,56.178357,0.15332500000000238,177087,29062
"157.56.241.150",443,"172.16.133.101",50802,10,775,6422,0,0,5,475,5,300,56.178772,240.08422099999999,15,9
"172.16.133.11",55137,"172.16.139.250",5440,10,1022,6423,0,0,10,1022,0,0,56.185101,0.0056409999999971205,1449388,0
"172.16.133.41",52976,"216.52.121.204",80,12,3951,6424,0,0,7,3394,5,557,56.1864,0.15080700000000036,180044,29547
"172.16.133.55",57574,"172.16.139.250",5440,10,1022,6425,0,0,10,1022,0,0,56.188445,0.0060789999999997235,1344958,0
"172.16.133.41",52977,"216.52.121.204",80,12,3951,6426,0,0,7,3394,5,557,56.192741,0.14769199999999927,183842,30170
"172.16.133.43",57770,"68.64.24.250",443,6,366,6427,0,0,4,246,2,120,56.20055,0.10580399999999912,18600,9073
"172.16.133.73",60631,"172.16.139.250",5440,12,1142,6428,0,0,12,1142,0,0,56.213357,0.006330999999995868,1443057,0
"172.16.133.53",54094,"172.16.139.250",5440,10,1022,6429,0,0,10,1022,0,0,56.213605,0.013062999999995384,625889,0
"172.16.133.93",60688,"173.194.74.95",80,6,372,6430,0,0,4,246,2,126,56.216246,11.307576999999995,174,89
"172.16.133.21",53168,"172.16.139.250",5440,10,1022,6431,0,0,10,1022,0,0,56.216395,0.006691000000003555,1221939,0
"172.16.133.93",60689,"173.194.74.95",80,6,372,6432,0,0,4,246,2,126,56.216513,11.308455000000002,174,89
"172.16.133.93",60690,"173.194.74.95",80,6,372,6433,0,0,4,246,2,126,56.216851,11.308392000000005,174,89
"172.16.133.93",60691,"190.93.240.8",80,6,372,6434,0,0,4,246,2,126,56.217154,11.293564999999994,174,89
"172.16.133.56",61423,"216.52.242.80",80,23,9818,6435,0,0,13,3908,10,5910,56.2174,206.677824,151,228
"172.16.133.93",60692,"190.93.240.8",80,7,432,6436,0,0,4,246,3,186,56.217463,11.294609000000001,174,131
"172.16.133.93",60693,"190.93.240.8",80,6,372,6437,0,0,4,246,2,126,56.21771,11.293996000000007,174,89
"172.16.133.93",60694,"23.60.241.224",80,6,372,6438,0,0,4,246,2,126,56.217994,11.312494000000008,173,89
"172.16.133.93",60695,"23.60.241.224",80,6,372,6439,0,0,4,246,2,126,56.218203,11.313574000000003,173,89
"172.16.133.93",60696,"23.60.241.224",80,6,372,6440,0,0,4,246,2,126,56.218419,11.313084000000003,173,89
"172.16.133.93",60697,"199.48.204.30",80,8,504,6441,0,0,5,312,3,192,56.218823,11.360157000000001,219,135
"172.16.133.93",60698,"199.48.204.30",80,10,624,6442,0,0,6,372,4,252,56.219032,14.355350999999999,207,140
"172.16.133.93",60699,"199.48.204.30",80,8,504,6443,0,0,5,312,3,192,56.219225,11.336295,220,135
"172.16.133.30",62611,"172.16.139.250",5440,10,1022,6444,0,0,10,1022,0,0,56.221192,0.009335000000000093,875843,0
"172.16.133.25",63433,"172.16.139.250",5440,10,1022,6445,0,0,10,1022,0,0,56.228141,0.0061019999999984975,1339888,0
"172.16.133.34",50434,"172.16.139.250",5440,10,1022,6446,0,0,10,1022,0,0,56.236403,0.004885999999999058,"",""
"172.16.133.97",59367,"172.16.139.250",5440,10,1022,6447,0,0,10,1022,0,0,56.247678,0.014631000000001393,558813,0
"172.16.133.93",60700,"174.35.22.147",80,7,432,6448,0,0,4,246,3,186,56.250505,11.26120000000001,174,132
"172.16.133.93",60701,"174.35.22.147",80,7,432,6449,0,0,4,246,3,186,56.250622,11.261366000000002,174,132
"172.16.133.93",60702,"174.35.22.147",80,7,432,6450,0,0,4,246,3,186,56.25076,11.261313999999999,174,132
"172.16.133.93",60703,"74.125.226.222",443,55,11001,6451,0,0,27,8019,28,2982,56.258147,227.691529,281,104
"172.16.133.84",49332,"172.16.139.250",5500,20,1740,6452,0,0,20,1740,0,0,56.281517,240.188961,57,0
"172.16.133.93",60704,"199.48.206.108",443,13,1416,6453,0,0,6,835,7,581,56.31938,24.702126,270,188
"172.16.133.33",57876,"172.16.139.250",5440,10,1022,6454,0,0,10,1022,0,0,56.322944,0.015467999999998483,528575,0
"172.16.133.26",49307,"172.16.139.250",5500,88,31424,6455,0,0,88,31424,0,0,56.340158,242.33106899999999,1037,0
"172.16.133.68",60722,"172.16.139.250",5440,10,1022,6456,0,0,10,1022,0,0,56.353542,0.015425000000000466,530048,0
"172.16.133.43",57771,"216.219.118.244",443,6,366,6457,0,0,4,246,2,120,56.360721,0.22294400000000536,8827,4306
"172.16.133.43",57772,"78.108.118.250",443,6,366,6458,0,0,4,246,2,120,56.362575,0.22967799999999983,8568,4179
"172.16.133.12",59729,"172.16.139.250",5440,10,1022,6459,0,0,10,1022,0,0,56.367847,0.005470000000002528,1494698,0
"172.16.133.63",53874,"172.16.139.250",5440,10,1022,6460,0,0,10,1022,0,0,56.377136,0.005501000000002421,1486275,0
"172.16.133.66",53855,"172.16.139.250",5440,10,1022,6461,0,0,10,1022,0,0,56.392086,0.015069000000003996,542570,0
"172.16.133.93",60705,"67.69.196.40",80,49,33040,6462,0,0,20,3633,29,29407,56.398339,225.28554,129,1044
"172.16.133.82",61317,"172.16.139.250",5440,10,1022,6463,0,0,10,1022,0,0,56.404402,0.006650000000000489,1229473,0
"172.16.133.37",60620,"172.16.139.250",5440,10,1022,6464,0,0,10,1022,0,0,56.418361,0.005150000000000432,1587572,0
"172.16.133.121",56502,"96.43.146.177",443,86,50726,6465,0,0,37,8330,49,42396,56.548822,42.867149,1554,7912
"172.16.133.78",59202,"172.16.139.250",5440,10,1022,6466,0,0,10,1022,0,0,56.575396,0.005834000000000117,1401439,0
"172.16.133.25",49360,"172.16.139.250",5447,14,1960,6467,0,0,14,1960,0,0,56.585716,226.12752899999998,69,0
"172.16.133.67",55980,"172.16.139.250",5440,10,1022,6468,0,0,10,1022,0,0,56.629301,0.005499000000000365,1486815,0
"172.16.133.56",61424,"172.16.139.250",5440,12,1142,6469,0,0,12,1142,0,0,56.65178,0.005292999999994663,1726053,0
"172.16.133.73",59402,"172.16.139.250",5447,10,1400,6470,0,0,10,1400,0,0,56.665128,240.000081,46,0
"172.16.133.42",57061,"172.16.139.250",5440,12,1142,6471,0,0,12,1142,0,0,56.682916,0.23025799999999919,39677,0
"172.16.133.41",52978,"172.16.139.250",5440,10,1022,6472,0,0,10,1022,0,0,56.707672,0.19431300000000107,42076,0
"172.16.133.85",52260,"172.16.139.250",5440,12,1142,6473,0,0,12,1142,0,0,56.725279,0.17902099999999876,51033,0
"172.16.133.43",57773,"172.16.139.250",5440,10,1022,6474,0,0,10,1022,0,0,56.781459,0.1209130000000016,67618,0
"172.16.133.75",50951,"68.64.28.20",443,86,12860,6475,0,0,44,5603,42,7257,56.784195,131.105842,341,442
"172.16.133.16",54501,"132.245.1.150",443,10,795,6476,0,0,5,495,5,300,56.795162,240.02214800000002,16,9
"172.16.133.13",53034,"172.16.139.250",5440,12,1142,6477,0,0,12,1142,0,0,56.796468,0.10764400000000052,84872,0
"172.16.133.26",59924,"132.245.1.150",443,14,1189,6478,0,0,7,769,7,420,56.797126,214.548254,28,15
"172.16.133.50",50706,"204.232.250.57",443,16,4433,6479,0,0,9,3453,7,980,56.803697,9.479135,2914,827
"172.16.133.43",57774,"216.115.219.126",443,6,366,6480,0,0,4,246,2,120,56.807693,0.4906160000000028,4011,1956
"172.16.133.41",52979,"216.52.121.204",80,14,5228,6481,0,0,7,3405,7,1823,56.807898,4.155577000000001,6555,3509
"172.16.133.41",52980,"216.52.121.204",80,12,3951,6482,0,0,7,3394,5,557,56.829177,0.13665999999999912,198682,32606
"172.16.133.41",52981,"216.52.121.204",80,12,3951,6483,0,0,7,3394,5,557,56.832057,0.13052700000000073,208018,34138
"172.16.133.41",52982,"216.52.121.204",80,12,3951,6484,0,0,7,3394,5,557,56.836725,0.12607500000000016,215363,35344
"172.16.133.41",52983,"216.52.121.204",80,12,3951,6485,0,0,7,3394,5,557,56.842205,0.13539300000000054,200542,32911
"172.16.133.41",52984,"216.52.121.204",80,12,3951,6486,0,0,7,3394,5,557,56.846077,0.13749999999999574,197469,32407
"172.16.133.20",62389,"172.16.139.250",5440,10,1022,6487,0,0,10,1022,0,0,56.846467,0.05653000000000219,144631,0
"172.16.133.29",54366,"172.16.139.250",5447,10,1390,6488,0,0,10,1390,0,0,56.85349,240.03019200000003,46,0
"172.16.133.75",50952,"172.16.139.250",5440,10,1022,6489,0,0,10,1022,0,0,56.862749,0.03979799999999756,205437,0
"172.16.133.28",65363,"172.16.139.250",5440,12,1142,6490,0,0,12,1142,0,0,56.877469,0.02507600000000565,364332,0
"172.16.133.99",56038,"172.16.139.250",5440,10,1022,6491,0,0,10,1022,0,0,56.903362,0.005058999999995706,1616129,0
"172.16.133.87",60193,"172.16.139.250",5440,12,1142,6492,0,0,12,1142,0,0,56.925814,0.00633699999999493,1441691,0
"172.16.133.35",49966,"172.16.139.250",5440,12,1142,6493,0,0,12,1142,0,0,56.93773,0.009540000000001214,957651,0
"172.16.133.116",53329,"172.16.139.250",5440,10,1022,6494,0,0,10,1022,0,0,56.942798,0.007283999999998514,1122460,0
"172.16.133.113",55612,"63.147.189.115",80,15,6286,6495,0,0,7,1352,8,4934,56.94387,0.3914439999999999,27631,100836
"172.16.133.40",51224,"96.43.146.48",443,27,8135,6496,0,0,15,5010,12,3125,56.944786,240.49989200000002,166,103
"172.16.133.113",55611,"63.147.189.115",80,17,6418,6497,0,0,8,1418,9,5000,56.945382,25.272153999999993,448,1582
"172.16.133.163",3531,"66.235.139.153",80,16,8751,6498,0,0,10,6997,6,1754,56.946052,18.174165999999992,3079,772
"172.16.133.116",53330,"172.16.139.250",5440,10,1022,6499,0,0,10,1022,0,0,56.950914,0.015568000000001803,525179,0
"172.16.133.84",58788,"172.16.139.250",5440,10,1022,6500,0,0,10,1022,0,0,56.96362,0.01492900000000219,547658,0
"172.16.133.116",53331,"172.16.139.250",5440,10,1022,6501,0,0,10,1022,0,0,56.967094,0.007369999999994548,1109362,0
"172.16.133.85",52265,"68.64.4.249",443,6,366,6502,0,0,4,246,2,120,56.972406,0.11738799999999827,16764,8178
"172.16.133.49",55761,"172.16.139.250",5440,10,1022,6503,0,0,10,1022,0,0,57.04068,0.015403999999996643,530771,0
"172.16.133.85",52266,"68.64.26.250",443,6,366,6504,0,0,4,246,2,120,57.052561,0.1595790000000008,12332,6015
"172.16.133.95",56963,"172.16.139.250",5440,12,1142,6505,0,0,12,1142,0,0,57.078666,0.015339000000004432,595605,0
"157.56.240.102",443,"172.16.133.87",65528,239,70038,6506,0,0,155,64992,84,5046,57.104831,240.187073,2164,168
"172.16.133.92",57677,"172.16.139.250",5440,10,1022,6507,0,0,10,1022,0,0,57.106797,0.006194000000000699,1319987,0
"172.16.133.29",60909,"172.16.139.250",5440,10,1022,6508,0,0,10,1022,0,0,57.12371,0.005525999999996145,1479551,0
"172.16.133.44",64794,"172.16.139.250",5440,10,1022,6509,0,0,10,1022,0,0,57.129881,0.005380999999999858,1519420,0
"172.16.133.87",60194,"96.43.146.22",443,17,1417,6510,0,0,9,808,8,609,57.136402,225.48992,28,21
"172.16.133.87",60195,"96.43.146.22",443,17,1417,6511,0,0,9,808,8,609,57.136595,225.48141299999997,28,21
"172.16.133.87",60196,"96.43.146.22",443,17,1417,6512,0,0,9,808,8,609,57.136741,225.494878,28,21
"172.16.133.87",60197,"96.43.146.22",443,17,1417,6513,0,0,9,808,8,609,57.136897,225.49040399999998,28,21
"172.16.133.207",55929,"172.16.139.250",5440,12,1142,6514,0,0,12,1142,0,0,57.155541,0.0177320000000023,515226,0
"172.16.133.46",64556,"192.147.107.13",80,9,1055,6515,0,0,5,724,4,331,57.161303,0.09331600000000151,62068,28376
"172.16.133.83",57086,"172.16.139.250",5440,12,1142,6516,0,0,12,1142,0,0,57.164535,0.004733999999999128,"",""
"172.16.133.93",60706,"172.16.139.250",5440,10,1022,6517,0,0,10,1022,0,0,57.181674,0.004851000000002159,"",""
"172.16.133.11",55138,"172.16.139.250",5440,10,1022,6518,0,0,10,1022,0,0,57.198815,0.005319000000000074,1537131,0
"172.16.133.55",57575,"172.16.139.250",5440,10,1022,6519,0,0,10,1022,0,0,57.202387,0.015536999999994805,526227,0
"172.16.133.55",57576,"172.16.128.169",8014,16,5642,6520,0,0,8,2762,8,2880,57.203259,37.58405499999999,587,613
"172.16.133.73",60632,"172.16.139.250",5440,10,1022,6521,0,0,10,1022,0,0,57.225485,0.02024099999999862,403932,0
"172.16.133.53",54095,"172.16.139.250",5440,10,1022,6522,0,0,10,1022,0,0,57.227615,0.005965000000003329,1370662,0
"172.16.133.88",51555,"172.16.139.250",5447,10,1390,6523,0,0,10,1390,0,0,57.229299,239.983392,46,0
"172.16.133.46",64557,"192.147.107.13",80,9,1072,6524,0,0,5,563,4,509,57.229948,0.08287500000000136,54346,49134
"172.16.133.21",53169,"172.16.139.250",5440,12,1142,6525,0,0,12,1142,0,0,57.230814,0.007550999999999419,1209905,0
"172.16.133.30",62612,"172.16.139.250",5440,10,1022,6526,0,0,10,1022,0,0,57.232779,0.009634999999995841,848572,0
"172.16.133.25",63434,"172.16.139.250",5440,10,1022,6527,0,0,10,1022,0,0,57.242301,0.015320000000002665,533681,0
"172.16.133.34",50435,"172.16.139.250",5440,10,1022,6528,0,0,10,1022,0,0,57.250221,0.01452199999999948,563007,0
"172.16.133.97",59368,"172.16.139.250",5440,10,1022,6529,0,0,10,1022,0,0,57.261628,0.006912999999997282,1182699,0
"172.16.133.46",64558,"192.147.107.13",80,10,949,6530,0,0,5,563,5,386,57.289432,0.996573000000005,4519,3098
"157.56.232.214",443,"172.16.133.63",60816,10,775,6531,0,0,5,475,5,300,57.332196,240.943623,15,9
"172.16.133.33",57877,"172.16.139.250",5440,12,1142,6532,0,0,12,1142,0,0,57.336852,0.0063600000000008095,1436477,0
"172.16.133.68",60724,"172.16.139.250",5440,10,1022,6533,0,0,10,1022,0,0,57.367609,0.005525999999996145,1479551,0
"172.16.133.12",59730,"172.16.139.250",5440,10,1022,6534,0,0,10,1022,0,0,57.381761,0.005588000000003035,1463135,0
"172.16.133.63",53875,"172.16.139.250",5440,10,1022,6535,0,0,10,1022,0,0,57.390538,0.014519999999997424,563085,0
"172.16.133.66",53856,"172.16.139.250",5440,10,1022,6536,0,0,10,1022,0,0,57.405871,0.0054230000000004,1507652,0
"172.16.133.82",61319,"172.16.139.250",5440,10,1022,6537,0,0,10,1022,0,0,57.418669,0.0056179999999983465,1455322,0
"172.16.133.37",60621,"172.16.139.250",5440,10,1022,6538,0,0,10,1022,0,0,57.432248,0.01575499999999863,518946,0
"172.16.133.46",64559,"216.115.216.250",443,6,366,6539,0,0,4,246,2,120,57.444099,0.03882199999999614,50692,24728
"132.245.1.150",443,"172.16.133.93",49424,12,1014,6540,0,0,6,654,6,360,57.516681,239.89952799999998,21,12
"172.16.133.46",64560,"68.64.4.249",443,6,366,6541,0,0,4,246,2,120,57.52306,0.08926499999999749,22046,10754
"172.16.133.87",65518,"96.43.146.48",443,29,8750,6542,0,0,16,5076,13,3674,57.564542,241.528709,168,121
"172.16.133.78",59203,"172.16.139.250",5440,10,1022,6543,0,0,10,1022,0,0,57.589452,0.01570499999999697,520598,0
"172.16.133.128",55297,"172.16.139.250",5447,10,1400,6544,0,0,10,1400,0,0,57.589655,239.98337700000002,46,0
"172.16.133.67",55981,"172.16.139.250",5440,10,1022,6545,0,0,10,1022,0,0,57.643125,0.0058580000000034715,1395698,0
"172.16.133.56",61425,"172.16.139.250",5440,10,1022,6546,0,0,10,1022,0,0,57.666033,0.014772000000000673,553479,0
"172.16.133.42",57062,"172.16.139.250",5440,12,1142,6547,0,0,12,1142,0,0,57.69823,0.019570999999999117,466813,0
"172.16.133.46",64562,"216.219.116.244",443,6,366,6548,0,0,4,246,2,120,57.717053,0.2635190000000023,7468,3643
"172.16.133.66",53857,"180.153.30.250",443,6,366,6549,0,0,4,246,2,120,57.717573,0.6853520000000017,2871,1400
"172.16.133.41",52985,"172.16.139.250",5440,10,1022,6550,0,0,10,1022,0,0,57.721798,0.005568000000003792,1468390,0
"172.16.133.85",52269,"172.16.139.250",5440,10,1022,6551,0,0,10,1022,0,0,57.739041,0.015493999999996788,527688,0
"172.16.133.55",50199,"157.56.232.214",443,10,775,6552,0,0,5,475,5,300,57.745738,240.021767,15,9
"172.16.133.43",57775,"172.16.139.250",5440,12,1142,6553,0,0,12,1142,0,0,57.794078,0.006160999999998751,1482876,0
"172.16.133.13",53035,"172.16.139.250",5440,10,1022,6554,0,0,10,1022,0,0,57.810613000000004,0.005405999999993583,1512393,0
"172.16.133.20",62390,"172.16.139.250",5440,12,1142,6555,0,0,12,1142,0,0,57.860479,0.004982000000005371,"",""
"172.16.133.75",50953,"172.16.139.250",5440,10,1022,6556,0,0,10,1022,0,0,57.877055,0.005380000000002383,1519702,0
"172.16.133.28",65364,"172.16.139.250",5440,12,1142,6557,0,0,12,1142,0,0,57.891309,0.005394000000002563,1693733,0
"172.16.133.99",56039,"172.16.139.250",5440,10,1022,6558,0,0,10,1022,0,0,57.918322,0.01475099999999685,554267,0
"172.16.133.87",60198,"172.16.139.250",5440,10,1022,6559,0,0,10,1022,0,0,57.939321,0.0052880000000001814,1546142,0
"172.16.133.116",53332,"208.111.160.6",80,47,42667,6560,0,0,14,3565,33,39102,57.945852,64.213939,444,4871
"172.16.133.35",49967,"172.16.139.250",5440,12,1142,6561,0,0,12,1142,0,0,57.954114,0.030627000000002624,298298,0
"172.16.133.116",53333,"172.16.139.250",5440,10,1022,6562,0,0,10,1022,0,0,57.956911,0.00612000000000279,1335947,0
"172.16.133.116",53334,"172.16.139.250",5440,10,1022,6563,0,0,10,1022,0,0,57.96355,0.005923000000002787,1380381,0
"172.16.133.116",53335,"172.16.139.250",5440,10,1022,6564,0,0,10,1022,0,0,57.970022,0.006236999999998716,1310886,0
"172.16.133.84",58789,"172.16.139.250",5440,10,1022,6565,0,0,10,1022,0,0,57.977369,0.005568999999994162,1468127,0
"172.16.133.82",61320,"216.219.116.244",443,6,366,6566,0,0,4,246,2,120,57.985644,0.23081899999999678,8526,4159
"172.16.133.82",61321,"68.64.4.249",443,6,366,6567,0,0,4,246,2,120,57.985699,0.08849000000000018,22239,10848
"172.16.133.82",61322,"68.64.26.250",443,6,366,6568,0,0,4,246,2,120,57.986805,0.08825900000000075,22298,10877
"172.16.133.82",61323,"216.115.216.250",443,6,366,6569,0,0,4,246,2,120,57.993207,0.04971700000000112,39584,19309
"172.16.133.101",50801,"157.56.241.150",443,10,775,6570,0,0,5,475,5,300,58.020833,240.03764799999996,15,9
"172.16.133.24",55880,"157.56.242.198",443,10,795,6571,0,0,5,495,5,300,58.031623,240.025861,16,9
"172.16.133.49",55762,"172.16.139.250",5440,10,1022,6572,0,0,10,1022,0,0,58.054508,0.006062000000000012,1348729,0
"65.54.61.211",443,"172.16.133.39",63621,11,2626,6573,0,0,5,1356,6,1270,58.058381,239.15162199999997,45,42
"172.16.133.95",56964,"172.16.139.250",5440,10,1022,6574,0,0,10,1022,0,0,58.093002,0.005347000000000435,1529081,0
"172.16.133.92",57678,"172.16.139.250",5440,10,1022,6575,0,0,10,1022,0,0,58.120555,0.005511999999995965,1483309,0
"172.16.133.29",60910,"172.16.139.250",5440,12,1142,6576,0,0,12,1142,0,0,58.13745,0.006116999999996153,1493542,0
"172.16.133.44",64795,"172.16.139.250",5440,10,1022,6577,0,0,10,1022,0,0,58.144947,0.00539999999999452,1514074,0
"172.16.133.132",42243,"63.241.108.124",80,8,1646,6578,0,0,5,857,3,789,58.161803,0.10916399999999982,62804,57821
"172.16.133.207",55930,"172.16.139.250",5440,12,1142,6579,0,0,12,1142,0,0,58.17067,0.015619000000000938,584928,0
"172.16.133.83",57087,"172.16.139.250",5440,12,1142,6580,0,0,12,1142,0,0,58.177583,0.004719999999998947,"",""
"172.16.133.46",64563,"192.147.107.13",80,9,926,6581,0,0,5,595,4,331,58.188211,0.09878499999999946,48185,26805
"172.16.133.93",60707,"172.16.139.250",5440,12,1142,6582,0,0,12,1142,0,0,58.195567,0.004962000000006128,"",""
"172.16.133.11",55139,"172.16.139.250",5440,10,1022,6583,0,0,10,1022,0,0,58.211203,0.006133000000005495,1333115,0
"172.16.133.55",57577,"172.16.139.250",5440,10,1022,6584,0,0,10,1022,0,0,58.217508,0.005607999999995172,1457917,0
"172.16.133.128",65026,"216.52.242.80",80,37,19105,6585,0,0,20,9213,17,9892,58.23522,237.29844599999998,310,333
"172.16.133.116",53336,"138.108.7.20",80,11,3074,6586,0,0,6,1944,5,1130,58.239283,22.413482000000002,693,403
"172.16.133.73",60633,"172.16.139.250",5440,10,1022,6587,0,0,10,1022,0,0,58.239914,0.005332000000002779,1533383,0
"172.16.133.53",54096,"172.16.139.250",5440,10,1022,6588,0,0,10,1022,0,0,58.241413,0.007609999999999673,1074375,0
"157.56.240.102",443,"172.16.133.87",65531,10,775,6589,0,0,5,475,5,300,58.244165,241.08390199999997,15,9
"172.16.133.21",53170,"172.16.139.250",5440,10,1022,6590,0,0,10,1022,0,0,58.244561,0.008324000000001774,982220,0
"172.16.133.116",53337,"64.94.107.62",80,8,1680,6591,0,0,5,1217,3,463,58.246682,0.06505599999999845,149655,56935
"172.16.133.30",62613,"172.16.139.250",5440,10,1022,6592,0,0,10,1022,0,0,58.247804,0.01794599999999491,455588,0
"172.16.133.25",63435,"172.16.139.250",5440,12,1142,6593,0,0,12,1142,0,0,58.257163,0.004964999999998554,"",""
"172.16.133.46",64564,"192.147.107.13",80,9,1456,6594,0,0,5,563,4,893,58.258097,0.08937099999999987,50396,79936
"172.16.133.128",65027,"208.111.161.254",80,8,492,6595,0,0,4,246,4,246,58.26069,17.423693,112,112
"172.16.133.128",65028,"208.111.161.254",80,8,492,6596,0,0,4,246,4,246,58.260818,17.423503999999994,112,112
"172.16.133.128",65029,"208.111.161.254",80,8,492,6597,0,0,4,246,4,246,58.260912,17.424332,112,112
"172.16.133.128",65030,"208.111.161.254",80,8,492,6598,0,0,4,246,4,246,58.261008,17.423375999999998,112,112
"172.16.133.128",65031,"208.111.161.254",80,8,492,6599,0,0,4,246,4,246,58.261118,17.425704000000003,112,112
"172.16.133.128",65032,"208.111.161.254",80,22,14483,6600,0,0,8,2146,14,12337,58.261216,37.424735000000005,458,2637
"172.16.133.34",50436,"172.16.139.250",5440,10,1022,6601,0,0,10,1022,0,0,58.264288,0.006087999999998317,1342969,0
"172.16.133.43",57776,"68.64.24.250",443,6,366,6602,0,0,4,246,2,120,58.2657,0.08433899999999994,23334,11382
"172.16.133.97",59369,"172.16.139.250",5440,10,1022,6603,0,0,10,1022,0,0,58.275781,0.0053849999999968645,1518291,0
"172.16.133.128",65033,"23.45.65.41",80,6,372,6604,0,0,4,246,2,126,58.279137,17.428024999999998,112,57
"172.16.133.128",65034,"8.27.243.253",80,9,1389,6605,0,0,5,306,4,1083,58.284794,17.396175000000007,140,498
"172.16.133.128",65035,"23.0.49.244",80,7,432,6606,0,0,4,246,3,186,58.292545,17.39675400000001,113,85
"172.16.133.128",65036,"23.0.49.244",80,6,372,6607,0,0,4,246,2,126,58.292663,17.390852000000002,113,57
"172.16.133.46",64565,"192.147.107.13",80,5,569,6608,0,0,3,443,2,126,58.322574,0.19851899999999745,17852,5077
"172.16.133.33",57878,"172.16.139.250",5440,12,1142,6609,0,0,12,1142,0,0,58.35179,0.006378999999995472,1432199,0
"172.16.133.68",60725,"172.16.139.250",5440,12,1142,6610,0,0,12,1142,0,0,58.38133,0.006260000000004595,1459424,0
"172.16.133.12",59731,"172.16.139.250",5440,12,1142,6611,0,0,12,1142,0,0,58.394653,0.006388999999998646,1429957,0
"172.16.133.113",55613,"172.16.139.250",135,8,492,6612,0,0,8,492,0,0,58.403683,0.010004999999999598,393403,0
"172.16.133.63",53876,"172.16.139.250",5440,10,1022,6613,0,0,10,1022,0,0,58.404718,0.015363999999998157,532153,0
"172.16.133.113",55614,"172.16.139.250",5462,10,696,6614,0,0,10,696,0,0,58.414158,0.5056849999999997,11010,0
"172.16.133.66",53858,"172.16.139.250",5440,10,1022,6615,0,0,10,1022,0,0,58.420926,0.005505999999996902,1484925,0
"172.16.133.82",61324,"172.16.139.250",5440,10,1022,6616,0,0,10,1022,0,0,58.432633,0.005598999999996579,1460260,0
"172.16.133.37",60622,"172.16.139.250",5440,10,1022,6617,0,0,10,1022,0,0,58.446381,0.005724999999998204,1428122,0
"172.16.133.43",57777,"216.219.118.244",443,6,366,6618,0,0,4,246,2,120,58.477745,0.2142029999999977,9187,4481
"172.16.133.43",57778,"78.108.118.250",443,6,366,6619,0,0,4,246,2,120,58.479612,0.1989059999999938,9894,4826
"172.16.133.78",59204,"172.16.139.250",5440,10,1022,6620,0,0,10,1022,0,0,58.602927,0.014615999999996632,559386,0
"172.16.133.67",55982,"172.16.139.250",5440,10,1022,6621,0,0,10,1022,0,0,58.658701,0.006693999999995981,1221392,0
"172.16.133.56",61426,"172.16.139.250",5440,10,1022,6622,0,0,10,1022,0,0,58.679173,0.004618000000000677,"",""
"172.16.133.42",57063,"172.16.139.250",5440,12,1142,6623,0,0,12,1142,0,0,58.722581,0.0485219999999984,188285,0
"172.16.133.93",60708,"173.194.74.95",443,15,3607,6624,0,0,8,962,7,2645,58.734395,2.214531000000001,3475,9555
"172.16.133.93",60709,"199.48.206.78",443,18,1534,6625,0,0,9,819,9,715,58.734728,225.885529,29,25
"172.16.133.93",60710,"199.48.206.78",443,17,1468,6626,0,0,9,819,8,649,58.734975,225.716866,29,23
"172.16.133.93",60711,"199.48.206.210",443,18,1748,6627,0,0,9,1038,9,710,58.735361,225.885827,36,25
"172.16.133.41",52986,"172.16.139.250",5440,12,1142,6628,0,0,12,1142,0,0,58.737822,0.0063120000000012055,1447401,0
"172.16.133.85",52270,"172.16.139.250",5440,10,1022,6629,0,0,10,1022,0,0,58.753164,0.005431999999998993,1505154,0
"172.16.133.43",57779,"172.16.139.250",5440,12,1142,6630,0,0,12,1142,0,0,58.808081,0.014656000000002223,623362,0
"132.245.1.150",443,"172.16.133.16",54502,10,795,6631,0,0,5,495,5,300,58.809442,239.499936,16,10
"172.16.133.13",53036,"172.16.139.250",5440,12,1142,6632,0,0,12,1142,0,0,58.824681,0.006261999999999546,1458958,0
"172.16.133.20",62391,"172.16.139.250",5440,10,1022,6633,0,0,10,1022,0,0,58.873521,0.004789000000002375,"",""
"172.16.133.75",50954,"172.16.139.250",5440,10,1022,6634,0,0,10,1022,0,0,58.89147,0.005074000000000467,1611351,0
"172.16.133.28",65365,"172.16.139.250",5440,10,1022,6635,0,0,10,1022,0,0,58.905401,0.005349999999999966,1528224,0
"172.16.133.99",56040,"172.16.139.250",5440,12,1142,6636,0,0,12,1142,0,0,58.93125,0.014771000000003198,618509,0
"172.16.133.83",51530,"172.16.139.250",5447,10,1400,6637,0,0,10,1400,0,0,58.932993,188.982759,59,0
"172.16.133.87",60199,"172.16.139.250",5440,12,1142,6638,0,0,12,1142,0,0,58.953299,0.016263999999999612,561731,0
"172.16.133.116",53338,"172.16.139.250",5440,10,1022,6639,0,0,10,1022,0,0,58.969279,0.004829999999998336,"",""
"172.16.133.116",53339,"172.16.139.250",5440,10,1022,6640,0,0,10,1022,0,0,58.975096,0.006217999999996948,1314892,0
"172.16.133.116",53340,"172.16.139.250",5440,10,1022,6641,0,0,10,1022,0,0,58.982216,0.005057000000000755,1616768,0
"172.16.133.84",58790,"172.16.139.250",5440,10,1022,6642,0,0,10,1022,0,0,58.991139,0.014391000000003373,568132,0
"172.16.133.35",49968,"172.16.139.250",5440,12,1142,6643,0,0,12,1142,0,0,58.993294,0.05024500000000387,181829,0
"172.16.133.132",57600,"173.194.43.59",80,6,412,6644,0,0,4,272,2,140,59.005484,0.033442999999998335,65065,33489
"172.16.133.132",53303,"54.243.154.81",80,6,412,6645,0,0,4,272,2,140,59.046181,0.04979600000000062,43698,22491
"172.16.133.43",57780,"216.115.219.126",443,6,366,6646,0,0,4,246,2,120,59.056701,0.5453690000000009,3608,1760
"172.16.133.49",55763,"172.16.139.250",5440,10,1022,6647,0,0,10,1022,0,0,59.068384,0.014862000000000819,550127,0
"172.16.133.95",56965,"172.16.139.250",5440,10,1022,6648,0,0,10,1022,0,0,59.106772,0.005343000000003428,1530226,0
"172.16.133.92",57679,"172.16.139.250",5440,10,1022,6649,0,0,10,1022,0,0,59.134256,0.005721999999998673,1428871,0
"172.16.133.63",49583,"96.43.146.48",443,27,8135,6650,0,0,15,5010,12,3125,59.138149,240.35172899999998,166,104
"172.16.133.29",60911,"172.16.139.250",5440,12,1142,6651,0,0,12,1142,0,0,59.151568,0.006251000000006002,1461526,0
"172.16.133.44",64796,"172.16.139.250",5440,10,1022,6652,0,0,10,1022,0,0,59.158993,0.0051339999999981956,1592520,0
"172.16.133.63",49363,"157.56.232.214",443,10,775,6653,0,0,5,475,5,300,59.161899,240.019998,15,9
"172.16.133.207",55931,"172.16.139.250",5440,10,1022,6654,0,0,10,1022,0,0,59.183721,0.004761000000002014,"",""
"172.16.133.83",57088,"172.16.139.250",5440,12,1142,6655,0,0,12,1142,0,0,59.191621,0.00482900000000086,"",""
"172.16.133.93",60712,"172.16.139.250",5440,12,1142,6656,0,0,12,1142,0,0,59.209276,0.014696999999998184,621623,0
"172.16.133.11",55140,"172.16.139.250",5440,10,1022,6657,0,0,10,1022,0,0,59.225319,0.0056200000000004025,1454804,0
"172.16.133.55",57578,"172.16.139.250",5440,10,1022,6658,0,0,10,1022,0,0,59.231537,0.015645999999996718,522561,0
"172.16.133.73",60634,"172.16.139.250",5440,10,1022,6659,0,0,10,1022,0,0,59.255117,0.005765000000003795,1418213,0
"172.16.133.53",54097,"172.16.139.250",5440,10,1022,6660,0,0,10,1022,0,0,59.255564,0.01727600000000251,473257,0
"172.16.133.21",53171,"172.16.139.250",5440,10,1022,6661,0,0,10,1022,0,0,59.258542,0.006222999999998535,1313835,0
"172.16.133.30",62614,"172.16.139.250",5440,10,1022,6662,0,0,10,1022,0,0,59.262071,0.006550000000004275,1248244,0
"172.16.133.25",63436,"172.16.139.250",5440,12,1142,6663,0,0,12,1142,0,0,59.27003,0.0063829999999995835,1431301,0
"172.16.133.34",50437,"172.16.139.250",5440,12,1142,6664,0,0,12,1142,0,0,59.279291,0.005000000000002558,1827199,0
"172.16.133.78",59205,"172.16.128.169",8014,9,1412,6665,0,0,6,1050,3,362,59.283818,15.218955000000008,551,190
"172.16.133.97",59370,"172.16.139.250",5440,10,1022,6666,0,0,10,1022,0,0,59.289974,0.005451000000000761,1499908,0
"172.16.133.34",61349,"96.43.146.176",443,25,8055,6667,0,0,15,5010,10,3045,59.325663,240.34192400000003,166,101
"172.16.133.33",57879,"172.16.139.250",5440,10,1022,6668,0,0,10,1022,0,0,59.365121,0.005567999999996687,1468390,0
"172.16.133.67",64697,"96.43.146.48",443,25,8055,6669,0,0,15,5010,10,3045,59.390128,240.418837,166,101
"172.16.133.68",60726,"172.16.139.250",5440,10,1022,6670,0,0,10,1022,0,0,59.395464,0.005780000000001451,1414532,0
"172.16.133.12",59732,"172.16.139.250",5440,10,1022,6671,0,0,10,1022,0,0,59.408719,0.005469000000005053,1494971,0
"172.16.133.63",53877,"172.16.139.250",5440,10,1022,6672,0,0,10,1022,0,0,59.419727,0.005248000000001696,1557926,0
"172.16.133.66",53859,"172.16.139.250",5440,12,1142,6673,0,0,12,1142,0,0,59.434151,0.0055499999999995,1646126,0
"172.16.133.82",61325,"172.16.139.250",5440,10,1022,6674,0,0,10,1022,0,0,59.446498,0.005455000000004873,1498808,0
"172.16.133.37",60623,"172.16.139.250",5440,10,1022,6675,0,0,10,1022,0,0,59.460332,0.014696999999998184,556304,0
"172.16.133.46",64566,"216.115.216.250",443,6,366,6676,0,0,4,246,2,120,59.463205,0.05063599999999724,38865,18958
"172.16.133.120",53438,"96.43.146.22",443,20,4133,6677,0,0,11,1193,9,2940,59.555279,225.48816900000003,42,104
"172.16.133.120",53439,"96.43.146.22",443,19,4073,6678,0,0,11,1193,8,2880,59.555535,225.325303,42,102
"172.16.133.120",53440,"96.43.146.22",443,17,1417,6679,0,0,9,808,8,609,59.559595,225.485118,28,21
"172.16.133.46",64567,"68.64.4.249",443,6,366,6680,0,0,4,246,2,120,59.562176,0.10517499999999558,18711,9127
"172.16.133.30",49589,"96.43.146.48",443,25,8055,6681,0,0,15,5010,10,3045,59.572739,240.367347,166,101
"172.16.133.78",59206,"172.16.139.250",5440,12,1142,6682,0,0,12,1142,0,0,59.617325,0.006298000000001025,1450619,0
"172.16.133.67",55983,"172.16.139.250",5440,10,1022,6683,0,0,10,1022,0,0,59.671281,0.014933999999996672,547475,0
"172.16.133.56",61427,"172.16.139.250",5440,12,1142,6684,0,0,12,1142,0,0,59.6937,0.014535000000002185,628551,0
"172.16.128.233",55230,"172.16.133.233",22,187,28868,6685,0,0,54,4420,133,24448,59.713887,7.912087,4469,24719
"172.16.133.42",57064,"172.16.139.250",5440,12,1142,6686,0,0,12,1142,0,0,59.725748,0.013538999999994417,674791,0
"172.16.133.41",52987,"172.16.139.250",5440,10,1022,6687,0,0,10,1022,0,0,59.750787,0.005364999999997622,1523951,0
"172.16.133.85",52271,"172.16.139.250",5440,10,1022,6688,0,0,10,1022,0,0,59.767168,0.015374999999998806,531772,0
"172.16.133.120",53441,"96.43.146.176",443,23,6197,6689,0,0,12,1249,11,4948,59.801527,225.446385,44,175
"172.16.133.120",53442,"96.43.146.176",443,954,796281,6690,0,0,397,186264,557,610017,59.801844,228.37995,6524,21368
"172.16.133.120",53443,"96.43.146.176",443,23,6197,6691,0,0,12,1249,11,4948,59.802266,225.44071899999997,44,175
"172.16.133.120",53444,"96.43.146.176",443,23,6197,6692,0,0,12,1249,11,4948,59.802268,225.44441300000003,44,175
"172.16.133.43",57781,"172.16.139.250",5440,12,1142,6693,0,0,12,1142,0,0,59.822091,0.015389999999996462,593632,0
"172.16.133.13",53037,"172.16.139.250",5440,10,1022,6694,0,0,10,1022,0,0,59.838719,0.00543500000000563,1504323,0
"172.16.133.46",64569,"216.219.116.244",443,6,366,6695,0,0,4,246,2,120,59.853139,0.22683400000000375,8675,4232
"172.16.133.20",62392,"172.16.139.250",5440,10,1022,6696,0,0,10,1022,0,0,59.88777,0.004603999999993391,"",""
"172.16.133.75",50955,"172.16.139.250",5440,10,1022,6697,0,0,10,1022,0,0,59.905101,0.0054680000000004725,1495245,0
"172.16.133.28",65366,"172.16.139.250",5440,10,1022,6698,0,0,10,1022,0,0,59.919096,0.0054609999999968295,1497161,0
"172.16.133.28",65367,"68.64.25.250",443,6,366,6699,0,0,4,246,2,120,59.931181,0.11452999999999491,17183,8382
"172.16.133.28",65368,"68.64.5.249",443,6,366,6700,0,0,4,246,2,120,59.931389,0.09822999999999382,20034,9772
"172.16.133.28",65369,"78.108.119.250",443,6,366,6701,0,0,4,246,2,120,59.932267,0.24152899999999988,8148,3974
"172.16.133.28",65370,"216.115.209.254",443,6,366,6702,0,0,4,246,2,120,59.932717,0.22039800000000298,8929,4355
"172.16.133.99",56041,"172.16.139.250",5440,12,1142,6703,0,0,12,1142,0,0,59.945704,0.014327000000001533,637677,0
"172.16.133.87",60200,"172.16.139.250",5440,12,1142,6704,0,0,12,1142,0,0,59.968871,0.0061249999999972715,1491591,0
"172.16.133.116",53341,"172.16.139.250",5440,10,1022,6705,0,0,10,1022,0,0,59.983335,0.0061920000000057485,1320413,0
"172.16.133.116",53342,"172.16.139.250",5440,10,1022,6706,0,0,10,1022,0,0,59.990064,0.006475000000001785,1262702,0
"172.16.133.116",53343,"172.16.139.250",5440,10,1022,6707,0,0,10,1022,0,0,59.997034,0.004503999999997177,"",""
"172.16.133.35",49970,"172.16.139.250",5440,12,1142,6708,0,0,12,1142,0,0,60.002238,0.014912000000002479,612660,0
"172.16.133.84",58791,"172.16.139.250",5440,10,1022,6709,0,0,10,1022,0,0,60.005468,0.008735999999998967,935897,0
"172.16.133.82",61326,"216.115.216.250",443,6,366,6710,0,0,4,246,2,120,60.020002,0.053201000000001386,36991,18044
"172.16.133.82",61327,"68.64.4.249",443,6,366,6711,0,0,4,246,2,120,60.035976,0.09085400000000021,21661,10566
"172.16.133.82",61328,"68.64.26.250",443,6,366,6712,0,0,4,246,2,120,60.036886,0.08694899999999706,22633,11040
"172.16.133.66",53860,"180.153.30.250",443,6,366,6713,0,0,4,246,2,120,60.065649,0.6750649999999965,2915,1422
"172.16.133.49",55764,"172.16.139.250",5440,12,1142,6714,0,0,12,1142,0,0,60.082721,0.01622000000000412,563255,0
"172.16.133.82",61329,"216.219.116.244",443,6,366,6715,0,0,4,246,2,120,60.103204,0.21716800000000092,9062,4420
"172.16.133.95",56966,"172.16.139.250",5440,12,1142,6716,0,0,12,1142,0,0,60.120816,0.005388000000003501,1695619,0
"172.16.133.92",57680,"172.16.139.250",5440,10,1022,6717,0,0,10,1022,0,0,60.148728,0.00553899999999885,1476078,0
"172.16.133.29",60912,"172.16.139.250",5440,10,1022,6718,0,0,10,1022,0,0,60.165836,0.005504000000001952,1485465,0
"172.16.128.169",8014,"172.16.133.35",49518,5,446,6719,0,0,3,326,2,120,60.169674,0.10837899999999934,24063,8857
"172.16.128.169",8014,"172.16.133.26",53046,5,446,6720,0,0,3,326,2,120,60.170955,0.10439699999999874,24981,9195
"172.16.133.44",64797,"172.16.139.250",5440,12,1142,6721,0,0,12,1142,0,0,60.173623,0.0146220000000028,624811,0
"172.16.133.207",55932,"172.16.139.250",5440,12,1142,6722,0,0,12,1142,0,0,60.198746,0.0050069999999990955,1824645,0
"172.16.133.83",57089,"172.16.139.250",5440,12,1142,6723,0,0,12,1142,0,0,60.205703,0.004731999999997072,"",""
"172.16.133.93",60713,"172.16.139.250",5440,10,1022,6724,0,0,10,1022,0,0,60.223533,0.00492999999999455,"",""
"172.16.133.11",55141,"172.16.139.250",5440,12,1142,6725,0,0,12,1142,0,0,60.239194,0.006001000000004808,1522412,0
"172.16.133.55",57579,"172.16.139.250",5440,10,1022,6726,0,0,10,1022,0,0,60.244836,0.00553899999999885,1476078,0
"172.16.133.73",60635,"172.16.139.250",5440,12,1142,6727,0,0,12,1142,0,0,60.268416,0.006498000000000559,1405971,0
"172.16.133.53",54098,"172.16.139.250",5440,10,1022,6728,0,0,10,1022,0,0,60.269703,0.016885000000002037,484216,0
"172.16.133.21",53172,"172.16.139.250",5440,10,1022,6729,0,0,10,1022,0,0,60.272616,0.0067220000000034474,1216304,0
"172.16.133.30",62615,"172.16.139.250",5440,12,1142,6730,0,0,12,1142,0,0,60.275756,0.006813000000001068,1340965,0
"172.16.133.25",63437,"172.16.139.250",5440,10,1022,6731,0,0,10,1022,0,0,60.28446,0.006073000000000661,1346286,0
"172.16.133.34",50438,"172.16.139.250",5440,12,1142,6732,0,0,12,1142,0,0,60.292302,0.005177000000003318,1764728,0
"172.16.133.97",59371,"172.16.139.250",5440,10,1022,6733,0,0,10,1022,0,0,60.303664,0.0054500000000032855,1500183,0
"172.16.133.18",50284,"173.194.75.147",443,6,384,6734,0,0,4,258,2,126,60.331846,0.1007719999999992,20481,10002
"172.16.133.29",60913,"78.108.119.250",443,6,366,6735,0,0,4,246,2,120,60.371965,0.2707759999999979,7268,3545
"172.16.133.29",60914,"216.115.209.254",443,6,366,6736,0,0,4,246,2,120,60.372357,0.1991609999999966,9881,4820
"172.16.133.29",60915,"68.64.5.249",443,6,366,6737,0,0,4,246,2,120,60.373435,0.11879100000000165,16566,8081
"172.16.133.29",60916,"68.64.25.250",443,6,366,6738,0,0,4,246,2,120,60.373752,0.12456299999999487,15799,7706
"172.16.133.33",57880,"172.16.139.250",5440,10,1022,6739,0,0,10,1022,0,0,60.379052,0.015382999999999925,531495,0
"172.16.133.18",50285,"173.194.75.147",443,172,114881,6740,0,0,74,8973,98,105908,60.380769,135.220215,530,6265
"172.16.133.68",60727,"172.16.139.250",5440,12,1142,6741,0,0,12,1142,0,0,60.409599,0.015630999999999062,584479,0
"172.16.133.12",59733,"172.16.139.250",5440,10,1022,6742,0,0,10,1022,0,0,60.424342,0.005358999999998559,1525657,0
"172.16.133.63",53878,"172.16.139.250",5440,10,1022,6743,0,0,10,1022,0,0,60.432272,0.014818000000005327,551761,0
"172.16.133.66",53861,"172.16.139.250",5440,10,1022,6744,0,0,10,1022,0,0,60.447853,0.014876000000001,549610,0
"172.16.133.82",61330,"172.16.139.250",5440,10,1022,6745,0,0,10,1022,0,0,60.461045,0.015371999999999275,531876,0
"172.16.133.37",60624,"172.16.139.250",5440,10,1022,6746,0,0,10,1022,0,0,60.474876,0.005901000000001488,1385527,0
"172.16.133.78",59207,"172.16.139.250",5440,12,1142,6747,0,0,12,1142,0,0,60.632309,0.005578999999997336,1637569,0
"172.16.133.103",63398,"23.67.242.81",80,1,60,6748,0,0,1,60,0,0,60.634049,0,"",""
"172.16.133.18",50286,"173.194.43.42",443,22,4509,6749,0,0,13,1274,9,3235,60.66286,52.879113999999994,192,489
"172.16.133.18",50287,"74.125.226.207",443,17,1899,6750,0,0,11,1253,6,646,60.668917,52.872747999999994,189,97
"172.16.133.67",55984,"172.16.139.250",5440,10,1022,6751,0,0,10,1022,0,0,60.685221,0.005596000000004153,1461043,0
"172.16.133.128",65037,"63.241.108.124",80,4,246,6752,0,0,2,126,2,120,60.695383,11.205870999999995,89,85
"172.16.133.128",65038,"63.241.108.124",80,4,246,6753,0,0,2,126,2,120,60.69558,10.496371000000003,96,91
"172.16.133.128",65039,"63.241.108.124",80,4,246,6754,0,0,2,126,2,120,60.695733,11.17305600000001,90,85
"172.16.133.56",61428,"172.16.139.250",5440,12,1142,6755,0,0,12,1142,0,0,60.70772,0.015594000000000108,585866,0
"172.16.133.128",65040,"208.47.254.9",80,6,372,6756,0,0,4,246,2,126,60.721363,14.958477000000002,131,67
"172.16.133.128",65041,"208.47.254.9",80,6,372,6757,0,0,4,246,2,126,60.721479,14.958309999999997,131,67
"172.16.133.128",65042,"208.47.254.9",80,6,372,6758,0,0,4,246,2,126,60.721592,14.958247,131,67
"172.16.133.42",57065,"172.16.139.250",5440,12,1142,6759,0,0,12,1142,0,0,60.750763,0.08229599999999948,111013,0
"172.16.133.41",52988,"172.16.139.250",5440,10,1022,6760,0,0,10,1022,0,0,60.764627,0.005447000000003754,1501009,0
"172.16.133.128",65043,"138.108.7.20",80,10,2547,6761,0,0,5,1829,5,718,60.781292,9.616980000000005,1521,597
"172.16.133.85",52272,"172.16.139.250",5440,10,1022,6762,0,0,10,1022,0,0,60.78189,0.014966000000001145,546304,0
"172.16.133.128",65044,"64.94.107.14",80,11,2583,6763,0,0,6,2000,5,583,60.795196,0.058419000000000665,273883,79837
"172.16.133.128",65045,"173.194.43.59",80,6,372,6764,0,0,4,246,2,126,60.801412,14.876815000000008,132,67
"172.16.133.128",65046,"216.52.242.80",80,6,372,6765,0,0,4,246,2,126,60.802329,14.959061000000005,131,67
"172.16.133.43",57782,"172.16.139.250",5440,10,1022,6766,0,0,10,1022,0,0,60.835129,0.005579999999994811,1465232,0
"172.16.133.13",53038,"172.16.139.250",5440,12,1142,6767,0,0,12,1142,0,0,60.852733,0.006003999999997234,1521652,0
"172.16.133.20",62393,"172.16.139.250",5440,10,1022,6768,0,0,10,1022,0,0,60.901829,0.004759999999997433,"",""
"172.16.133.75",50956,"172.16.139.250",5440,12,1142,6769,0,0,12,1142,0,0,60.919328,0.018154000000002668,503249,0
"172.16.133.28",65371,"172.16.139.250",5440,10,1022,6770,0,0,10,1022,0,0,60.932879,0.008001000000000147,1021872,0
"172.16.133.120",53445,"96.43.146.22",443,29,12896,6771,0,0,16,11209,13,1687,60.947565,5.725816000000009,15660,2357
"172.16.133.120",53446,"96.43.146.22",443,37,16554,6772,0,0,21,14366,16,2188,60.947837,14.406932000000005,7977,1214
"172.16.133.41",52989,"216.52.121.204",80,16,7927,6773,0,0,8,3465,8,4462,60.955411,6.427478000000008,4312,5553
"172.16.133.99",56042,"172.16.139.250",5440,12,1142,6774,0,0,12,1142,0,0,60.960174,0.005694999999995787,1604214,0
"172.16.133.41",52990,"216.52.121.204",80,12,3951,6775,0,0,7,3394,5,557,60.974761,0.14096099999999723,192620,31611
"172.16.133.41",52991,"216.52.121.204",80,12,3951,6776,0,0,7,3394,5,557,60.977291,0.13924800000000204,194990,32000
"172.16.133.87",60201,"172.16.139.250",5440,10,1022,6777,0,0,10,1022,0,0,60.98196,0.005406000000000688,1512393,0
"172.16.133.41",52992,"216.52.121.204",80,12,3951,6778,0,0,7,3394,5,557,60.987368000000004,0.1384479999999968,196116,32185
"172.16.133.35",49971,"172.16.139.250",5440,12,1142,6779,0,0,12,1142,0,0,60.993042,0.015632999999994013,584404,0
"172.16.133.41",52993,"216.52.121.204",80,12,3951,6780,0,0,7,3394,5,557,60.995326,0.17948900000000378,151273,24826
"172.16.133.116",53344,"172.16.139.250",5440,10,1022,6781,0,0,10,1022,0,0,60.997442,0.005578999999997336,1465495,0
"172.16.133.41",52994,"216.52.121.204",80,12,3951,6782,0,0,7,3394,5,557,60.999265,0.14067200000000213,193016,31676
"172.16.133.116",53345,"172.16.139.250",5440,10,1022,6783,0,0,10,1022,0,0,61.003833,0.006565999999999406,1245202,0
"172.16.133.116",53346,"172.16.139.250",5440,10,1022,6784,0,0,10,1022,0,0,61.011514,0.0067430000000001655,1212516,0
"172.16.133.84",58792,"172.16.139.250",5440,10,1022,6785,0,0,10,1022,0,0,61.019354,0.005361000000000615,1525088,0
"172.16.133.49",55765,"172.16.139.250",5440,10,1022,6787,0,0,10,1022,0,0,61.097016,0.00567899999999355,1439690,0
"172.16.133.95",56967,"172.16.139.250",5440,10,1022,6788,0,0,10,1022,0,0,61.135027,0.0053339999999977294,1532808,0
"172.16.133.92",57681,"172.16.139.250",5440,10,1022,6789,0,0,10,1022,0,0,61.162822,0.015261999999999887,535709,0
"172.16.133.28",65372,"216.52.242.80",80,146,131708,6790,0,0,50,18376,96,113332,61.171497,52.739441,2787,17191
"172.16.133.29",60917,"172.16.139.250",5440,10,1022,6791,0,0,10,1022,0,0,61.179862,0.016824999999997203,485943,0
"172.16.133.44",64798,"172.16.139.250",5440,12,1142,6792,0,0,12,1142,0,0,61.187506,0.006211000000000411,1470938,0
"172.16.133.207",55933,"172.16.139.250",5440,10,1022,6793,0,0,10,1022,0,0,61.211875,0.01645200000000102,496960,0
"172.16.133.83",57090,"172.16.139.250",5440,12,1142,6794,0,0,12,1142,0,0,61.219803,0.004732000000004177,"",""
"172.16.133.93",60714,"172.16.139.250",5440,12,1142,6795,0,0,12,1142,0,0,61.237305,0.004770000000000607,"",""
"172.16.133.11",55142,"172.16.139.250",5440,10,1022,6796,0,0,10,1022,0,0,61.253228,0.005750999999996509,1421665,0
"172.16.133.55",57580,"172.16.139.250",5440,10,1022,6797,0,0,10,1022,0,0,61.258447,0.005924000000000262,1380148,0
"172.16.133.73",60636,"172.16.139.250",5440,10,1022,6798,0,0,10,1022,0,0,61.281873,0.006990999999999303,1169503,0
"172.16.133.53",54099,"172.16.139.250",5440,10,1022,6799,0,0,10,1022,0,0,61.283726,0.016970000000000596,481791,0
"172.16.133.21",53173,"172.16.139.250",5440,10,1022,6800,0,0,10,1022,0,0,61.286653,0.006315000000000737,1294695,0
"172.16.133.30",62616,"172.16.139.250",5440,10,1022,6801,0,0,10,1022,0,0,61.289844,0.006912999999997282,1182699,0
"172.16.133.28",65373,"64.94.107.55",80,7,428,6802,0,0,4,246,3,182,61.295917,18.33627899999999,107,79
"172.16.133.28",65374,"64.94.107.55",80,7,428,6803,0,0,4,246,3,182,61.296566,18.336855,107,79
"172.16.133.28",65375,"64.94.107.55",80,7,428,6804,0,0,4,246,3,182,61.296912,18.336312,107,79
"172.16.133.28",65376,"23.45.65.19",80,6,372,6805,0,0,4,246,2,126,61.297176,18.365721,107,54
"172.16.133.28",65377,"23.45.65.19",80,6,372,6806,0,0,4,246,2,126,61.298163,18.365590999999995,107,54
"172.16.133.25",63438,"172.16.139.250",5440,12,1142,6807,0,0,12,1142,0,0,61.29822,0.006331000000002973,1443057,0
"172.16.133.28",65378,"64.94.107.62",80,10,2404,6808,0,0,6,1881,4,523,61.298692,4.879727000000003,3083,857
"172.16.133.28",65379,"64.94.107.62",80,8,2053,6809,0,0,5,1590,3,463,61.29891,0.7035770000000028,18079,5264
"172.16.133.28",65380,"64.94.107.62",80,7,428,6810,0,0,4,246,3,182,61.299103,18.33881699999999,107,79
"172.16.133.28",65381,"23.0.49.244",80,19,6761,6811,0,0,9,1537,10,5224,61.299337,98.38434699999999,124,424
"172.16.133.28",65382,"206.33.41.253",80,121,74258,6812,0,0,46,13475,75,60783,61.299569,18.337219999999995,5878,26517
"172.16.133.28",65383,"206.33.41.253",80,110,59096,6813,0,0,46,12785,64,46311,61.299765,18.335804000000003,5578,20205
"172.16.133.28",65384,"206.33.41.253",80,192,140453,6814,0,0,67,16948,125,123505,61.299972,18.340485,7392,53872
"172.16.133.28",65385,"206.33.41.253",80,78,45809,6815,0,0,31,8237,47,37572,61.300383,18.340590000000006,3592,16388
"172.16.133.28",65386,"206.33.41.253",80,129,75450,6816,0,0,50,17385,79,58065,61.300582,18.340256000000004,7583,25327
"172.16.133.28",65387,"206.33.41.253",80,105,63335,6817,0,0,39,11097,66,52238,61.300796,18.335787000000003,4841,22791
"172.16.133.28",65388,"208.111.160.6",80,75,67589,6818,0,0,25,4794,50,62795,61.301291,38.344156000000005,1000,13101
"172.16.133.28",65389,"208.111.160.6",80,32,25562,6819,0,0,10,2278,22,23284,61.301578,38.343664999999994,475,4857
"172.16.133.28",65390,"208.111.160.6",80,50,37163,6820,0,0,20,2949,30,34214,61.301833,38.343976,615,7138
"172.16.133.28",65391,"208.111.160.6",80,28,22916,6821,0,0,9,1944,19,20972,61.302054,38.343604,405,4375
"172.16.133.28",65392,"208.111.160.6",80,8,492,6822,0,0,4,246,4,246,61.302244,18.341193000000004,107,107
"172.16.133.34",50439,"172.16.139.250",5440,10,1022,6823,0,0,10,1022,0,0,61.306148,0.005155999999999494,1585725,0
"172.16.133.97",59372,"172.16.139.250",5440,10,1022,6824,0,0,10,1022,0,0,61.317747,0.014763999999999555,553779,0
"172.16.133.33",57881,"172.16.139.250",5440,10,1022,6825,0,0,10,1022,0,0,61.393824,0.0330680000000001,247248,0
"172.16.133.97",55912,"172.16.139.250",5500,24,2388,6826,0,0,24,2388,0,0,61.402709,160.178588,119,0
"172.16.133.68",60728,"172.16.139.250",5440,10,1022,6827,0,0,10,1022,0,0,61.423384,0.014914000000004535,548209,0
"172.16.133.18",50288,"173.194.43.34",443,6,416,6828,0,0,4,276,2,140,61.432396,0.09400600000000026,23487,11914
"172.16.133.12",59734,"172.16.139.250",5440,12,1142,6829,0,0,12,1142,0,0,61.439187,0.006254000000005533,1460825,0
"172.16.133.63",53879,"172.16.139.250",5440,12,1142,6830,0,0,12,1142,0,0,61.44587,0.006121000000000265,1492566,0
"172.16.133.66",53862,"172.16.139.250",5440,12,1142,6831,0,0,12,1142,0,0,61.461868,0.015478999999999132,590219,0
"172.16.133.82",61331,"172.16.139.250",5440,12,1142,6832,0,0,12,1142,0,0,61.474792,0.016680000000000916,547721,0
"172.16.133.48",60514,"50.16.236.32",80,10,1391,6833,0,0,5,906,5,485,61.476876,0.09351400000000609,77507,41491
"172.16.133.37",60625,"172.16.139.250",5440,10,1022,6834,0,0,10,1022,0,0,61.488327,0.014679000000000997,556986,0
"172.16.133.57",60578,"157.56.242.198",443,3,180,6835,0,0,2,120,1,60,61.490568,0.031338999999995565,30632,15316
"172.16.133.57",60594,"157.56.242.198",443,60,23592,6836,0,0,30,9137,30,14455,61.490569,125.892075,580,918
"172.16.133.18",50289,"173.194.43.34",443,65,19156,6837,0,0,33,5753,32,13403,61.505079,134.063819,343,799
"172.16.133.121",56503,"96.43.146.22",443,67,30349,6838,0,0,38,26394,29,3955,61.587311,230.354627,916,137
"172.16.133.78",59208,"172.16.139.250",5440,10,1022,6839,0,0,10,1022,0,0,61.645461,0.005390000000005557,1516883,0
"172.16.133.50",50707,"96.43.146.22",443,23,4658,6840,0,0,13,3675,10,983,61.651401,225.503456,130,34
"172.16.133.28",65393,"23.0.49.244",80,28,11582,6841,0,0,13,3249,15,8333,61.660351,211.657349,122,314
"172.16.133.28",65394,"23.0.49.244",80,36,15756,6842,0,0,17,4725,19,11031,61.671011,231.29640200000003,163,381
"172.16.133.28",65395,"23.0.49.244",80,14,3667,6843,0,0,7,923,7,2744,61.671216,67.96928899999999,108,322
"172.16.133.28",65396,"23.0.49.244",80,30,10880,6844,0,0,14,3311,16,7569,61.698926,231.345332,114,261
"172.16.133.67",55985,"172.16.139.250",5440,10,1022,6845,0,0,10,1022,0,0,61.699478,0.005279000000001588,1548778,0
"172.16.133.18",50290,"173.194.43.34",443,20,4487,6846,0,0,12,1198,8,3289,61.711265,52.830534,181,498
"172.16.133.56",61429,"172.16.139.250",5440,10,1022,6847,0,0,10,1022,0,0,61.721218,0.004406000000003019,"",""
"172.16.133.57",60595,"157.56.242.198",443,31,10665,6848,0,0,16,2651,15,8014,61.729727,63.880362000000005,331,1003
"172.16.133.28",65397,"173.194.43.59",80,6,372,6849,0,0,4,246,2,126,61.761303,17.872935,110,56
"172.16.133.28",65398,"23.0.49.244",80,7,432,6850,0,0,4,246,3,186,61.761602,17.88486799999999,110,83
"172.16.133.28",65399,"23.0.49.244",80,7,432,6851,0,0,4,246,3,186,61.761725,17.886742999999996,110,83
"172.16.133.41",52995,"172.16.139.250",5440,10,1022,6852,0,0,10,1022,0,0,61.778911,0.005445999999999174,1501285,0
"172.16.133.42",57066,"172.16.139.250",5440,12,1142,6853,0,0,12,1142,0,0,61.78203,0.0367870000000039,248348,0
"172.16.133.85",52273,"172.16.139.250",5440,10,1022,6854,0,0,10,1022,0,0,61.79533,0.005318000000002598,1537420,0
"172.16.133.43",57783,"172.16.139.250",5440,12,1142,6855,0,0,12,1142,0,0,61.849149,0.006225000000000591,1467630,0
"172.16.133.13",53039,"172.16.139.250",5440,12,1142,6856,0,0,12,1142,0,0,61.866889,0.006008999999998821,1520386,0
"172.16.133.20",62394,"172.16.139.250",5440,12,1142,6857,0,0,12,1142,0,0,61.915478,0.01461100000000215,625282,0
"172.16.133.75",50957,"172.16.139.250",5440,10,1022,6858,0,0,10,1022,0,0,61.93344,0.005253000000003283,1556443,0
"172.16.133.28",65400,"172.16.139.250",5440,10,1022,6859,0,0,10,1022,0,0,61.946616,0.005465999999998417,1495792,0
"172.16.133.28",65401,"138.108.7.20",80,11,4062,6860,0,0,6,2932,5,1130,61.953654,15.301445000000001,1532,590
"172.16.133.99",56043,"172.16.139.250",5440,12,1142,6861,0,0,12,1142,0,0,61.973261,0.014912999999999954,612619,0
"172.16.133.28",65402,"68.64.5.249",443,6,366,6862,0,0,4,246,2,120,61.9803,0.11591700000000316,16977,8281
"172.16.133.28",65403,"68.64.25.250",443,6,366,6863,0,0,4,246,2,120,61.991274,0.118070000000003,16668,8130
"172.16.133.87",60202,"172.16.139.250",5440,10,1022,6864,0,0,10,1022,0,0,61.995249,0.0054079999999956385,1511834,0
"172.16.133.35",49972,"172.16.139.250",5440,12,1142,6865,0,0,12,1142,0,0,62.007382,0.014884000000002118,613813,0
"172.16.133.116",53347,"172.16.139.250",5440,12,1142,6866,0,0,12,1142,0,0,62.011635,0.00991000000000497,921897,0
"172.16.133.116",53348,"172.16.139.250",5440,12,1142,6867,0,0,12,1142,0,0,62.022201,0.015563000000000216,587033,0
"172.16.133.84",58793,"172.16.139.250",5440,12,1142,6868,0,0,12,1142,0,0,62.033449,0.008510000000001128,1073560,0
"172.16.133.116",53349,"172.16.139.250",5440,10,1022,6869,0,0,10,1022,0,0,62.03831,0.007342999999998767,1113441,0
"172.16.133.28",65404,"216.115.209.254",443,6,366,6870,0,0,4,246,2,120,62.046356,0.20875900000000058,9427,4598
"172.16.133.82",61332,"216.115.216.250",443,6,366,6871,0,0,4,246,2,120,62.050221,0.05136399999999952,38314,18690
"172.16.133.28",65405,"78.108.119.250",443,6,366,6872,0,0,4,246,2,120,62.053496,0.24660799999999483,7980,3892
"172.16.133.82",61333,"68.64.26.250",443,6,366,6873,0,0,4,246,2,120,62.080142,0.09186400000000106,21422,10450
"172.16.133.82",61334,"68.64.4.249",443,6,366,6874,0,0,4,246,2,120,62.08903,0.08857100000000173,22219,10838
"172.16.133.49",55766,"172.16.139.250",5440,12,1142,6875,0,0,12,1142,0,0,62.110476,0.007339000000001761,1244856,0
"172.16.133.95",56968,"172.16.139.250",5440,10,1022,6876,0,0,10,1022,0,0,62.148149,0.005658000000003938,1445033,0
"172.16.133.92",57682,"172.16.139.250",5440,12,1142,6877,0,0,12,1142,0,0,62.17549,0.006135999999997921,1488917,0
"172.16.133.95",56969,"157.56.240.102",443,23,10561,6878,0,0,10,2442,13,8119,62.193205,1.4121829999999989,13833,45994
"172.16.133.29",60918,"172.16.139.250",5440,10,1022,6879,0,0,10,1022,0,0,62.196294,0.006042999999998244,1352970,0
"172.16.133.44",64799,"172.16.139.250",5440,12,1142,6880,0,0,12,1142,0,0,62.202903,0.005746000000002027,1589975,0
"172.16.133.82",61335,"216.219.116.244",443,6,366,6881,0,0,4,246,2,120,62.216159,0.2516250000000042,7821,3815
"172.16.133.207",55934,"172.16.139.250",5440,12,1142,6882,0,0,12,1142,0,0,62.225947,0.01699400000000395,537601,0
"172.16.133.83",57091,"172.16.139.250",5440,12,1142,6883,0,0,12,1142,0,0,62.234037,0.0048340000000024475,"",""
"172.16.133.93",60715,"172.16.139.250",5440,12,1142,6884,0,0,12,1142,0,0,62.251953,0.004810999999996568,"",""
"172.16.133.11",55143,"172.16.139.250",5440,12,1142,6885,0,0,12,1142,0,0,62.269269,0.006495999999998503,1406403,0
"172.16.133.55",57581,"172.16.139.250",5440,10,1022,6886,0,0,10,1022,0,0,62.27198,0.016037000000004298,509821,0
"172.16.133.44",64800,"23.0.49.244",80,21,6328,6887,0,0,10,1627,11,4701,62.291776,216.761849,60,173
"172.16.133.44",64801,"23.0.49.244",80,16,2885,6888,0,0,8,904,8,1981,62.2922,108.11484899999999,66,146
"172.16.133.73",60637,"172.16.139.250",5440,12,1142,6889,0,0,12,1142,0,0,62.294457,0.01576599999999928,579474,0
"172.16.133.53",54100,"172.16.139.250",5440,10,1022,6890,0,0,10,1022,0,0,62.297657,0.020089999999996166,406968,0
"172.16.133.21",53174,"172.16.139.250",5440,12,1142,6891,0,0,12,1142,0,0,62.300779,0.021751999999999327,420007,0
"172.16.133.30",62617,"172.16.139.250",5440,10,1022,6892,0,0,10,1022,0,0,62.303958,0.00969599999999815,843234,0
"172.16.133.25",63439,"172.16.139.250",5440,12,1142,6893,0,0,12,1142,0,0,62.320277,0.005377000000002852,1699088,0
"172.16.133.34",50440,"172.16.139.250",5440,10,1022,6894,0,0,10,1022,0,0,62.320849,0.014949999999998909,546889,0
"172.16.133.97",59373,"172.16.139.250",5440,12,1142,6895,0,0,12,1142,0,0,62.337044,0.006166000000000338,1481673,0
"172.16.133.42",57067,"96.43.146.22",443,20,6969,6896,0,0,10,5616,10,1353,62.34046,1.5055479999999974,29841,7189
"172.16.133.57",60588,"157.56.242.198",443,3,180,6897,0,0,2,120,1,60,62.370337,0.02342999999999762,40973,20486
"172.16.133.57",60596,"157.56.242.198",443,43,17687,6898,0,0,23,7202,20,10485,62.370731,63.076288999999996,913,1329
"172.16.133.66",53863,"180.153.30.250",443,6,366,6899,0,0,4,246,2,120,62.397641,0.6755309999999994,2913,1421
"172.16.133.33",57882,"172.16.139.250",5440,10,1022,6900,0,0,10,1022,0,0,62.406929,0.005585000000003504,1463921,0
"172.16.133.68",60729,"172.16.139.250",5440,10,1022,6901,0,0,10,1022,0,0,62.437798,0.005423999999997875,1507374,0
"172.16.133.29",60919,"68.64.5.249",443,6,366,6902,0,0,4,246,2,120,62.443267,0.14781100000000436,13314,6494
"172.16.133.29",60920,"68.64.25.250",443,6,366,6903,0,0,4,246,2,120,62.445122,0.15164299999999997,12977,6330
"172.16.133.12",59735,"172.16.139.250",5440,10,1022,6904,0,0,10,1022,0,0,62.452691,0.005494999999996253,1487898,0
"172.16.133.63",53880,"172.16.139.250",5440,10,1022,6905,0,0,10,1022,0,0,62.459746,0.014400999999999442,567738,0
"173.252.110.27",443,"172.16.133.78",58850,8,522,6906,0,0,5,321,3,201,62.464261,0.06627199999999789,38749,24263
"173.252.110.27",443,"172.16.133.78",58845,8,522,6907,0,0,5,321,3,201,62.469545,0.060512000000002786,42437,26573
"172.16.133.29",60921,"216.115.209.254",443,6,366,6908,0,0,4,246,2,120,62.476197,0.24619500000000016,7993,3899
"172.16.133.66",53864,"172.16.139.250",5440,10,1022,6909,0,0,10,1022,0,0,62.477301,0.005541000000000906,1475545,0
"172.16.133.57",60597,"157.56.242.198",443,38,15621,6910,0,0,19,5019,19,10602,62.483598,62.965714000000006,637,1347
"172.16.133.82",61336,"172.16.139.250",5440,10,1022,6911,0,0,10,1022,0,0,62.488615,0.014602999999993926,559884,0
"172.16.133.37",60626,"172.16.139.250",5440,12,1142,6912,0,0,12,1142,0,0,62.502585,0.00599399999999406,1524190,0
"172.16.133.29",60922,"78.108.119.250",443,6,366,6913,0,0,4,246,2,120,62.511145,0.2600850000000037,7566,3691
"172.16.133.57",60598,"96.43.146.176",443,37,13824,6914,0,0,20,1948,17,11876,62.548166,0.30539199999999767,51029,311101
"172.16.133.25",63440,"173.194.43.34",80,6,372,6915,0,0,4,246,2,126,62.55989,15.226928999999991,129,66
"172.16.133.25",63441,"173.194.43.34",80,6,372,6916,0,0,4,246,2,126,62.560067,15.226339000000003,129,66
"172.16.133.25",63442,"74.125.170.42",80,6,372,6917,0,0,4,246,2,126,62.560432,15.300765000000006,128,65
"172.16.133.25",63443,"173.194.43.36",80,6,372,6918,0,0,4,246,2,126,62.560686,15.225826000000005,129,66
"172.16.133.25",63444,"173.194.43.36",80,6,372,6919,0,0,4,246,2,126,62.560824,15.224964,129,66
"172.16.133.25",63445,"173.194.43.36",80,7,432,6920,0,0,4,246,3,186,62.560989,15.225772,129,97
"172.16.133.25",63446,"173.194.43.36",80,7,432,6921,0,0,4,246,3,186,62.561126,15.225331999999995,129,97
"172.16.133.25",63447,"173.194.43.36",80,6,372,6922,0,0,4,246,2,126,62.561292,15.224782999999995,129,66
"172.16.133.25",63448,"173.194.43.47",80,6,372,6923,0,0,4,246,2,126,62.590034,15.195692999999991,129,66
"172.16.133.25",63449,"173.194.43.47",80,6,372,6924,0,0,4,246,2,126,62.590193,15.195937,129,66
"172.16.133.25",63450,"173.194.43.47",80,6,372,6925,0,0,4,246,2,126,62.590356,15.195088999999996,129,66
"172.16.133.78",59209,"172.16.139.250",5440,12,1142,6926,0,0,12,1142,0,0,62.660789,0.006596000000001823,1385081,0
"172.16.133.67",55986,"172.16.139.250",5440,12,1142,6927,0,0,12,1142,0,0,62.71415,0.006287000000000376,1453157,0
"172.16.133.56",61430,"172.16.139.250",5440,10,1022,6928,0,0,10,1022,0,0,62.735719,0.005224999999995816,1564784,0
"173.252.110.27",443,"172.16.133.36",64996,9,640,6929,0,0,4,328,5,312,62.755062,0.037952999999994574,69138,65765
"172.16.133.42",57068,"172.16.139.250",5440,12,1142,6930,0,0,12,1142,0,0,62.774486,0.018290999999997837,499480,0
"172.16.133.41",52996,"172.16.139.250",5440,12,1142,6931,0,0,12,1142,0,0,62.791853,0.01455999999999591,627472,0
"172.16.133.85",52274,"172.16.139.250",5440,10,1022,6932,0,0,10,1022,0,0,62.810515,0.01510499999999837,541277,0
"172.16.133.43",57784,"172.16.139.250",5440,12,1142,6933,0,0,12,1142,0,0,62.8639,0.015577999999997871,586468,0
"172.16.133.13",53040,"172.16.139.250",5440,10,1022,6934,0,0,10,1022,0,0,62.880536,0.014986999999997863,545539,0
"64.4.23.161",40011,"172.16.133.47",54021,33,2455,6935,0,0,19,1160,14,1295,62.90976,198.37814300000002,46,52
"172.16.133.113",55615,"172.16.139.250",135,8,492,6936,0,0,8,492,0,0,62.923859,0.004969000000002666,"",""
"172.16.133.113",55616,"172.16.139.250",5462,12,816,6937,0,0,12,816,0,0,62.929164,0.520902999999997,12532,0
"172.16.133.20",62395,"172.16.139.250",5440,10,1022,6938,0,0,10,1022,0,0,62.929775,0.014127000000001999,578749,0
"173.252.110.27",80,"172.16.133.36",65026,4,264,6939,0,0,2,132,2,132,62.939924,7.691075000000005,137,137
"172.16.133.75",50958,"172.16.139.250",5440,10,1022,6940,0,0,10,1022,0,0,62.947866,0.005604000000005271,1458957,0
"172.16.133.28",65406,"172.16.139.250",5440,10,1022,6941,0,0,10,1022,0,0,62.960989,0.005261000000004401,1554077,0
"172.16.133.99",56044,"172.16.139.250",5440,10,1022,6942,0,0,10,1022,0,0,62.988683,0.005019999999994695,1628685,0
"172.16.133.87",60203,"172.16.139.250",5440,10,1022,6943,0,0,10,1022,0,0,63.009868,0.015053999999999235,543111,0
"172.16.133.116",53350,"172.16.139.250",5440,10,1022,6944,0,0,10,1022,0,0,63.025166,0.006385999999999115,1280300,0
"172.16.133.116",53351,"172.16.139.250",5440,10,1022,6945,0,0,10,1022,0,0,63.032814,0.005794000000001631,1411114,0
"172.16.133.116",53352,"172.16.139.250",5440,10,1022,6946,0,0,10,1022,0,0,63.039383,0.006650999999997964,1229288,0
"172.16.133.35",49973,"172.16.139.250",5440,12,1142,6947,0,0,12,1142,0,0,63.042717,0.0811390000000003,112596,0
"172.16.133.84",58794,"172.16.139.250",5440,10,1022,6948,0,0,10,1022,0,0,63.047563,0.01757700000000284,465153,0
"172.16.133.49",55767,"172.16.139.250",5440,10,1022,6949,0,0,10,1022,0,0,63.12445,0.00572700000000026,1427623,0
"172.16.133.95",56970,"172.16.139.250",5440,10,1022,6950,0,0,10,1022,0,0,63.16145,0.041407999999997,197449,0
"172.16.133.25",63451,"173.194.43.47",80,18,3039,6951,0,0,9,1038,9,2001,63.163853,225.162105,36,71
"172.16.133.25",63452,"173.194.43.47",80,6,372,6952,0,0,4,246,2,126,63.163981,14.621806,134,68
"172.16.133.92",57683,"172.16.139.250",5440,10,1022,6953,0,0,10,1022,0,0,63.189666,0.00913800000000009,894725,0
"172.16.133.29",60923,"172.16.139.250",5440,10,1022,6954,0,0,10,1022,0,0,63.207879,0.005442999999999643,1502112,0
"172.16.133.44",64802,"172.16.139.250",5440,12,1142,6955,0,0,12,1142,0,0,63.215349,0.015727999999995745,580874,0
"172.16.133.207",55935,"172.16.139.250",5440,12,1142,6956,0,0,12,1142,0,0,63.240782,0.00496700000000061,"",""
"172.16.133.83",57092,"172.16.139.250",5440,12,1142,6957,0,0,12,1142,0,0,63.247729,0.014360000000003481,636211,0
"172.16.133.93",60716,"172.16.139.250",5440,10,1022,6958,0,0,10,1022,0,0,63.264615,0.00475200000000342,"",""
"172.16.133.11",55144,"172.16.139.250",5440,10,1022,6959,0,0,10,1022,0,0,63.281213,0.014904999999998836,548540,0
"172.16.133.55",57582,"172.16.139.250",5440,10,1022,6960,0,0,10,1022,0,0,63.285683,0.014603000000001032,559884,0
"172.16.133.73",60638,"172.16.139.250",5440,12,1142,6961,0,0,12,1142,0,0,63.309602,0.006267000000001133,1457794,0
"172.16.133.53",54101,"172.16.139.250",5440,10,1022,6962,0,0,10,1022,0,0,63.312105,0.015304000000000428,534239,0
"172.16.133.21",53175,"172.16.139.250",5440,10,1022,6963,0,0,10,1022,0,0,63.314819,0.005871999999996547,1392370,0
"172.16.133.30",62618,"172.16.139.250",5440,10,1022,6964,0,0,10,1022,0,0,63.319052,0.015757999999998162,518847,0
"172.16.133.25",63453,"172.16.139.250",5440,12,1142,6965,0,0,12,1142,0,0,63.32728,0.016308999999999685,560181,0
"172.16.133.34",50441,"172.16.139.250",5440,10,1022,6966,0,0,10,1022,0,0,63.334745,0.0049380000000027735,"",""
"172.16.133.97",59374,"172.16.139.250",5440,12,1142,6967,0,0,12,1142,0,0,63.345795,0.015357999999999095,594869,0
"172.16.133.235",2696,"172.16.131.10",8080,19,3213,6968,0,0,10,1627,9,1586,63.374109,19.045358999999998,683,666
"172.16.133.33",57883,"172.16.139.250",5440,10,1022,6969,0,0,10,1022,0,0,63.420931,0.01622099999999449,504037,0
"172.16.133.68",60730,"172.16.139.250",5440,10,1022,6970,0,0,10,1022,0,0,63.451682,0.005597999999999104,1460521,0
"172.16.133.12",59736,"172.16.139.250",5440,10,1022,6971,0,0,10,1022,0,0,63.46487,0.006581000000004167,1242364,0
"172.16.133.63",53881,"172.16.139.250",5440,10,1022,6972,0,0,10,1022,0,0,63.475313,0.015773000000002924,518354,0
"172.16.133.66",53865,"172.16.139.250",5440,10,1022,6973,0,0,10,1022,0,0,63.489963,0.0056129999999967595,1456618,0
"172.16.133.82",61337,"172.16.139.250",5440,10,1022,6974,0,0,10,1022,0,0,63.502816,0.005641999999994596,1449131,0
"172.16.133.37",60627,"172.16.139.250",5440,10,1022,6975,0,0,10,1022,0,0,63.516583,0.005585000000003504,1463921,0
"172.16.133.78",59210,"172.16.139.250",5440,10,1022,6976,0,0,10,1022,0,0,63.673605,0.008626999999997054,947722,0
"172.16.133.67",55987,"172.16.139.250",5440,10,1022,6977,0,0,10,1022,0,0,63.727183,0.005187000000006492,1576248,0
"172.16.133.56",61431,"172.16.139.250",5440,12,1142,6978,0,0,12,1142,0,0,63.750145,0.005058999999995706,1805890,0
"172.16.133.42",57069,"172.16.139.250",5440,12,1142,6979,0,0,12,1142,0,0,63.785767,0.010272999999997978,889321,0
"172.16.133.41",52997,"172.16.139.250",5440,10,1022,6980,0,0,10,1022,0,0,63.807055,0.00538699999999892,1517727,0
"172.16.133.85",52275,"172.16.139.250",5440,10,1022,6981,0,0,10,1022,0,0,63.82373,0.015826000000004115,516618,0
"172.16.133.43",57785,"172.16.139.250",5440,10,1022,6982,0,0,10,1022,0,0,63.877185,0.05261400000000549,155395,0
"172.16.133.13",53041,"172.16.139.250",5440,10,1022,6983,0,0,10,1022,0,0,63.894719,0.029069999999997265,281252,0
"172.16.133.20",62396,"172.16.139.250",5440,10,1022,6984,0,0,10,1022,0,0,63.943864,0.014358000000001425,569438,0
"172.16.133.75",50959,"172.16.139.250",5440,10,1022,6985,0,0,10,1022,0,0,63.961416,0.004981999999998266,"",""
"172.16.133.28",65407,"172.16.139.250",5440,10,1022,6986,0,0,10,1022,0,0,63.974927,0.005352000000002022,1527653,0
"172.16.133.99",56045,"172.16.139.250",5440,12,1142,6987,0,0,12,1142,0,0,64.00098,0.013917000000006396,656463,0
"172.16.133.87",60204,"172.16.139.250",5440,10,1022,6988,0,0,10,1022,0,0,64.023678,0.005698999999992793,1434637,0
"172.16.133.28",65408,"68.64.5.249",443,6,366,6989,0,0,4,246,2,120,64.03853,0.10829200000000583,18173,8864
"172.16.133.35",49974,"172.16.139.250",5440,12,1142,6990,0,0,12,1142,0,0,64.039301,0.017791000000002555,513518,0
"172.16.133.116",53353,"172.16.139.250",5440,10,1022,6991,0,0,10,1022,0,0,64.039354,0.00490499999999372,"",""
"172.16.133.116",53354,"172.16.139.250",5440,10,1022,6992,0,0,10,1022,0,0,64.045652,0.0060560000000009495,1350066,0
"172.16.133.116",53355,"172.16.139.250",5440,10,1022,6993,0,0,10,1022,0,0,64.052908,0.005774000000002388,1416002,0
"172.16.133.28",65409,"68.64.25.250",443,6,366,6994,0,0,4,246,2,120,64.055478,0.11413200000001211,17243,8411
"172.16.133.25",63454,"173.194.43.35",80,24,5378,6995,0,0,13,3675,11,1703,64.061285,226.31468999999998,129,60
"172.16.133.84",58795,"172.16.139.250",5440,12,1142,6996,0,0,12,1142,0,0,64.06238,0.010373999999998773,880663,0
"172.16.133.132",43633,"23.45.65.19",80,6,412,6997,0,0,4,272,2,140,64.076864,0.09367500000000462,23229,11956
"172.16.133.82",61338,"216.115.216.250",443,6,366,6998,0,0,4,246,2,120,64.082198,0.047416999999995824,41504,20245
"172.16.133.82",61339,"68.64.26.250",443,6,366,6999,0,0,4,246,2,120,64.1333,0.09050999999999476,21743,10606
"172.16.133.82",61340,"68.64.4.249",443,6,366,7000,0,0,4,246,2,120,64.137146,0.09297100000000569,21167,10325
"172.16.133.49",55768,"172.16.139.250",5440,12,1142,7001,0,0,12,1142,0,0,64.138766,0.015557999999998628,587222,0
"172.16.133.28",65410,"216.115.209.254",443,6,366,7002,0,0,4,246,2,120,64.15742,0.19057999999999709,10326,5037
"172.16.133.95",56971,"172.16.139.250",5440,12,1142,7003,0,0,12,1142,0,0,64.175961,0.006046999999995251,1510831,0
"172.16.133.28",65411,"78.108.119.250",443,6,366,7004,0,0,4,246,2,120,64.183484,0.2547309999999925,7725,3768
"172.16.133.132",46092,"23.15.129.231",80,7,478,7005,0,0,4,272,3,206,64.202527,0.05434400000000039,40041,30325
"172.16.133.92",57684,"172.16.139.250",5440,10,1022,7006,0,0,10,1022,0,0,64.204969,0.005725999999995679,1427872,0
"172.16.133.29",60924,"172.16.139.250",5440,10,1022,7007,0,0,10,1022,0,0,64.221551,0.005491999999989616,1488710,0
"172.16.133.44",64803,"172.16.139.250",5440,12,1142,7008,0,0,12,1142,0,0,64.229232,0.016030000000000655,569931,0
"172.16.133.207",55936,"172.16.139.250",5440,12,1142,7009,0,0,12,1142,0,0,64.253884,0.014790000000004966,617714,0
"172.16.133.83",57093,"172.16.139.250",5440,12,1142,7010,0,0,12,1142,0,0,64.261917,0.014741000000000781,619767,0
"172.16.133.93",60717,"172.16.139.250",5440,12,1142,7011,0,0,12,1142,0,0,64.278532,0.0051799999999957436,1763706,0
"172.16.133.11",55145,"172.16.139.250",5440,10,1022,7012,0,0,10,1022,0,0,64.296617,0.015329000000008364,533368,0
"172.16.133.132",52517,"23.15.128.251",80,6,412,7013,0,0,4,272,2,140,64.297773,0.04908499999999094,44331,22817
"172.16.133.55",57583,"172.16.139.250",5440,10,1022,7014,0,0,10,1022,0,0,64.300353,0.005527000000000726,1479283,0
"172.16.133.73",60639,"172.16.139.250",5440,10,1022,7015,0,0,10,1022,0,0,64.322835,0.006004000000004339,1361758,0
"172.16.133.53",54102,"172.16.139.250",5440,12,1142,7016,0,0,12,1142,0,0,64.325733,0.00741299999999967,1232429,0
"172.16.133.21",53176,"172.16.139.250",5440,10,1022,7017,0,0,10,1022,0,0,64.328794,0.007860999999991236,1040071,0
"172.16.133.30",62619,"172.16.139.250",5440,10,1022,7018,0,0,10,1022,0,0,64.332325,0.008577999999999975,953135,0
"172.16.133.25",63455,"172.16.139.250",5440,12,1142,7019,0,0,12,1142,0,0,64.340632,0.017544000000000892,520747,0
"172.16.133.82",61341,"216.219.116.244",443,6,366,7020,0,0,4,246,2,120,64.347245,0.2549240000000026,7719,3765
"172.16.133.34",50442,"172.16.139.250",5440,12,1142,7021,0,0,12,1142,0,0,64.348624,0.005687999999992144,1606188,0
"172.16.133.132",55404,"208.47.254.9",80,6,412,7022,0,0,4,272,2,140,64.350687,0.04652700000001175,46768,24072
"172.16.133.97",59375,"172.16.139.250",5440,12,1142,7023,0,0,12,1142,0,0,64.361053,0.016204000000001884,563811,0
"172.16.133.132",49890,"74.217.1.83",80,7,482,7024,0,0,4,272,3,210,64.426926,0.09758899999999926,22297,17215
"172.16.133.33",57884,"172.16.139.250",5440,10,1022,7025,0,0,10,1022,0,0,64.433813,0.005697999999995318,1434889,0
"172.16.133.73",60640,"173.194.43.36",443,45,24429,7026,0,0,18,2058,27,22371,64.437575,225.30647900000002,73,794
"172.16.133.73",60641,"173.194.43.41",80,37,23897,7027,0,0,15,1837,22,22060,64.438377,223.820588,65,788
"172.16.133.68",60731,"172.16.139.250",5440,10,1022,7028,0,0,10,1022,0,0,64.465418,0.005511999999995965,1483309,0
"172.16.133.73",60642,"173.194.43.39",80,37,23575,7029,0,0,15,2609,22,20966,64.473925,224.234257,93,748
"172.16.133.73",60643,"173.194.43.39",80,25,9899,7030,0,0,12,1655,13,8244,64.474084,229.86508800000001,57,286
"172.16.133.73",60644,"173.194.43.41",80,47,31710,7031,0,0,18,3333,29,28377,64.474292,224.23424599999998,118,1012
"172.16.133.73",60645,"173.194.43.41",80,40,25107,7032,0,0,17,2896,23,22211,64.474438,223.77687799999995,103,794
"172.16.133.12",59737,"172.16.139.250",5440,10,1022,7033,0,0,10,1022,0,0,64.479758,0.005673999999999069,1440958,0
"172.16.133.63",53882,"172.16.139.250",5440,10,1022,7034,0,0,10,1022,0,0,64.487527,0.014840000000006626,550943,0
"172.16.133.66",53866,"172.16.139.250",5440,10,1022,7035,0,0,10,1022,0,0,64.504194,0.006270000000000664,1303987,0
"172.16.133.82",61342,"172.16.139.250",5440,10,1022,7036,0,0,10,1022,0,0,64.516819,0.0055240000000083,1480086,0
"172.16.133.37",60628,"172.16.139.250",5440,10,1022,7037,0,0,10,1022,0,0,64.531332,0.00538699999999892,1517727,0
"172.16.133.29",60925,"68.64.5.249",443,6,366,7038,0,0,4,246,2,120,64.539285,0.11236699999999189,17514,8543
"172.16.133.29",60926,"68.64.25.250",443,6,366,7039,0,0,4,246,2,120,64.540198,0.17479600000000062,11258,5492
"172.16.133.132",46760,"23.67.242.58",80,6,412,7040,0,0,4,272,2,140,64.558896,0.04712699999998904,46173,23765
"172.16.133.132",44422,"63.140.35.28",80,6,410,7041,0,0,4,272,2,138,64.61593,0.4612459999999885,4717,2393
"172.16.133.29",60927,"216.115.209.254",443,6,366,7042,0,0,4,246,2,120,64.627164,0.230267000000012,8546,4169
"172.16.133.29",60928,"78.108.119.250",443,6,366,7043,0,0,4,246,2,120,64.649195,0.25613500000000045,7683,3748
"172.16.133.78",59211,"172.16.139.250",5440,10,1022,7044,0,0,10,1022,0,0,64.686455,0.006180999999997994,1322763,0
"172.16.133.66",53867,"180.153.30.250",443,6,366,7045,0,0,4,246,2,120,64.729732,0.6997230000000059,2812,1371
"172.16.133.67",55988,"172.16.139.250",5440,10,1022,7046,0,0,10,1022,0,0,64.741881,0.015371999999999275,531876,0
"172.16.133.20",62397,"199.16.156.8",80,12,3570,7047,0,0,6,1619,6,1951,64.753154,31.338366000000008,413,498
"172.16.133.56",61432,"172.16.139.250",5440,10,1022,7048,0,0,10,1022,0,0,64.763254,0.01370099999999752,596744,0
"172.16.133.42",57070,"172.16.139.250",5440,12,1142,7049,0,0,12,1142,0,0,64.799361,0.018225000000001046,501289,0
"172.16.133.41",52998,"172.16.139.250",5440,10,1022,7050,0,0,10,1022,0,0,64.820346,0.005531000000004838,1478213,0
"172.16.133.132",41948,"64.94.107.19",80,7,436,7051,0,0,4,254,3,182,64.826918,0.05242299999999034,38761,27774
"172.16.133.85",52276,"172.16.139.250",5440,10,1022,7052,0,0,10,1022,0,0,64.841131,0.005344999999991273,1529653,0
"172.16.133.57",60565,"173.194.43.2",443,37,11813,7053,0,0,21,7832,16,3981,64.866239,40.37672300000001,1551,788
"172.16.133.132",38831,"75.98.35.10",80,6,408,7054,0,0,4,272,2,136,64.890974,0.049801000000002205,43693,21846
"172.16.133.43",57786,"172.16.139.250",5440,10,1022,7055,0,0,10,1022,0,0,64.891249,0.015546999999997979,525889,0
"172.16.133.13",53042,"172.16.139.250",5440,10,1022,7056,0,0,10,1022,0,0,64.909015,0.005532000000002313,1477946,0
"172.16.133.25",63456,"173.194.41.111",80,17,1990,7057,0,0,9,1265,8,725,64.929838,225.61314799999997,44,25
"172.16.133.25",63457,"173.194.43.41",80,49,26789,7058,0,0,29,21929,20,4860,64.935754,230.731885,760,168
"172.16.133.132",33259,"173.194.43.60",80,6,412,7059,0,0,4,272,2,140,64.946531,0.04948300000000927,43974,22634
"172.16.133.73",60646,"173.194.43.57",80,17,1863,7060,0,0,9,1191,8,672,64.953916,225.159401,42,23
"172.16.133.73",60647,"173.194.43.57",80,22,4129,7061,0,0,12,2366,10,1763,64.95463,228.63401999999996,82,61
"172.16.133.73",60648,"173.194.43.57",80,17,1863,7062,0,0,9,1192,8,671,64.955037,225.14987200000002,42,23
"172.16.133.20",62398,"172.16.139.250",5440,10,1022,7063,0,0,10,1022,0,0,64.957531,0.014797000000001503,552544,0
"172.16.133.73",60649,"173.194.43.57",80,17,1861,7064,0,0,9,1188,8,673,64.962765,225.144653,42,23
"172.16.133.73",60650,"173.194.43.57",80,17,1864,7065,0,0,9,1191,8,673,64.969637,225.150816,42,23
"172.16.133.73",60651,"173.194.43.57",80,60,38354,7066,0,0,25,3859,35,34495,64.97028,230.602937,133,1196
"172.16.133.75",50960,"172.16.139.250",5440,12,1142,7067,0,0,12,1142,0,0,64.974355,0.006225000000000591,1467630,0
"172.16.133.28",65412,"172.16.139.250",5440,10,1022,7068,0,0,10,1022,0,0,64.988862,0.021968000000001098,372177,0
"172.16.133.99",56046,"172.16.139.250",5440,10,1022,7069,0,0,10,1022,0,0,65.015314,0.0048709999999942966,"",""
"172.16.133.132",59689,"138.108.7.20",80,6,412,7070,0,0,4,272,2,140,65.02689,0.18525900000000206,11745,6045
"172.16.133.87",60206,"172.16.139.250",5440,10,1022,7071,0,0,10,1022,0,0,65.037123,0.0050880000000006476,1606918,0
"172.16.133.35",49975,"172.16.139.250",5440,12,1142,7072,0,0,12,1142,0,0,65.049297,0.018505000000004657,493704,0
"172.16.133.116",53356,"172.16.139.250",5440,10,1022,7073,0,0,10,1022,0,0,65.052755,0.014090999999993414,580228,0
"172.16.133.116",53357,"172.16.139.250",5440,10,1022,7074,0,0,10,1022,0,0,65.068294,0.005414000000001806,1510158,0
"172.16.133.116",53358,"172.16.139.250",5440,10,1022,7075,0,0,10,1022,0,0,65.074682,0.005339000000006422,1531372,0
"172.16.133.84",58796,"172.16.139.250",5440,10,1022,7076,0,0,10,1022,0,0,65.076677,0.0070470000000000255,1160210,0
"172.16.133.22",53982,"184.72.243.110",80,9,882,7077,0,0,5,494,4,388,65.091805,0.09328299999999956,42365,33275
"172.16.133.25",63458,"173.194.43.35",80,22,8664,7078,0,0,13,6293,9,2371,65.091807,210.165958,239,90
"172.16.133.49",55769,"172.16.139.250",5440,10,1022,7079,0,0,10,1022,0,0,65.152757,0.005897000000004482,1386467,0
"172.16.133.95",56972,"172.16.139.250",5440,12,1142,7080,0,0,12,1142,0,0,65.191068,0.006136999999995396,1488675,0
"172.16.133.28",65413,"216.52.242.80",80,6,372,7081,0,0,4,246,2,126,65.201669,14.566734000000011,135,69
"172.16.133.132",36771,"64.94.107.23",80,7,436,7082,0,0,4,254,3,182,65.218046,0.06255199999999661,32484,23276
"172.16.133.92",57685,"172.16.139.250",5440,10,1022,7083,0,0,10,1022,0,0,65.219172,0.006172000000006506,1324692,0
"172.16.133.29",60929,"172.16.139.250",5440,10,1022,7084,0,0,10,1022,0,0,65.235621,0.005324999999999136,1535399,0
"172.16.133.44",64804,"172.16.139.250",5440,12,1142,7085,0,0,12,1142,0,0,65.242502,0.01562699999999495,584629,0
"172.16.133.207",55937,"172.16.139.250",5440,10,1022,7086,0,0,10,1022,0,0,65.268029,0.004834999999999923,"",""
"172.16.133.83",57094,"172.16.139.250",5440,12,1142,7087,0,0,12,1142,0,0,65.275829,0.004654999999999632,"",""
"172.16.133.132",44826,"66.77.124.68",80,7,482,7088,0,0,4,272,3,210,65.284646,0.24666100000000313,8821,6810
"172.16.133.93",60718,"172.16.139.250",5440,12,1142,7089,0,0,12,1142,0,0,65.292627,0.014431999999999334,633037,0
"172.16.133.28",65414,"173.194.43.60",80,36,26693,7090,0,0,12,1567,24,25126,65.295745,225.275398,55,892
"172.16.133.28",65415,"23.15.129.231",80,10,1802,7091,0,0,5,1221,5,581,65.299516,0.12247500000000855,79755,37950
"172.16.133.28",65416,"54.243.68.206",80,14,3909,7092,0,0,8,2101,6,1808,65.300676,64.33409999999999,261,224
"172.16.133.11",55146,"172.16.139.250",5440,10,1022,7093,0,0,10,1022,0,0,65.309859,0.01587700000000325,514958,0
"172.16.133.55",57584,"172.16.139.250",5440,10,1022,7094,0,0,10,1022,0,0,65.314982,0.0057879999999954634,1412577,0
"172.16.133.29",60930,"74.125.226.232",443,27,4244,7095,0,0,15,2335,12,1909,65.318794,225.30680600000002,82,67
"172.16.133.28",65417,"23.62.196.46",80,20,7004,7096,0,0,9,1539,11,5465,65.324141,225.38478800000001,54,193
"172.16.133.73",60652,"172.16.139.250",5440,10,1022,7097,0,0,10,1022,0,0,65.337704,0.0053779999999932215,1520267,0
"172.16.133.53",54103,"172.16.139.250",5440,10,1022,7098,0,0,10,1022,0,0,65.33964,0.007238000000000966,1129593,0
"172.16.133.21",53177,"172.16.139.250",5440,10,1022,7099,0,0,10,1022,0,0,65.345704,0.018912999999997737,432295,0
"172.16.133.30",62620,"172.16.139.250",5440,10,1022,7100,0,0,10,1022,0,0,65.345964,0.00533500000000231,1532521,0
"172.16.133.25",63459,"172.16.139.250",5440,10,1022,7101,0,0,10,1022,0,0,65.354127,0.006478000000001316,1262117,0
"172.16.133.34",50443,"172.16.139.250",5440,10,1022,7102,0,0,10,1022,0,0,65.362682,0.014139000000000124,578258,0
"172.16.133.97",59376,"172.16.139.250",5440,12,1142,7103,0,0,12,1142,0,0,65.37391,0.015311000000011177,596695,0
"173.252.110.27",443,"172.16.133.78",58861,7,462,7104,0,0,4,261,3,201,65.380435,0.06085699999999861,34309,26422
"173.252.110.27",443,"172.16.133.78",58804,7,462,7105,0,0,4,261,3,201,65.382775,0.05769700000000455,36189,27869
"172.16.133.29",60931,"173.194.43.39",443,51,18907,7106,0,0,24,3154,27,15753,65.443442,225.45016299999997,111,558
"172.16.133.33",57885,"172.16.139.250",5440,12,1142,7107,0,0,12,1142,0,0,65.44931,0.006369000000006508,1434448,0
"172.16.133.28",65418,"204.154.111.33",80,11,2489,7108,0,0,6,1963,5,526,65.466102,0.13565599999999733,115763,31019
"172.16.133.68",60732,"172.16.139.250",5440,10,1022,7109,0,0,10,1022,0,0,65.479499,0.005619999999993297,1454804,0
"172.16.133.12",59738,"172.16.139.250",5440,12,1142,7110,0,0,12,1142,0,0,65.492897,0.009045999999997889,1009949,0
"172.16.133.63",53883,"172.16.139.250",5440,12,1142,7111,0,0,12,1142,0,0,65.502996,0.016269000000008305,561558,0
"172.16.133.28",65419,"23.15.129.231",80,15,2121,7112,0,0,8,1409,7,712,65.508923,124.126479,90,45
"172.16.133.66",53868,"172.16.139.250",5440,12,1142,7113,0,0,12,1142,0,0,65.517172,0.006620999999995547,1379851,0
"172.16.133.82",61343,"172.16.139.250",5440,10,1022,7114,0,0,10,1022,0,0,65.529618,0.0054520000000053415,1499633,0
"172.16.133.37",60629,"172.16.139.250",5440,12,1142,7115,0,0,12,1142,0,0,65.545106,0.00656399999999735,1391834,0
"172.16.133.28",65420,"50.17.220.219",80,13,1740,7116,0,0,7,1335,6,405,65.641356,63.998354000000006,166,50
"157.56.234.118",443,"172.16.133.121",53747,17,2537,7117,0,0,10,2111,7,426,65.650456,212.70185199999997,79,16
"172.16.133.78",59212,"172.16.139.250",5440,12,1142,7118,0,0,12,1142,0,0,65.700902,0.006333999999995399,1442374,0
"172.16.133.67",55989,"172.16.139.250",5440,12,1142,7119,0,0,12,1142,0,0,65.755464,0.0059040000000010195,1547425,0
"172.16.133.56",61433,"172.16.139.250",5440,10,1022,7120,0,0,10,1022,0,0,65.777623,0.004849999999990473,"",""
"172.16.133.48",60515,"184.73.197.44",443,19,8172,7121,0,0,9,2106,10,6066,65.79352,10.219024000000005,1648,4748
"172.16.133.42",57071,"172.16.139.250",5440,12,1142,7122,0,0,12,1142,0,0,65.82047,0.023566999999999894,387660,0
"172.16.133.41",52999,"172.16.139.250",5440,12,1142,7123,0,0,12,1142,0,0,65.833867,0.00866800000000012,1053991,0
"172.16.133.85",52277,"172.16.139.250",5440,12,1142,7124,0,0,12,1142,0,0,65.85131,0.015482000000005769,590104,0
"172.16.133.43",57787,"172.16.139.250",5440,10,1022,7125,0,0,10,1022,0,0,65.905361,0.0052540000000078635,1556147,0
"172.16.133.13",53043,"172.16.139.250",5440,10,1022,7126,0,0,10,1022,0,0,65.922666,0.014472999999995295,564913,0
"172.16.133.20",62399,"172.16.139.250",5440,10,1022,7127,0,0,10,1022,0,0,65.971674,0.014562000000012176,561461,0
"172.16.133.75",50961,"172.16.139.250",5440,10,1022,7128,0,0,10,1022,0,0,65.988425,0.015362999999993576,532187,0
"172.16.133.28",65421,"172.16.139.250",5440,10,1022,7129,0,0,10,1022,0,0,66.003365,0.005729000000002316,1427125,0
"172.16.133.99",56047,"172.16.139.250",5440,10,1022,7130,0,0,10,1022,0,0,66.028829,0.005075000000005048,1611034,0
"172.16.133.87",60207,"172.16.139.250",5440,10,1022,7131,0,0,10,1022,0,0,66.051599,0.01229000000000724,665256,0
"172.16.133.35",49976,"172.16.139.250",5440,12,1142,7132,0,0,12,1142,0,0,66.064029,0.013566999999994778,673398,0
"172.16.133.116",53359,"172.16.139.250",5440,12,1142,7133,0,0,12,1142,0,0,66.066046,0.008459000000001993,1080033,0
"172.16.133.116",53360,"172.16.139.250",5440,12,1142,7134,0,0,12,1142,0,0,66.075048,0.006135000000000446,1489160,0
"172.16.133.116",53361,"172.16.139.250",5440,10,1022,7135,0,0,10,1022,0,0,66.081609,0.014383999999992625,568409,0
"172.16.133.84",58797,"172.16.139.250",5440,10,1022,7136,0,0,10,1022,0,0,66.090536,0.008954000000002793,913111,0
"172.16.133.28",65422,"68.64.5.249",443,6,366,7137,0,0,4,246,2,120,66.098697,0.10889600000000144,18072,8815
"172.16.133.82",61344,"216.115.216.250",443,6,366,7138,0,0,4,246,2,120,66.112337,0.05353200000000413,36763,17933
"172.16.133.28",65423,"68.64.25.250",443,6,366,7139,0,0,4,246,2,120,66.118019,0.11236399999999946,17514,8543
"172.16.133.49",55770,"172.16.139.250",5440,12,1142,7140,0,0,12,1142,0,0,66.16651,0.015518999999997618,588697,0
"172.16.133.82",61345,"68.64.26.250",443,6,366,7141,0,0,4,246,2,120,66.182322,0.12021900000000585,16370,7985
"172.16.133.26",53076,"172.16.128.169",8014,10,4598,7142,0,0,5,1898,5,2700,66.183927,2.214847000000006,6855,9752
"172.16.133.82",61346,"68.64.4.249",443,6,366,7143,0,0,4,246,2,120,66.18817,0.1299149999999969,15148,7389
"172.16.133.95",56973,"172.16.139.250",5440,12,1142,7144,0,0,12,1142,0,0,66.205004,0.006270000000000664,1457097,0
"172.16.133.92",57686,"172.16.139.250",5440,10,1022,7145,0,0,10,1022,0,0,66.231497,0.0055949999999995725,1461304,0
"172.16.133.29",60932,"172.16.139.250",5440,10,1022,7146,0,0,10,1022,0,0,66.250404,0.005557999999993513,1471032,0
"172.16.133.28",65424,"216.115.209.254",443,6,366,7147,0,0,4,246,2,120,66.250591,0.1941669999999931,10135,4944
"172.16.133.44",64805,"172.16.139.250",5440,12,1142,7148,0,0,12,1142,0,0,66.25613,0.006006999999996765,1520892,0
"172.16.133.207",55938,"172.16.139.250",5440,12,1142,7149,0,0,12,1142,0,0,66.284491,0.004781999999991626,"",""
"172.16.133.83",57095,"172.16.139.250",5440,12,1142,7150,0,0,12,1142,0,0,66.289892,0.004692000000005692,"",""
"172.16.133.93",60719,"172.16.139.250",5440,10,1022,7151,0,0,10,1022,0,0,66.306652,0.004565999999996961,"",""
"172.16.133.28",65425,"78.108.119.250",443,6,366,7152,0,0,4,246,2,120,66.320538,0.24973900000000526,7880,3844
"172.16.133.11",55147,"172.16.139.250",5440,10,1022,7153,0,0,10,1022,0,0,66.325131,0.005205000000003679,1570797,0
"172.16.133.55",57585,"172.16.139.250",5440,10,1022,7154,0,0,10,1022,0,0,66.328725,0.01563600000000065,522895,0
"172.16.133.73",60653,"172.16.139.250",5440,10,1022,7155,0,0,10,1022,0,0,66.351578,0.005725999999995679,1427872,0
"172.16.133.53",54104,"172.16.139.250",5440,10,1022,7156,0,0,10,1022,0,0,66.354025,0.015921000000005847,513535,0
"172.16.133.21",53178,"172.16.139.250",5440,10,1022,7157,0,0,10,1022,0,0,66.355865,0.005662000000000944,1444012,0
"172.16.133.30",62621,"172.16.139.250",5440,10,1022,7158,0,0,10,1022,0,0,66.360035,0.00677900000000875,1206077,0
"172.16.133.25",63460,"172.16.139.250",5440,12,1142,7159,0,0,12,1142,0,0,66.368277,0.016784999999998718,544295,0
"172.16.133.34",50444,"172.16.139.250",5440,10,1022,7160,0,0,10,1022,0,0,66.376211,0.005060999999997762,1615491,0
"172.16.133.97",59377,"172.16.139.250",5440,10,1022,7161,0,0,10,1022,0,0,66.38805,0.0054239999999907695,1507374,0
"172.16.133.33",57886,"172.16.139.250",5440,12,1142,7162,0,0,12,1142,0,0,66.461918,0.006723000000008028,1358917,0
"172.16.133.82",61347,"216.219.116.244",443,6,366,7163,0,0,4,246,2,120,66.479314,0.2615909999999957,7523,3669
"172.16.133.68",60733,"172.16.139.250",5440,10,1022,7164,0,0,10,1022,0,0,66.49393,0.005934999999993806,1377590,0
"172.16.133.12",59739,"172.16.139.250",5440,12,1142,7165,0,0,12,1142,0,0,66.507013,0.0062680000000057134,1457562,0
"172.16.133.63",53884,"172.16.139.250",5440,12,1142,7166,0,0,12,1142,0,0,66.516996,0.015204999999994584,600854,0
"172.16.133.66",53869,"172.16.139.250",5440,10,1022,7167,0,0,10,1022,0,0,66.53187,0.005517999999995027,1481696,0
"172.16.133.82",61348,"172.16.139.250",5440,10,1022,7168,0,0,10,1022,0,0,66.5439,0.015489000000002306,527858,0
"172.16.133.37",60630,"172.16.139.250",5440,12,1142,7169,0,0,12,1142,0,0,66.558361,0.016537999999997055,552424,0
"172.16.133.29",60933,"68.64.5.249",443,6,366,7170,0,0,4,246,2,120,66.603295,0.10336099999999249,19040,9287
"172.16.133.29",60934,"68.64.25.250",443,6,366,7171,0,0,4,246,2,120,66.618551,0.11970700000000534,16440,8019
"172.16.128.233",55233,"172.16.133.233",22,207,22756,7172,0,0,57,4678,150,18078,66.660211,9.037172999999996,4141,16003
"172.16.133.49",55651,"172.16.139.250",5440,4,240,7173,0,0,4,240,0,0,66.673964,7.600000000707041e-05,"",""
"172.16.133.49",55771,"172.16.139.250",5440,10,1020,7174,0,0,10,1020,0,0,66.674539,120.01074799999999,67,0
"172.16.133.99",55927,"172.16.139.250",5440,4,240,7175,0,0,4,240,0,0,66.689501,0.00016699999999048032,"",""
"172.16.133.82",61175,"172.16.139.250",5440,4,240,7176,0,0,4,240,0,0,66.689903,6.399999999473494e-05,"",""
"172.16.133.87",60034,"172.16.139.250",5440,4,240,7177,0,0,4,240,0,0,66.689966,0.00016100000000562886,"",""
"172.16.133.99",56048,"172.16.139.250",5440,10,1020,7178,0,0,10,1020,0,0,66.690226,120.01052899999999,67,0
"172.16.133.82",61349,"172.16.139.250",5440,10,1020,7179,0,0,10,1020,0,0,66.690476,120.01073899999999,67,0
"172.16.133.87",60208,"172.16.139.250",5440,10,1020,7180,0,0,10,1020,0,0,66.691032,120.01031,67,0
"172.16.133.78",59213,"172.16.139.250",5440,10,1022,7181,0,0,10,1022,0,0,66.714576,0.016191000000006284,504971,0
"172.16.133.29",60935,"216.115.209.254",443,6,366,7182,0,0,4,246,2,120,66.746322,0.21370199999999784,9209,4492
"172.16.133.76",62360,"173.194.43.38",80,17,2267,7183,0,0,9,1025,8,1242,66.761359,225.35011699999998,36,44
"172.16.133.67",55990,"172.16.139.250",5440,10,1022,7184,0,0,10,1022,0,0,66.769461,0.01477999999998758,553179,0
"172.16.133.29",60936,"78.108.119.250",443,6,366,7185,0,0,4,246,2,120,66.782369,0.2574900000000042,7643,3728
"172.16.133.56",61434,"172.16.139.250",5440,10,1022,7186,0,0,10,1022,0,0,66.792037,0.005038000000013199,1622866,0
"172.16.133.42",57072,"172.16.139.250",5440,12,1142,7187,0,0,12,1142,0,0,66.832222,0.0388499999999965,235160,0
"172.16.133.41",53000,"172.16.139.250",5440,10,1022,7188,0,0,10,1022,0,0,66.84823,0.015173000000004322,538851,0
"172.16.133.85",52278,"172.16.139.250",5440,10,1022,7189,0,0,10,1022,0,0,66.865489,0.005412000000006856,1510716,0
"172.16.133.43",57788,"172.16.139.250",5440,10,1022,7190,0,0,10,1022,0,0,66.919128,0.005465999999998417,1495792,0
"172.16.133.13",53044,"172.16.139.250",5440,10,1022,7191,0,0,10,1022,0,0,66.936809,0.005412000000006856,1510716,0
"172.16.133.20",62400,"172.16.139.250",5440,12,1142,7192,0,0,12,1142,0,0,66.985807,0.004872000000005983,"",""
"172.16.133.75",50962,"172.16.139.250",5440,10,1022,7193,0,0,10,1022,0,0,67.002554,0.00574100000000044,1424142,0
"172.16.133.28",65426,"172.16.139.250",5440,12,1142,7194,0,0,12,1142,0,0,67.017052,0.006107000000000085,1495988,0
"172.16.133.99",56049,"172.16.139.250",5440,10,1022,7195,0,0,10,1022,0,0,67.043686,0.014475000000004457,564835,0
"172.16.133.87",60209,"172.16.139.250",5440,10,1022,7196,0,0,10,1022,0,0,67.06608,0.006939000000002693,1178267,0
"172.16.133.35",49977,"172.16.139.250",5440,12,1142,7197,0,0,12,1142,0,0,67.076763,0.007824999999996862,1167539,0
"172.16.133.116",53362,"172.16.139.250",5440,10,1022,7198,0,0,10,1022,0,0,67.080842,0.005583000000001448,1464445,0
"172.16.133.116",53363,"172.16.139.250",5440,10,1022,7199,0,0,10,1022,0,0,67.087392,0.005335999999999785,1532233,0
"172.16.133.116",53364,"172.16.139.250",5440,10,1022,7200,0,0,10,1022,0,0,67.093611,0.01551200000000108,527075,0
"172.16.133.84",58798,"172.16.139.250",5440,10,1022,7201,0,0,10,1022,0,0,67.104894,0.007780999999994265,1050764,0
"172.16.133.49",55772,"172.16.139.250",5440,10,1022,7202,0,0,10,1022,0,0,67.180848,0.005481000000003178,1491698,0
"172.16.133.35",49978,"172.16.128.169",8014,12,5434,7203,0,0,6,2674,6,2760,67.189932,2.3298599999999965,9181,9476
"172.16.133.95",56974,"172.16.139.250",5440,12,1142,7204,0,0,12,1142,0,0,67.218449,0.016620999999986452,549666,0
"172.16.133.92",57687,"172.16.139.250",5440,10,1022,7205,0,0,10,1022,0,0,67.24595,0.005400000000008731,1514074,0
"172.16.133.29",60937,"172.16.139.250",5440,10,1022,7206,0,0,10,1022,0,0,67.263526,0.005210000000005266,1569289,0
"172.16.133.44",64806,"172.16.139.250",5440,10,1022,7207,0,0,10,1022,0,0,67.270051,0.005462000000008516,1496887,0
"172.16.133.207",55939,"172.16.139.250",5440,12,1142,7208,0,0,12,1142,0,0,67.296157,0.016392000000010398,557345,0
"172.16.133.83",57096,"172.16.139.250",5440,10,1022,7209,0,0,10,1022,0,0,67.304048,0.004651000000009731,"",""
"172.16.133.93",60720,"172.16.139.250",5440,10,1022,7210,0,0,10,1022,0,0,67.320574,0.004697000000007279,"",""
"172.16.133.11",55148,"172.16.139.250",5440,10,1022,7211,0,0,10,1022,0,0,67.338842,0.015943000000007146,512826,0
"172.16.128.169",1923,"172.16.139.250",80,9,1229,7212,0,0,5,488,4,741,67.339849,0.2820679999999953,13840,21016
"172.16.133.55",57586,"172.16.139.250",5440,10,1022,7213,0,0,10,1022,0,0,67.342335,0.00539999999999452,1514074,0
"172.16.133.73",60654,"172.16.139.250",5440,10,1022,7214,0,0,10,1022,0,0,67.364859,0.005350000000007071,1528224,0
"172.16.133.53",54105,"172.16.139.250",5440,12,1142,7215,0,0,12,1142,0,0,67.367477,0.007347000000009984,1243500,0
"172.16.133.21",53179,"172.16.139.250",5440,10,1022,7216,0,0,10,1022,0,0,67.370339,0.015208999999998696,537576,0
"172.16.133.30",62623,"172.16.139.250",5440,10,1022,7217,0,0,10,1022,0,0,67.373762,0.01609399999999539,508015,0
"172.16.133.41",53001,"216.52.121.204",80,37,30893,7218,0,0,12,3705,25,27188,67.382954,6.349827000000005,4667,34253
"172.16.133.25",63461,"172.16.139.250",5440,10,1022,7219,0,0,10,1022,0,0,67.383254,0.010004000000009228,817273,0
"172.16.133.34",50445,"172.16.139.250",5440,10,1022,7220,0,0,10,1022,0,0,67.391075,0.006067000000001599,1347618,0
"172.16.133.97",59378,"172.16.139.250",5440,10,1022,7221,0,0,10,1022,0,0,67.402285,0.015292999999999779,534623,0
"172.16.133.41",53002,"216.52.121.204",80,12,3951,7222,0,0,7,3394,5,557,67.403122,0.13221599999999967,205360,33702
"172.16.133.41",53003,"216.52.121.204",80,12,3951,7223,0,0,7,3394,5,557,67.407257,0.14402499999999918,188522,30939
"172.16.133.41",53004,"216.52.121.204",80,12,3951,7224,0,0,7,3394,5,557,67.412265,0.13472099999999898,201542,33075
"172.16.133.41",53005,"216.52.121.204",80,12,3951,7225,0,0,7,3394,5,557,67.414673,0.13249900000000991,204922,33630
"172.16.133.113",55617,"172.16.139.250",135,8,492,7226,0,0,8,492,0,0,67.462168,0.014135999999993487,278438,0
"172.16.133.33",57887,"172.16.139.250",5440,10,1022,7227,0,0,10,1022,0,0,67.47579,0.006441999999992731,1269171,0
"172.16.133.113",55618,"172.16.139.250",5462,10,696,7228,0,0,10,696,0,0,67.477421,0.5089989999999887,10939,0
"172.16.133.68",60734,"172.16.139.250",5440,10,1022,7229,0,0,10,1022,0,0,67.507616,0.0055490000000020245,1473418,0
"172.16.133.12",59740,"172.16.139.250",5440,12,1142,7230,0,0,12,1142,0,0,67.520855,0.006090000000000373,1500164,0
"172.16.133.63",53885,"172.16.139.250",5440,10,1022,7231,0,0,10,1022,0,0,67.531268,0.015455000000002883,529019,0
"172.16.133.66",53870,"172.16.139.250",5440,10,1022,7232,0,0,10,1022,0,0,67.545109,0.005546000000009599,1474215,0
"172.16.133.82",61350,"172.16.139.250",5440,10,1022,7233,0,0,10,1022,0,0,67.559374,0.005690000000001305,1436906,0
"172.16.133.37",60631,"172.16.139.250",5440,10,1022,7234,0,0,10,1022,0,0,67.572557,0.014639999999999986,558469,0
"172.16.133.78",59214,"172.16.139.250",5440,10,1022,7235,0,0,10,1022,0,0,67.729591,0.01596999999999582,511959,0
"172.16.133.67",55991,"172.16.139.250",5440,10,1022,7236,0,0,10,1022,0,0,67.783988,0.015389000000013198,531288,0
"172.16.133.73",60655,"173.194.43.43",443,41,11445,7237,0,0,20,2553,21,8892,67.801231,220.450033,92,322
"172.16.133.56",61435,"172.16.139.250",5440,12,1142,7238,0,0,12,1142,0,0,67.805791,0.005098000000003822,1792075,0
"172.16.133.116",53365,"23.0.49.244",80,6,372,7239,0,0,4,246,2,126,67.815794,14.34615500000001,137,70
"172.16.133.42",57073,"172.16.139.250",5440,12,1142,7240,0,0,12,1142,0,0,67.845987,0.15212100000000817,60057,0
"172.16.133.83",53373,"172.16.139.250",5500,6,4640,7241,0,0,6,4640,0,0,67.851701,0.00757999999999015,4897097,0
"172.16.133.41",53006,"172.16.139.250",5440,12,1142,7242,0,0,12,1142,0,0,67.861932,0.08125200000000632,112440,0
"172.16.133.26",53077,"107.20.103.220",443,332,182127,7243,0,0,210,136252,122,45875,67.873147,148.636164,7333,2469
"172.16.133.85",52279,"172.16.139.250",5440,10,1022,7244,0,0,10,1022,0,0,67.879319,0.06765900000000613,120841,0
"172.16.133.73",60656,"74.125.226.5",80,17,1999,7245,0,0,9,966,8,1033,67.93182,225.490653,34,36
"172.16.133.43",57789,"172.16.139.250",5440,10,1022,7246,0,0,10,1022,0,0,67.933158,0.08104399999999146,100883,0
"172.16.133.13",53045,"172.16.139.250",5440,10,1022,7247,0,0,10,1022,0,0,67.95145,0.058267000000000735,140319,0
"172.16.133.20",62401,"172.16.139.250",5440,10,1022,7248,0,0,10,1022,0,0,67.999699,0.018179999999986762,449724,0
"172.16.133.73",60657,"74.125.170.143",80,825,1051673,7249,0,0,125,11868,700,1039805,68.009029,12.408271999999997,7651,670394
"172.16.133.73",60658,"74.125.170.143",80,3948,4776833,7250,0,0,817,58156,3131,4718677,68.009134,70.668821,6583,534173
"172.16.133.75",50963,"172.16.139.250",5440,12,1142,7251,0,0,12,1142,0,0,68.01693,0.007013999999998077,1302537,0
"172.16.133.73",60659,"74.125.170.143",80,6,372,7252,0,0,4,246,2,126,68.024127,10.695552000000006,184,94
"172.16.133.28",65427,"172.16.139.250",5440,12,1142,7253,0,0,12,1142,0,0,68.031396,0.005899999999996908,1548474,0
"172.16.133.99",56050,"172.16.139.250",5440,12,1142,7254,0,0,12,1142,0,0,68.057609,0.01453300000000013,628638,0
"172.16.133.87",60210,"172.16.139.250",5440,12,1142,7255,0,0,12,1142,0,0,68.079314,0.015441000000009808,591671,0
"172.16.133.35",49979,"172.16.139.250",5440,12,1142,7256,0,0,12,1142,0,0,68.09393,0.12952400000000353,70535,0
"172.16.133.116",53366,"172.16.139.250",5440,10,1022,7257,0,0,10,1022,0,0,68.097546,0.006133000000005495,1333115,0
"172.16.133.116",53367,"172.16.139.250",5440,10,1022,7258,0,0,10,1022,0,0,68.104425,0.005229999999997403,1563288,0
"172.16.133.116",53368,"172.16.139.250",5440,10,1022,7259,0,0,10,1022,0,0,68.110152,0.0049949999999938655,"",""
"172.16.133.84",58799,"172.16.139.250",5440,10,1022,7260,0,0,10,1022,0,0,68.116472,0.0053089999999968995,1540026,0
"172.16.133.28",65428,"68.64.5.249",443,6,366,7261,0,0,4,246,2,120,68.155411,0.1077449999999942,18265,8909
"172.16.133.28",65429,"68.64.25.250",443,6,366,7262,0,0,4,246,2,120,68.173424,0.12728800000000717,15461,7541
"172.16.133.49",55773,"172.16.139.250",5440,10,1022,7263,0,0,10,1022,0,0,68.194673,0.005774999999999864,1415757,0
"172.16.133.95",56975,"172.16.139.250",5440,10,1022,7264,0,0,10,1022,0,0,68.232973,0.00539999999999452,1514074,0
"172.16.133.92",57688,"172.16.139.250",5440,10,1022,7265,0,0,10,1022,0,0,68.260693,0.015427999999999997,529945,0
"172.16.133.29",60938,"172.16.139.250",5440,10,1022,7266,0,0,10,1022,0,0,68.277691,0.014709999999993784,555812,0
"172.16.133.44",64807,"172.16.139.250",5440,10,1022,7267,0,0,10,1022,0,0,68.288457,0.0075590000000005375,1081624,0
"172.16.133.93",60721,"199.48.204.30",80,17,8343,7268,0,0,8,1167,9,7176,68.305051,9.251373999999998,1009,6205
"172.16.133.207",55940,"172.16.139.250",5440,12,1142,7269,0,0,12,1142,0,0,68.309881,0.017694999999989136,516304,0
"172.16.133.83",57097,"172.16.139.250",5440,12,1142,7270,0,0,12,1142,0,0,68.317915,0.005746000000002027,1589975,0
"172.16.133.93",60722,"172.16.139.250",5440,12,1142,7271,0,0,12,1142,0,0,68.334289,0.0047969999999963875,"",""
"172.16.133.11",55149,"172.16.139.250",5440,10,1022,7272,0,0,10,1022,0,0,68.3527,0.005386000000001445,1518009,0
"172.16.133.28",65430,"216.115.209.254",443,6,366,7273,0,0,4,246,2,120,68.35345,0.2005929999999978,9810,4785
"172.16.133.55",57587,"172.16.139.250",5440,10,1022,7274,0,0,10,1022,0,0,68.355897,0.01553400000000238,526329,0
"172.16.133.73",60660,"172.16.139.250",5440,10,1022,7275,0,0,10,1022,0,0,68.378933,0.00546299999999178,1496613,0
"172.16.133.53",54106,"172.16.139.250",5440,12,1142,7276,0,0,12,1142,0,0,68.381797,0.0072449999999975034,1261007,0
"172.16.133.21",53180,"172.16.139.250",5440,10,1022,7277,0,0,10,1022,0,0,68.384152,0.008101999999993836,1009133,0
"172.16.133.30",62624,"172.16.139.250",5440,12,1142,7278,0,0,12,1142,0,0,68.388158,0.0176529999999957,517532,0
"172.16.133.83",57098,"172.16.139.250",5440,12,1142,7279,0,0,12,1142,0,0,68.396506,0.0047560000000004266,"",""
"172.16.133.25",63462,"172.16.139.250",5440,10,1022,7280,0,0,10,1022,0,0,68.399071,0.011693999999991433,699161,0
"172.16.133.34",50446,"172.16.139.250",5440,10,1022,7281,0,0,10,1022,0,0,68.404916,0.00935400000000186,874064,0
"172.16.133.97",59379,"172.16.139.250",5440,12,1142,7282,0,0,12,1142,0,0,68.415009,0.016801000000000954,543777,0
"172.16.133.28",65431,"78.108.119.250",443,6,366,7283,0,0,4,246,2,120,68.449375,0.2418869999999913,8136,3968
"172.16.133.33",57888,"172.16.139.250",5440,10,1022,7284,0,0,10,1022,0,0,68.490917,0.007517000000007101,1087667,0
"172.16.133.73",60661,"173.194.75.99",80,53,39746,7285,0,0,19,4205,34,35541,68.501835,225.956001,148,1258
"172.16.133.68",60735,"172.16.139.250",5440,10,1022,7286,0,0,10,1022,0,0,68.52194,0.01544699999999466,529293,0
"172.16.133.12",59741,"172.16.139.250",5440,12,1142,7287,0,0,12,1142,0,0,68.536273,0.006120000000009895,1492810,0
"172.16.133.120",53447,"74.125.226.39",443,30,6299,7288,0,0,16,2317,14,3982,68.538389,225.38072,82,141
"172.16.133.63",53886,"172.16.139.250",5440,12,1142,7289,0,0,12,1142,0,0,68.544049,0.015642999999997187,584031,0
"172.16.133.82",61351,"172.16.139.250",5440,10,1022,7290,0,0,10,1022,0,0,68.546982,0.005443999999997118,1501836,0
"172.16.133.66",53871,"172.16.139.250",5440,12,1142,7291,0,0,12,1142,0,0,68.560076,0.006911000000002332,1321950,0
"172.16.133.82",61352,"172.16.139.250",5440,12,1142,7292,0,0,12,1142,0,0,68.575223,0.006970000000009691,1310760,0
"172.16.133.37",60632,"172.16.139.250",5440,12,1142,7293,0,0,12,1142,0,0,68.586338,0.015554000000008728,587373,0
"172.16.133.73",60662,"74.125.226.26",80,17,1640,7294,0,0,9,969,8,671,68.642651,225.27477,34,23
"172.16.133.29",60939,"68.64.5.249",443,6,366,7295,0,0,4,246,2,120,68.65939,0.10003499999999121,19673,9596
"172.16.133.29",60940,"68.64.25.250",443,6,366,7296,0,0,4,246,2,120,68.679581,0.13459600000000194,14621,7132
"172.16.133.66",53872,"173.194.43.53",443,197,152872,7297,0,0,77,41933,120,110939,68.68571,205.69523999999998,1630,4314
"172.16.133.120",53448,"96.43.146.22",443,17,1415,7298,0,0,9,806,8,609,68.688315,225.383551,28,21
"172.16.133.120",53449,"96.43.146.22",443,17,1415,7299,0,0,9,806,8,609,68.688642,225.392385,28,21
"172.16.133.93",60723,"168.215.63.101",80,9,1188,7300,0,0,5,773,4,415,68.691634,0.16105200000001219,38397,20614
"213.199.179.161",40047,"172.16.133.26",53913,19,1152,7301,0,0,11,672,8,480,68.71813,226.39131999999998,23,16
"172.16.133.78",59215,"172.16.139.250",5440,12,1142,7302,0,0,12,1142,0,0,68.743744,0.00673099999998783,1357302,0
"172.16.133.67",55992,"172.16.139.250",5440,12,1142,7303,0,0,12,1142,0,0,68.797536,0.015373000000010961,594288,0
"172.16.133.120",53450,"96.43.146.22",443,37,16864,7304,0,0,21,14709,16,2155,68.806766,9.297179999999997,12656,1854
"172.16.133.73",60663,"173.194.43.41",80,135,144573,7305,0,0,33,2374,102,142199,68.811501,225.41377899999998,84,5046
"172.16.133.56",61436,"172.16.139.250",5440,10,1022,7306,0,0,10,1022,0,0,68.819733,0.00480299999999545,"",""
"172.16.133.29",60941,"216.115.209.254",443,6,366,7307,0,0,4,246,2,120,68.864471,0.22768400000001066,8643,4216
"172.16.133.42",57074,"172.16.139.250",5440,12,1142,7308,0,0,12,1142,0,0,68.865937,0.04618899999999826,197796,0
"172.16.133.41",53007,"172.16.139.250",5440,12,1142,7309,0,0,12,1142,0,0,68.87704,0.0135710000000131,673200,0
"172.16.133.85",52280,"172.16.139.250",5440,10,1022,7310,0,0,10,1022,0,0,68.893504,0.0058760000000006585,1391422,0
"172.16.133.29",60942,"78.108.119.250",443,6,366,7311,0,0,4,246,2,120,68.919434,0.2742140000000006,7176,3500
"172.16.133.43",57790,"172.16.139.250",5440,12,1142,7312,0,0,12,1142,0,0,68.94756,0.006443000000004417,1417972,0
"172.16.133.13",53046,"172.16.139.250",5440,12,1142,7313,0,0,12,1142,0,0,68.964885,0.00628400000000795,1453851,0
"172.16.133.20",62402,"172.16.139.250",5440,12,1142,7314,0,0,12,1142,0,0,69.013824,0.005160000000003606,1770542,0
"172.16.133.28",65432,"172.16.139.250",5440,10,1022,7315,0,0,10,1022,0,0,69.045096,0.01928800000000308,423890,0
"172.16.133.99",56051,"172.16.139.250",5440,12,1142,7316,0,0,12,1142,0,0,69.071699,0.014929000000009296,611963,0
"172.16.133.87",60211,"172.16.139.250",5440,10,1022,7317,0,0,10,1022,0,0,69.093859,0.01553600000001154,526261,0
"172.16.133.116",53369,"172.16.139.250",5440,10,1022,7318,0,0,10,1022,0,0,69.108116,0.005401000000006206,1513793,0
"172.16.133.116",53370,"172.16.139.250",5440,12,1142,7319,0,0,12,1142,0,0,69.114172,0.00593000000000643,1540640,0
"172.16.133.35",49980,"172.16.139.250",5440,12,1142,7320,0,0,12,1142,0,0,69.114492,0.02389800000000264,382291,0
"172.16.133.116",53371,"172.16.139.250",5440,10,1022,7321,0,0,10,1022,0,0,69.120669,0.005775999999997339,1415512,0
"172.16.133.84",58800,"172.16.139.250",5440,10,1022,7322,0,0,10,1022,0,0,69.131608,0.006269000000003189,1304195,0
"172.16.133.75",50964,"172.16.139.250",5440,10,1022,7323,0,0,10,1022,0,0,69.15093,0.00585399999999936,1396651,0
"172.16.133.103",63399,"172.16.139.250",5440,4,240,7324,0,0,4,240,0,0,69.158318,0.000125000000011255,"",""
"172.16.133.103",63440,"172.16.139.250",5440,10,1020,7325,0,0,10,1020,0,0,69.161511,120.008221,67,0
"172.16.133.73",60664,"173.194.43.35",80,32,17229,7326,0,0,14,2433,18,14796,69.175307,219.082162,88,540
"172.16.133.49",55774,"172.16.139.250",5440,10,1022,7327,0,0,10,1022,0,0,69.208809,0.005606000000000222,1458437,0
"172.16.133.116",53372,"208.111.160.6",80,8,492,7328,0,0,4,246,4,246,69.230486,12.932506000000004,152,152
"172.16.133.116",53373,"208.111.160.6",80,8,492,7329,0,0,4,246,4,246,69.230777,12.932058999999995,152,152
"172.16.133.116",53374,"208.111.160.6",80,8,492,7330,0,0,4,246,4,246,69.231164,12.930851999999987,152,152
"172.16.133.116",53375,"208.111.160.6",80,8,492,7331,0,0,4,246,4,246,69.231554,12.931489999999997,152,152
"172.16.133.116",53376,"208.111.160.6",80,8,492,7332,0,0,4,246,4,246,69.231832,12.930186000000006,152,152
"172.16.133.95",56976,"172.16.139.250",5440,10,1022,7333,0,0,10,1022,0,0,69.246066,0.005250000000003752,1557333,0
"172.16.133.92",57689,"172.16.139.250",5440,10,1022,7334,0,0,10,1022,0,0,69.275188,0.006200000000006867,1318709,0
"172.16.133.29",60943,"172.16.139.250",5440,10,1022,7335,0,0,10,1022,0,0,69.295097,0.016022000000006642,510298,0
"172.16.133.44",64808,"172.16.139.250",5440,12,1142,7336,0,0,12,1142,0,0,69.298486,0.01616800000000751,565066,0
"172.16.133.207",55941,"172.16.139.250",5440,10,1022,7337,0,0,10,1022,0,0,69.323835,0.016691999999991936,489815,0
"172.16.133.83",57099,"172.16.139.250",5440,12,1142,7338,0,0,12,1142,0,0,69.331964,0.004683999999997468,"",""
"172.16.133.93",60724,"172.16.139.250",5440,12,1142,7339,0,0,12,1142,0,0,69.348815,0.014331999999996015,637454,0
"172.16.133.11",55150,"172.16.139.250",5440,12,1142,7340,0,0,12,1142,0,0,69.366432,0.005898000000001957,1548999,0
"172.16.133.55",57588,"172.16.139.250",5440,10,1022,7341,0,0,10,1022,0,0,69.370958,0.005490999999992141,1488981,0
"172.16.133.73",60665,"172.16.139.250",5440,12,1142,7342,0,0,12,1142,0,0,69.395032,0.017253999999994107,529500,0
"172.16.133.53",54107,"172.16.139.250",5440,10,1022,7343,0,0,10,1022,0,0,69.396055,0.005619999999993297,1454804,0
"172.16.133.21",53181,"172.16.139.250",5440,10,1022,7344,0,0,10,1022,0,0,69.397928,0.02141400000000715,381806,0
"172.16.133.30",62625,"172.16.139.250",5440,10,1022,7345,0,0,10,1022,0,0,69.402368,0.005341000000001372,1530799,0
"172.16.133.25",63463,"172.16.139.250",5440,10,1022,7346,0,0,10,1022,0,0,69.410057,0.00562600000000657,1453252,0
"172.16.133.34",50447,"172.16.139.250",5440,12,1142,7347,0,0,12,1142,0,0,69.418879,0.005071000000000936,1801617,0
"172.16.133.73",60666,"173.194.43.60",80,20,3323,7348,0,0,11,1501,9,1822,69.425221,226.24617800000001,53,64
"172.16.133.97",59380,"172.16.139.250",5440,12,1142,7349,0,0,12,1142,0,0,69.430721,0.0058389999999945985,1564651,0
"172.16.133.33",57889,"172.16.139.250",5440,12,1142,7350,0,0,12,1142,0,0,69.504971,0.006262000000006651,1458958,0
"172.16.133.68",60736,"172.16.139.250",5440,10,1022,7351,0,0,10,1022,0,0,69.535824,0.005540999999993801,1475545,0
"172.16.133.116",53377,"64.94.107.62",80,8,1678,7352,0,0,5,1215,3,463,69.544371,0.06452300000000832,150643,57405
"172.16.133.12",59742,"172.16.139.250",5440,12,1142,7353,0,0,12,1142,0,0,69.549042,0.0055899999999979855,1634347,0
"172.16.133.63",53887,"172.16.139.250",5440,10,1022,7354,0,0,10,1022,0,0,69.558254,0.005538000000001375,1476345,0
"172.16.133.66",53873,"172.16.139.250",5440,12,1142,7355,0,0,12,1142,0,0,69.574147,0.006267000000008238,1457794,0
"172.16.133.82",61353,"172.16.139.250",5440,12,1142,7356,0,0,12,1142,0,0,69.58623,0.006247999999999365,1462227,0
"172.16.133.37",60633,"172.16.139.250",5440,12,1142,7357,0,0,12,1142,0,0,69.600414,0.005591999999992936,1633762,0
"172.16.133.12",59743,"216.52.242.80",80,90,71802,7358,0,0,33,12022,57,59780,69.649159,212.068961,453,2255
"172.16.133.12",59744,"216.52.242.80",80,6,372,7359,0,0,4,246,2,126,69.649292,20.136173,97,50
"172.16.133.12",59745,"216.52.242.80",80,6,372,7360,0,0,4,246,2,126,69.649395,20.136882,97,50
"172.16.133.12",59746,"216.52.242.80",80,14,4749,7361,0,0,10,2755,4,1994,69.649498,227.15178000000003,97,70
"172.16.133.12",59747,"64.94.107.63",80,7,428,7362,0,0,4,246,3,182,69.655767,20.053329000000005,98,72
"172.16.133.12",59748,"64.94.107.63",80,7,428,7363,0,0,4,246,3,182,69.655893,10.043791999999996,195,144
"172.16.133.12",59749,"64.94.107.63",80,7,428,7364,0,0,4,246,3,182,69.656016,20.05329300000001,98,72
"172.16.133.12",59750,"23.45.65.19",80,19,2224,7365,0,0,10,1176,9,1048,69.65615,180.06698,52,46
"172.16.133.12",59751,"23.45.65.19",80,6,372,7366,0,0,4,246,2,126,69.656252,20.082086000000004,97,50
"172.16.133.12",59752,"23.45.65.19",80,6,372,7367,0,0,4,246,2,126,69.65635,20.081932999999992,97,50
"172.16.133.12",59753,"8.27.243.253",80,39,20497,7368,0,0,17,2333,22,18164,69.656461,20.056154000000006,930,7245
"172.16.133.12",59754,"8.27.243.253",80,28,13753,7369,0,0,12,1632,16,12121,69.656555,20.055807,650,4834
"172.16.133.12",59755,"8.27.243.253",80,14,3693,7370,0,0,7,827,7,2866,69.656653,20.055871999999994,329,1143
"172.16.133.12",59756,"8.27.243.253",80,17,5965,7371,0,0,8,993,9,4972,69.656763,20.055301,396,1983
"172.16.133.12",59757,"8.27.243.253",80,17,7845,7372,0,0,7,935,10,6910,69.656862,10.043713999999994,744,5503
"172.16.133.12",59758,"8.27.243.253",80,9,1389,7373,0,0,5,306,4,1083,69.65696,20.055301,122,432
"172.16.133.12",59759,"64.94.107.58",80,7,428,7374,0,0,4,246,3,182,69.657866,20.05154900000001,98,72
"172.16.133.12",59760,"64.94.107.58",80,8,1411,7375,0,0,5,948,3,463,69.657986,2.6528120000000115,2858,1396
"172.16.133.12",59761,"64.94.107.58",80,7,428,7376,0,0,4,246,3,182,69.658091,20.049949999999995,98,72
"172.16.133.12",59762,"50.16.236.32",80,7,432,7377,0,0,4,246,3,186,69.659064,10.108743000000004,194,147
"172.16.133.12",59763,"50.16.236.32",80,7,432,7378,0,0,4,246,3,186,69.65918,10.108532999999994,194,147
"172.16.133.12",59764,"50.16.236.32",80,7,432,7379,0,0,4,246,3,186,69.659279,10.108338000000003,194,147
"172.16.133.12",59765,"208.111.161.254",80,8,492,7380,0,0,4,246,4,246,69.659806,20.055797999999996,98,98
"172.16.133.12",59766,"208.111.161.254",80,8,492,7381,0,0,4,246,4,246,69.659916,20.06126400000001,98,98
"172.16.133.12",59767,"208.111.161.254",80,8,492,7382,0,0,4,246,4,246,69.660078,20.055526999999998,98,98
"172.16.133.12",59768,"208.111.161.254",80,8,492,7383,0,0,4,246,4,246,69.66014,20.054575,98,98
"172.16.133.12",59769,"173.252.100.27",80,7,432,7384,0,0,4,246,3,186,69.68767,20.049097000000003,98,74
"172.16.133.12",59770,"173.252.100.27",80,7,432,7385,0,0,4,246,3,186,69.687774,20.039519999999996,98,74
"172.16.133.12",59771,"173.252.100.27",80,7,432,7386,0,0,4,246,3,186,69.687956,20.050326,98,74
"172.16.133.12",59772,"173.252.100.27",443,23,2177,7387,0,0,11,1158,12,1019,69.688121,122.555319,75,66
"172.16.133.12",59773,"23.33.82.110",443,17,3315,7388,0,0,9,951,8,2364,69.688263,22.831891999999996,333,828
"172.16.133.12",59774,"23.33.82.110",443,17,3315,7389,0,0,9,951,8,2364,69.688373,22.820351000000002,333,828
"172.16.133.12",59775,"23.33.82.110",443,17,3315,7390,0,0,9,951,8,2364,69.688476,22.821300000000008,333,828
"172.16.133.73",60667,"173.194.43.43",80,24,9258,7391,0,0,11,1496,13,7762,69.718273,225.29414099999997,53,275
"172.16.133.78",59216,"172.16.139.250",5440,10,1022,7392,0,0,10,1022,0,0,69.756327,0.014987000000004969,545539,0
"172.16.133.67",55993,"172.16.139.250",5440,10,1022,7393,0,0,10,1022,0,0,69.811426,0.00523300000000404,1562392,0
"172.16.133.56",61437,"172.16.139.250",5440,10,1022,7394,0,0,10,1022,0,0,69.833878,0.00508100000000411,1609132,0
"172.16.133.41",53008,"172.16.139.250",5440,10,1022,7395,0,0,10,1022,0,0,69.890978,0.005270999999993364,1551128,0
"172.16.133.42",57075,"172.16.139.250",5440,12,1142,7396,0,0,12,1142,0,0,69.905841,0.025916000000009376,352523,0
"172.16.133.85",52281,"172.16.139.250",5440,10,1022,7397,0,0,10,1022,0,0,69.906671,0.00893299999999897,915258,0
"172.16.133.43",57791,"172.16.139.250",5440,10,1022,7398,0,0,10,1022,0,0,69.961371,0.0054379999999980555,1503493,0
"172.16.133.13",53047,"172.16.139.250",5440,10,1022,7399,0,0,10,1022,0,0,69.97915,0.005388999999993871,1517164,0
"172.16.133.20",62403,"172.16.139.250",5440,12,1142,7400,0,0,12,1142,0,0,70.028032,0.004848000000009733,"",""
"172.16.133.75",50965,"172.16.139.250",5440,10,1022,7401,0,0,10,1022,0,0,70.044279,0.005363000000002671,1524519,0
"172.16.133.28",65433,"172.16.139.250",5440,10,1022,7402,0,0,10,1022,0,0,70.059581,0.007703000000006455,1061404,0
"172.16.133.99",56052,"172.16.139.250",5440,12,1142,7403,0,0,12,1142,0,0,70.08551,0.005024000000005913,1818471,0
"172.16.133.87",60212,"172.16.139.250",5440,12,1142,7404,0,0,12,1142,0,0,70.10783,0.016229999999993083,562908,0
"172.16.133.35",49981,"172.16.139.250",5440,12,1142,7405,0,0,12,1142,0,0,70.12321,0.052789000000004194,173066,0
"172.16.133.116",53378,"172.16.139.250",5440,10,1022,7406,0,0,10,1022,0,0,70.123632,0.015064999999992779,542714,0
"172.16.133.116",53379,"172.16.139.250",5440,10,1022,7407,0,0,10,1022,0,0,70.139257,0.005780999999998926,1414288,0
"172.16.133.27",60920,"74.125.226.232",443,22,6392,7408,0,0,13,2197,9,4195,70.142047,0.15045099999998968,116822,223062
"172.16.133.84",58801,"172.16.139.250",5440,10,1022,7409,0,0,10,1022,0,0,70.144772,0.018407999999993763,444154,0
"172.16.133.116",53380,"172.16.139.250",5440,12,1142,7410,0,0,12,1142,0,0,70.145622,0.006270000000000664,1457097,0
"172.16.133.73",60668,"74.125.226.35",80,24,6761,7411,0,0,13,3959,11,2802,70.204253,225.641548,140,99
"172.16.133.49",55775,"172.16.139.250",5440,10,1022,7412,0,0,10,1022,0,0,70.222986,0.00556499999999005,1469182,0
"172.16.133.95",56977,"172.16.139.250",5440,10,1022,7413,0,0,10,1022,0,0,70.261208,0.014464000000003807,565265,0
"172.16.133.92",57690,"172.16.139.250",5440,12,1142,7414,0,0,12,1142,0,0,70.287991,0.016090999999988753,567770,0
"172.16.133.27",60921,"173.194.43.41",443,44,16859,7415,0,0,25,3138,19,13721,70.294298,0.22785899999999515,110173,481736
"172.16.133.29",60944,"172.16.139.250",5440,10,1022,7416,0,0,10,1022,0,0,70.305336,0.006206000000005929,1317434,0
"172.16.133.44",64809,"172.16.139.250",5440,12,1142,7417,0,0,12,1142,0,0,70.312767,0.015611000000006925,585228,0
"172.16.133.207",55942,"172.16.139.250",5440,10,1022,7418,0,0,10,1022,0,0,70.338239,0.004723999999995954,"",""
"172.16.133.83",57100,"172.16.139.250",5440,12,1142,7419,0,0,12,1142,0,0,70.346079,0.004649999999998045,"",""
"172.16.133.93",60725,"172.16.139.250",5440,12,1142,7420,0,0,12,1142,0,0,70.362669,0.014420999999998685,633520,0
"172.16.133.11",55151,"172.16.139.250",5440,10,1022,7421,0,0,10,1022,0,0,70.37961,0.015801999999993654,517402,0
"172.16.133.47",56476,"216.52.242.80",80,9,2771,7422,0,0,5,1802,4,969,70.384174,117.980325,122,65
"172.16.133.55",57589,"172.16.139.250",5440,10,1022,7423,0,0,10,1022,0,0,70.384967,0.015692999999998847,520996,0
"172.16.133.132",40609,"184.173.189.190",80,6,374,7424,0,0,4,254,2,120,70.406725,0.06120599999999854,33199,15684
"172.16.133.73",60669,"172.16.139.250",5440,12,1142,7425,0,0,12,1142,0,0,70.406726,0.005877999999995609,1554270,0
"172.16.133.53",54108,"172.16.139.250",5440,12,1142,7426,0,0,12,1142,0,0,70.409465,0.006939000000002693,1316616,0
"172.16.133.21",53182,"172.16.139.250",5440,10,1022,7427,0,0,10,1022,0,0,70.412039,0.007886000000013382,1036774,0
"172.16.133.30",62627,"172.16.139.250",5440,12,1142,7428,0,0,12,1142,0,0,70.416289,0.01655399999999929,551890,0
"172.16.133.73",60670,"216.52.242.80",80,6,372,7429,0,0,4,246,2,126,70.423317,18.248554,107,55
"172.16.133.25",63464,"172.16.139.250",5440,10,1022,7430,0,0,10,1022,0,0,70.423505,0.005615999999989185,1455840,0
"172.16.133.34",50448,"172.16.139.250",5440,10,1022,7431,0,0,10,1022,0,0,70.432736,0.004942999999997255,"",""
"172.16.133.73",60671,"173.194.43.57",80,22,5121,7432,0,0,12,3295,10,1826,70.441584,227.16405899999998,116,64
"172.16.133.97",59381,"172.16.139.250",5440,10,1022,7433,0,0,10,1022,0,0,70.444088,0.005530000000007362,1478481,0
"172.16.133.132",33515,"63.116.244.139",80,6,412,7434,0,0,4,272,2,140,70.501884,0.0491439999999983,44278,22790
"172.16.133.33",57890,"172.16.139.250",5440,12,1142,7435,0,0,12,1142,0,0,70.518047,0.006371999999998934,1433772,0
"172.16.133.73",60672,"173.194.43.60",80,6,372,7436,0,0,4,246,2,126,70.540089,18.056572000000003,108,55
"172.16.133.68",60737,"172.16.139.250",5440,10,1022,7437,0,0,10,1022,0,0,70.548729,0.005482000000000653,1491426,0
"172.16.133.12",59776,"172.16.139.250",5440,12,1142,7438,0,0,12,1142,0,0,70.563678,0.006328000000010547,1443742,0
"172.16.133.63",53888,"172.16.139.250",5440,10,1022,7439,0,0,10,1022,0,0,70.572497,0.005544999999997913,1474481,0
"172.16.133.73",60673,"12.130.81.228",80,10,612,7440,0,0,9,546,1,66,70.581011,36.894914,118,14
"172.16.133.73",60674,"12.130.81.228",80,18,10600,7441,0,0,9,5101,9,5499,70.581154,1.8720560000000006,21798,23499
"172.16.133.132",39407,"63.116.244.114",80,6,412,7442,0,0,4,272,2,140,70.584097,0.042972000000006005,50637,26063
"172.16.133.66",53874,"172.16.139.250",5440,10,1022,7443,0,0,10,1022,0,0,70.58739,0.005453000000002817,1499358,0
"172.16.133.82",61354,"172.16.139.250",5440,10,1022,7444,0,0,10,1022,0,0,70.599968,0.01565499999999531,522261,0
"172.16.133.37",60634,"172.16.139.250",5440,12,1142,7445,0,0,12,1142,0,0,70.614102,0.005886000000003833,1552157,0
"172.16.133.132",60633,"23.46.16.170",80,6,412,7446,0,0,4,272,2,140,70.662097,0.037562999999991575,57929,29816
"157.56.245.198",443,"172.16.133.54",64179,8,620,7447,0,0,4,380,4,240,70.703084,180.209922,16,10
"172.16.133.132",51430,"23.67.242.17",80,6,412,7448,0,0,4,272,2,140,70.746114,0.0433749999999975,50167,25821
"172.16.133.78",59217,"172.16.139.250",5440,12,1142,7449,0,0,12,1142,0,0,70.771597,0.006461000000001604,1414022,0
"172.16.133.44",64810,"208.111.161.254",80,29,20223,7450,0,0,10,1469,19,18754,70.773125,29.634697000000003,396,5062
"172.16.133.44",64811,"208.111.161.254",80,62,64786,7451,0,0,14,2379,48,62407,70.773224,29.641686000000007,642,16843
"172.16.133.44",64812,"208.111.161.254",80,43,36075,7452,0,0,15,1529,28,34546,70.773365,29.633199000000005,412,9326
"172.16.133.67",55994,"172.16.139.250",5440,12,1142,7453,0,0,12,1142,0,0,70.824737,0.006275000000002251,1455936,0
"172.16.133.44",64813,"208.111.161.254",80,8,492,7454,0,0,4,246,4,246,70.834915,19.58364200000001,100,100
"172.16.133.56",61438,"172.16.139.250",5440,10,1022,7455,0,0,10,1022,0,0,70.847833,0.004889000000005694,"",""
"172.16.133.42",57076,"172.16.139.250",5440,12,1142,7456,0,0,12,1142,0,0,70.890392,0.06345799999999713,143969,0
"172.16.133.41",53009,"172.16.139.250",5440,10,1022,7457,0,0,10,1022,0,0,70.905171,0.005441000000004692,1502664,0
"172.16.133.76",62361,"173.194.43.47",80,18,3389,7458,0,0,9,828,9,2561,70.908887,225.22110800000002,29,90
"172.16.133.85",52282,"172.16.139.250",5440,10,1022,7459,0,0,10,1022,0,0,70.921134,0.015070000000008577,542534,0
"172.16.133.73",60675,"74.125.170.112",80,15,6231,7460,0,0,8,4268,7,1963,70.960356,0.39967199999999536,85430,39292
"172.16.133.43",57792,"172.16.139.250",5440,10,1022,7461,0,0,10,1022,0,0,70.97527,0.005481000000003178,1491698,0
"172.16.133.13",53048,"172.16.139.250",5440,10,1022,7462,0,0,10,1022,0,0,70.992694,0.005353999999996972,1527082,0
"172.16.133.44",64814,"216.52.242.80",80,131,101083,7463,0,0,51,23522,80,77561,71.000368,194.21180700000002,968,3194
"172.16.133.73",60676,"74.125.170.112",80,12,3949,7464,0,0,6,2586,6,1363,71.023311,2.5695399999999893,8051,4243
"172.16.133.20",62404,"172.16.139.250",5440,12,1142,7465,0,0,12,1142,0,0,71.041862,0.004806999999999562,"",""
"172.16.133.44",64815,"173.194.43.59",80,24,8363,7466,0,0,13,5222,11,3141,71.057845,197.96162400000003,211,126
"172.16.133.75",50966,"172.16.139.250",5440,10,1022,7467,0,0,10,1022,0,0,71.059252,0.01614600000000621,506379,0
"172.16.133.28",65434,"172.16.139.250",5440,10,1022,7468,0,0,10,1022,0,0,71.073175,0.005845999999991136,1398563,0
"172.16.133.44",64816,"206.33.41.253",80,20,6400,7469,0,0,9,957,11,5443,71.096929,9.317612999999994,821,4673
"172.16.133.99",56053,"172.16.139.250",5440,12,1142,7470,0,0,12,1142,0,0,71.099615,0.005076999999999998,1799487,0
"172.16.133.87",60213,"172.16.139.250",5440,10,1022,7471,0,0,10,1022,0,0,71.121842,0.0055499999999995,1473153,0
"172.16.133.35",49982,"172.16.139.250",5440,12,1142,7472,0,0,12,1142,0,0,71.135369,0.03680400000000361,248233,0
"172.16.133.116",53381,"172.16.139.250",5440,10,1022,7473,0,0,10,1022,0,0,71.138601,0.0055490000000020245,1473418,0
"172.16.133.116",53382,"172.16.139.250",5440,10,1022,7474,0,0,10,1022,0,0,71.145135,0.017070000000003915,478968,0
"172.16.133.26",53075,"172.16.139.250",5440,4,240,7475,0,0,4,240,0,0,71.158477,5.699999999819738e-05,"",""
"172.16.133.26",53078,"172.16.139.250",5440,12,1140,7476,0,0,12,1140,0,0,71.15929,120.01078899999999,75,0
"172.16.133.84",58802,"172.16.139.250",5440,10,1022,7477,0,0,10,1022,0,0,71.159447,0.007232000000001904,1130530,0
"172.16.133.116",53383,"172.16.139.250",5440,10,1022,7478,0,0,10,1022,0,0,71.16282,0.01140399999999886,716941,0
"172.16.133.49",55776,"172.16.139.250",5440,10,1022,7479,0,0,10,1022,0,0,71.236741,0.01569000000000642,521096,0
"172.16.133.95",56978,"172.16.139.250",5440,12,1142,7480,0,0,12,1142,0,0,71.275391,0.005560000000002674,1643165,0
"172.16.133.92",57691,"172.16.139.250",5440,10,1022,7481,0,0,10,1022,0,0,71.302003,0.018596000000002277,439664,0
"172.16.133.29",60945,"172.16.139.250",5440,12,1142,7482,0,0,12,1142,0,0,71.319184,0.00625999999999749,1459424,0
"172.16.133.44",64817,"172.16.139.250",5440,12,1142,7483,0,0,12,1142,0,0,71.326425,0.015867000000000075,575786,0
"172.16.133.207",55943,"172.16.139.250",5440,12,1142,7484,0,0,12,1142,0,0,71.351989,0.016873000000003913,541456,0
"172.16.133.83",57101,"172.16.139.250",5440,12,1142,7485,0,0,12,1142,0,0,71.360195,0.004688999999999055,"",""
"172.16.133.44",64818,"64.94.107.55",80,7,428,7486,0,0,4,246,3,182,71.368533,19.041921000000002,103,76
"172.16.133.44",64819,"64.94.107.55",80,7,428,7487,0,0,4,246,3,182,71.370114,19.037155,103,76
"172.16.133.44",64820,"64.94.107.55",80,7,428,7488,0,0,4,246,3,182,71.370338,19.036789,103,76
"172.16.133.93",60726,"172.16.139.250",5440,12,1142,7489,0,0,12,1142,0,0,71.376705,0.004715000000004466,"",""
"172.16.133.44",64821,"173.194.43.45",80,6,372,7490,0,0,4,246,2,126,71.380645,19.031715000000005,103,52
"172.16.133.44",64822,"173.194.43.45",80,6,372,7491,0,0,4,246,2,126,71.380768,19.03072999999999,103,52
"172.16.133.44",64823,"173.194.43.58",80,6,372,7492,0,0,4,246,2,126,71.381332,19.034595999999993,103,52
"172.16.133.44",64824,"173.194.43.58",80,6,372,7493,0,0,4,246,2,126,71.381481,19.03456100000001,103,52
"172.16.133.44",64825,"173.194.43.58",443,15,3612,7494,0,0,8,967,7,2645,71.381596,6.776707999999999,1141,3122
"172.16.133.44",64826,"64.94.107.14",80,8,1499,7495,0,0,5,1036,3,463,71.381763,0.3161489999999958,26215,11715
"172.16.133.44",64827,"64.94.107.14",80,8,1696,7496,0,0,5,1233,3,463,71.381868,3.738456999999997,2638,990
"172.16.133.44",64828,"64.94.107.14",80,7,428,7497,0,0,4,246,3,182,71.38197,18.610582000000008,105,78
"172.16.133.12",59777,"173.194.43.60",80,24,6162,7498,0,0,13,3756,11,2406,71.390495,225.58410000000003,133,85
"172.16.133.11",55152,"172.16.139.250",5440,10,1022,7499,0,0,10,1022,0,0,71.39394,0.015280000000004179,535078,0
"172.16.133.55",57590,"172.16.139.250",5440,10,1022,7500,0,0,10,1022,0,0,71.397985,0.015426999999988311,529979,0
"172.16.133.44",64829,"208.47.254.83",80,6,372,7501,0,0,4,246,2,126,71.407859,19.002798999999996,103,53
"172.16.133.44",64830,"208.47.254.83",80,6,372,7502,0,0,4,246,2,126,71.408019,19.002638000000005,103,53
"172.16.133.44",64831,"138.108.6.20",80,11,2965,7503,0,0,6,1835,5,1130,71.410827,17.175695000000005,854,526
"172.16.133.44",64832,"138.108.6.20",80,4,252,7504,0,0,2,126,2,126,71.410995,10.124322000000006,99,99
"172.16.133.44",64833,"138.108.6.20",80,4,252,7505,0,0,2,126,2,126,71.41116,11.432138000000009,88,88
"172.16.133.73",60677,"172.16.139.250",5440,12,1142,7506,0,0,12,1142,0,0,71.421483,0.006493000000006077,1407053,0
"172.16.133.53",54109,"172.16.139.250",5440,10,1022,7507,0,0,10,1022,0,0,71.424007,0.007024999999998727,1163843,0
"172.16.133.21",53183,"172.16.139.250",5440,10,1022,7508,0,0,10,1022,0,0,71.426026,0.008852000000004523,923633,0
"172.16.133.30",62628,"172.16.139.250",5440,12,1142,7509,0,0,12,1142,0,0,71.429963,0.01733600000000024,526995,0
"172.16.133.25",63465,"172.16.139.250",5440,12,1142,7510,0,0,12,1142,0,0,71.437701,0.005020000000001801,1819920,0
"172.16.133.34",50449,"172.16.139.250",5440,10,1022,7511,0,0,10,1022,0,0,71.446799,0.0048799999999999955,"",""
"172.16.133.97",59382,"172.16.139.250",5440,12,1142,7512,0,0,12,1142,0,0,71.458145,0.00622299999999143,1468102,0
"172.16.133.73",60678,"74.125.170.114",80,1463,1864711,7513,0,0,228,15909,1235,1848802,71.464114,37.208290000000005,3420,397503
"172.16.133.73",60679,"74.125.170.114",80,514,622323,7514,0,0,103,9978,411,612345,71.516331,37.16023800000001,2148,131828
"172.16.133.33",57891,"172.16.139.250",5440,12,1142,7515,0,0,12,1142,0,0,71.532312,0.005708999999995967,1600280,0
"172.16.133.68",60738,"172.16.139.250",5440,10,1022,7516,0,0,10,1022,0,0,71.563022,0.005682999999990557,1438676,0
"172.16.133.12",59778,"172.16.139.250",5440,12,1142,7517,0,0,12,1142,0,0,71.576871,0.005842000000001235,1563847,0
"172.16.133.63",53889,"172.16.139.250",5440,10,1022,7518,0,0,10,1022,0,0,71.586059,0.005332999999993149,1533095,0
"172.16.133.66",53875,"172.16.139.250",5440,10,1022,7519,0,0,10,1022,0,0,71.601123,0.005394999999992933,1515477,0
"172.16.133.60",62130,"180.153.31.250",443,6,366,7520,0,0,4,246,2,120,71.603859,0.4753369999999961,4140,2019
"172.16.133.82",61355,"172.16.139.250",5440,10,1022,7521,0,0,10,1022,0,0,71.613805,0.014746999999999844,554417,0
"172.16.133.37",60635,"172.16.139.250",5440,12,1142,7522,0,0,12,1142,0,0,71.629071,0.006287000000000376,1453157,0
"172.16.133.12",59779,"173.194.43.60",80,6,372,7523,0,0,4,246,2,126,71.643737,18.066312999999994,108,55
"172.16.133.12",59780,"173.194.43.60",80,6,372,7524,0,0,4,246,2,126,71.643932,18.066115999999994,108,55
"172.16.133.12",59781,"208.111.161.254",80,8,492,7525,0,0,4,246,4,246,71.644333,18.071179,108,108
"172.16.133.12",59782,"208.111.161.254",80,8,492,7526,0,0,4,246,4,246,71.644502,18.07191999999999,108,108
"172.16.133.78",59218,"172.16.139.250",5440,12,1142,7527,0,0,12,1142,0,0,71.784623,0.0065310000000096124,1398866,0
"172.16.133.67",55995,"172.16.139.250",5440,10,1022,7528,0,0,10,1022,0,0,71.838715,0.005290000000002237,1545557,0
"172.16.133.56",61439,"172.16.139.250",5440,10,1022,7529,0,0,10,1022,0,0,71.860877,0.005155000000002019,1586032,0
"172.16.133.12",59783,"173.194.43.58",443,14,3552,7530,0,0,8,967,6,2585,71.872155,0.3291109999999975,23505,62835
"173.194.43.30",443,"172.16.133.25",63156,7,730,7531,0,0,7,730,0,0,71.904121,3.4217330000000032,1706,0
"172.16.133.42",57077,"172.16.139.250",5440,12,1142,7532,0,0,12,1142,0,0,71.904733,0.007930000000001769,1152080,0
"172.16.133.41",53010,"172.16.139.250",5440,10,1022,7533,0,0,10,1022,0,0,71.917906,0.0054789999999940164,1492243,0
"172.16.133.85",52283,"172.16.139.250",5440,10,1022,7534,0,0,10,1022,0,0,71.934543,0.005327999999991562,1534534,0
"172.16.133.12",59784,"173.194.43.58",80,17,2528,7535,0,0,9,1188,8,1340,71.954637,225.19532500000003,42,47
"172.16.133.113",55619,"172.16.139.250",135,8,492,7536,0,0,8,492,0,0,71.988807,0.03469100000000935,113458,0
"172.16.133.43",57793,"172.16.139.250",5440,10,1022,7537,0,0,10,1022,0,0,71.990557,0.006142000000011194,1331162,0
"172.16.133.13",53049,"172.16.139.250",5440,10,1022,7538,0,0,10,1022,0,0,72.00581,0.005260000000006926,1554372,0
"172.16.133.113",55620,"172.16.139.250",5462,10,696,7539,0,0,10,696,0,0,72.024581,0.5061770000000081,11000,0
"172.16.133.12",59785,"173.194.43.57",80,18,3291,7540,0,0,10,2293,8,998,72.044632,225.182835,81,35
"172.16.133.20",62405,"172.16.139.250",5440,12,1142,7541,0,0,12,1142,0,0,72.055765,0.005160000000003606,1770542,0
"172.16.133.75",50967,"172.16.139.250",5440,10,1022,7542,0,0,10,1022,0,0,72.072674,0.015380999999990763,531564,0
"172.16.133.28",65435,"172.16.139.250",5440,10,1022,7543,0,0,10,1022,0,0,72.086197,0.005796000000003687,1410628,0
"172.16.133.99",56054,"172.16.139.250",5440,12,1142,7544,0,0,12,1142,0,0,72.114961,0.0049820000000124764,"",""
"172.16.133.12",59786,"138.108.6.20",80,8,1445,7545,0,0,4,787,4,658,72.132656,11.820571000000001,532,445
"172.16.133.87",60214,"172.16.139.250",5440,12,1142,7546,0,0,12,1142,0,0,72.136076,0.006017999999997414,1518112,0
"172.16.133.40",50087,"173.194.75.105",80,17,2849,7547,0,0,9,1753,8,1096,72.149619,225.65831999999997,62,38
"172.16.133.116",53384,"172.16.139.250",5440,10,1022,7548,0,0,10,1022,0,0,72.150308,0.005463000000005991,1496613,0
"172.16.133.35",49983,"172.16.139.250",5440,12,1142,7549,0,0,12,1142,0,0,72.155202,0.027189999999990278,336005,0
"172.16.133.116",53385,"172.16.139.250",5440,10,1022,7550,0,0,10,1022,0,0,72.156474,0.014472999999995295,564913,0
"172.16.133.116",53386,"172.16.139.250",5440,10,1022,7551,0,0,10,1022,0,0,72.171603,0.015221999999994296,537117,0
"172.16.133.84",58803,"172.16.139.250",5440,10,1022,7552,0,0,10,1022,0,0,72.173727,0.016857000000001676,485021,0
"172.16.133.49",55777,"172.16.139.250",5440,10,1022,7553,0,0,10,1022,0,0,72.250691,0.014701000000002296,556152,0
"172.16.133.39",64256,"132.245.1.150",443,26,14035,7554,0,0,11,2042,15,11993,72.287733,1.8163380000000018,8993,52822
"172.16.133.95",56979,"172.16.139.250",5440,12,1142,7555,0,0,12,1142,0,0,72.288942,0.0057419999999979154,1591083,0
"172.16.133.40",50088,"173.194.75.105",80,6,372,7556,0,0,4,246,2,126,72.288944,20.040549999999996,98,50
"172.16.133.40",50089,"216.52.242.80",80,41,16265,7557,0,0,23,11690,18,4575,72.296557,222.58211799999998,420,164
"172.16.133.92",57692,"172.16.139.250",5440,10,1022,7558,0,0,10,1022,0,0,72.316961,0.005793999999994526,1411114,0
"172.16.133.29",60946,"172.16.139.250",5440,10,1022,7559,0,0,10,1022,0,0,72.333079,0.04607199999999523,177461,0
"172.16.133.44",64834,"172.16.139.250",5440,10,1022,7560,0,0,10,1022,0,0,72.34037,0.03526100000000554,231870,0
"172.16.133.110",52140,"174.129.20.55",80,10,1098,7561,0,0,6,514,4,584,72.344776,0.09521800000000269,43185,49066
"172.16.133.207",55944,"172.16.139.250",5440,12,1142,7562,0,0,12,1142,0,0,72.365001,0.018105999999988853,504584,0
"172.16.133.83",57102,"172.16.139.250",5440,12,1142,7563,0,0,12,1142,0,0,72.374078,0.012357000000008611,739338,0
"172.16.133.93",60727,"172.16.139.250",5440,10,1022,7564,0,0,10,1022,0,0,72.39066,0.014484000000010155,564484,0
"172.16.133.73",60680,"173.194.43.57",80,21,5394,7565,0,0,12,3378,9,2016,72.406439,185.97620399999997,145,86
"172.16.133.73",60681,"173.194.43.57",80,17,2432,7566,0,0,9,1434,8,998,72.406853,225.20894599999997,50,35
"172.16.133.11",55153,"172.16.139.250",5440,10,1022,7567,0,0,10,1022,0,0,72.408104,0.005622000000002458,1454286,0
"172.16.133.55",57591,"172.16.139.250",5440,10,1022,7568,0,0,10,1022,0,0,72.411921,0.014895999999993137,548872,0
"172.16.133.73",60682,"172.16.139.250",5440,10,1022,7569,0,0,10,1022,0,0,72.435502,0.014994999999998981,545248,0
"172.16.133.53",54110,"172.16.139.250",5440,10,1022,7570,0,0,10,1022,0,0,72.438037,0.01635900000000845,499786,0
"172.16.133.21",53184,"172.16.139.250",5440,12,1142,7571,0,0,12,1142,0,0,72.440345,0.022381000000009976,408203,0
"172.16.133.30",62629,"172.16.139.250",5440,10,1022,7572,0,0,10,1022,0,0,72.444299,0.021581999999995105,378834,0
"172.16.133.25",63466,"172.16.139.250",5440,12,1142,7573,0,0,12,1142,0,0,72.451659,0.006866999999999734,1330420,0
"172.16.133.34",50450,"172.16.139.250",5440,10,1022,7574,0,0,10,1022,0,0,72.460891,0.008857999999989374,923007,0
"172.16.133.97",59383,"172.16.139.250",5440,10,1022,7575,0,0,10,1022,0,0,72.471761,0.014850999999993064,550535,0
"172.16.133.33",57892,"172.16.139.250",5440,12,1142,7576,0,0,12,1142,0,0,72.547109,0.0062819999999987886,1454313,0
"172.16.133.68",60740,"172.16.139.250",5440,10,1022,7577,0,0,10,1022,0,0,72.576903,0.015490999999997257,527790,0
"172.16.133.73",60683,"74.125.226.67",80,37,13229,7578,0,0,20,9560,17,3669,72.589675,189.03756499999997,404,155
"172.16.133.12",59787,"172.16.139.250",5440,12,1142,7579,0,0,12,1142,0,0,72.592145,0.006323999999992225,1444655,0
"172.16.133.63",53890,"172.16.139.250",5440,12,1142,7580,0,0,12,1142,0,0,72.600184,0.015221999999994296,600183,0
"172.16.133.66",53876,"172.16.139.250",5440,10,1022,7581,0,0,10,1022,0,0,72.616066,0.005459999999999354,1497435,0
"172.16.133.82",61356,"172.16.139.250",5440,10,1022,7582,0,0,10,1022,0,0,72.628224,0.0057240000000007285,1428371,0
"172.16.133.40",50090,"173.194.75.105",443,319,273431,7583,0,0,93,22242,226,251189,72.631672,223.752205,795,8980
"172.16.133.40",50091,"173.194.43.40",443,14,4028,7584,0,0,8,958,6,3070,72.636224,0.8746380000000045,8762,28080
"172.16.133.40",50092,"74.125.226.207",443,14,4028,7585,0,0,8,958,6,3070,72.637043,2.6219679999999954,2922,9367
"172.16.133.37",60636,"172.16.139.250",5440,10,1022,7586,0,0,10,1022,0,0,72.641463,0.00585399999999936,1396651,0
"172.16.133.18",50291,"174.129.20.55",443,28,11678,7587,0,0,13,2267,15,9411,72.697784,10.456805000000003,1734,7199
"172.16.133.78",59219,"172.16.139.250",5440,10,1022,7588,0,0,10,1022,0,0,72.798766,0.015557999999998628,525517,0
"172.16.133.67",55996,"172.16.139.250",5440,10,1022,7589,0,0,10,1022,0,0,72.853405,0.005082000000001585,1608815,0
"172.16.133.56",61440,"172.16.139.250",5440,12,1142,7590,0,0,12,1142,0,0,72.875083,0.014769999999998618,618551,0
"172.16.133.41",53011,"172.16.139.250",5440,10,1022,7591,0,0,10,1022,0,0,72.9319,0.005510999999998489,1483578,0
"172.16.133.85",52284,"172.16.139.250",5440,12,1142,7592,0,0,12,1142,0,0,72.948234,0.006242000000000303,1463633,0
"172.16.133.96",49798,"96.43.146.48",443,13,5242,7593,0,0,7,4206,6,1036,72.95867,180.635356,186,45
"172.16.133.45",61339,"64.90.204.229",443,20,5549,7594,0,0,10,4013,10,1536,73.002462,5.082650000000001,6316,2417
"172.16.133.45",61340,"64.90.204.229",443,20,5681,7595,0,0,10,3943,10,1738,73.010001,5.076573999999994,6213,2738
"172.16.133.43",57794,"172.16.139.250",5440,10,1022,7596,0,0,10,1022,0,0,73.011298,0.005774000000002388,1416002,0
"172.16.133.13",53050,"172.16.139.250",5440,10,1022,7597,0,0,10,1022,0,0,73.020471,0.0055899999999979855,1462611,0
"172.16.133.20",62406,"172.16.139.250",5440,12,1142,7598,0,0,12,1142,0,0,73.069967,0.014530999999990968,628724,0
"172.16.133.75",50968,"172.16.139.250",5440,10,1022,7599,0,0,10,1022,0,0,73.086498,0.01887800000000084,433096,0
"172.16.133.28",65436,"172.16.139.250",5440,10,1022,7600,0,0,10,1022,0,0,73.100118,0.008886000000003946,920099,0
"172.16.133.99",56055,"172.16.139.250",5440,10,1022,7601,0,0,10,1022,0,0,73.128455,0.0060649999999924376,1348062,0
"172.16.133.40",50093,"74.125.228.127",443,31,8343,7602,0,0,16,2804,15,5539,73.149336,225.400015,99,196
"172.16.133.87",60215,"172.16.139.250",5440,10,1022,7603,0,0,10,1022,0,0,73.149861,0.015558999999996104,525483,0
"172.16.133.116",53387,"172.16.139.250",5440,12,1142,7604,0,0,12,1142,0,0,73.165103,0.0061659999999932324,1481673,0
"172.16.133.35",49984,"172.16.139.250",5440,12,1142,7605,0,0,12,1142,0,0,73.165856,0.04214999999999236,216749,0
"172.16.133.116",53388,"172.16.139.250",5440,10,1022,7606,0,0,10,1022,0,0,73.172461,0.005926000000002318,1379682,0
"172.16.133.116",53389,"172.16.139.250",5440,10,1022,7607,0,0,10,1022,0,0,73.17859,0.0612650000000059,133453,0
"172.16.133.84",58804,"172.16.139.250",5440,10,1022,7608,0,0,10,1022,0,0,73.187163,0.048760999999998944,167674,0
"172.16.133.41",53012,"199.204.31.83",80,14,4890,7609,0,0,8,3936,6,954,73.246599,0.38024599999999964,82809,20071
"172.16.133.49",55778,"172.16.139.250",5440,12,1142,7610,0,0,12,1142,0,0,73.264833,0.006166000000007443,1481673,0
"172.16.133.95",56980,"172.16.139.250",5440,10,1022,7611,0,0,10,1022,0,0,73.302394,0.006015999999988253,1359042,0
"172.16.133.25",63467,"173.194.43.47",80,17,1900,7612,0,0,9,1028,8,872,73.329177,225.21939499999996,36,30
"172.16.133.25",63468,"173.194.43.47",80,17,1900,7613,0,0,9,1028,8,872,73.329494,225.219196,36,30
"172.16.133.92",57693,"172.16.139.250",5440,12,1142,7614,0,0,12,1142,0,0,73.329999,0.01620499999999936,563776,0
"172.16.133.29",60947,"172.16.139.250",5440,12,1142,7615,0,0,12,1142,0,0,73.346855,0.00636399999999071,1435575,0
"172.16.133.44",64835,"172.16.139.250",5440,12,1142,7616,0,0,12,1142,0,0,73.35467,0.006415000000004056,1424162,0
"172.16.133.42",57078,"172.16.139.250",5440,12,1142,7617,0,0,12,1142,0,0,73.36634,0.05804000000000542,157408,0
"172.16.133.207",55945,"172.16.139.250",5440,12,1142,7618,0,0,12,1142,0,0,73.379733,0.014932999999999197,611799,0
"172.16.133.132",36654,"96.43.146.48",443,921,737832,7619,0,0,379,81110,542,656722,73.385341,66.89034600000001,9700,78543
"172.16.133.83",57103,"172.16.139.250",5440,10,1022,7620,0,0,10,1022,0,0,73.388248,0.013812999999998965,591906,0
"172.16.133.93",60728,"172.16.139.250",5440,10,1022,7621,0,0,10,1022,0,0,73.404684,0.005504000000001952,1485465,0
"172.16.133.11",55154,"172.16.139.250",5440,10,1022,7622,0,0,10,1022,0,0,73.425029,0.015441000000009808,529499,0
"172.16.133.55",57592,"172.16.139.250",5440,10,1022,7623,0,0,10,1022,0,0,73.426162,0.0070099999999939655,1166333,0
"172.16.133.73",60684,"172.16.139.250",5440,10,1022,7624,0,0,10,1022,0,0,73.44887,0.014943999999999846,547109,0
"172.16.133.53",54111,"172.16.139.250",5440,10,1022,7625,0,0,10,1022,0,0,73.451677,0.020511999999996533,398595,0
"172.16.133.21",53185,"172.16.139.250",5440,12,1142,7626,0,0,12,1142,0,0,73.453985,0.02641899999998998,345811,0
"172.16.133.30",62630,"172.16.139.250",5440,12,1142,7627,0,0,12,1142,0,0,73.45829,0.010251999999994155,891143,0
"172.16.133.25",63469,"172.16.139.250",5440,12,1142,7628,0,0,12,1142,0,0,73.465885,0.009384999999994648,973468,0
"172.16.133.34",50451,"172.16.139.250",5440,12,1142,7629,0,0,12,1142,0,0,73.47483,0.01466299999999876,623064,0
"172.16.133.97",59384,"172.16.139.250",5440,12,1142,7630,0,0,12,1142,0,0,73.485414,0.00857899999999745,1064925,0
"172.16.133.40",50094,"23.33.85.199",80,115,102643,7631,0,0,41,8242,74,94401,73.501068,181.571716,363,4159
"172.16.133.40",50095,"23.33.85.199",80,121,105215,7632,0,0,44,7994,77,97221,73.501207,181.570581,352,4283
"172.16.133.40",50096,"173.194.43.40",443,165,79424,7633,0,0,64,18857,101,60567,73.5112,222.34958600000002,678,2179
"172.16.133.33",57893,"172.16.139.250",5440,12,1142,7634,0,0,12,1142,0,0,73.560868,0.0066690000000022565,1369920,0
"172.16.133.68",60741,"172.16.139.250",5440,10,1022,7635,0,0,10,1022,0,0,73.59076,0.01575699999999358,518880,0
"172.16.133.12",59788,"172.16.139.250",5440,12,1142,7636,0,0,12,1142,0,0,73.606033,0.005648000000007869,1617563,0
"172.16.133.63",53891,"172.16.139.250",5440,12,1142,7637,0,0,12,1142,0,0,73.615153,0.006143999999991934,1486979,0
"172.16.133.66",53877,"172.16.139.250",5440,10,1022,7638,0,0,10,1022,0,0,73.629488,0.005645000000001232,1448361,0
"172.16.133.40",50097,"23.33.85.199",80,136,128620,7639,0,0,44,7551,92,121069,73.638217,226.35456599999998,266,4278
"172.16.133.82",61357,"172.16.139.250",5440,10,1022,7640,0,0,10,1022,0,0,73.642244,0.015940999999997985,512891,0
"172.16.133.37",60637,"172.16.139.250",5440,10,1022,7641,0,0,10,1022,0,0,73.656401,0.00575399999999604,1420924,0
"172.16.133.132",36655,"96.43.146.48",443,459,351525,7642,0,0,210,57678,249,293847,73.667938,66.60935399999998,6927,35291
"172.16.133.132",36656,"96.43.146.48",443,559,487635,7643,0,0,210,55533,349,432102,73.673303,66.603654,6670,51901
"172.16.133.40",50098,"23.33.85.199",80,68,51028,7644,0,0,26,6051,42,44977,73.675432,181.393612,266,1983
"172.16.133.40",50099,"23.33.85.199",80,317,367388,7645,0,0,70,7472,247,359916,73.676223,181.420007,329,15871
"172.16.133.132",36657,"96.43.146.48",443,408,298270,7646,0,0,192,46819,216,251451,73.676797,66.60084600000002,5623,30203
"172.16.133.40",50100,"23.33.85.199",80,159,152548,7647,0,0,49,8321,110,144227,73.677422,181.491524,366,6357
"172.16.133.132",36658,"96.43.146.48",443,520,457128,7648,0,0,193,49318,327,407810,73.680271,66.595755,5924,48989
"172.16.133.40",50101,"72.21.91.196",80,15,4079,7649,0,0,8,3203,7,876,73.69116,8.619681999999997,2972,813
"172.16.133.40",50102,"72.21.91.196",80,15,6590,7650,0,0,7,3077,8,3513,73.691388,8.618231999999992,2856,3260
"172.16.133.132",36659,"96.43.146.48",443,230,188430,7651,0,0,90,28588,140,159842,73.796501,66.480246,3440,19234
"172.16.133.78",59220,"172.16.139.250",5440,10,1022,7652,0,0,10,1022,0,0,73.812879,0.005591000000009672,1462350,0
"172.16.133.60",62131,"180.153.31.250",443,6,366,7653,0,0,4,246,2,120,73.845207,0.47300099999999645,4160,2029
"172.16.128.233",55238,"172.16.133.233",22,172,20140,7654,0,0,55,4752,117,15388,73.861677,8.097043,4695,15203
"172.16.133.67",55997,"172.16.139.250",5440,10,1022,7655,0,0,10,1022,0,0,73.867083,0.005273000000002526,1550540,0
"172.16.133.56",61441,"172.16.139.250",5440,12,1142,7656,0,0,12,1142,0,0,73.88883,0.005122000000000071,1783678,0
"172.16.133.41",53013,"199.102.234.31",80,11,3427,7657,0,0,6,2894,5,533,73.905695,0.10264400000001217,225556,41541
"172.16.133.41",53014,"216.52.121.204",80,12,3945,7658,0,0,7,3388,5,557,73.911457,0.15881500000000415,170663,28057
"172.16.133.41",53015,"199.102.234.31",80,14,5825,7659,0,0,7,2944,7,2881,73.911831,0.09877699999999834,238436,233333
"172.16.133.42",57079,"172.16.139.250",5440,12,1142,7660,0,0,12,1142,0,0,73.929033,0.03131299999999726,291763,0
"172.16.133.41",53016,"172.16.139.250",5440,12,1142,7661,0,0,12,1142,0,0,73.945758,0.007445000000004143,1227132,0
"172.16.133.85",52285,"172.16.139.250",5440,10,1022,7662,0,0,10,1022,0,0,73.963335,0.014679000000000997,556986,0
"172.16.133.40",50103,"23.67.242.83",80,23,10909,7663,0,0,10,1429,13,9480,74.014593,225.26515799999999,50,336
"172.16.133.40",50104,"23.67.242.83",80,26,12172,7664,0,0,11,1482,15,10690,74.014727,218.29159700000002,54,391
"172.16.133.43",57795,"172.16.139.250",5440,10,1022,7665,0,0,10,1022,0,0,74.016223,0.0171670000000006,476262,0
"172.16.133.13",53051,"172.16.139.250",5440,10,1022,7666,0,0,10,1022,0,0,74.033948,0.005745000000004552,1423150,0
"172.16.133.132",52353,"96.43.149.26",443,45,22171,7667,0,0,24,3227,21,18944,74.049999,66.186359,390,2289
"172.16.133.132",52354,"96.43.149.26",443,37,16805,7668,0,0,20,2536,17,14269,74.055794,66.181564,306,1724
"172.16.133.20",62407,"172.16.139.250",5440,12,1142,7669,0,0,12,1142,0,0,74.083965,0.0050639999999901875,1804107,0
"172.16.133.75",50969,"172.16.139.250",5440,10,1022,7670,0,0,10,1022,0,0,74.101223,0.01585500000000195,515673,0
"172.16.133.28",65437,"172.16.139.250",5440,10,1022,7671,0,0,10,1022,0,0,74.1142,0.006506000000001677,1256686,0
"172.16.133.99",56056,"172.16.139.250",5440,12,1142,7672,0,0,12,1142,0,0,74.140831,0.005265999999991777,1734903,0
"172.16.133.132",52355,"96.43.149.26",443,32,10100,7673,0,0,19,2872,13,7228,74.155023,66.08210299999999,347,875
"172.16.133.87",60216,"172.16.139.250",5440,10,1022,7674,0,0,10,1022,0,0,74.16402,0.005548000000004549,1473684,0
"172.16.133.35",49985,"172.16.139.250",5440,12,1142,7675,0,0,12,1142,0,0,74.176055,0.017974999999992747,508261,0
"172.16.133.116",53390,"172.16.139.250",5440,10,1022,7676,0,0,10,1022,0,0,74.17857,0.005293000000008874,1544681,0
"172.16.133.116",53391,"172.16.139.250",5440,10,1022,7677,0,0,10,1022,0,0,74.184724,0.008783999999991465,930783,0
"172.16.133.116",53392,"172.16.139.250",5440,10,1022,7678,0,0,10,1022,0,0,74.194389,0.005290000000002237,1545557,0
"172.16.133.84",58805,"172.16.139.250",5440,10,1022,7679,0,0,10,1022,0,0,74.201619,0.005262000000001876,1553781,0
"172.16.133.41",53017,"216.52.121.204",80,12,4286,7680,0,0,7,3729,5,557,74.206561,0.21855000000000757,136499,20388
"172.16.133.41",53018,"216.52.121.204",80,12,4286,7681,0,0,7,3729,5,557,74.211124,0.2287369999999953,130420,19480
"172.16.133.41",53019,"216.52.121.204",80,12,4223,7682,0,0,7,3666,5,557,74.233591,0.3723579999999913,78762,11966
"172.16.133.41",53020,"216.52.121.204",80,12,4243,7683,0,0,7,3686,5,557,74.24188,0.36311900000001174,81207,12271
"172.16.133.49",55779,"172.16.139.250",5440,12,1142,7684,0,0,12,1142,0,0,74.27806,0.006218000000004054,1469282,0
"172.16.133.132",37318,"23.33.47.60",443,141,112450,7685,0,0,60,5895,81,106555,74.283651,65.967639,714,12922
"172.16.133.132",37319,"23.33.47.60",443,49,23656,7686,0,0,27,3328,22,20328,74.284149,65.96733300000001,403,2465
"172.16.133.132",37320,"23.33.47.60",443,21,5436,7687,0,0,12,1499,9,3937,74.284603,20.069716,597,1569
"172.16.133.132",37321,"23.33.47.60",443,21,5436,7688,0,0,12,1499,9,3937,74.285038,20.069091999999998,597,1569
"172.16.133.132",37322,"23.33.47.60",443,64,36710,7689,0,0,34,3353,30,33357,74.285468,65.97574200000001,406,4044
"172.16.133.132",37323,"23.33.47.60",443,21,5436,7690,0,0,12,1499,9,3937,74.285905,20.067499999999995,597,1569
"172.16.133.41",53021,"216.52.121.204",80,13,4052,7691,0,0,8,3495,5,557,74.294741,0.7030429999999939,39769,6338
"172.16.133.41",53022,"216.52.121.204",80,13,4052,7692,0,0,8,3495,5,557,74.296767,0.6806040000000024,41081,6547
"172.16.133.95",56981,"172.16.139.250",5440,10,1022,7693,0,0,10,1022,0,0,74.31544,0.014610000000004675,559616,0
"172.16.133.41",53023,"216.52.121.204",80,13,4313,7694,0,0,8,3756,5,557,74.334355,0.7360819999999961,40821,6053
"172.16.133.41",53024,"216.52.121.204",80,15,6920,7695,0,0,9,6303,6,617,74.341101,0.6412109999999984,78638,7697
"172.16.133.92",57694,"172.16.139.250",5440,12,1142,7696,0,0,12,1142,0,0,74.345502,0.005542000000005487,1648502,0
"172.16.133.29",60948,"172.16.139.250",5440,10,1022,7697,0,0,10,1022,0,0,74.361114,0.040017000000005964,204313,0
"172.16.133.44",64836,"172.16.139.250",5440,12,1142,7698,0,0,12,1142,0,0,74.369093,0.03390100000000018,269490,0
"172.16.133.132",52362,"96.43.149.26",443,24,6518,7699,0,0,14,1416,10,5102,74.371791,65.86506399999999,171,619
"172.16.133.39",64257,"174.129.24.9",443,1997,2047607,7700,0,0,662,47305,1335,2000302,74.375299,15.66158,24163,1021762
"172.16.133.207",55946,"172.16.139.250",5440,12,1142,7701,0,0,12,1142,0,0,74.394089,0.016266999999999143,561627,0
"172.16.133.83",57104,"172.16.139.250",5440,12,1142,7702,0,0,12,1142,0,0,74.402235,0.014692999999994072,621792,0
"172.16.133.93",60729,"172.16.139.250",5440,12,1142,7703,0,0,12,1142,0,0,74.418897,0.021860000000003765,417932,0
"172.16.133.11",55155,"172.16.139.250",5440,10,1022,7704,0,0,10,1022,0,0,74.436765,0.008431999999999107,969639,0
"172.16.133.55",57593,"172.16.139.250",5440,10,1022,7705,0,0,10,1022,0,0,74.44006,0.01573999999999387,519440,0
"172.16.133.73",60685,"172.16.139.250",5440,10,1022,7706,0,0,10,1022,0,0,74.46458,0.00584299999999871,1399281,0
"172.16.133.53",54112,"172.16.139.250",5440,10,1022,7707,0,0,10,1022,0,0,74.46503,0.008559000000005312,955251,0
"172.16.133.21",53186,"172.16.139.250",5440,12,1142,7708,0,0,12,1142,0,0,74.468161,0.019439000000005535,469983,0
"172.16.133.30",62631,"172.16.139.250",5440,10,1022,7709,0,0,10,1022,0,0,74.472175,0.018894000000003075,432729,0
"172.16.133.66",53878,"74.125.226.207",443,18,1920,7710,0,0,10,1205,8,715,74.474944,183.17641700000001,52,31
"172.16.133.25",63470,"172.16.139.250",5440,10,1022,7711,0,0,10,1022,0,0,74.479927,0.01654800000000023,494077,0
"172.16.133.66",53879,"74.125.226.207",443,18,1920,7712,0,0,10,1205,8,715,74.482797,183.168562,52,31
"172.16.133.66",53880,"74.125.226.207",443,18,1920,7713,0,0,10,1205,8,715,74.483755,183.20378300000002,52,31
"172.16.133.66",53881,"74.125.226.207",443,8,498,7714,0,0,5,312,3,186,74.484093,22.640278999999992,110,65
"172.16.133.34",50452,"172.16.139.250",5440,12,1142,7715,0,0,12,1142,0,0,74.488957,0.009816000000000713,930725,0
"172.16.133.41",53025,"216.52.121.204",80,13,4058,7716,0,0,8,3501,5,557,74.498056,3.192089999999993,8774,1395
"172.16.133.41",53026,"216.52.121.204",80,13,4058,7717,0,0,8,3501,5,557,74.499584,3.1675500000000056,8842,1406
"172.16.133.97",59385,"172.16.139.250",5440,10,1022,7718,0,0,10,1022,0,0,74.500455,0.005455999999995242,1498533,0
"172.16.133.33",57894,"172.16.139.250",5440,10,1022,7719,0,0,10,1022,0,0,74.574965,0.008581999999989876,952691,0
"172.16.133.68",60742,"172.16.139.250",5440,10,1022,7720,0,0,10,1022,0,0,74.604855,0.005555999999998562,1471562,0
"172.16.133.12",59789,"172.16.139.250",5440,10,1022,7721,0,0,10,1022,0,0,74.619218,0.0059040000000010195,1384823,0
"172.16.133.41",53027,"216.52.121.204",80,13,4058,7722,0,0,8,3501,5,557,74.627691,3.1619290000000007,8857,1409
"172.16.133.63",53892,"172.16.139.250",5440,10,1022,7723,0,0,10,1022,0,0,74.628121,0.0054290000000065675,1505986,0
"172.16.133.41",53028,"216.52.121.204",80,13,4058,7724,0,0,8,3501,5,557,74.635922,3.160192000000009,8862,1410
"172.16.133.66",53882,"172.16.139.250",5440,12,1142,7725,0,0,12,1142,0,0,74.644074,0.006453999999990856,1415556,0
"172.16.133.82",61358,"172.16.139.250",5440,10,1022,7726,0,0,10,1022,0,0,74.65592,0.005463000000005991,1496613,0
"172.16.133.37",60638,"172.16.139.250",5440,10,1022,7727,0,0,10,1022,0,0,74.669736,0.05410499999999274,151113,0
"172.16.133.87",60217,"157.56.240.102",443,22,9615,7728,0,0,10,2240,12,7375,74.688354,0.2733300000000014,65561,215856
"172.16.133.66",53883,"74.125.226.207",443,250,224607,7729,0,0,70,7968,180,216639,74.720698,202.937129,314,8540
"172.16.133.78",59221,"172.16.139.250",5440,10,1022,7730,0,0,10,1022,0,0,74.827785,0.005808999999999287,1407471,0
"172.16.133.44",64837,"173.194.43.59",80,6,372,7731,0,0,4,246,2,126,74.845222,15.56176099999999,126,64
"172.16.133.44",64838,"173.194.43.59",80,6,372,7732,0,0,4,246,2,126,74.845493,15.561492000000001,126,64
"172.16.133.44",64839,"23.0.49.244",80,7,432,7733,0,0,4,246,3,186,74.845892,15.594853999999998,126,95
"172.16.133.44",64840,"23.0.49.244",80,7,432,7734,0,0,4,246,3,186,74.846123,15.575958999999997,126,95
"172.16.133.67",55998,"172.16.139.250",5440,12,1142,7735,0,0,12,1142,0,0,74.880663,0.006034999999997126,1513835,0
"172.16.133.44",64841,"23.0.49.244",80,7,432,7736,0,0,4,246,3,186,74.883277,15.538856999999993,126,95
"172.16.133.44",64842,"23.0.49.244",80,7,432,7737,0,0,4,246,3,186,74.883518,15.552810000000008,126,95
"172.16.133.44",64843,"23.0.49.244",80,6,372,7738,0,0,4,246,2,126,74.883696,15.533946999999998,126,64
"172.16.133.44",64844,"23.0.49.244",80,7,432,7739,0,0,4,246,3,186,74.883855,15.541038,126,95
"172.16.133.44",64845,"23.0.49.244",80,6,372,7740,0,0,4,246,2,126,74.884004,15.533639999999991,126,64
"172.16.133.44",64846,"23.0.49.244",80,7,432,7741,0,0,4,246,3,186,74.884126,15.558250000000001,126,95
"172.16.133.40",50105,"173.194.43.45",80,6,372,7742,0,0,4,246,2,126,74.885337,17.42973599999999,112,57
"172.16.133.40",50106,"173.194.43.45",80,6,372,7743,0,0,4,246,2,126,74.885429,17.42872,112,57
"172.16.133.56",61442,"172.16.139.250",5440,12,1142,7744,0,0,12,1142,0,0,74.902997,0.0054379999999980555,1680029,0
"172.16.133.40",50107,"64.215.255.17",80,13,6563,7745,0,0,7,3458,6,3105,74.915542,0.16630499999999415,166344,149364
"172.16.133.40",50108,"64.215.255.17",80,8,692,7746,0,0,5,306,3,386,74.915681,17.401314,140,177
"172.16.133.40",50109,"204.2.197.201",80,7,432,7747,0,0,4,246,3,186,74.915802,7.39143,266,201
"172.16.133.40",50110,"204.2.197.201",80,7,432,7748,0,0,4,246,3,186,74.915916,7.390297000000004,266,201
"172.16.133.40",50111,"64.215.255.17",80,8,692,7749,0,0,5,306,3,386,74.916392,17.40162099999999,140,177
"172.16.133.40",50112,"64.215.255.17",80,10,3731,7750,0,0,6,3116,4,615,74.916806,0.2761070000000103,90283,17819
"172.16.133.40",50113,"216.38.163.167",80,7,432,7751,0,0,4,246,3,186,74.917049,17.419533,112,85
"172.16.133.40",50114,"216.38.163.167",80,14,2990,7752,0,0,8,1417,6,1573,74.917157,7.416021999999998,1528,1696
"172.16.133.42",57080,"172.16.139.250",5440,12,1142,7753,0,0,12,1142,0,0,74.953039,0.010212999999993144,894546,0
"172.16.133.41",53029,"216.52.121.204",80,12,3992,7754,0,0,7,3435,5,557,74.954998,0.17053299999999183,161141,26129
"172.16.133.41",53030,"172.16.139.250",5440,12,1142,7755,0,0,12,1142,0,0,74.960008,0.006185999999999581,1476883,0
"172.16.133.40",50115,"64.215.255.56",80,8,1387,7756,0,0,5,1066,3,321,74.96941,0.10113499999999931,84322,25391
"172.16.133.85",52286,"172.16.139.250",5440,12,1142,7757,0,0,12,1142,0,0,74.976778,0.0062220000000081654,1468338,0
"172.16.133.87",60218,"157.56.240.102",443,96,90779,7758,0,0,27,4460,69,86319,74.983971,1.2358499999999992,28870,558766
"172.16.133.43",57796,"172.16.139.250",5440,10,1022,7759,0,0,10,1022,0,0,75.032017,0.00548700000000224,1490067,0
"172.16.133.41",53031,"216.52.121.204",80,12,3992,7760,0,0,7,3435,5,557,75.035088,0.16006299999999385,171682,27839
"172.16.133.13",53052,"172.16.139.250",5440,10,1022,7761,0,0,10,1022,0,0,75.058638,0.014782999999994217,553067,0
"172.16.133.40",50116,"64.215.255.17",80,8,1921,7762,0,0,5,1405,3,516,75.07064,0.08926999999999907,125910,46241
"172.16.133.41",53032,"216.52.121.204",80,12,3992,7763,0,0,7,3435,5,557,75.095235,0.15639199999999676,175712,28492
"172.16.133.20",62408,"172.16.139.250",5440,12,1142,7764,0,0,12,1142,0,0,75.098013,0.014515000000002942,629417,0
"172.16.133.40",50117,"208.89.14.135",80,73,53787,7765,0,0,25,5550,48,48237,75.10109,180.613122,245,2136
"172.16.133.75",50970,"172.16.139.250",5440,10,1022,7766,0,0,10,1022,0,0,75.114334,0.005409000000000219,1511554,0
"172.16.133.28",65438,"172.16.139.250",5440,10,1022,7767,0,0,10,1022,0,0,75.128406,0.005345000000005484,1529653,0
"172.16.133.40",50118,"74.121.142.248",80,11,2843,7768,0,0,6,1579,5,1264,75.153751,7.1578659999999985,1764,1412
"172.16.133.99",56057,"172.16.139.250",5440,12,1142,7769,0,0,12,1142,0,0,75.156213,0.004795000000001437,"",""
"172.16.133.41",53033,"216.52.121.204",80,12,3992,7770,0,0,7,3435,5,557,75.167864,0.15393400000000668,178518,28947
"172.16.133.87",60219,"172.16.139.250",5440,10,1022,7771,0,0,10,1022,0,0,75.178397,0.015391999999991413,531185,0
"172.16.133.35",49986,"172.16.139.250",5440,12,1142,7772,0,0,12,1142,0,0,75.189036,0.01672599999999136,546215,0
"172.16.133.116",53393,"172.16.139.250",5440,10,1022,7773,0,0,10,1022,0,0,75.192504,0.005628000000001521,1452736,0
"172.16.133.116",53394,"172.16.139.250",5440,10,1022,7774,0,0,10,1022,0,0,75.199035,0.007217000000011353,1132880,0
"172.16.133.116",53395,"172.16.139.250",5440,10,1022,7775,0,0,10,1022,0,0,75.207081,0.006174999999998931,1324048,0
"172.16.133.84",58806,"172.16.139.250",5440,10,1022,7776,0,0,10,1022,0,0,75.214784,0.016119000000003325,507227,0
"172.16.133.49",55780,"172.16.139.250",5440,12,1142,7777,0,0,12,1142,0,0,75.291852,0.0055479999999903384,1646719,0
"172.16.133.75",50971,"172.16.139.250",5440,10,1022,7778,0,0,10,1022,0,0,75.319816,0.0076930000000032805,1062784,0
"172.16.133.132",39769,"70.42.13.101",443,20,7605,7779,0,0,10,1961,10,5644,75.323944,11.273237000000009,1391,4005
"172.16.133.95",56982,"172.16.139.250",5440,10,1022,7780,0,0,10,1022,0,0,75.329441,0.014628000000001862,558928,0
"172.16.133.92",57695,"172.16.139.250",5440,10,1022,7781,0,0,10,1022,0,0,75.358288,0.0054980000000028895,1487086,0
"172.16.133.29",60949,"172.16.139.250",5440,10,1022,7782,0,0,10,1022,0,0,75.375175,0.005477999999996541,1492515,0
"172.16.133.44",64847,"172.16.139.250",5440,12,1142,7783,0,0,12,1142,0,0,75.38234,0.006106000000002609,1496233,0
"172.16.133.207",55947,"172.16.139.250",5440,10,1022,7784,0,0,10,1022,0,0,75.408664,0.004717999999996891,"",""
"172.16.133.83",57105,"172.16.139.250",5440,12,1142,7785,0,0,12,1142,0,0,75.416155,0.004672999999996819,"",""
"172.16.133.93",60730,"172.16.139.250",5440,10,1022,7786,0,0,10,1022,0,0,75.432767,0.00470099999999718,"",""
"172.16.133.11",55156,"172.16.139.250",5440,10,1022,7787,0,0,10,1022,0,0,75.450005,0.015390999999993937,531219,0
"172.16.133.55",57594,"172.16.139.250",5440,10,1022,7788,0,0,10,1022,0,0,75.453965,0.005403999999998632,1512953,0
"172.16.133.73",60686,"172.16.139.250",5440,10,1022,7789,0,0,10,1022,0,0,75.477779,0.015325000000004252,533507,0
"172.16.133.53",54113,"172.16.139.250",5440,10,1022,7790,0,0,10,1022,0,0,75.479144,0.018226999999995996,448565,0
"172.16.133.21",53187,"172.16.139.250",5440,10,1022,7791,0,0,10,1022,0,0,75.482176,0.005534000000011474,1477412,0
"172.16.133.30",62632,"172.16.139.250",5440,10,1022,7792,0,0,10,1022,0,0,75.486088,0.023704000000009273,344920,0
"172.16.133.25",63471,"172.16.139.250",5440,12,1142,7793,0,0,12,1142,0,0,75.493706,0.007953999999998018,1148604,0
"172.16.133.34",50453,"172.16.139.250",5440,10,1022,7794,0,0,10,1022,0,0,75.501861,0.01543799999998896,529602,0
"172.16.133.97",59386,"172.16.139.250",5440,10,1022,7795,0,0,10,1022,0,0,75.51407,0.014709999999993784,555812,0
"172.16.133.26",53074,"23.67.242.67",80,1,60,7796,0,0,1,60,0,0,75.582588,0,"",""
"172.16.133.33",57895,"172.16.139.250",5440,10,1022,7797,0,0,10,1022,0,0,75.589007,0.015465000000006057,528677,0
"172.16.133.68",60743,"172.16.139.250",5440,10,1022,7798,0,0,10,1022,0,0,75.618832,0.014668000000000347,557403,0
"172.16.133.12",59790,"172.16.139.250",5440,12,1142,7799,0,0,12,1142,0,0,75.633237,0.006209000000012566,1471412,0
"172.16.133.63",53893,"172.16.139.250",5440,10,1022,7800,0,0,10,1022,0,0,75.642712,0.0057559999999909905,1420430,0
"172.16.133.87",60220,"157.56.240.102",443,23,10445,7801,0,0,10,2315,13,8130,75.653534,0.7196590000000072,25734,90376
"172.16.133.66",53884,"172.16.139.250",5440,10,1022,7802,0,0,10,1022,0,0,75.658093,0.008221000000006029,994526,0
"172.16.133.82",61359,"172.16.139.250",5440,10,1022,7803,0,0,10,1022,0,0,75.670382,0.015271999999995955,535358,0
"172.16.133.126",61768,"173.194.74.84",443,51,29778,7804,0,0,24,4585,27,25193,75.682818,180.386689,203,1117
"172.16.133.37",60639,"172.16.139.250",5440,12,1142,7805,0,0,12,1142,0,0,75.684323,0.006627999999992085,1378394,0
"172.16.133.30",62633,"173.194.75.106",80,25,16479,7806,0,0,10,1051,15,15428,75.741816,119.78956,70,1030
"172.16.133.78",59222,"172.16.139.250",5440,10,1022,7807,0,0,10,1022,0,0,75.840677,0.006298000000001025,1298189,0
"172.16.133.67",55999,"172.16.139.250",5440,10,1022,7808,0,0,10,1022,0,0,75.894786,0.005225000000010027,1564784,0
"172.16.133.56",61443,"172.16.139.250",5440,10,1022,7809,0,0,10,1022,0,0,75.91717,0.0046590000000037435,"",""
"172.16.133.120",53451,"96.43.146.22",443,26,12177,7810,0,0,16,11177,10,1000,75.947845,20.198703999999992,4426,396
"172.16.133.42",57081,"172.16.139.250",5440,12,1142,7811,0,0,12,1142,0,0,75.971031,0.015906000000001086,574374,0
"172.16.133.41",53034,"172.16.139.250",5440,12,1142,7812,0,0,12,1142,0,0,75.973404,0.015418999999994298,592515,0
"172.16.133.85",52287,"172.16.139.250",5440,12,1142,7813,0,0,12,1142,0,0,75.990626,0.015350999999995452,595140,0
"172.16.133.43",57797,"172.16.139.250",5440,10,1022,7814,0,0,10,1022,0,0,76.044214,0.0056960000000003674,1435393,0
"172.16.133.13",53053,"172.16.139.250",5440,12,1142,7815,0,0,12,1142,0,0,76.061945,0.006352000000006797,1438287,0
"172.16.133.60",62132,"180.153.31.250",443,6,366,7816,0,0,4,246,2,120,76.080348,0.4869199999999978,4041,1971
"172.16.133.20",62409,"172.16.139.250",5440,12,1142,7817,0,0,12,1142,0,0,76.112336,0.014131000000006111,646521,0
"172.16.133.75",50972,"172.16.139.250",5440,10,1022,7818,0,0,10,1022,0,0,76.128564,0.005446000000006279,1501285,0
"172.16.133.28",65439,"172.16.139.250",5440,10,1022,7819,0,0,10,1022,0,0,76.142048,0.005476000000001591,1493060,0
"172.16.133.99",56058,"172.16.139.250",5440,12,1142,7820,0,0,12,1142,0,0,76.1694,0.01521700000000692,600381,0
"172.16.133.132",42238,"66.235.146.171",443,31,13661,7821,0,0,17,5538,14,8123,76.173915,64.092747,691,1013
"172.16.133.87",60221,"172.16.139.250",5440,10,1022,7822,0,0,10,1022,0,0,76.191417,0.005313999999998487,1538577,0
"172.16.133.35",49988,"172.16.139.250",5440,12,1142,7823,0,0,12,1142,0,0,76.205814,0.025199000000000638,362554,0
"172.16.133.116",53396,"172.16.139.250",5440,10,1022,7824,0,0,10,1022,0,0,76.207639,0.005319000000000074,1537131,0
"172.16.133.116",53397,"172.16.139.250",5440,10,1022,7825,0,0,10,1022,0,0,76.213891,0.006574999999997999,1243498,0
"172.16.133.116",53398,"172.16.139.250",5440,10,1022,7826,0,0,10,1022,0,0,76.221258,0.00804899999999975,1015778,0
"172.16.133.84",58807,"172.16.139.250",5440,12,1142,7827,0,0,12,1142,0,0,76.228583,0.014630999999994287,624427,0
"172.16.133.49",55781,"172.16.139.250",5440,10,1022,7828,0,0,10,1022,0,0,76.306255,0.00664000000000442,1231325,0
"172.16.133.95",56983,"172.16.139.250",5440,10,1022,7829,0,0,10,1022,0,0,76.344686,0.10080000000000666,81111,0
"172.16.133.92",57696,"172.16.139.250",5440,12,1142,7830,0,0,12,1142,0,0,76.371298,0.07863799999999799,116177,0
"172.16.133.29",60950,"172.16.139.250",5440,12,1142,7831,0,0,12,1142,0,0,76.389244,0.06471099999998842,141181,0
"172.16.133.44",64848,"172.16.139.250",5440,10,1022,7832,0,0,10,1022,0,0,76.396253,0.0676650000000052,120830,0
"172.16.133.207",55948,"172.16.139.250",5440,10,1022,7833,0,0,10,1022,0,0,76.422402,0.0461039999999997,177338,0
"172.16.133.83",57106,"172.16.139.250",5440,12,1142,7834,0,0,12,1142,0,0,76.430376,0.0417720000000088,218711,0
"172.16.133.93",60731,"172.16.139.250",5440,10,1022,7835,0,0,10,1022,0,0,76.446769,0.028897000000000617,282935,0
"172.16.133.11",55157,"172.16.139.250",5440,12,1142,7836,0,0,12,1142,0,0,76.463724,0.016722000000001458,546346,0
"172.16.133.55",57595,"172.16.139.250",5440,12,1142,7837,0,0,12,1142,0,0,76.46915,0.015542999999993867,587788,0
"172.16.133.73",60687,"172.16.139.250",5440,10,1022,7838,0,0,10,1022,0,0,76.493015,0.019915999999994938,410524,0
"172.16.133.53",54114,"172.16.139.250",5440,12,1142,7839,0,0,12,1142,0,0,76.493258,0.008586000000008198,1064057,0
"172.16.133.21",53188,"172.16.139.250",5440,10,1022,7840,0,0,10,1022,0,0,76.496474,0.008579999999994925,952913,0
"172.16.133.30",62634,"172.16.139.250",5440,12,1142,7841,0,0,12,1142,0,0,76.500368,0.009038000000003876,1010843,0
"172.16.133.25",63472,"172.16.139.250",5440,12,1142,7842,0,0,12,1142,0,0,76.507634,0.0090720000000033,1007054,0
"172.16.133.34",50454,"172.16.139.250",5440,12,1142,7843,0,0,12,1142,0,0,76.515836,0.0051620000000127675,1769856,0
"172.16.133.97",59387,"172.16.139.250",5440,10,1022,7844,0,0,10,1022,0,0,76.528172,0.005425000000002456,1507096,0
"172.16.133.113",55621,"172.16.139.250",135,8,492,7845,0,0,8,492,0,0,76.533598,0.0037180000000063274,"",""
"172.16.133.113",55622,"172.16.139.250",5462,8,576,7846,0,0,8,576,0,0,76.538625,0.5076880000000017,9076,0
"172.16.133.33",57896,"172.16.139.250",5440,10,1022,7847,0,0,10,1022,0,0,76.602774,0.064746999999997,126276,0
"172.16.133.68",60745,"172.16.139.250",5440,12,1142,7848,0,0,12,1142,0,0,76.632869,0.02880100000000141,317211,0
"172.16.125.220",38786,"172.16.133.233",80,7,420,7849,0,0,4,240,3,180,76.63507,0.19293500000000563,9951,7463
"172.16.133.12",59791,"172.16.139.250",5440,12,1142,7850,0,0,12,1142,0,0,76.646183,0.019370000000009213,471657,0
"172.16.133.63",53894,"172.16.139.250",5440,10,1022,7851,0,0,10,1022,0,0,76.656577,0.01466100000000381,557670,0
"172.16.133.66",53885,"172.16.139.250",5440,10,1022,7852,0,0,10,1022,0,0,76.671406,0.07732799999999429,105731,0
"172.16.133.82",61360,"172.16.139.250",5440,10,1022,7853,0,0,10,1022,0,0,76.684547,0.06895200000001012,118575,0
"172.16.133.37",60640,"172.16.139.250",5440,10,1022,7854,0,0,10,1022,0,0,76.69783,0.061400000000006116,133159,0
"172.16.133.45",61452,"172.16.139.250",5500,10,1124,7855,0,0,10,1124,0,0,76.700566,0.22159800000000018,40577,0
"172.16.133.55",57596,"199.16.156.40",80,12,2954,7856,0,0,6,1003,6,1951,76.847132,40.670528000000004,197,383
"172.16.133.78",59223,"172.16.139.250",5440,10,1022,7857,0,0,10,1022,0,0,76.854817,0.005670000000009168,1441975,0
"172.16.133.67",56000,"172.16.139.250",5440,12,1142,7858,0,0,12,1142,0,0,76.90881,0.006389999999996121,1429733,0
"172.16.133.82",52658,"72.21.215.197",80,2,120,7859,0,0,1,60,1,60,76.928922,9.900000000584441e-05,"",""
"172.16.133.82",61361,"72.21.215.197",80,6,2062,7860,0,0,4,832,2,1230,76.929243,0.2728879999999947,24390,36058
"172.16.133.56",61444,"172.16.139.250",5440,12,1142,7861,0,0,12,1142,0,0,76.931113,0.005011000000010313,1823188,0
"172.16.133.42",57082,"172.16.139.250",5440,12,1142,7862,0,0,12,1142,0,0,76.973851,0.02865100000001064,318871,0
"172.16.133.41",53035,"172.16.139.250",5440,12,1142,7863,0,0,12,1142,0,0,76.988068,0.01706900000000644,535239,0
"172.16.133.85",52288,"172.16.139.250",5440,12,1142,7864,0,0,12,1142,0,0,77.005511,0.006236999999998716,1464806,0
"172.16.133.43",57798,"172.16.139.250",5440,12,1142,7865,0,0,12,1142,0,0,77.058446,0.016378000000003112,557821,0
"172.16.133.87",60222,"67.69.174.32",80,10,1322,7866,0,0,6,636,4,686,77.064524,152.569495,33,35
"172.16.133.13",53054,"172.16.139.250",5440,12,1142,7867,0,0,12,1142,0,0,77.076161,0.005465000000000941,1671729,0
"172.16.133.20",62410,"172.16.139.250",5440,12,1142,7868,0,0,12,1142,0,0,77.126012,0.016187999999999647,564368,0
"172.16.133.75",50973,"172.16.139.250",5440,10,1022,7869,0,0,10,1022,0,0,77.143735,0.005072999999995886,1611669,0
"172.16.133.28",65441,"172.16.139.250",5440,10,1022,7870,0,0,10,1022,0,0,77.15684,0.006091999999995323,1342087,0
"172.16.133.99",56059,"172.16.139.250",5440,10,1022,7871,0,0,10,1022,0,0,77.182798,0.004951999999988743,"",""
"172.16.133.87",60223,"172.16.139.250",5440,10,1022,7872,0,0,10,1022,0,0,77.205743,0.005310000000008586,1539736,0
"172.16.133.103",63441,"172.16.139.250",5440,12,1142,7873,0,0,12,1142,0,0,77.215286,0.019019999999997594,480336,0
"172.16.133.35",49989,"172.16.139.250",5440,12,1142,7874,0,0,12,1142,0,0,77.220666,0.014044000000012602,650526,0
"172.16.133.116",53399,"172.16.139.250",5440,12,1142,7875,0,0,12,1142,0,0,77.220807,0.005922000000012417,1542722,0
"172.16.133.116",53400,"172.16.139.250",5440,10,1022,7876,0,0,10,1022,0,0,77.227736,0.01588600000000895,514667,0
"172.16.133.84",58808,"172.16.139.250",5440,10,1022,7877,0,0,10,1022,0,0,77.243766,0.015374000000008436,531806,0
"172.16.133.116",53401,"172.16.139.250",5440,10,1022,7878,0,0,10,1022,0,0,77.244557,0.00536099999999351,1525088,0
"172.16.133.48",60516,"96.43.146.22",443,16,3738,7879,0,0,9,3172,7,566,77.29266,42.937568999999996,590,105
"172.16.133.49",55782,"172.16.139.250",5440,10,1022,7880,0,0,10,1022,0,0,77.319753,0.014857999999989602,550275,0
"172.16.133.95",56984,"172.16.139.250",5440,12,1142,7881,0,0,12,1142,0,0,77.357356,0.005831999999998061,1566529,0
"172.16.133.92",57697,"172.16.139.250",5440,12,1142,7882,0,0,12,1142,0,0,77.385592,0.005915000000001669,1544547,0
"172.16.133.46",64570,"192.147.107.14",8883,8,521,7883,0,0,5,335,3,186,77.395097,0.10816299999999046,24777,13757
"172.16.133.29",60951,"172.16.139.250",5440,12,1142,7884,0,0,12,1142,0,0,77.404081,0.006163000000000807,1482394,0
"172.16.133.44",64849,"172.16.139.250",5440,12,1142,7885,0,0,12,1142,0,0,77.41086,0.016482999999993808,554268,0
"172.16.133.207",55949,"172.16.139.250",5440,12,1142,7886,0,0,12,1142,0,0,77.43536,0.021166999999991276,431615,0
"172.16.133.83",57107,"172.16.139.250",5440,12,1142,7887,0,0,12,1142,0,0,77.444359,0.004784999999998263,"",""
"172.16.133.93",60732,"172.16.139.250",5440,10,1022,7888,0,0,10,1022,0,0,77.46356,0.004763999999994439,"",""
"172.16.133.11",55158,"172.16.139.250",5440,10,1022,7889,0,0,10,1022,0,0,77.476933,0.016066999999992504,508869,0
"172.16.133.55",57597,"172.16.139.250",5440,12,1142,7890,0,0,12,1142,0,0,77.483375,0.006414000000006581,1424384,0
"172.16.133.53",54115,"172.16.139.250",5440,12,1142,7891,0,0,12,1142,0,0,77.507057,0.018394000000000688,496683,0
"172.16.133.73",60688,"172.16.139.250",5440,10,1022,7892,0,0,10,1022,0,0,77.509528,0.02085599999999488,392021,0
"172.16.133.21",53189,"172.16.139.250",5440,10,1022,7893,0,0,10,1022,0,0,77.510375,0.00594300000000203,1375736,0
"172.16.133.30",62635,"172.16.139.250",5440,12,1142,7894,0,0,12,1142,0,0,77.513464,0.006934000000001106,1317565,0
"172.16.133.25",63473,"172.16.139.250",5440,12,1142,7895,0,0,12,1142,0,0,77.521715,0.012175999999996634,750328,0
"172.16.133.34",50455,"172.16.139.250",5440,10,1022,7896,0,0,10,1022,0,0,77.530247,0.015061000000002878,542859,0
"172.16.133.97",59388,"172.16.139.250",5440,10,1022,7897,0,0,10,1022,0,0,77.542869,0.006362000000009971,1285130,0
"172.16.133.33",57897,"172.16.139.250",5440,10,1022,7898,0,0,10,1022,0,0,77.620028,0.006225999999998066,1313202,0
"172.16.133.68",60746,"172.16.139.250",5440,10,1022,7899,0,0,10,1022,0,0,77.647337,0.015532000000007429,526397,0
"172.16.133.12",59792,"172.16.139.250",5440,10,1022,7900,0,0,10,1022,0,0,77.661461,0.005822999999992362,1404087,0
"172.16.133.63",53895,"172.16.139.250",5440,12,1142,7901,0,0,12,1142,0,0,77.670432,0.016290999999995392,560800,0
"172.16.133.66",53886,"172.16.139.250",5440,10,1022,7902,0,0,10,1022,0,0,77.685543,0.005363000000002671,1524519,0
"172.16.133.82",61362,"172.16.139.250",5440,10,1022,7903,0,0,10,1022,0,0,77.699817,0.015884999999997262,514699,0
"172.16.133.37",60641,"172.16.139.250",5440,10,1022,7904,0,0,10,1022,0,0,77.711879,0.007668000000009556,1066249,0
"172.16.133.78",59224,"172.16.139.250",5440,10,1022,7905,0,0,10,1022,0,0,77.870179,0.00704600000000255,1160374,0
"172.16.133.67",56001,"172.16.139.250",5440,12,1142,7906,0,0,12,1142,0,0,77.922801,0.006125999999994747,1491348,0
"172.16.133.56",61445,"172.16.139.250",5440,10,1022,7907,0,0,10,1022,0,0,77.944666,0.004475999999996816,"",""
"172.16.133.42",57083,"172.16.139.250",5440,12,1142,7908,0,0,12,1142,0,0,77.991411,0.028538999999994985,320123,0
"172.16.133.41",53036,"172.16.139.250",5440,12,1142,7909,0,0,12,1142,0,0,78.00117,0.005406999999991058,1689661,0
"172.16.133.45",61341,"64.90.204.229",443,17,3100,7910,0,0,8,1780,9,1320,78.009592,8.006372999999996,1778,1318
"172.16.133.85",52289,"172.16.139.250",5440,10,1022,7911,0,0,10,1022,0,0,78.019994,0.005359999999996035,1525373,0
"172.16.133.43",57799,"172.16.139.250",5440,12,1142,7912,0,0,12,1142,0,0,78.072909,0.0062989999999985,1450388,0
"172.16.133.13",53055,"172.16.139.250",5440,10,1022,7913,0,0,10,1022,0,0,78.090143,0.005387999999996396,1517446,0
"172.16.133.20",62411,"172.16.139.250",5440,10,1022,7914,0,0,10,1022,0,0,78.140228,0.015165000000010309,539136,0
"172.16.133.75",50974,"172.16.139.250",5440,10,1022,7915,0,0,10,1022,0,0,78.157825,0.005511999999995965,1483309,0
"172.16.133.28",65442,"172.16.139.250",5440,10,1022,7916,0,0,10,1022,0,0,78.171112,0.016213000000007582,504286,0
"172.16.133.99",56060,"172.16.139.250",5440,12,1142,7917,0,0,12,1142,0,0,78.198153,0.014542999999989092,628206,0
"172.16.133.87",60224,"172.16.139.250",5440,10,1022,7918,0,0,10,1022,0,0,78.21934,0.005341999999998848,1530512,0
"172.16.133.35",49990,"172.16.139.250",5440,12,1142,7919,0,0,12,1142,0,0,78.232714,0.014746999999999844,619515,0
"172.16.133.116",53402,"172.16.139.250",5440,10,1022,7920,0,0,10,1022,0,0,78.235043,0.005874999999988972,1391659,0
"172.16.133.116",53403,"172.16.139.250",5440,10,1022,7921,0,0,10,1022,0,0,78.241902,0.006933000000003631,1179287,0
"172.16.133.116",53404,"172.16.139.250",5440,10,1022,7922,0,0,10,1022,0,0,78.249719,0.00655100000000175,1248053,0
"172.16.133.84",58809,"172.16.139.250",5440,10,1022,7923,0,0,10,1022,0,0,78.257852,0.006079999999997199,1344736,0
"172.16.133.60",62133,"180.153.31.250",443,6,366,7924,0,0,4,246,2,120,78.322685,0.4737859999999898,4153,2026
"172.16.133.49",55783,"172.16.139.250",5440,10,1022,7925,0,0,10,1022,0,0,78.333907,0.006238000000010402,1310676,0
"172.16.133.95",56985,"172.16.139.250",5440,12,1142,7926,0,0,12,1142,0,0,78.372766,0.006084000000001311,1501643,0
"172.16.133.67",56002,"157.56.242.198",443,30,20336,7927,0,0,11,3360,19,16976,78.398253,0.5398300000000091,49793,251575
"172.16.133.92",57698,"172.16.139.250",5440,12,1142,7928,0,0,12,1142,0,0,78.40018,0.015518000000000143,588735,0
"172.16.133.29",60952,"172.16.139.250",5440,10,1022,7929,0,0,10,1022,0,0,78.417524,0.005341999999998848,1530512,0
"172.16.133.44",64850,"172.16.139.250",5440,10,1022,7930,0,0,10,1022,0,0,78.424458,0.005426999999997406,1506541,0
"172.16.133.207",55950,"172.16.139.250",5440,12,1142,7931,0,0,12,1142,0,0,78.449164,0.016677000000001385,547820,0
"172.16.133.83",57108,"172.16.139.250",5440,12,1142,7932,0,0,12,1142,0,0,78.457269,0.004744000000002302,"",""
"172.16.133.93",60733,"172.16.139.250",5440,12,1142,7933,0,0,12,1142,0,0,78.474853,0.014656000000002223,623362,0
"172.16.133.11",55159,"172.16.139.250",5440,10,1022,7934,0,0,10,1022,0,0,78.491809,0.005482999999998128,1491154,0
"172.16.133.55",57598,"172.16.139.250",5440,10,1022,7935,0,0,10,1022,0,0,78.49701,0.005668999999997482,1442229,0
"172.16.133.73",60689,"172.16.139.250",5440,12,1142,7936,0,0,12,1142,0,0,78.518966,0.006025999999991427,1516096,0
"172.16.133.53",54116,"172.16.139.250",5440,10,1022,7937,0,0,10,1022,0,0,78.521466,0.01597900000000152,511671,0
"172.16.133.21",53190,"172.16.139.250",5440,10,1022,7938,0,0,10,1022,0,0,78.52429,0.005555000000001087,1471827,0
"172.16.133.30",62636,"172.16.139.250",5440,12,1142,7939,0,0,12,1142,0,0,78.527401,0.006340000000008672,1441009,0
"172.16.133.25",63474,"172.16.139.250",5440,10,1022,7940,0,0,10,1022,0,0,78.536132,0.005943999999999505,1375504,0
"172.16.133.34",50456,"172.16.139.250",5440,10,1022,7941,0,0,10,1022,0,0,78.543824,0.00670300000000168,1219752,0
"172.16.133.97",59389,"172.16.139.250",5440,10,1022,7942,0,0,10,1022,0,0,78.555223,0.005430000000004043,1505709,0
"172.16.133.33",57898,"172.16.139.250",5440,12,1142,7943,0,0,12,1142,0,0,78.630836,0.006443000000004417,1417972,0
"172.16.133.68",60747,"172.16.139.250",5440,12,1142,7944,0,0,12,1142,0,0,78.660917,0.006456000000000017,1415117,0
"172.16.133.12",59793,"172.16.139.250",5440,10,1022,7945,0,0,10,1022,0,0,78.674452,0.006616999999991435,1235605,0
"172.16.133.63",53897,"172.16.139.250",5440,10,1022,7946,0,0,10,1022,0,0,78.685578,0.005431999999998993,1505154,0
"172.16.133.66",53887,"172.16.139.250",5440,10,1022,7947,0,0,10,1022,0,0,78.699326,0.005065999999999349,1613896,0
"172.16.133.82",61363,"172.16.139.250",5440,10,1022,7948,0,0,10,1022,0,0,78.712163,0.005474999999989905,1493333,0
"172.16.133.37",60642,"172.16.139.250",5440,10,1022,7949,0,0,10,1022,0,0,78.725995,0.0061249999999972715,1334857,0
"172.16.133.103",63401,"96.43.146.48",443,4,240,7950,0,0,2,120,2,120,78.769778,0.04125600000000418,23269,23269
"172.16.133.103",63442,"96.43.146.48",443,22,5386,7951,0,0,13,3456,9,1930,78.770041,25.993000999999992,1063,594
"172.16.133.78",59225,"172.16.139.250",5440,10,1022,7952,0,0,10,1022,0,0,78.882725,0.005644000000003757,1448618,0
"172.16.133.67",56003,"172.16.139.250",5440,12,1142,7953,0,0,12,1142,0,0,78.936664,0.015621000000010099,584853,0
"172.16.133.56",61446,"172.16.139.250",5440,12,1142,7954,0,0,12,1142,0,0,78.959436,0.004946000000003892,"",""
"172.16.133.42",57084,"172.16.139.250",5440,12,1142,7955,0,0,12,1142,0,0,79.003389,0.0663899999999984,137611,0
"172.16.133.41",53037,"172.16.139.250",5440,10,1022,7956,0,0,10,1022,0,0,79.015352,0.03178200000000686,257252,0
"172.16.133.85",52290,"172.16.139.250",5440,10,1022,7957,0,0,10,1022,0,0,79.032716,0.018090000000000828,451962,0
"172.16.133.43",57800,"172.16.139.250",5440,10,1022,7958,0,0,10,1022,0,0,79.086313,0.014541999999991617,562233,0
"172.16.133.18",50182,"157.56.238.6",443,3,180,7959,0,0,2,120,1,60,79.093989,0.09208200000000488,10425,5212
"172.16.133.18",50292,"157.56.238.6",443,825,777778,7960,0,0,390,385647,435,392131,79.094392,213.80141,14430,14672
"172.16.133.13",53056,"172.16.139.250",5440,10,1022,7961,0,0,10,1022,0,0,79.1041,0.014420999999998685,566950,0
"172.16.133.20",62412,"172.16.139.250",5440,12,1142,7962,0,0,12,1142,0,0,79.154226,0.005258000000011975,1737542,0
"172.16.133.75",50975,"172.16.139.250",5440,10,1022,7963,0,0,10,1022,0,0,79.171839,0.016329999999996403,500673,0
"172.16.133.28",65444,"172.16.139.250",5440,10,1022,7964,0,0,10,1022,0,0,79.184259,0.015375000000005912,531772,0
"172.16.133.99",56061,"172.16.139.250",5440,12,1142,7965,0,0,12,1142,0,0,79.211975,0.015123000000002662,604112,0
"172.16.133.87",60225,"172.16.139.250",5440,10,1022,7966,0,0,10,1022,0,0,79.233056,0.014737999999994145,554756,0
"172.16.133.35",49991,"172.16.139.250",5440,12,1142,7967,0,0,12,1142,0,0,79.245705,0.0085679999999968,1066293,0
"172.16.133.116",53405,"172.16.139.250",5440,10,1022,7968,0,0,10,1022,0,0,79.249165,0.01496699999999862,546268,0
"172.16.133.116",53406,"172.16.139.250",5440,10,1022,7969,0,0,10,1022,0,0,79.265146,0.00514400000000137,1589424,0
"172.16.133.116",53407,"172.16.139.250",5440,10,1022,7970,0,0,10,1022,0,0,79.271122,0.006208999999998355,1316798,0
"172.16.133.84",58810,"172.16.139.250",5440,12,1142,7971,0,0,12,1142,0,0,79.271808,0.045313000000007264,201619,0
"172.16.133.49",55784,"172.16.139.250",5440,12,1142,7972,0,0,12,1142,0,0,79.348041,0.016232000000002245,562838,0
"172.16.133.95",56986,"172.16.139.250",5440,12,1142,7973,0,0,12,1142,0,0,79.387394,0.01552499999999668,588470,0
"172.16.133.92",57699,"172.16.139.250",5440,12,1142,7974,0,0,12,1142,0,0,79.414374,0.017480000000006157,522654,0
"172.16.133.56",60775,"96.43.146.48",443,2,120,7975,0,0,1,60,1,60,79.423116,0.00016300000000057935,"",""
"172.16.133.56",61447,"96.43.146.48",443,21,4104,7976,0,0,12,2537,9,1567,79.423823,65.96017599999999,307,190
"172.16.133.29",60953,"172.16.139.250",5440,10,1022,7977,0,0,10,1022,0,0,79.432058,0.005656000000001882,1445544,0
"172.16.133.44",64851,"172.16.139.250",5440,10,1022,7978,0,0,10,1022,0,0,79.438726,0.015406999999996174,530667,0
"172.16.133.207",55951,"172.16.139.250",5440,10,1022,7979,0,0,10,1022,0,0,79.463834,0.004656999999994582,"",""
"172.16.133.83",57109,"172.16.139.250",5440,12,1142,7980,0,0,12,1142,0,0,79.471466,0.004724999999993429,"",""
"172.16.133.93",60734,"172.16.139.250",5440,12,1142,7981,0,0,12,1142,0,0,79.488996,0.0050650000000018736,1803751,0
"172.16.133.11",55160,"172.16.139.250",5440,10,1022,7982,0,0,10,1022,0,0,79.505021,0.005616000000003396,1455840,0
"172.16.133.55",57599,"172.16.139.250",5440,12,1142,7983,0,0,12,1142,0,0,79.511056,0.015568000000001803,586844,0
"172.16.133.73",60690,"172.16.139.250",5440,10,1022,7984,0,0,10,1022,0,0,79.534016,0.0058120000000059235,1406744,0
"172.16.133.53",54117,"172.16.139.250",5440,12,1142,7985,0,0,12,1142,0,0,79.535156,0.017151999999995837,532649,0
"172.16.133.21",53191,"172.16.139.250",5440,10,1022,7986,0,0,10,1022,0,0,79.538184,0.006249999999994316,1308160,0
"172.16.133.30",62637,"172.16.139.250",5440,12,1142,7987,0,0,12,1142,0,0,79.541451,0.006696000000005142,1364396,0
"172.16.133.25",63475,"172.16.139.250",5440,12,1142,7988,0,0,12,1142,0,0,79.549587,0.006518999999997277,1401441,0
"172.16.133.34",50457,"172.16.139.250",5440,12,1142,7989,0,0,12,1142,0,0,79.557836,0.007783000000003426,1173840,0
"172.16.133.97",59390,"172.16.139.250",5440,10,1022,7990,0,0,10,1022,0,0,79.569548,0.015331000000003314,533298,0
"172.16.133.33",57899,"172.16.139.250",5440,10,1022,7991,0,0,10,1022,0,0,79.644885,0.01585500000000195,515673,0
"172.16.133.68",60748,"172.16.139.250",5440,10,1022,7992,0,0,10,1022,0,0,79.675133,0.005901999999991858,1385293,0
"172.16.133.12",59794,"172.16.139.250",5440,10,1022,7993,0,0,10,1022,0,0,79.688615,0.005722000000005778,1428871,0
"172.16.133.63",53898,"172.16.139.250",5440,10,1022,7994,0,0,10,1022,0,0,79.699515,0.0053089999999968995,1540026,0
"172.16.133.66",53888,"172.16.139.250",5440,10,1022,7995,0,0,10,1022,0,0,79.714339,0.005794000000008737,1411114,0
"172.16.133.82",61364,"172.16.139.250",5440,12,1142,7996,0,0,12,1142,0,0,79.726174,0.0061939999999935935,1474975,0
"172.16.133.37",60643,"172.16.139.250",5440,10,1022,7997,0,0,10,1022,0,0,79.739983,0.014482000000000994,564562,0
"172.16.133.78",59226,"172.16.139.250",5440,10,1022,7998,0,0,10,1022,0,0,79.896919,0.005723000000003253,1428621,0
"172.16.133.48",60517,"184.73.197.44",443,17,5459,7999,0,0,9,2021,8,3438,79.907175,14.217990999999998,1137,1934
"172.16.133.67",56004,"172.16.139.250",5440,10,1022,8000,0,0,10,1022,0,0,79.950819,0.0053460000000029595,1529367,0
"172.16.133.56",61448,"172.16.139.250",5440,10,1022,8001,0,0,10,1022,0,0,79.972983,0.00480299999999545,"",""
"172.16.133.42",57085,"172.16.139.250",5440,12,1142,8002,0,0,12,1142,0,0,80.021727,0.05608999999999753,162881,0
"172.16.133.41",53038,"172.16.139.250",5440,12,1142,8003,0,0,12,1142,0,0,80.030421,0.0060560000000009495,1508586,0
"172.16.133.85",52291,"172.16.139.250",5440,12,1142,8004,0,0,12,1142,0,0,80.04666,0.018771999999998457,486682,0
"172.16.133.43",57801,"172.16.139.250",5440,10,1022,8005,0,0,10,1022,0,0,80.100712,0.015260999999995306,535744,0
"172.16.133.13",53057,"172.16.139.250",5440,10,1022,8006,0,0,10,1022,0,0,80.118262,0.0055720000000007985,1467336,0
"172.16.133.20",62413,"172.16.139.250",5440,10,1022,8007,0,0,10,1022,0,0,80.167082,0.0048799999999999955,"",""
"172.16.133.75",50976,"172.16.139.250",5440,10,1022,8008,0,0,10,1022,0,0,80.185428,0.0158660000000026,515315,0
"172.16.133.28",65446,"172.16.139.250",5440,10,1022,8009,0,0,10,1022,0,0,80.198387,0.015219999999999345,537187,0
"172.16.133.99",56062,"172.16.139.250",5440,12,1142,8010,0,0,12,1142,0,0,80.224811,0.014869000000004462,614432,0
"172.16.133.87",60226,"172.16.139.250",5440,12,1142,8011,0,0,12,1142,0,0,80.248159,0.006067999999999074,1505603,0
"172.16.133.116",53409,"172.16.139.250",5440,10,1022,8012,0,0,10,1022,0,0,80.262726,0.005101999999993723,1602508,0
"172.16.133.116",53410,"172.16.139.250",5440,10,1022,8013,0,0,10,1022,0,0,80.268986,0.005384000000006495,1518573,0
"172.16.133.35",49992,"172.16.139.250",5440,12,1142,8014,0,0,12,1142,0,0,80.271741,0.008168999999995208,1118374,0
"172.16.133.116",53411,"172.16.139.250",5440,10,1022,8015,0,0,10,1022,0,0,80.275224,0.006927000000004568,1180308,0
"172.16.133.84",58811,"172.16.139.250",5440,10,1022,8016,0,0,10,1022,0,0,80.28467,0.005330000000000723,1533958,0
"172.16.133.49",55785,"172.16.139.250",5440,10,1022,8017,0,0,10,1022,0,0,80.362081,0.04300299999999879,190126,0
"172.16.133.95",56987,"172.16.139.250",5440,12,1142,8018,0,0,12,1142,0,0,80.39971800000001,0.015331999999986579,595877,0
"172.16.133.92",57700,"172.16.139.250",5440,12,1142,8019,0,0,12,1142,0,0,80.426374,0.015735000000006494,580616,0
"172.16.133.29",60954,"172.16.139.250",5440,10,1022,8020,0,0,10,1022,0,0,80.447107,0.015586999999996465,524539,0
"172.16.133.44",64852,"172.16.139.250",5440,10,1022,8021,0,0,10,1022,0,0,80.452877,0.015179000000003384,538638,0
"172.16.133.207",55952,"172.16.139.250",5440,12,1142,8022,0,0,12,1142,0,0,80.477492,0.014479000000008568,630982,0
"172.16.133.83",57110,"172.16.139.250",5440,12,1142,8023,0,0,12,1142,0,0,80.485412,0.01431800000000294,638077,0
"172.16.133.93",60735,"172.16.139.250",5440,12,1142,8024,0,0,12,1142,0,0,80.502743,0.014968000000010306,610368,0
"172.16.133.11",55161,"172.16.139.250",5440,12,1142,8025,0,0,12,1142,0,0,80.518926,0.018316000000012878,498798,0
"172.16.133.55",57600,"172.16.139.250",5440,10,1022,8026,0,0,10,1022,0,0,80.52442,0.008145999999996434,1003682,0
"172.16.133.73",60691,"172.16.139.250",5440,12,1142,8027,0,0,12,1142,0,0,80.548086,0.018101999999998952,504695,0
"172.16.133.53",54118,"172.16.139.250",5440,10,1022,8028,0,0,10,1022,0,0,80.549178,0.019967000000008284,409475,0
"172.16.133.21",53192,"172.16.139.250",5440,12,1142,8029,0,0,12,1142,0,0,80.55241,0.020915000000002237,436815,0
"172.16.133.30",62638,"172.16.139.250",5440,10,1022,8030,0,0,10,1022,0,0,80.5557,0.005999000000002752,1362893,0
"172.16.133.60",62134,"180.153.31.250",443,6,366,8031,0,0,4,246,2,120,80.563487,0.49942900000000634,3940,1922
"172.16.133.25",63476,"172.16.139.250",5440,12,1142,8032,0,0,12,1142,0,0,80.56361,0.013412000000002422,681181,0
"172.16.133.34",50458,"172.16.139.250",5440,12,1142,8033,0,0,12,1142,0,0,80.572214,0.008703999999994494,1049632,0
"172.16.133.97",59391,"172.16.139.250",5440,10,1022,8034,0,0,10,1022,0,0,80.583332,0.005521999999999139,1480622,0
"172.16.133.33",57900,"172.16.139.250",5440,12,1142,8035,0,0,12,1142,0,0,80.659143,0.006531999999992877,1398652,0
"172.16.133.68",60749,"172.16.139.250",5440,10,1022,8036,0,0,10,1022,0,0,80.68922,0.00575200000000109,1421418,0
"172.16.133.12",59795,"172.16.139.250",5440,12,1142,8037,0,0,12,1142,0,0,80.702151,0.0063739999999938846,1433322,0
"172.16.133.63",53899,"172.16.139.250",5440,12,1142,8038,0,0,12,1142,0,0,80.711745,0.006110000000006721,1495253,0
"172.16.133.184",47034,"205.216.16.228",80,127,102210,8039,0,0,54,3346,73,98864,80.722876,2.6679029999999955,10033,296454
"172.16.133.66",53889,"172.16.139.250",5440,10,1022,8040,0,0,10,1022,0,0,80.72805,0.015107000000000426,541206,0
"172.16.133.82",61365,"172.16.139.250",5440,10,1022,8041,0,0,10,1022,0,0,80.740104,0.00686799999999721,1190448,0
"172.16.133.49",55786,"72.21.214.199",443,27,11271,8042,0,0,12,1610,15,9661,80.741263,180.363703,71,428
"172.16.133.42",57086,"172.16.139.250",5440,12,1102,8043,0,0,12,1102,0,0,80.743331,0.027468999999996413,320943,0
"172.16.133.37",60644,"172.16.139.250",5440,12,1142,8044,0,0,12,1142,0,0,80.754231,0.016063000000002603,568760,0
"172.16.133.42",57087,"172.16.139.250",5440,12,1108,8045,0,0,12,1108,0,0,80.771493,0.019362999999998465,457780,0
"172.16.133.42",57088,"172.16.139.250",5440,12,1206,8046,0,0,12,1206,0,0,80.790804,0.01006399999999985,958664,0
"172.16.133.42",57089,"172.16.139.250",5440,12,1394,8047,0,0,12,1394,0,0,80.835209,0.01273699999998712,875559,0
"172.16.133.42",57090,"172.16.139.250",5440,12,1152,8048,0,0,12,1152,0,0,80.854009,0.0090979999999945,1012969,0
"172.16.133.42",57091,"172.16.139.250",5440,14,3184,8049,0,0,14,3184,0,0,80.864145,0.011362000000005423,2241858,0
"172.16.133.42",57092,"172.16.139.250",5440,12,1328,8050,0,0,12,1328,0,0,80.875552,0.01645899999999756,645482,0
"172.16.133.42",57093,"172.16.139.250",5440,12,1110,8051,0,0,12,1110,0,0,80.892657,0.02578900000000317,344332,0
"172.16.133.42",57094,"172.16.139.250",5440,12,1136,8052,0,0,12,1136,0,0,80.893101,0.025009999999994648,363374,0
"172.16.133.42",57095,"172.16.139.250",5440,12,1112,8053,0,0,12,1112,0,0,80.893606,0.013225999999988858,672614,0
"172.16.133.42",57096,"172.16.139.250",5440,12,1114,8054,0,0,12,1114,0,0,80.893982,0.024468000000013035,364230,0
"172.16.133.78",59227,"172.16.139.250",5440,12,1142,8055,0,0,12,1142,0,0,80.911972,0.008772999999990816,1041376,0
"172.16.133.42",57097,"172.16.139.250",5440,12,1136,8056,0,0,12,1136,0,0,80.918206,0.01232900000000825,737123,0
"172.16.133.42",57098,"172.16.139.250",5440,12,1118,8057,0,0,12,1118,0,0,80.918385,0.0244339999999994,366047,0
"172.16.133.42",57099,"172.16.139.250",5440,12,1136,8058,0,0,12,1136,0,0,80.918803,0.02316199999999924,392366,0
"172.16.133.42",57100,"172.16.139.250",5440,12,1136,8059,0,0,12,1136,0,0,80.930629,0.021224000000003684,428194,0
"172.16.133.49",55787,"216.219.118.244",443,6,366,8060,0,0,4,246,2,120,80.938547,0.21893599999999935,8988,4384
"172.16.133.49",55788,"78.108.118.250",443,6,366,8061,0,0,4,246,2,120,80.940991,0.21493700000000615,9156,4466
"172.16.133.42",57101,"172.16.139.250",5440,14,1708,8062,0,0,14,1708,0,0,80.942328,0.03714499999999532,367855,0
"172.16.133.49",55789,"68.64.24.250",443,6,366,8063,0,0,4,246,2,120,80.94443,0.09917099999999834,19844,9680
"172.16.133.49",55790,"216.115.219.126",443,6,366,8064,0,0,4,246,2,120,80.945062,0.490548000000004,4011,1956
"172.16.133.42",57102,"172.16.139.250",5440,12,1140,8065,0,0,12,1140,0,0,80.951774,0.027697000000003413,329277,0
"172.16.133.42",57103,"172.16.139.250",5440,12,1136,8066,0,0,12,1136,0,0,80.95193,0.027346999999991795,332321,0
"172.16.133.42",57104,"172.16.139.250",5440,12,1122,8067,0,0,12,1122,0,0,80.952088,0.051287999999999556,175011,0
"172.16.133.67",56005,"172.16.139.250",5440,12,1142,8068,0,0,12,1142,0,0,80.964803,0.01330799999999499,686504,0
"172.16.133.42",57105,"172.16.139.250",5440,12,1136,8069,0,0,12,1136,0,0,80.979374,0.06462099999998827,140635,0
"172.16.133.42",57106,"172.16.139.250",5440,14,1792,8070,0,0,14,1792,0,0,80.979607,0.07424899999999468,193080,0
"172.16.133.42",57107,"172.16.139.250",5440,12,1152,8071,0,0,12,1152,0,0,80.979609,0.06454200000000299,142790,0
"172.16.133.12",59796,"172.16.139.250",5440,12,1142,8072,0,0,12,1142,0,0,80.984531,0.01625500000000102,562042,0
"172.16.133.56",61449,"172.16.139.250",5440,12,1142,8073,0,0,12,1142,0,0,80.988375,0.005018999999990115,1820282,0
"172.16.133.21",53193,"64.74.80.187",443,6,366,8074,0,0,4,246,2,120,81.035246,0.05843299999999374,33679,16429
"172.16.133.21",53194,"67.217.65.244",443,6,366,8075,0,0,4,246,2,120,81.03547,0.06681600000000287,29454,14367
"172.16.133.21",53195,"202.173.28.250",443,6,366,8076,0,0,4,246,2,120,81.036769,0.5052919999999972,3894,1899
"172.16.133.42",57108,"172.16.139.250",5440,12,1136,8077,0,0,12,1136,0,0,81.043933,0.016099000000011188,564507,0
"172.16.133.41",53039,"172.16.139.250",5440,12,1142,8078,0,0,12,1142,0,0,81.044203,0.038207999999997355,239112,0
"172.16.133.42",57109,"172.16.139.250",5440,14,1252,8079,0,0,14,1252,0,0,81.044255,0.07430399999999793,134797,0
"172.16.133.42",57110,"172.16.139.250",5440,12,1112,8080,0,0,12,1112,0,0,81.044257,0.01577899999999488,563787,0
"172.16.133.42",57111,"172.16.139.250",5440,12,1142,8081,0,0,12,1142,0,0,81.046214,0.059701999999987265,153026,0
"172.16.133.21",53196,"216.115.212.254",443,6,366,8082,0,0,4,246,2,120,81.048066,0.19425400000000081,10131,4941
"172.16.133.113",55623,"172.16.139.250",135,8,492,8083,0,0,8,492,0,0,81.05013,0.005009000000001151,785785,0
"172.16.133.42",57112,"172.16.139.250",5440,12,1194,8084,0,0,12,1194,0,0,81.053789,0.052287000000006856,182684,0
"172.16.133.113",55624,"172.16.139.250",5462,10,696,8085,0,0,10,696,0,0,81.05636,0.509799000000001,10921,0
"172.16.133.85",52292,"172.16.139.250",5440,10,1022,8086,0,0,10,1022,0,0,81.061842,0.04543300000000272,179957,0
"172.16.133.42",57113,"172.16.139.250",5440,12,1108,8087,0,0,12,1108,0,0,81.063148,0.05238800000000765,169199,0
"172.16.133.42",57114,"172.16.139.250",5440,12,1126,8088,0,0,12,1126,0,0,81.114145,0.04288800000000492,210035,0
"172.16.133.43",57802,"172.16.139.250",5440,10,1022,8089,0,0,10,1022,0,0,81.114677,0.0056869999999946685,1437664,0
"172.16.133.42",57115,"172.16.139.250",5440,12,1212,8090,0,0,12,1212,0,0,81.115333,0.04192899999999611,231248,0
"172.16.133.42",57116,"172.16.139.250",5440,12,1212,8091,0,0,12,1212,0,0,81.11534,0.04195699999999647,231093,0
"172.16.133.13",53058,"172.16.139.250",5440,12,1142,8092,0,0,12,1142,0,0,81.132094,0.023171000000004938,394285,0
"172.16.133.42",57117,"172.16.139.250",5440,12,1152,8093,0,0,12,1152,0,0,81.166057,0.028400000000004866,324507,0
"172.16.133.42",57118,"172.16.139.250",5440,12,1224,8094,0,0,12,1224,0,0,81.172021,0.025808999999995308,379402,0
"172.16.133.20",62414,"172.16.139.250",5440,12,1142,8095,0,0,12,1142,0,0,81.18131,0.014547000000007415,628033,0
"172.16.133.42",57119,"172.16.139.250",5440,12,1110,8096,0,0,12,1110,0,0,81.197777,0.008600000000001273,1032558,0
"172.16.133.75",50977,"172.16.139.250",5440,10,1022,8097,0,0,10,1022,0,0,81.198729,0.015782000000001517,518058,0
"172.16.133.42",57120,"172.16.139.250",5440,12,1222,8098,0,0,12,1222,0,0,81.206322,0.0038279999999986103,"",""
"172.16.133.28",65447,"172.16.139.250",5440,12,1142,8099,0,0,12,1142,0,0,81.212312,0.006685000000004493,1366641,0
"172.16.133.42",57121,"172.16.139.250",5440,12,1126,8100,0,0,12,1126,0,0,81.212313,0.02632800000000657,342145,0
"172.16.133.99",56063,"172.16.139.250",5440,12,1142,8101,0,0,12,1142,0,0,81.239481,0.014335000000002651,637321,0
"172.16.133.42",57122,"172.16.139.250",5440,12,1206,8102,0,0,12,1206,0,0,81.257453,0.025667999999996027,375876,0
"172.16.133.87",60227,"172.16.139.250",5440,10,1022,8103,0,0,10,1022,0,0,81.261294,0.00586699999999496,1393557,0
"132.245.2.22",443,"172.16.133.84",49348,34,22121,8104,0,0,22,21401,12,720,81.271686,179.978001,951,32
"172.16.133.35",49993,"172.16.139.250",5440,12,1142,8105,0,0,12,1142,0,0,81.274935,0.018533000000005018,492958,0
"172.16.133.116",53412,"172.16.139.250",5440,12,1142,8106,0,0,12,1142,0,0,81.276811,0.004891000000000645,"",""
"172.16.133.116",53413,"172.16.139.250",5440,12,1142,8107,0,0,12,1142,0,0,81.282598,0.008806000000006975,1037474,0
"172.16.133.42",57123,"172.16.139.250",5440,12,1110,8108,0,0,12,1110,0,0,81.284198,0.017786000000000968,499269,0
"172.16.133.116",53414,"172.16.139.250",5440,10,1022,8109,0,0,10,1022,0,0,81.292328,0.005240999999998053,1560007,0
"172.16.133.84",58812,"172.16.139.250",5440,10,1022,8110,0,0,10,1022,0,0,81.299209,0.005451999999991131,1499633,0
"172.16.133.42",57124,"172.16.139.250",5440,12,1140,8111,0,0,12,1140,0,0,81.303601,0.009634000000005472,946647,0
"172.16.133.42",57125,"172.16.139.250",5440,12,1164,8112,0,0,12,1164,0,0,81.324979,0.013615999999998962,683901,0
"172.16.133.42",57126,"172.16.139.250",5440,16,1814,8113,0,0,16,1814,0,0,81.338541,0.020144999999999413,720377,0
"172.16.133.73",60692,"74.125.170.143",80,2179,2694424,8114,0,0,409,29058,1770,2665366,81.358448,47.32857800000001,4911,450529
"172.16.133.42",57127,"172.16.139.250",5440,12,1126,8115,0,0,12,1126,0,0,81.35863,0.013860999999991463,649880,0
"172.16.133.49",55791,"172.16.139.250",5440,10,1022,8116,0,0,10,1022,0,0,81.375816,0.005826999999996474,1403123,0
"172.16.133.42",57128,"172.16.139.250",5440,12,1126,8117,0,0,12,1126,0,0,81.384234,0.013478999999989583,668298,0
"172.16.133.42",57129,"172.16.139.250",5440,12,1168,8118,0,0,12,1168,0,0,81.397659,0.007925000000000182,1179053,0
"172.16.133.42",57130,"172.16.139.250",5440,12,1134,8119,0,0,12,1134,0,0,81.410763,0.02669899999999359,339788,0
"172.16.133.95",56988,"172.16.139.250",5440,12,1142,8120,0,0,12,1142,0,0,81.41473,0.006372999999996409,1433547,0
"172.16.133.92",57701,"172.16.139.250",5440,10,1022,8121,0,0,10,1022,0,0,81.442543,0.015362999999993576,532187,0
"172.16.133.29",60955,"172.16.139.250",5440,10,1022,8122,0,0,10,1022,0,0,81.459546,0.005358000000001084,1525942,0
"172.16.133.44",64853,"172.16.139.250",5440,10,1022,8123,0,0,10,1022,0,0,81.470321,0.005620000000007508,1454804,0
"172.16.133.207",55953,"172.16.139.250",5440,10,1022,8124,0,0,10,1022,0,0,81.4915,0.004790999999997325,"",""
"172.16.133.83",57111,"172.16.139.250",5440,12,1142,8125,0,0,12,1142,0,0,81.49955,0.014793999999994867,617547,0
"172.16.133.42",57131,"172.16.139.250",5440,12,1132,8126,0,0,12,1132,0,0,81.504831,0.007103000000000748,1274954,0
"172.16.133.42",57132,"172.16.139.250",5440,12,1136,8127,0,0,12,1136,0,0,81.510799,0.009189999999989595,988900,0
"172.16.133.42",57133,"172.16.139.250",5440,12,1208,8128,0,0,12,1208,0,0,81.513395,0.006596999999999298,1464908,0
"172.16.133.93",60736,"172.16.139.250",5440,12,1142,8129,0,0,12,1142,0,0,81.516801,0.014842999999999051,615508,0
"172.16.133.42",57134,"172.16.139.250",5440,12,1240,8130,0,0,12,1240,0,0,81.521109,0.01343400000000372,738424,0
"172.16.133.11",55162,"172.16.139.250",5440,12,1142,8131,0,0,12,1142,0,0,81.533568,0.01569700000000296,582022,0
"172.16.133.42",57135,"172.16.139.250",5440,12,1234,8132,0,0,12,1234,0,0,81.537694,0.026460999999997625,373077,0
"172.16.133.55",57601,"172.16.139.250",5440,12,1142,8133,0,0,12,1142,0,0,81.538311,0.016351000000000226,558742,0
"172.16.133.73",60693,"172.16.139.250",5440,12,1142,8134,0,0,12,1142,0,0,81.560683,0.006585000000001173,1387395,0
"172.16.133.53",54119,"172.16.139.250",5440,12,1142,8135,0,0,12,1142,0,0,81.563488,0.008494999999996367,1075456,0
"172.16.133.42",57136,"172.16.139.250",5440,12,1112,8136,0,0,12,1112,0,0,81.564051,0.016252999999991857,547345,0
"172.16.133.21",53197,"172.16.139.250",5440,12,1142,8137,0,0,12,1142,0,0,81.566507,0.014821999999995228,616381,0
"172.16.133.30",62639,"172.16.139.250",5440,10,1022,8138,0,0,10,1022,0,0,81.569005,0.01771800000000212,461451,0
"172.16.133.25",63477,"172.16.139.250",5440,12,1142,8139,0,0,12,1142,0,0,81.57771,0.013016000000007466,701905,0
"172.16.133.42",57137,"172.16.139.250",5440,16,1908,8140,0,0,16,1908,0,0,81.580251,0.029118999999994344,524193,0
"172.16.133.34",50459,"172.16.139.250",5440,12,1142,8141,0,0,12,1142,0,0,81.586295,0.008369999999999322,1091517,0
"172.16.133.97",59392,"172.16.139.250",5440,12,1142,8142,0,0,12,1142,0,0,81.597334,0.008596999999994637,1062696,0
"172.16.133.42",57138,"172.16.139.250",5440,12,1208,8143,0,0,12,1208,0,0,81.60932,0.006776999999999589,1425999,0
"172.16.133.42",57139,"172.16.139.250",5440,12,1150,8144,0,0,12,1150,0,0,81.623076,0.010648000000003321,864012,0
"172.16.133.42",57140,"172.16.139.250",5440,14,1740,8145,0,0,14,1740,0,0,81.633232,0.020547999999990907,677438,0
"172.16.133.42",57141,"172.16.139.250",5440,14,1740,8146,0,0,14,1740,0,0,81.658388,0.04795799999999417,290253,0
"172.16.133.33",57901,"172.16.139.250",5440,10,1022,8147,0,0,10,1022,0,0,81.672978,0.018863999999993553,433418,0
"172.16.133.68",60750,"172.16.139.250",5440,12,1142,8148,0,0,12,1142,0,0,81.703263,0.006634999999988622,1376940,0
"172.16.133.42",57142,"172.16.139.250",5440,14,1734,8149,0,0,14,1734,0,0,81.706291,0.04460800000001086,310975,0
"172.16.133.12",59797,"172.16.139.250",5440,12,1142,8150,0,0,12,1142,0,0,81.71652,0.0262209999999925,348423,0
"172.16.133.63",53900,"172.16.139.250",5440,10,1022,8151,0,0,10,1022,0,0,81.726785,0.019123999999990815,427525,0
"172.16.133.66",53890,"172.16.139.250",5440,10,1022,8152,0,0,10,1022,0,0,81.74139,0.00818600000000913,998778,0
"172.16.133.42",57143,"172.16.139.250",5440,18,2064,8153,0,0,18,2064,0,0,81.751848,0.03164700000000664,521755,0
"172.16.133.82",61366,"172.16.139.250",5440,10,1022,8154,0,0,10,1022,0,0,81.754506,0.01598099999999647,511607,0
"172.16.133.37",60645,"172.16.139.250",5440,10,1022,8155,0,0,10,1022,0,0,81.767615,0.017139999999997713,477012,0
"172.16.133.42",57144,"172.16.139.250",5440,12,1126,8156,0,0,12,1126,0,0,81.807812,0.01293900000000292,696189,0
"172.16.133.42",57145,"172.16.139.250",5440,16,1824,8157,0,0,16,1824,0,0,81.821087,0.017816999999993754,818993,0
"172.16.133.42",57146,"172.16.139.250",5440,16,1846,8158,0,0,16,1846,0,0,81.839507,0.22146800000000155,66682,0
"172.16.133.78",59228,"172.16.139.250",5440,12,1142,8159,0,0,12,1142,0,0,81.924782,0.005873000000008233,1555593,0
"172.16.133.67",56006,"172.16.139.250",5440,10,1022,8160,0,0,10,1022,0,0,81.979407,0.0056960000000003674,1435393,0
"172.16.133.56",61450,"172.16.139.250",5440,12,1142,8161,0,0,12,1142,0,0,82.001462,0.004880999999997471,"",""
"172.16.133.41",53040,"172.16.139.250",5440,12,1142,8162,0,0,12,1142,0,0,82.058436,0.016272999999998206,561420,0
"172.16.133.85",52293,"172.16.139.250",5440,12,1142,8163,0,0,12,1142,0,0,82.075402,0.007125999999999522,1282065,0
"172.16.133.43",57803,"172.16.139.250",5440,12,1142,8164,0,0,12,1142,0,0,82.128285,0.006369999999989773,1434222,0
"172.16.133.13",53059,"172.16.139.250",5440,12,1142,8165,0,0,12,1142,0,0,82.146088,0.016246999999992795,562319,0
"172.16.133.20",62415,"172.16.139.250",5440,10,1022,8166,0,0,10,1022,0,0,82.196259,0.004761000000002014,"",""
"172.16.133.75",50978,"172.16.139.250",5440,12,1142,8167,0,0,12,1142,0,0,82.212845,0.016795999999999367,543939,0
"172.16.133.28",65448,"172.16.139.250",5440,12,1142,8168,0,0,12,1142,0,0,82.226213,0.009861000000000786,926478,0
"172.16.133.99",56064,"172.16.139.250",5440,10,1022,8169,0,0,10,1022,0,0,82.253578,0.005135999999993146,1591900,0
"172.16.133.87",60228,"172.16.139.250",5440,12,1142,8170,0,0,12,1142,0,0,82.276265,0.015388999999998987,593670,0
"172.16.133.35",49994,"172.16.139.250",5440,12,1142,8171,0,0,12,1142,0,0,82.286658,0.039332999999999174,232273,0
"172.16.133.116",53415,"172.16.139.250",5440,10,1022,8172,0,0,10,1022,0,0,82.291605,0.005563999999992575,1469446,0
"172.16.133.116",53416,"172.16.139.250",5440,10,1022,8173,0,0,10,1022,0,0,82.298194,0.0062539999999984275,1307323,0
"172.16.133.116",53417,"172.16.139.250",5440,10,1022,8174,0,0,10,1022,0,0,82.305432,0.005623999999997409,1453769,0
"172.16.133.84",58813,"172.16.139.250",5440,10,1022,8175,0,0,10,1022,0,0,82.313715,0.10010300000000427,81675,0
"172.16.133.56",51726,"172.16.139.250",5500,22,4212,8176,0,0,22,4212,0,0,82.332801,65.728225,512,0
"172.16.133.49",55792,"172.16.139.250",5440,12,1142,8177,0,0,12,1142,0,0,82.39005,0.030816999999998984,296459,0
"172.16.133.95",56989,"172.16.139.250",5440,12,1142,8178,0,0,12,1142,0,0,82.427907,0.007028999999988628,1299758,0
"172.16.133.92",57702,"172.16.139.250",5440,12,1142,8179,0,0,12,1142,0,0,82.456386,0.01733200000001034,527117,0
"172.16.133.29",60956,"172.16.139.250",5440,12,1142,8180,0,0,12,1142,0,0,82.473119,0.008949999999998681,1020782,0
"172.16.133.44",64854,"172.16.139.250",5440,12,1142,8181,0,0,12,1142,0,0,82.480774,0.016910000000009973,540272,0
"172.16.133.207",55954,"172.16.139.250",5440,10,1022,8182,0,0,10,1022,0,0,82.505167,0.004743000000004827,"",""
"172.16.133.83",57112,"172.16.139.250",5440,10,1022,8183,0,0,10,1022,0,0,82.513657,0.005648000000007869,1447592,0
"172.16.133.93",60737,"172.16.139.250",5440,10,1022,8184,0,0,10,1022,0,0,82.529928,0.006730000000004566,1214858,0
"172.16.133.11",55163,"172.16.139.250",5440,10,1022,8185,0,0,10,1022,0,0,82.548312,0.006443000000004417,1268974,0
"172.16.133.55",57602,"172.16.139.250",5440,12,1142,8186,0,0,12,1142,0,0,82.552142,0.00792299999999102,1153098,0
"172.16.133.73",60694,"172.16.139.250",5440,10,1022,8187,0,0,10,1022,0,0,82.575673,0.007865000000009559,1039542,0
"172.16.133.53",54120,"172.16.139.250",5440,12,1142,8188,0,0,12,1142,0,0,82.577169,0.010135000000005334,901430,0
"172.16.133.21",53198,"172.16.139.250",5440,12,1142,8189,0,0,12,1142,0,0,82.580403,0.018862999999996077,484334,0
"172.16.133.30",62640,"172.16.139.250",5440,12,1142,8190,0,0,12,1142,0,0,82.583148,0.00976900000000569,935203,0
"172.16.133.25",63478,"172.16.139.250",5440,12,1142,8191,0,0,12,1142,0,0,82.592024,0.01074600000001169,850176,0
"172.16.133.34",50460,"172.16.139.250",5440,12,1142,8192,0,0,12,1142,0,0,82.600156,0.007380999999995197,1237772,0
"172.16.133.97",59393,"172.16.139.250",5440,10,1022,8193,0,0,10,1022,0,0,82.612427,0.005536000000006425,1476878,0
"172.16.133.33",57902,"172.16.139.250",5440,10,1022,8194,0,0,10,1022,0,0,82.686748,0.006796000000008462,1203060,0
"172.16.133.68",60751,"172.16.139.250",5440,10,1022,8195,0,0,10,1022,0,0,82.717174,0.01734500000000594,471375,0
"172.16.133.12",59798,"172.16.139.250",5440,12,1142,8196,0,0,12,1142,0,0,82.731275,0.00936699999999746,975338,0
"172.16.133.63",53901,"172.16.139.250",5440,12,1142,8197,0,0,12,1142,0,0,82.741652,0.006885999999994397,1326749,0
"172.16.133.66",53891,"172.16.139.250",5440,12,1142,8198,0,0,12,1142,0,0,82.756269,0.006294999999994388,1451310,0
"172.16.133.82",61367,"172.16.139.250",5440,10,1022,8199,0,0,10,1022,0,0,82.768426,0.005485999999990554,1490339,0
"172.16.133.37",60646,"172.16.139.250",5440,12,1142,8200,0,0,12,1142,0,0,82.781857,0.006408999999990783,1425495,0
"172.16.133.121",56504,"74.125.228.120",443,14,4141,8201,0,0,8,956,6,3185,82.830004,0.2745949999999908,27851,92791
"172.16.133.121",56505,"74.125.226.207",443,14,4027,8202,0,0,8,958,6,3069,82.831408,0.2734049999999968,28031,89800
"172.16.128.233",55242,"172.16.133.233",22,168,19932,8203,0,0,51,4528,117,15404,82.845896,8.14209000000001,4448,15135
"172.16.133.78",59229,"172.16.139.250",5440,10,1022,8204,0,0,10,1022,0,0,82.93814,0.01556200000000274,525382,0
"172.16.133.67",56007,"172.16.139.250",5440,10,1022,8205,0,0,10,1022,0,0,82.993335,0.01829800000000148,446824,0
"172.16.133.49",55793,"68.64.24.250",443,7,432,8206,0,0,5,312,2,120,82.998391,3.100747999999996,804,309
"172.16.133.56",61451,"172.16.139.250",5440,10,1022,8207,0,0,10,1022,0,0,83.015222,0.004859000000010383,"",""
"172.16.133.49",55794,"78.108.118.250",443,7,432,8208,0,0,5,312,2,120,83.052536,3.203282999999999,779,299
"172.16.133.49",55795,"216.219.118.244",443,7,432,8209,0,0,5,312,2,120,83.05272,3.2169110000000103,775,298
"172.16.133.42",57147,"172.16.139.250",5440,12,1142,8210,0,0,12,1142,0,0,83.072341,0.014988000000002444,609554,0
"172.16.133.41",53041,"172.16.139.250",5440,12,1142,8211,0,0,12,1142,0,0,83.072525,0.006326999999998861,1443970,0
"172.16.133.21",53199,"67.217.65.244",443,7,432,8212,0,0,5,312,2,120,83.073036,3.0532560000000046,817,314
"172.16.133.21",53200,"64.74.80.187",443,7,432,8213,0,0,5,312,2,120,83.074887,3.0467239999999975,819,315
"172.16.133.85",52294,"172.16.139.250",5440,10,1022,8214,0,0,10,1022,0,0,83.08841,0.005454999999997767,1498808,0
"172.16.133.43",57804,"172.16.139.250",5440,12,1142,8215,0,0,12,1142,0,0,83.1425,0.006196000000002755,1474499,0
"172.16.133.21",53201,"216.115.212.254",443,6,366,8216,0,0,4,246,2,120,83.147017,0.22582099999999627,8714,4251
"172.16.133.13",53060,"172.16.139.250",5440,10,1022,8217,0,0,10,1022,0,0,83.160449,0.0054800000000057025,1491970,0
"172.16.133.49",55796,"216.115.219.126",443,6,366,8218,0,0,4,246,2,120,83.195357,0.5352579999999989,3676,1793
"172.16.133.20",62416,"172.16.139.250",5440,12,1142,8219,0,0,12,1142,0,0,83.21024,0.005111999999996897,1787167,0
"172.16.133.75",50979,"172.16.139.250",5440,12,1142,8220,0,0,12,1142,0,0,83.226502,0.07171900000000164,127386,0
"172.16.133.28",65450,"172.16.139.250",5440,10,1022,8221,0,0,10,1022,0,0,83.240307,0.060711999999995214,134668,0
"172.16.133.235",2697,"172.16.131.10",8080,40,11919,8222,0,0,20,9097,20,2822,83.251491,18.405266999999995,3954,1226
"172.16.133.99",56065,"172.16.139.250",5440,12,1142,8223,0,0,12,1142,0,0,83.266877,0.03782200000000557,241552,0
"172.16.133.132",56415,"216.185.152.144",80,40,24748,8224,0,0,21,1370,19,23378,83.272397,0.3935809999999975,27846,475185
"172.16.133.87",60229,"172.16.139.250",5440,12,1142,8225,0,0,12,1142,0,0,83.289536,0.019945000000006985,458059,0
"172.16.133.184",39912,"204.14.235.101",443,32,13513,8226,0,0,16,1693,16,11820,83.29627,0.5825179999999932,23250,162329
"172.16.133.21",53202,"202.173.28.250",443,7,426,8227,0,0,5,306,2,120,83.301951,1.468086999999997,1667,653
"172.16.133.116",53418,"172.16.139.250",5440,12,1142,8228,0,0,12,1142,0,0,83.30527,0.0080470000000048,1135329,0
"172.16.133.116",53419,"172.16.139.250",5440,12,1142,8229,0,0,12,1142,0,0,83.314171,0.0061249999999972715,1491591,0
"172.16.133.116",53420,"172.16.139.250",5440,12,1142,8230,0,0,12,1142,0,0,83.321205,0.0059499999999985675,1535462,0
"172.16.133.84",58814,"172.16.139.250",5440,10,1022,8231,0,0,10,1022,0,0,83.326894,0.0153580000000062,532360,0
"172.16.133.49",55797,"172.16.139.250",5440,12,1142,8232,0,0,12,1142,0,0,83.403924,0.0062349999999895545,1465276,0
"172.16.133.95",56990,"172.16.139.250",5440,12,1142,8233,0,0,12,1142,0,0,83.441773,0.0061160000000057835,1493786,0
"172.16.133.92",57704,"172.16.139.250",5440,10,1022,8234,0,0,10,1022,0,0,83.468655,0.005991000000008739,1364713,0
"172.16.133.29",60957,"172.16.139.250",5440,12,1142,8235,0,0,12,1142,0,0,83.487176,0.018237999999996646,500932,0
"172.16.133.44",64855,"172.16.139.250",5440,12,1142,8236,0,0,12,1142,0,0,83.495003,0.006594000000006872,1385501,0
"172.16.133.207",55955,"172.16.139.250",5440,12,1142,8237,0,0,12,1142,0,0,83.519319,0.014696000000000708,621665,0
"172.16.133.83",57113,"172.16.139.250",5440,12,1142,8238,0,0,12,1142,0,0,83.527561,0.013973999999990383,653785,0
"172.16.133.93",60738,"172.16.139.250",5440,12,1142,8239,0,0,12,1142,0,0,83.543956,0.004955000000009591,"",""
"172.16.133.11",55164,"172.16.139.250",5440,12,1142,8240,0,0,12,1142,0,0,83.560635,0.005876999999998134,1554534,0
"172.16.133.55",57603,"172.16.139.250",5440,10,1022,8241,0,0,10,1022,0,0,83.565486,0.015517999999985932,526872,0
"172.16.133.132",58903,"96.43.146.176",443,32,13469,8242,0,0,16,1680,16,11789,83.588112,0.954425999999998,14081,98815
"172.16.133.73",60695,"172.16.139.250",5440,10,1022,8243,0,0,10,1022,0,0,83.588496,0.006310999999996625,1295515,0
"172.16.133.53",54121,"172.16.139.250",5440,10,1022,8244,0,0,10,1022,0,0,83.591336,0.016625000000004775,491789,0
"172.16.133.21",53203,"172.16.139.250",5440,12,1142,8245,0,0,12,1142,0,0,83.59432,0.006555000000005862,1393745,0
"172.16.133.30",62641,"172.16.139.250",5440,12,1142,8246,0,0,12,1142,0,0,83.597681,0.0063420000000036225,1440555,0
"172.16.133.25",63479,"172.16.139.250",5440,12,1142,8247,0,0,12,1142,0,0,83.60567,0.017887999999999238,510733,0
"172.16.133.34",50461,"172.16.139.250",5440,10,1022,8248,0,0,10,1022,0,0,83.614138,0.005100999999996247,1602822,0
"172.16.133.97",59394,"172.16.139.250",5440,10,1022,8249,0,0,10,1022,0,0,83.625471,0.005369999999999209,1522532,0
"172.16.133.33",57903,"172.16.139.250",5440,10,1022,8250,0,0,10,1022,0,0,83.699044,0.005865999999997484,1393794,0
"172.16.133.68",60752,"172.16.139.250",5440,10,1022,8251,0,0,10,1022,0,0,83.731286,0.005718000000001666,1429870,0
"172.16.133.12",59799,"172.16.139.250",5440,10,1022,8252,0,0,10,1022,0,0,83.745254,0.0054750000000041155,1493333,0
"172.16.133.63",53902,"172.16.139.250",5440,12,1142,8253,0,0,12,1142,0,0,83.7546,0.015286000000003241,597671,0
"172.16.133.66",53892,"172.16.139.250",5440,10,1022,8254,0,0,10,1022,0,0,83.770367,0.005326000000010822,1535110,0
"172.16.133.82",61368,"172.16.139.250",5440,10,1022,8255,0,0,10,1022,0,0,83.782425,0.005595999999997048,1461043,0
"172.16.133.184",59151,"204.14.235.101",443,26,8249,8256,0,0,15,1648,11,6601,83.785796,0.7344599999999986,17950,71900
"172.16.133.37",60647,"172.16.139.250",5440,10,1022,8257,0,0,10,1022,0,0,83.795955,0.005096999999992136,1604080,0
"132.245.1.150",443,"172.16.133.26",59925,10,855,8258,0,0,5,555,5,300,83.91653,179.91063699999998,24,13
"172.16.133.121",56506,"98.129.142.248",80,17,6144,8259,0,0,9,4282,8,1862,83.919122,10.095566000000005,3393,1475
"172.16.133.121",56507,"98.129.142.248",80,21,8932,8260,0,0,11,6298,10,2634,83.919405,10.093859000000009,4991,2087
"172.16.133.121",56508,"98.129.142.248",80,17,6176,8261,0,0,9,4256,8,1920,83.919771,10.094841000000002,3372,1521
"172.16.133.121",56509,"98.129.142.248",80,21,9035,8262,0,0,11,6339,10,2696,83.919976,10.094415999999995,5023,2136
"172.16.133.121",56510,"98.129.142.248",80,17,6153,8263,0,0,9,4294,8,1859,83.920159,10.095235000000002,3402,1473
"172.16.133.121",56511,"98.129.142.248",80,19,6738,8264,0,0,10,4400,9,2338,83.920346,10.091806000000005,3487,1853
"172.16.133.121",56512,"209.167.231.15",80,21,3161,8265,0,0,11,1847,10,1314,83.92072,140.06234,105,75
"172.16.133.121",56513,"209.167.231.15",80,6,366,8266,0,0,4,246,2,120,83.920934,20.064937,98,47
"172.16.133.121",56514,"173.194.43.58",80,19,5646,8267,0,0,11,3140,8,2506,83.921207,183.86478300000005,136,109
"172.16.133.121",56515,"173.194.43.58",80,7,432,8268,0,0,4,246,3,186,83.921367,10.046565000000001,195,148
"172.16.133.121",56516,"173.194.43.38",80,6,372,8269,0,0,4,246,2,126,83.921601,10.043455000000009,195,100
"172.16.133.121",56517,"173.194.43.38",80,20,5765,8270,0,0,11,3964,9,1801,83.921714,183.091364,173,78
"172.16.133.121",56518,"66.235.147.78",80,10,5032,8271,0,0,6,4085,4,947,83.943883,19.447737000000004,1680,389
"172.16.133.121",56519,"208.74.204.95",80,37,30401,8272,0,0,14,2419,23,27982,83.945925,0.8854129999999998,21856,252826
"172.16.133.121",56520,"208.74.204.95",80,11,2688,8273,0,0,6,1855,5,833,83.94607,1.2569309999999945,11806,5301
"172.16.133.121",56521,"208.74.204.95",80,39,33810,8274,0,0,14,2304,25,31506,83.946179,7.2931310000000025,2527,34559
"172.16.133.121",56522,"208.74.204.95",80,11,2685,8275,0,0,6,1852,5,833,83.946293,7.566041999999996,1958,880
"172.16.133.121",56523,"208.74.204.95",80,7,432,8276,0,0,4,246,3,186,83.946413,20.09656799999999,97,74
"172.16.133.121",56524,"63.116.244.170",80,6,372,8277,0,0,4,246,2,126,83.950295,20.011606999999998,98,50
"172.16.133.121",56525,"63.116.244.170",80,6,372,8278,0,0,4,246,2,126,83.950595,20.011304999999993,98,50
"172.16.133.121",56526,"63.116.244.170",80,8,504,8279,0,0,5,312,3,192,83.950753,20.01102499999999,124,76
"172.16.133.121",56527,"96.43.149.26",80,7,432,8280,0,0,4,246,3,186,83.950919,20.015172000000007,98,74
"172.16.133.121",56528,"96.43.149.26",80,16,3739,8281,0,0,9,3180,7,559,83.951053,180.95810999999998,140,24
"172.16.133.78",59230,"172.16.139.250",5440,10,1022,8282,0,0,10,1022,0,0,83.95202,0.005488999999997191,1489524,0
"172.16.133.121",56529,"72.21.91.97",80,15,3288,8283,0,0,8,1769,7,1519,83.95414,7.170916000000005,1973,1694
"172.16.133.121",56530,"72.21.91.97",80,24,15776,8284,0,0,10,1780,14,13996,83.954298,20.005939000000012,711,5596
"172.16.133.121",56531,"72.21.91.97",80,17,6000,8285,0,0,8,1690,9,4310,83.954416,20.006285000000005,675,1723
"172.16.133.121",56532,"72.21.91.97",80,13,4630,8286,0,0,6,986,7,3644,83.954535,20.006094999999988,394,1457
"172.16.133.121",56533,"72.21.91.97",80,13,4621,8287,0,0,6,984,7,3637,83.954645,20.005889999999994,393,1454
"172.16.133.121",56534,"72.21.91.97",80,12,3941,8288,0,0,6,979,6,2962,83.954749,7.175927999999999,1091,3302
"172.16.133.67",56008,"172.16.139.250",5440,10,1022,8289,0,0,10,1022,0,0,84.007115,0.005622000000002458,1454286,0
"172.16.133.56",61452,"172.16.139.250",5440,10,1022,8290,0,0,10,1022,0,0,84.030342,0.004719999999991842,"",""
"172.16.133.42",57148,"172.16.139.250",5440,12,1142,8291,0,0,12,1142,0,0,84.07748,0.02680100000000607,340882,0
"172.16.133.41",53042,"172.16.139.250",5440,12,1142,8292,0,0,12,1142,0,0,84.086409,0.006028999999998064,1515342,0
"172.16.133.85",52295,"172.16.139.250",5440,10,1022,8293,0,0,10,1022,0,0,84.103892,0.015312999999991916,533925,0
"172.16.133.121",56535,"74.125.226.207",443,14,4029,8294,0,0,8,958,6,3071,84.113267,8.990428000000009,852,2732
"172.16.133.40",50119,"108.162.199.98",80,104,54408,8295,0,0,33,9068,71,45340,84.122759,58.18621300000001,1246,6233
"172.16.133.43",57805,"172.16.139.250",5440,10,1022,8296,0,0,10,1022,0,0,84.157707,0.015412999999995236,530461,0
"172.16.133.13",53061,"172.16.139.250",5440,10,1022,8297,0,0,10,1022,0,0,84.174165,0.014617999999998688,559310,0
"172.16.133.20",62417,"172.16.139.250",5440,12,1142,8298,0,0,12,1142,0,0,84.223047,0.004837000000009084,"",""
"172.16.133.75",50980,"172.16.139.250",5440,10,1022,8299,0,0,10,1022,0,0,84.241612,0.005557999999993513,1471032,0
"172.16.133.28",65453,"172.16.139.250",5440,12,1142,8300,0,0,12,1142,0,0,84.254539,0.006076000000007298,1503620,0
"172.16.133.99",56066,"172.16.139.250",5440,10,1022,8301,0,0,10,1022,0,0,84.281255,0.014687999999992485,556644,0
"172.16.133.87",60230,"172.16.139.250",5440,10,1022,8302,0,0,10,1022,0,0,84.304395,0.015708000000003608,520499,0
"172.16.133.116",53421,"172.16.139.250",5440,10,1022,8303,0,0,10,1022,0,0,84.317842,0.006129999999998859,1333768,0
"172.16.133.116",53422,"172.16.139.250",5440,10,1022,8304,0,0,10,1022,0,0,84.324762,0.005394999999992933,1515477,0
"172.16.133.116",53423,"172.16.139.250",5440,10,1022,8305,0,0,10,1022,0,0,84.330894,0.005257000000000289,1555259,0
"172.16.133.84",58815,"172.16.139.250",5440,10,1022,8306,0,0,10,1022,0,0,84.341941,0.005780000000001451,1414532,0
"172.16.133.49",55798,"172.16.139.250",5440,12,1142,8307,0,0,12,1142,0,0,84.417978,0.0062989999999985,1450388,0
"172.16.133.184",36088,"204.14.235.101",443,23,7308,8308,0,0,13,1512,10,5796,84.422469,0.5958369999999888,20300,77819
"172.16.133.116",53424,"23.0.49.244",80,6,372,8309,0,0,4,246,2,126,84.427034,17.736234999999994,110,56
"172.16.133.116",53425,"208.111.160.6",80,34,29374,8310,0,0,10,2027,24,27347,84.427352,37.732707000000005,429,5798
"172.16.133.116",53426,"208.111.160.6",80,8,492,8311,0,0,4,246,4,246,84.427582,17.736523000000005,110,110
"172.16.133.116",53427,"208.111.160.6",80,20,10889,8312,0,0,7,1146,13,9743,84.427829,37.731835000000004,242,2065
"172.16.133.116",53428,"208.111.160.6",80,8,492,8313,0,0,4,246,4,246,84.428049,17.736058999999997,110,110
"172.16.133.116",53429,"208.111.160.6",80,28,21082,8314,0,0,9,1965,19,19117,84.428265,37.731697,416,4053
"172.16.133.116",53430,"23.0.49.244",80,6,372,8315,0,0,4,246,2,126,84.448179,17.715927000000008,111,56
"172.16.133.95",56991,"172.16.139.250",5440,10,1022,8316,0,0,10,1022,0,0,84.455757,0.0052629999999993515,1553486,0
"172.16.133.116",53431,"208.111.161.254",80,59,31514,8317,0,0,24,5539,35,25975,84.472213,105.895527,418,1962
"172.16.133.116",53432,"208.111.161.254",80,124,79906,8318,0,0,46,10958,78,68948,84.472338,105.88772100000001,827,5209
"172.16.133.116",53433,"208.111.161.254",80,70,38751,8319,0,0,28,6197,42,32554,84.472454,105.889769,468,2459
"172.16.133.116",53434,"208.111.161.254",80,64,32309,8320,0,0,27,5707,37,26602,84.472565,105.893937,431,2009
"172.16.133.116",53435,"208.111.161.254",80,90,49322,8321,0,0,35,8445,55,40877,84.472664,105.889437,638,3088
"172.16.133.92",57705,"172.16.139.250",5440,10,1022,8322,0,0,10,1022,0,0,84.485171,0.005538000000001375,1476345,0
"172.16.133.29",60958,"172.16.139.250",5440,10,1022,8323,0,0,10,1022,0,0,84.501545,0.015750000000011255,519111,0
"172.16.133.132",51406,"38.70.64.178",80,35,21315,8324,0,0,19,1447,16,19868,84.5022,0.3644000000000034,31767,436180
"172.16.133.44",64856,"172.16.139.250",5440,10,1022,8325,0,0,10,1022,0,0,84.508212,0.007479000000003566,1093194,0
"172.16.133.207",55956,"172.16.139.250",5440,10,1022,8326,0,0,10,1022,0,0,84.533297,0.00473999999999819,"",""
"172.16.133.83",57114,"172.16.139.250",5440,12,1142,8327,0,0,12,1142,0,0,84.541537,0.014072999999996227,649186,0
"172.16.133.93",60739,"172.16.139.250",5440,10,1022,8328,0,0,10,1022,0,0,84.558125,0.004762999999996964,"",""
"172.16.133.11",55165,"172.16.139.250",5440,10,1022,8329,0,0,10,1022,0,0,84.575736,0.005854999999996835,1396413,0
"172.16.133.55",57604,"172.16.139.250",5440,10,1022,8330,0,0,10,1022,0,0,84.579235,0.005713999999997554,1430871,0
"172.16.133.73",60696,"172.16.139.250",5440,10,1022,8331,0,0,10,1022,0,0,84.602787,0.018749999999997158,436053,0
"172.16.133.53",54122,"172.16.139.250",5440,12,1142,8332,0,0,12,1142,0,0,84.60547,0.005518000000009238,1655672,0
"172.16.133.21",53204,"172.16.139.250",5440,10,1022,8333,0,0,10,1022,0,0,84.608467,0.017229000000000383,474548,0
"172.16.133.153",36660,"209.112.253.15",80,178,151484,8334,0,0,72,4861,106,146623,84.609972,1.429105000000007,27211,820782
"172.16.133.30",62642,"172.16.139.250",5440,10,1022,8335,0,0,10,1022,0,0,84.612172,0.0055629999999951,1469710,0
"172.16.133.25",63480,"172.16.139.250",5440,10,1022,8336,0,0,10,1022,0,0,84.621656,0.008154000000004658,1002698,0
"172.16.133.34",50462,"172.16.139.250",5440,12,1142,8337,0,0,12,1142,0,0,84.628308,0.005398999999997045,1692165,0
"172.16.133.97",59395,"172.16.139.250",5440,10,1022,8338,0,0,10,1022,0,0,84.639469,0.005708999999995967,1432124,0
"172.16.133.132",47682,"96.43.146.50",443,33,11869,8339,0,0,19,4198,14,7671,84.704999,55.806347,601,1099
"172.16.133.33",57904,"172.16.139.250",5440,10,1022,8340,0,0,10,1022,0,0,84.714011,0.015558999999996104,525483,0
"172.16.133.68",60753,"172.16.139.250",5440,10,1022,8341,0,0,10,1022,0,0,84.745252,0.015527000000005842,526566,0
"172.16.133.12",59800,"172.16.139.250",5440,12,1142,8342,0,0,12,1142,0,0,84.758739,0.006577999999990425,1388871,0
"172.16.133.63",53903,"172.16.139.250",5440,10,1022,8343,0,0,10,1022,0,0,84.768758,0.014420999999998685,566950,0
"172.16.133.66",53893,"172.16.139.250",5440,10,1022,8344,0,0,10,1022,0,0,84.783328,0.0053280000000057726,1534534,0
"172.16.133.82",61369,"172.16.139.250",5440,10,1022,8345,0,0,10,1022,0,0,84.796286,0.005594000000002097,1461565,0
"172.16.133.132",50675,"38.70.64.178",80,66,48823,8346,0,0,31,2196,35,46627,84.799262,0.5310560000000066,33081,702404
"172.16.133.37",60648,"172.16.139.250",5440,10,1022,8347,0,0,10,1022,0,0,84.809882,0.06468800000000385,126391,0
"172.16.133.184",52081,"204.14.235.101",443,24,7136,8348,0,0,14,1597,10,5539,84.924831,0.5984990000000039,21346,74038
"172.16.133.78",59231,"172.16.139.250",5440,10,1022,8349,0,0,10,1022,0,0,84.966867,0.005975000000006503,1368368,0
"172.16.133.67",56009,"172.16.139.250",5440,10,1022,8350,0,0,10,1022,0,0,85.021002,0.01564500000000635,522595,0
"172.16.133.56",61453,"172.16.139.250",5440,10,1022,8351,0,0,10,1022,0,0,85.043181,0.014493999999999119,564095,0
"172.16.133.41",53043,"172.16.139.250",5440,12,1142,8352,0,0,12,1142,0,0,85.100113,0.0060700000000082355,1505107,0
"172.16.133.85",52296,"172.16.139.250",5440,10,1022,8353,0,0,10,1022,0,0,85.117541,0.01533200000000079,533263,0
"172.16.133.42",57149,"172.16.139.250",5440,12,1142,8354,0,0,12,1142,0,0,85.163975,0.05905000000001337,154716,0
"172.16.133.43",57806,"172.16.139.250",5440,12,1142,8355,0,0,12,1142,0,0,85.170427,0.04141899999999055,220575,0
"172.16.133.13",53062,"172.16.139.250",5440,10,1022,8356,0,0,10,1022,0,0,85.188494,0.03129299999999091,261272,0
"172.16.133.20",62418,"172.16.139.250",5440,12,1142,8357,0,0,12,1142,0,0,85.237332,0.005075000000005048,1800197,0
"172.16.133.75",50981,"172.16.139.250",5440,12,1142,8358,0,0,12,1142,0,0,85.254925,0.006355999999996698,1437382,0
"172.16.133.21",53205,"216.115.212.254",443,6,366,8359,0,0,4,246,2,120,85.26611,0.19830799999999726,9923,4840
"172.16.133.28",65454,"172.16.139.250",5440,12,1142,8360,0,0,12,1142,0,0,85.26856,0.00617100000000903,1480473,0
"172.16.133.99",56067,"172.16.139.250",5440,12,1142,8361,0,0,12,1142,0,0,85.294975,0.014977000000001794,610002,0
"172.16.133.87",60231,"172.16.139.250",5440,12,1142,8362,0,0,12,1142,0,0,85.318597,0.006085999999996261,1501150,0
"172.16.133.116",53436,"172.16.139.250",5440,12,1142,8363,0,0,12,1142,0,0,85.332241,0.005659000000008518,1614419,0
"172.16.133.116",53437,"172.16.139.250",5440,12,1142,8364,0,0,12,1142,0,0,85.338543,0.006023999999996477,1516600,0
"172.16.133.116",53438,"172.16.139.250",5440,10,1022,8365,0,0,10,1022,0,0,85.345244,0.005963000000008378,1371121,0
"172.16.133.84",58816,"172.16.139.250",5440,12,1142,8366,0,0,12,1142,0,0,85.355018,0.011590999999995688,788197,0
"172.16.133.75",50821,"96.43.146.178",443,4,240,8367,0,0,2,120,2,120,85.357496,0.041007000000007565,23410,23410
"172.16.133.75",50982,"96.43.146.178",443,21,4141,8368,0,0,12,2574,9,1567,85.357903,101.638543,202,123
"172.16.133.184",38111,"204.14.235.101",443,25,8042,8369,0,0,14,1588,11,6454,85.399905,0.593980000000002,21387,86925
"172.16.133.49",55799,"172.16.139.250",5440,12,1142,8370,0,0,12,1142,0,0,85.43235,0.005876999999998134,1554534,0
"172.16.133.49",55800,"216.115.219.126",443,6,366,8371,0,0,4,246,2,120,85.447506,0.49881499999999335,3945,1924
"172.16.133.95",56992,"172.16.139.250",5440,10,1022,8372,0,0,10,1022,0,0,85.469892,0.005430000000004043,1505709,0
"172.16.133.92",57706,"172.16.139.250",5440,10,1022,8373,0,0,10,1022,0,0,85.498204,0.015458999999992784,528882,0
"172.16.133.29",60959,"172.16.139.250",5440,10,1022,8374,0,0,10,1022,0,0,85.515628,0.018192999999996573,449403,0
"172.16.133.44",64857,"172.16.139.250",5440,10,1022,8375,0,0,10,1022,0,0,85.521588,0.01592500000000996,513406,0
"172.16.133.207",55957,"172.16.139.250",5440,10,1022,8376,0,0,10,1022,0,0,85.547793,0.00542400000000498,1507374,0
"172.16.133.83",57115,"172.16.139.250",5440,12,1142,8377,0,0,12,1142,0,0,85.55565,0.004560999999995374,"",""
"172.16.133.113",55625,"172.16.139.250",135,8,492,8378,0,0,8,492,0,0,85.571032,0.0038990000000040936,"",""
"172.16.133.93",60740,"172.16.139.250",5440,10,1022,8379,0,0,10,1022,0,0,85.571939,0.005662999999998419,1443757,0
"172.16.133.113",55626,"172.16.139.250",5462,10,696,8380,0,0,10,696,0,0,85.578355,0.5085019999999929,10949,0
"172.16.133.11",55166,"172.16.139.250",5440,12,1142,8381,0,0,12,1142,0,0,85.588849,0.005813000000003399,1571649,0
"172.16.133.55",57605,"172.16.139.250",5440,10,1022,8382,0,0,10,1022,0,0,85.593756,0.005455999999995242,1498533,0
"172.16.133.21",53206,"202.173.28.250",443,6,366,8383,0,0,4,246,2,120,85.599089,0.5018839999999898,3921,1912
"172.16.133.73",60697,"172.16.139.250",5440,10,1022,8384,0,0,10,1022,0,0,85.617554,0.0054800000000057025,1491970,0
"172.16.133.53",54123,"172.16.139.250",5440,12,1142,8385,0,0,12,1142,0,0,85.620528,0.016121000000012486,566714,0
"172.16.133.21",53207,"172.16.139.250",5440,12,1142,8386,0,0,12,1142,0,0,85.621711,0.019027999999991607,480134,0
"172.16.133.30",62643,"172.16.139.250",5440,10,1022,8387,0,0,10,1022,0,0,85.625978,0.021636000000000877,377888,0
"172.16.133.116",53439,"208.111.161.254",80,64,36537,8388,0,0,27,6176,37,30361,85.627862,104.73407700000001,471,2319
"172.16.133.25",63481,"172.16.139.250",5440,10,1022,8389,0,0,10,1022,0,0,85.634192,0.00989500000000021,826275,0
"172.16.133.40",50120,"108.162.199.98",80,31,18746,8390,0,0,13,3662,18,15084,85.637495,56.672124,516,2129
"172.16.133.34",50463,"172.16.139.250",5440,10,1022,8391,0,0,10,1022,0,0,85.642142,0.009283999999993853,880654,0
"172.16.133.97",59396,"172.16.139.250",5440,10,1022,8392,0,0,10,1022,0,0,85.654408,0.014579999999995152,560768,0
"172.16.133.40",50121,"108.162.199.98",80,35,20553,8393,0,0,16,3932,19,16621,85.725724,56.584019,555,2349
"172.16.133.40",50122,"108.162.199.98",80,20,7905,8394,0,0,9,2019,11,5886,85.726346,56.58350999999999,285,832
"172.16.133.40",50123,"108.162.199.98",80,28,16583,8395,0,0,14,4665,14,11918,85.726817,56.58266400000001,659,1685
"172.16.133.33",57905,"172.16.139.250",5440,12,1142,8396,0,0,12,1142,0,0,85.726818,0.006263000000004126,1458725,0
"172.16.133.40",50124,"108.162.199.98",80,34,22207,8397,0,0,13,4052,21,18155,85.727282,56.581053,572,2566
"172.16.133.42",57150,"172.16.139.250",5440,12,1140,8398,0,0,12,1140,0,0,85.744956,120.02823000000001,75,0
"172.16.133.68",60755,"172.16.139.250",5440,10,1022,8399,0,0,10,1022,0,0,85.759089,0.014635999999995875,558622,0
"172.16.133.40",50125,"173.194.43.33",80,29,10399,8400,0,0,16,8109,13,2290,85.766789,210.70973199999997,307,86
"172.16.133.12",59801,"172.16.139.250",5440,10,1022,8401,0,0,10,1022,0,0,85.773361,0.00700700000000154,1166833,0
"172.16.133.40",50127,"173.194.43.45",80,18,2402,8402,0,0,10,1582,8,820,85.774509,180.442982,70,36
"172.16.133.40",50128,"216.137.33.73",80,78,63756,8403,0,0,29,7342,49,56414,85.774671,208.859778,281,2160
"172.16.133.40",50129,"216.137.33.73",80,371,388730,8404,0,0,101,19825,270,368905,85.774784,209.996823,755,14053
"172.16.133.63",53904,"172.16.139.250",5440,10,1022,8405,0,0,10,1022,0,0,85.782042,0.015279999999989968,535078,0
"172.16.133.66",53894,"172.16.139.250",5440,10,1022,8406,0,0,10,1022,0,0,85.796369,0.005288000000007287,1546142,0
"172.16.133.82",61370,"172.16.139.250",5440,10,1022,8407,0,0,10,1022,0,0,85.809258,0.008018000000006964,1019705,0
"172.16.133.37",60649,"172.16.139.250",5440,10,1022,8408,0,0,10,1022,0,0,85.824262,0.006046999999995251,1352075,0
"172.16.133.116",53440,"23.0.49.244",443,16,3547,8409,0,0,8,1007,8,2540,85.862364,21.157626000000008,380,960
"172.16.133.116",53441,"23.0.49.244",443,16,3547,8410,0,0,8,1007,8,2540,85.862568,21.163652,380,960
"172.16.133.184",41926,"204.14.235.101",443,24,7471,8411,0,0,14,1610,10,5861,85.901832,0.9493650000000002,13566,49388
"172.16.133.153",59827,"184.84.3.78",80,232,214473,8412,0,0,89,5990,143,208483,85.94286,0.7729210000000108,61998,2157871
"172.16.133.78",59232,"172.16.139.250",5440,10,1022,8413,0,0,10,1022,0,0,85.980983,0.005752999999998565,1421171,0
"172.16.133.67",56010,"172.16.139.250",5440,12,1142,8414,0,0,12,1142,0,0,86.035121,0.006653999999997495,1373008,0
"172.16.133.56",61454,"172.16.139.250",5440,10,1022,8415,0,0,10,1022,0,0,86.05734,0.005063000000006923,1614852,0
"172.16.133.42",57151,"172.16.139.250",5440,12,1142,8416,0,0,12,1142,0,0,86.108552,0.012906000000000972,707887,0
"172.16.133.41",53044,"172.16.139.250",5440,12,1142,8417,0,0,12,1142,0,0,86.114453,0.016247000000007006,562319,0
"172.16.133.85",52297,"172.16.139.250",5440,12,1142,8418,0,0,12,1142,0,0,86.131685,0.01544699999999466,591441,0
"172.16.133.43",57807,"172.16.139.250",5440,10,1022,8419,0,0,10,1022,0,0,86.184371,0.0055069999999943775,1484655,0
"172.16.133.116",53442,"138.108.7.20",80,9,2540,8420,0,0,5,1882,4,658,86.1962,12.686031999999997,1186,414
"172.16.133.13",53063,"172.16.139.250",5440,10,1022,8421,0,0,10,1022,0,0,86.202226,0.005440000000007217,1502941,0
"172.16.133.116",53443,"64.94.107.62",80,8,1677,8422,0,0,5,1214,3,463,86.210731,0.09457700000000102,102688,39163
"172.16.133.40",50130,"216.137.33.73",80,137,124871,8423,0,0,50,15474,87,109397,86.252069,208.39196800000002,594,4199
"172.16.133.20",62419,"172.16.139.250",5440,12,1142,8424,0,0,12,1142,0,0,86.252273,0.0051940000000030295,1758952,0
"172.16.133.40",50131,"216.137.33.73",80,181,176249,8425,0,0,56,12556,125,163693,86.252327,209.08461500000004,480,6263
"172.16.133.40",50132,"216.137.33.73",80,166,158490,8426,0,0,58,14243,108,144247,86.252609,209.085329,544,5519
"172.16.133.40",50133,"216.137.33.73",80,160,156144,8427,0,0,51,19076,109,137068,86.253406,208.41911400000004,732,5261
"172.16.133.40",50134,"173.194.43.45",80,70,50253,8428,0,0,30,16490,40,33763,86.257023,209.404702,629,1289
"172.16.133.40",50135,"72.21.91.121",80,24,16471,8429,0,0,10,2244,14,14227,86.257239,16.094690999999997,1115,7071
"172.16.133.40",50136,"72.21.91.121",80,18,8165,8430,0,0,9,2184,9,5981,86.257348,16.09486600000001,1085,2972
"172.16.133.40",50137,"72.21.91.121",80,18,7908,8431,0,0,9,2184,9,5724,86.257465,16.094656,1085,2845
"172.16.133.40",50138,"72.21.91.121",80,12,4161,8432,0,0,6,912,6,3249,86.257577,6.050022999999996,1205,4296
"172.16.133.40",50139,"72.21.91.121",80,13,4450,8433,0,0,6,912,7,3538,86.257685,6.05104,1205,4677
"172.16.133.40",50140,"72.21.91.121",80,13,4604,8434,0,0,6,912,7,3692,86.257792,6.055122000000011,1204,4877
"172.16.133.40",50141,"72.21.91.121",80,12,3350,8435,0,0,6,912,6,2438,86.257897,16.094841000000002,453,1211
"172.16.133.40",50142,"72.21.91.121",80,14,4987,8436,0,0,7,978,7,4009,86.260322,6.048594999999992,1293,5302
"172.16.133.75",50983,"172.16.139.250",5440,10,1022,8437,0,0,10,1022,0,0,86.267747,0.005342999999996323,1530226,0
"172.16.133.28",65455,"172.16.139.250",5440,10,1022,8438,0,0,10,1022,0,0,86.28231,0.0055680000000108976,1468390,0
"172.16.133.40",50143,"72.21.91.121",80,12,3402,8439,0,0,6,912,6,2490,86.294643,16.058205,454,1240
"172.16.133.40",50144,"72.21.91.121",80,12,3407,8440,0,0,6,912,6,2495,86.294845,16.058102000000005,454,1242
"172.16.133.40",50145,"72.21.91.121",80,6,372,8441,0,0,4,246,2,126,86.295041,16.05909100000001,122,62
"172.16.133.35",49995,"172.16.139.250",5440,12,1142,8442,0,0,12,1142,0,0,86.299291,0.015559000000010315,587184,0
"172.16.133.99",56068,"172.16.139.250",5440,12,1142,8443,0,0,12,1142,0,0,86.308056,0.017628000000001975,518266,0
"172.16.133.35",49996,"172.16.139.250",5440,12,1142,8444,0,0,12,1142,0,0,86.314794,0.010934999999989259,835482,0
"172.16.133.35",49997,"172.16.139.250",5440,12,1142,8445,0,0,12,1142,0,0,86.326747,0.009017999999997528,1013084,0
"172.16.133.87",60232,"172.16.139.250",5440,10,1022,8446,0,0,10,1022,0,0,86.331278,0.0054340000000081545,1504600,0
"172.16.133.35",49998,"172.16.139.250",5440,12,1142,8447,0,0,12,1142,0,0,86.34145,0.014706000000003883,621243,0
"172.16.133.116",53444,"172.16.139.250",5440,10,1022,8448,0,0,10,1022,0,0,86.345908,0.008636000000009858,946734,0
"172.16.133.116",53445,"172.16.139.250",5440,10,1022,8449,0,0,10,1022,0,0,86.355594,0.005806000000006861,1408198,0
"172.16.133.116",53446,"172.16.139.250",5440,10,1022,8450,0,0,10,1022,0,0,86.362554,0.005468999999990842,1494971,0
"172.16.133.84",58817,"172.16.139.250",5440,12,1142,8451,0,0,12,1142,0,0,86.369906,0.006133000000005495,1489646,0
"172.16.133.153",53084,"205.153.84.114",80,9,980,8452,0,0,5,612,4,368,86.411426,0.3495419999999996,14006,8422
"172.16.133.49",55801,"172.16.139.250",5440,12,1142,8453,0,0,12,1142,0,0,86.445859,0.00686799999999721,1330227,0
"172.16.133.184",59541,"204.14.235.101",443,24,7565,8454,0,0,14,1591,10,5974,86.463516,1.5606230000000068,8155,30623
"172.16.133.95",56993,"172.16.139.250",5440,8,902,8455,0,0,8,902,0,0,86.483852,0.005510999999998489,1309381,0
"172.16.133.92",57707,"172.16.139.250",5440,12,1142,8456,0,0,12,1142,0,0,86.510943,0.006478000000001316,1410311,0
"172.16.133.29",60960,"172.16.139.250",5440,10,1022,8457,0,0,10,1022,0,0,86.529335,0.007252999999991516,1127257,0
"172.16.133.44",64858,"172.16.139.250",5440,10,1022,8458,0,0,10,1022,0,0,86.537181,0.005800999999991063,1409412,0
"172.16.133.207",55958,"172.16.139.250",5440,10,1022,8459,0,0,10,1022,0,0,86.560761,0.004694000000000642,"",""
"172.16.133.83",57116,"172.16.139.250",5440,12,1142,8460,0,0,12,1142,0,0,86.569809,0.014717999999987796,620736,0
"172.16.133.93",60741,"172.16.139.250",5440,10,1022,8461,0,0,10,1022,0,0,86.586,0.006561000000004924,1246151,0
"172.16.133.126",61565,"172.16.139.250",5440,6,360,8462,0,0,6,360,0,0,86.588975,0.0012589999999903512,"",""
"172.16.133.126",61796,"172.16.139.250",5440,12,1140,8463,0,0,12,1140,0,0,86.59158,120.066799,75,0
"172.16.133.40",50146,"173.194.43.45",80,162,169544,8464,0,0,40,4163,122,165381,86.594813,209.103723,159,6327
"172.16.133.40",50147,"173.252.100.27",80,7,432,8465,0,0,4,246,3,186,86.598721,15.756326999999999,124,94
"172.16.133.40",50148,"173.252.100.27",80,21,5196,8466,0,0,11,3269,10,1927,86.5989,208.29375999999996,125,74
"172.16.133.11",55167,"172.16.139.250",5440,10,1022,8467,0,0,10,1022,0,0,86.602883,0.005758999999997627,1419690,0
"172.16.133.55",57606,"172.16.139.250",5440,10,1022,8468,0,0,10,1022,0,0,86.608527,0.005386000000001445,1518009,0
"172.16.133.73",60698,"172.16.139.250",5440,10,1022,8469,0,0,10,1022,0,0,86.631708,0.005554000000003612,1472092,0
"172.16.133.53",54124,"172.16.139.250",5440,10,1022,8470,0,0,10,1022,0,0,86.634877,0.015171999999992636,538887,0
"172.16.133.21",53208,"172.16.139.250",5440,10,1022,8471,0,0,10,1022,0,0,86.635252,0.01853900000000408,441016,0
"172.16.133.30",62644,"172.16.139.250",5440,10,1022,8472,0,0,10,1022,0,0,86.639719,0.0058300000000031105,1402401,0
"172.16.133.40",50149,"173.194.43.45",80,15,1569,8473,0,0,8,965,7,604,86.640864,180.151536,42,26
"172.16.133.25",63482,"172.16.139.250",5440,10,1022,8474,0,0,10,1022,0,0,86.647985,0.013400999999987562,610103,0
"172.16.133.34",50464,"172.16.139.250",5440,12,1142,8475,0,0,12,1142,0,0,86.656143,0.01546199999999942,590867,0
"172.16.133.97",59397,"172.16.139.250",5440,12,1142,8476,0,0,12,1142,0,0,86.668488,0.015382999999999925,593902,0
"172.16.133.40",50150,"23.15.128.239",80,93,95202,8477,0,0,25,4202,68,91000,86.679123,208.018526,161,3499
"172.16.133.40",50151,"23.6.17.224",80,57,56371,8478,0,0,17,3092,40,53279,86.679422,75.642498,327,5634
"172.16.133.40",50152,"23.62.164.136",80,54,43605,8479,0,0,20,6034,34,37571,86.680046,181.08214299999997,266,1659
"172.16.133.153",46526,"23.62.195.78",80,63,44927,8480,0,0,31,2152,32,42775,86.737049,0.2859370000000041,60209,1196767
"172.16.133.33",57906,"172.16.139.250",5440,12,1142,8481,0,0,12,1142,0,0,86.741027,0.006725000000002979,1358513,0
"172.16.133.92",57548,"23.67.242.67",80,1,60,8482,0,0,1,60,0,0,86.760331,0,"",""
"172.16.133.68",60756,"172.16.139.250",5440,10,1022,8483,0,0,10,1022,0,0,86.773454,0.005561000000000149,1470239,0
"172.16.133.12",59802,"172.16.139.250",5440,12,1142,8484,0,0,12,1142,0,0,86.787231,0.006153999999995108,1484562,0
"172.16.133.63",53905,"172.16.139.250",5440,10,1022,8485,0,0,10,1022,0,0,86.797296,0.005393999999995458,1515758,0
"172.16.133.66",53895,"172.16.139.250",5440,12,1142,8486,0,0,12,1142,0,0,86.810421,0.005900999999994383,1548212,0
"172.16.133.24",57697,"96.43.146.22",443,48,23224,8487,0,0,28,19378,20,3846,86.813474,188.74988000000002,821,163
"172.16.133.24",57698,"96.43.146.22",443,33,14004,8488,0,0,20,11722,13,2282,86.813684,173.538984,540,105
"172.16.133.82",61371,"172.16.139.250",5440,10,1022,8489,0,0,10,1022,0,0,86.8233,0.005567999999996687,1468390,0
"172.16.133.37",60650,"172.16.139.250",5440,10,1022,8490,0,0,10,1022,0,0,86.838013,0.01473699999999667,554794,0
"172.16.133.40",50153,"23.6.17.224",80,21,5917,8491,0,0,11,4258,10,1659,86.901062,85.414504,398,155
"172.16.133.40",50154,"199.59.148.86",443,31,9494,8492,0,0,13,3935,18,5559,86.904283,32.312253,974,1376
"172.16.133.40",50155,"23.6.17.224",80,13,2561,8493,0,0,7,1707,6,854,86.906719,55.404713,246,123
"172.16.133.153",60410,"23.62.195.78",80,119,102830,8494,0,0,50,3441,69,99389,86.966617,0.40337900000000104,68243,1971128
"172.16.133.78",59233,"172.16.139.250",5440,12,1142,8495,0,0,12,1142,0,0,86.994207,0.00575399999999604,1587765,0
"172.16.133.40",50156,"23.67.243.40",443,29,11432,8496,0,0,13,2475,16,8957,86.994579,58.316545000000005,339,1228
"172.16.133.40",50157,"23.67.243.40",443,32,14596,8497,0,0,15,3218,17,11378,86.995088,48.282528,533,1885
"172.16.133.40",50158,"31.13.77.42",443,31,6032,8498,0,0,14,1967,17,4065,86.995411,122.296478,128,265
"172.16.133.40",50159,"173.252.100.27",443,124,54310,8499,0,0,46,9760,78,44550,87.003419,203.34701,383,1752
"172.16.133.40",50160,"199.59.148.86",443,17,5451,8500,0,0,8,1218,9,4233,87.033614,38.334877000000006,254,883
"172.16.133.67",56011,"172.16.139.250",5440,10,1022,8501,0,0,10,1022,0,0,87.048947,0.005413000000004331,1510437,0
"172.16.133.56",61455,"172.16.139.250",5440,10,1022,8502,0,0,10,1022,0,0,87.072567,0.004832999999990761,"",""
"172.16.133.42",57152,"172.16.139.250",5440,12,1142,8503,0,0,12,1142,0,0,87.121085,0.0672750000000093,135800,0
"172.16.133.41",53045,"172.16.139.250",5440,10,1022,8504,0,0,10,1022,0,0,87.127084,0.03718899999999792,219849,0
"172.16.133.40",50161,"4.28.73.137",80,12,5872,8505,0,0,6,2141,6,3731,87.13023,0.09340699999999913,183369,319547
"172.16.133.85",52298,"172.16.139.250",5440,10,1022,8506,0,0,10,1022,0,0,87.145,0.02282100000000753,358266,0
"172.16.133.43",57808,"172.16.139.250",5440,10,1022,8507,0,0,10,1022,0,0,87.199778,0.005848000000000297,1398084,0
"172.16.133.40",50162,"23.62.164.136",80,26,11928,8508,0,0,12,4100,14,7828,87.213367,180.55564900000002,181,346
"172.16.133.40",50163,"208.47.254.81",80,18,4255,8509,0,0,10,3279,8,976,87.215131,65.09673500000001,402,119
"172.16.133.13",53064,"172.16.139.250",5440,10,1022,8510,0,0,10,1022,0,0,87.216548,0.010970999999997844,745237,0
"172.16.133.20",62420,"172.16.139.250",5440,12,1142,8511,0,0,12,1142,0,0,87.265184,0.004979999999989104,"",""
"172.16.133.75",50984,"172.16.139.250",5440,10,1022,8512,0,0,10,1022,0,0,87.282804,0.0064059999999983575,1276303,0
"172.16.133.28",65456,"172.16.139.250",5440,10,1022,8513,0,0,10,1022,0,0,87.296361,0.005322999999989975,1535975,0
"172.16.133.153",54037,"64.17.236.31",80,66,42668,8514,0,0,34,2450,32,40218,87.314886,2.279777999999993,8597,141129
"172.16.133.99",56069,"172.16.139.250",5440,12,1142,8515,0,0,12,1142,0,0,87.322514,0.005105000000000359,1789618,0
"172.16.133.87",60233,"172.16.139.250",5440,12,1142,8516,0,0,12,1142,0,0,87.345376,0.01534699999999134,595295,0
"172.16.133.35",49999,"172.16.139.250",5440,12,1142,8517,0,0,12,1142,0,0,87.359517,0.012408000000007746,736299,0
"172.16.133.116",53447,"172.16.139.250",5440,12,1142,8518,0,0,12,1142,0,0,87.361326,0.006019999999992365,1517607,0
"172.16.133.21",53209,"216.115.212.254",443,6,366,8519,0,0,4,246,2,120,87.367155,0.18451600000000212,10665,5202
"172.16.133.116",53448,"172.16.139.250",5440,10,1022,8520,0,0,10,1022,0,0,87.368219,0.015229000000005044,536870,0
"172.16.133.84",58818,"172.16.139.250",5440,10,1022,8521,0,0,10,1022,0,0,87.383122,0.015251000000006343,536095,0
"172.16.133.116",53449,"172.16.139.250",5440,10,1022,8522,0,0,10,1022,0,0,87.384484,0.017700000000004934,461920,0
"172.16.133.40",50164,"23.32.180.136",80,64,47332,8523,0,0,27,13995,37,33337,87.424319,182.79729899999998,612,1458
"172.16.133.40",50165,"23.32.180.136",80,59,43500,8524,0,0,26,13935,33,29565,87.425075,182.85897900000003,609,1293
"172.16.133.49",55802,"172.16.139.250",5440,12,1142,8525,0,0,12,1142,0,0,87.459908,0.03626800000000685,251902,0
"172.16.133.40",50166,"23.32.180.136",80,61,44627,8526,0,0,26,13932,35,30695,87.463338,182.87709700000002,609,1342
"172.16.133.40",50167,"23.32.180.136",80,59,41472,8527,0,0,27,13995,32,27477,87.463795,182.933833,612,1201
"172.16.133.93",60742,"199.48.204.30",80,12,3132,8528,0,0,6,1015,6,2117,87.472885,10.100054,803,1676
"172.16.133.93",60743,"199.48.204.30",80,12,3578,8529,0,0,6,1014,6,2564,87.489208,10.063052999999996,806,2038
"172.16.133.95",56994,"172.16.139.250",5440,12,1142,8530,0,0,12,1142,0,0,87.497977,0.006150999999988471,1485286,0
"172.16.133.92",57708,"172.16.139.250",5440,12,1142,8531,0,0,12,1142,0,0,87.525446,0.0062999999999959755,1450158,0
"172.16.133.29",60961,"172.16.139.250",5440,12,1142,8532,0,0,12,1142,0,0,87.544742,0.009026000000005752,1012187,0
"172.16.133.44",64859,"172.16.139.250",5440,10,1022,8533,0,0,10,1022,0,0,87.550151,0.008320999999995138,982574,0
"172.16.133.207",55959,"172.16.139.250",5440,12,1142,8534,0,0,12,1142,0,0,87.574516,0.014578999999997677,626654,0
"172.16.133.83",57117,"172.16.139.250",5440,10,1022,8535,0,0,10,1022,0,0,87.583837,0.014589999999998327,560383,0
"172.16.133.93",60744,"172.16.139.250",5440,12,1142,8536,0,0,12,1142,0,0,87.600028,0.014534000000011815,628595,0
"172.16.133.11",55168,"172.16.139.250",5440,10,1022,8537,0,0,10,1022,0,0,87.616745,0.005836999999999648,1400719,0
"172.16.133.55",57607,"172.16.139.250",5440,10,1022,8538,0,0,10,1022,0,0,87.62245,0.01471100000000547,555774,0
"172.16.133.73",60699,"172.16.139.250",5440,12,1142,8539,0,0,12,1142,0,0,87.645152,0.00704600000000255,1296622,0
"172.16.133.53",54125,"172.16.139.250",5440,12,1142,8540,0,0,12,1142,0,0,87.648538,0.016795999999999367,543939,0
"172.16.133.21",53210,"172.16.139.250",5440,10,1022,8541,0,0,10,1022,0,0,87.649743,0.0059640000000058535,1370892,0
"172.16.133.30",62645,"172.16.139.250",5440,10,1022,8542,0,0,10,1022,0,0,87.653441,0.0065529999999967,1247672,0
"172.16.133.25",63483,"172.16.139.250",5440,12,1142,8543,0,0,12,1142,0,0,87.662078,0.0072499999999990905,1260137,0
"172.16.133.34",50465,"172.16.139.250",5440,12,1142,8544,0,0,12,1142,0,0,87.67113,0.014569999999991978,627041,0
"172.16.133.97",59398,"172.16.139.250",5440,12,1142,8545,0,0,12,1142,0,0,87.682375,0.015379000000010024,594056,0
"172.16.133.49",55803,"216.115.219.126",443,6,366,8546,0,0,4,246,2,120,87.703489,0.4903889999999933,4013,1957
"172.16.133.33",57907,"172.16.139.250",5440,10,1022,8547,0,0,10,1022,0,0,87.755036,0.03734899999999186,218908,0
"172.16.133.40",50168,"173.192.61.226",80,8,1642,8548,0,0,5,1021,3,621,87.779971,0.213318000000001,38290,23289
"172.16.133.68",60757,"172.16.139.250",5440,10,1022,8549,0,0,10,1022,0,0,87.787486,0.07226099999999747,113145,0
"172.16.133.12",59803,"172.16.139.250",5440,10,1022,8550,0,0,10,1022,0,0,87.801521,0.06135199999999941,133263,0
"172.16.133.63",53906,"172.16.139.250",5440,10,1022,8551,0,0,10,1022,0,0,87.810006,0.056355999999993855,145077,0
"172.16.133.66",53896,"172.16.139.250",5440,10,1022,8552,0,0,10,1022,0,0,87.825375,0.04433600000000126,184409,0
"172.16.133.82",61373,"172.16.139.250",5440,12,1142,8553,0,0,12,1142,0,0,87.837426,0.02109900000000664,433006,0
"172.16.133.37",60651,"172.16.139.250",5440,10,1022,8554,0,0,10,1022,0,0,87.855224,0.018443999999988137,443287,0
"172.16.133.21",53211,"202.173.28.250",443,6,366,8555,0,0,4,246,2,120,87.861102,0.529949000000002,3713,1811
"172.16.133.75",60490,"172.16.139.250",5500,4,1492,8556,0,0,4,1492,0,0,87.893826,0.2011669999999981,59333,0
"172.16.133.40",50169,"23.45.65.10",80,183,190381,8557,0,0,55,18216,128,172165,87.950142,208.45598399999997,699,6607
"172.16.133.78",59234,"172.16.139.250",5440,10,1022,8558,0,0,10,1022,0,0,88.009129,0.005594000000002097,1461565,0
"172.16.133.49",55804,"68.64.24.250",443,6,366,8559,0,0,4,246,2,120,88.054751,0.0972590000000082,20234,9870
"172.16.133.67",56012,"172.16.139.250",5440,10,1022,8560,0,0,10,1022,0,0,88.063235,0.005516000000000076,1482233,0
"172.16.133.56",61456,"172.16.139.250",5440,10,1022,8561,0,0,10,1022,0,0,88.085339,0.004801000000000499,"",""
"172.16.133.21",53212,"67.217.65.244",443,6,366,8562,0,0,4,246,2,120,88.100153,0.06054499999999052,32504,15855
"172.16.133.21",53213,"64.74.80.187",443,6,366,8563,0,0,4,246,2,120,88.103007,0.050619999999995,38877,18964
"172.16.133.42",57153,"172.16.139.250",5440,12,1142,8564,0,0,12,1142,0,0,88.136354,0.028429000000002702,321361,0
"172.16.133.41",53046,"172.16.139.250",5440,12,1142,8565,0,0,12,1142,0,0,88.14116,0.015392000000005623,593555,0
"172.16.133.49",55805,"78.108.118.250",443,7,426,8566,0,0,4,246,3,180,88.147453,0.21533100000000616,9139,6687
"172.16.133.85",52299,"172.16.139.250",5440,12,1142,8567,0,0,12,1142,0,0,88.159716,0.00698299999999108,1308320,0
"172.16.133.49",55806,"216.219.118.244",443,6,366,8568,0,0,4,246,2,120,88.164396,0.21205100000000243,9280,4527
"172.16.133.40",50170,"208.47.254.81",80,6,372,8569,0,0,4,246,2,126,88.201397,14.152677999999995,139,71
"172.16.133.40",50171,"23.45.65.10",80,61,48594,8570,0,0,25,9305,36,39289,88.201714,208.20428800000002,357,1509
"172.16.133.40",50172,"23.45.65.10",80,16,4182,8571,0,0,8,1732,8,2450,88.201843,181.55296800000002,76,107
"172.16.133.40",50173,"23.45.65.10",80,23,11318,8572,0,0,11,3177,12,8141,88.201967,208.204265,122,312
"172.16.133.40",50174,"173.194.43.33",80,6,372,8573,0,0,4,246,2,126,88.202195,14.150976,139,71
"172.16.133.43",57809,"172.16.139.250",5440,12,1142,8574,0,0,12,1142,0,0,88.212375,0.015367000000011899,594520,0
"172.16.133.13",53065,"172.16.139.250",5440,10,1022,8575,0,0,10,1022,0,0,88.230286,0.005359999999996035,1525373,0
"172.16.133.40",50175,"173.192.42.179",80,11,2336,8576,0,0,6,1824,5,512,88.232478,2.603213999999994,5605,1573
"172.16.133.40",50176,"173.192.42.179",80,11,2438,8577,0,0,6,1926,5,512,88.232614,2.028508000000002,7595,2019
"172.16.133.40",50177,"174.37.29.148",80,9,3238,8578,0,0,6,1962,3,1276,88.234691,1.2023420000000016,13054,8490
"172.16.133.40",50178,"174.37.29.148",80,8,1650,8579,0,0,5,1002,3,648,88.234853,0.39099899999999366,20501,13258
"172.16.133.40",50179,"174.37.29.148",80,9,3688,8580,0,0,5,1634,4,2054,88.235008,0.2843690000000123,45968,57784
"172.16.133.40",50180,"67.228.244.117",80,7,432,8581,0,0,4,246,3,186,88.235165,1.9525620000000004,1007,762
"172.16.133.40",50181,"67.228.244.117",80,7,432,8582,0,0,4,246,3,186,88.235305,1.9529959999999988,1007,761
"172.16.133.20",62421,"172.16.139.250",5440,12,1142,8583,0,0,12,1142,0,0,88.280037,0.005141000000008944,1777086,0
"172.16.133.75",50985,"172.16.139.250",5440,10,1022,8584,0,0,10,1022,0,0,88.296998,0.005416999999994232,1509322,0
"172.16.133.28",65457,"172.16.139.250",5440,12,1142,8585,0,0,12,1142,0,0,88.310326,0.008055999999996288,1134061,0
"172.16.133.99",56070,"172.16.139.250",5440,10,1022,8586,0,0,10,1022,0,0,88.336287,0.014859999999998763,550201,0
"172.16.133.87",60234,"172.16.139.250",5440,10,1022,8587,0,0,10,1022,0,0,88.36039,0.0054149999999992815,1509879,0
"172.16.133.35",50000,"172.16.139.250",5440,12,1142,8588,0,0,12,1142,0,0,88.372729,0.009341999999989525,977949,0
"172.16.133.116",53450,"172.16.139.250",5440,10,1022,8589,0,0,10,1022,0,0,88.376543,0.00633600000000456,1290404,0
"172.16.133.40",50182,"74.125.226.207",443,14,4027,8590,0,0,8,958,6,3069,88.377955,6.880683000000005,1113,3568
"172.16.133.40",50183,"173.194.43.46",443,17,1854,8591,0,0,9,1139,8,715,88.38001,180.20994900000002,50,31
"172.16.133.116",53451,"172.16.139.250",5440,10,1022,8592,0,0,10,1022,0,0,88.384592,0.005407000000005269,1512113,0
"172.16.133.116",53452,"172.16.139.250",5440,10,1022,8593,0,0,10,1022,0,0,88.391548,0.005743999999992866,1423398,0
"172.16.133.84",58819,"172.16.139.250",5440,12,1142,8594,0,0,12,1142,0,0,88.395948,0.015232999999994945,599750,0
"172.16.133.40",50184,"23.67.242.50",80,70,61364,8595,0,0,22,2704,48,58660,88.401807,181.95757499999996,118,2579
"172.16.133.40",50185,"67.228.30.242",80,12,5411,8596,0,0,6,849,6,4562,88.430436,0.2202130000000011,30842,165730
"172.16.133.49",55807,"172.16.139.250",5440,10,1022,8597,0,0,10,1022,0,0,88.474058,0.00615999999999417,1327272,0
"172.16.133.95",56995,"172.16.139.250",5440,12,1142,8598,0,0,12,1142,0,0,88.513037,0.006275000000002251,1455936,0
"172.16.133.40",50186,"4.28.73.137",80,12,6281,8599,0,0,6,2299,6,3982,88.520591,0.1300600000000003,141411,244933
"172.16.133.40",50187,"208.47.254.8",443,14,2394,8600,0,0,7,858,7,1536,88.520947,26.77872699999999,256,458
"172.16.133.40",50188,"208.47.254.8",443,14,2394,8601,0,0,7,858,7,1536,88.521076,26.777381000000005,256,458
"172.16.133.92",57709,"172.16.139.250",5440,10,1022,8602,0,0,10,1022,0,0,88.540819,0.0056359999999955335,1450674,0
"172.16.133.40",50189,"64.94.107.58",80,8,2117,8603,0,0,5,1654,3,463,88.551842,0.07167100000000914,184621,51680
"172.16.133.29",60962,"172.16.139.250",5440,10,1022,8604,0,0,10,1022,0,0,88.557085,0.01659800000000189,492589,0
"172.16.133.44",64860,"172.16.139.250",5440,10,1022,8605,0,0,10,1022,0,0,88.563978,0.005676999999991494,1440197,0
"172.16.133.40",50190,"107.21.205.194",80,11,1762,8606,0,0,6,944,5,818,88.58695,13.766374999999996,548,475
"172.16.133.207",55960,"172.16.139.250",5440,10,1022,8607,0,0,10,1022,0,0,88.588641,0.004829999999998336,"",""
"172.16.133.83",57118,"172.16.139.250",5440,12,1142,8608,0,0,12,1142,0,0,88.597826,0.01380100000000084,661981,0
"172.16.133.93",60745,"172.16.139.250",5440,12,1142,8609,0,0,12,1142,0,0,88.614114,0.00524599999999964,1741517,0
"172.16.133.11",55169,"172.16.139.250",5440,10,1022,8610,0,0,10,1022,0,0,88.631418,0.015505000000004543,527313,0
"172.16.133.55",57608,"172.16.139.250",5440,10,1022,8611,0,0,10,1022,0,0,88.63648,0.005568999999994162,1468127,0
"172.16.133.73",60700,"172.16.139.250",5440,10,1022,8612,0,0,10,1022,0,0,88.658655,0.005685999999997193,1437917,0
"172.16.133.53",54126,"172.16.139.250",5440,12,1142,8613,0,0,12,1142,0,0,88.662367,0.00660299999999836,1383613,0
"172.16.133.21",53214,"172.16.139.250",5440,10,1022,8614,0,0,10,1022,0,0,88.663616,0.015351999999992927,532569,0
"172.16.133.30",62647,"172.16.139.250",5440,12,1142,8615,0,0,12,1142,0,0,88.667846,0.005976000000003978,1528781,0
"172.16.133.25",63484,"172.16.139.250",5440,12,1142,8616,0,0,12,1142,0,0,88.675949,0.006890999999995984,1325787,0
"172.16.133.34",50466,"172.16.139.250",5440,10,1022,8617,0,0,10,1022,0,0,88.685522,0.00666799999999057,1226154,0
"172.16.133.97",59399,"172.16.139.250",5440,12,1142,8618,0,0,12,1142,0,0,88.695696,0.01645899999999756,555076,0
"172.16.133.54",64341,"173.194.73.99",443,170,112840,8619,0,0,68,12420,102,100420,88.722519,179.75877799999998,552,4469
"172.16.133.33",57908,"172.16.139.250",5440,12,1142,8620,0,0,12,1142,0,0,88.769847,0.005528999999995676,1652378,0
"172.16.133.68",60758,"172.16.139.250",5440,10,1022,8621,0,0,10,1022,0,0,88.801073,0.015723999999991634,519969,0
"172.16.133.12",59804,"172.16.139.250",5440,12,1142,8622,0,0,12,1142,0,0,88.814438,0.006437000000005355,1419294,0
"172.16.133.63",53907,"172.16.139.250",5440,12,1142,8624,0,0,12,1142,0,0,88.823714,0.006392000000005282,1429286,0
"172.16.133.66",53897,"172.16.139.250",5440,10,1022,8625,0,0,10,1022,0,0,88.838295,0.005380999999999858,1519420,0
"172.16.133.40",50191,"23.67.242.50",80,6,372,8626,0,0,4,246,2,126,88.842612,13.511517999999995,145,74
"172.16.133.82",61374,"172.16.139.250",5440,10,1022,8627,0,0,10,1022,0,0,88.851097,0.014932999999999197,547512,0
"172.16.133.37",60652,"172.16.139.250",5440,12,1142,8628,0,0,12,1142,0,0,88.865812,0.011493999999999005,794849,0
"172.16.133.40",50192,"67.228.30.242",80,10,1771,8629,0,0,5,1180,5,591,88.880929,0.32392700000001184,29142,14595
"172.16.133.40",50193,"173.192.61.226",80,8,1973,8630,0,0,5,1056,3,917,88.884904,0.316395,26700,23186
"172.16.133.40",50194,"4.28.73.137",80,13,6650,8631,0,0,6,2456,7,4194,88.885285,0.1835010000000068,107072,182843
"172.16.133.66",53898,"199.59.149.230",443,33,12896,8632,0,0,14,3643,19,9253,88.996251,31.153729999999996,935,2376
"172.16.133.40",50195,"23.6.17.224",443,25,8719,8633,0,0,12,3131,13,5588,89.004583,66.27806799999999,377,674
"172.16.133.40",50196,"23.6.17.224",443,25,8773,8634,0,0,12,2769,13,6004,89.004865,76.28617700000001,290,629
"172.16.133.78",59235,"172.16.139.250",5440,10,1022,8635,0,0,10,1022,0,0,89.022192,0.005748999999994453,1422160,0
"172.16.133.67",56013,"172.16.139.250",5440,10,1022,8636,0,0,10,1022,0,0,89.077167,0.014541999999991617,562233,0
"172.16.133.40",50197,"23.67.243.40",443,20,5304,8637,0,0,9,1467,11,3837,89.088902,46.18766699999999,254,664
"172.16.133.40",50198,"23.67.243.40",443,18,5146,8638,0,0,8,1407,10,3739,89.089749,46.18805300000001,243,647
"172.16.133.40",50199,"23.67.243.40",443,23,9629,8639,0,0,10,2134,13,7495,89.090211,46.18770300000001,369,1298
"172.16.133.40",50200,"23.67.243.40",443,20,5848,8640,0,0,9,1467,11,4381,89.090673,56.22052000000001,208,623
"172.16.133.56",61457,"172.16.139.250",5440,12,1142,8641,0,0,12,1142,0,0,89.099357,0.005961999999996692,1532371,0
"172.16.133.40",50201,"4.28.73.137",80,13,6907,8642,0,0,6,2612,7,4295,89.12279,0.07842899999999986,266432,438103
"172.16.133.42",57154,"172.16.139.250",5440,12,1142,8643,0,0,12,1142,0,0,89.152336,0.01566799999999091,583099,0
"172.16.133.41",53047,"172.16.139.250",5440,10,1022,8644,0,0,10,1022,0,0,89.156786,0.01583999999999719,516161,0
"172.16.133.85",52300,"172.16.139.250",5440,10,1022,8645,0,0,10,1022,0,0,89.171547,0.014867999999992776,549905,0
"172.16.133.43",57810,"172.16.139.250",5440,10,1022,8646,0,0,10,1022,0,0,89.226457,0.11297400000000835,72370,0
"172.16.133.13",53066,"172.16.139.250",5440,10,1022,8647,0,0,10,1022,0,0,89.244461,0.09600799999999765,85159,0
"172.16.133.20",62422,"172.16.139.250",5440,12,1142,8648,0,0,12,1142,0,0,89.293254,0.050831999999999766,179729,0
"172.16.133.75",50986,"172.16.139.250",5440,10,1022,8649,0,0,10,1022,0,0,89.309766,0.03779699999999764,216313,0
"172.16.133.28",65458,"172.16.139.250",5440,10,1022,8650,0,0,10,1022,0,0,89.334696,0.017676000000008685,462548,0
"172.16.133.99",56071,"172.16.139.250",5440,12,1142,8651,0,0,12,1142,0,0,89.351111,0.00525899999999524,1737212,0
"172.16.133.40",50202,"4.28.73.137",80,13,7165,8652,0,0,6,2698,7,4467,89.371064,0.22640899999998965,95331,157838
"172.16.133.87",60235,"172.16.139.250",5440,10,1022,8653,0,0,10,1022,0,0,89.374148,0.005317999999988388,1537420,0
"172.16.133.35",50001,"172.16.139.250",5440,12,1142,8654,0,0,12,1142,0,0,89.385053,0.0224319999999949,407275,0
"172.16.133.116",53453,"172.16.139.250",5440,10,1022,8655,0,0,10,1022,0,0,89.387949,0.004961999999991917,"",""
"172.16.133.116",53454,"172.16.139.250",5440,10,1022,8656,0,0,10,1022,0,0,89.39373,0.008254999999991242,990430,0
"172.16.133.116",53455,"172.16.139.250",5440,10,1022,8657,0,0,10,1022,0,0,89.403081,0.015441999999993072,529465,0
"172.16.133.84",58820,"172.16.139.250",5440,12,1142,8658,0,0,12,1142,0,0,89.410025,0.016367999999999938,558162,0
"172.16.133.21",53215,"216.115.212.254",443,6,366,8659,0,0,4,246,2,120,89.459199,0.19892199999999605,9893,4826
"172.16.133.49",55808,"172.16.139.250",5440,12,1142,8660,0,0,12,1142,0,0,89.487952,0.00638799999998696,1430181,0
"172.16.133.95",56996,"172.16.139.250",5440,10,1022,8661,0,0,10,1022,0,0,89.526035,0.014877000000012686,549573,0
"172.16.133.153",48327,"64.17.236.31",80,119,103430,8662,0,0,51,3516,68,99914,89.548777,1.0502070000000003,26783,761099
"172.16.133.92",57710,"172.16.139.250",5440,12,1142,8663,0,0,12,1142,0,0,89.553951,0.005395000000007144,1693419,0
"172.16.133.29",60963,"172.16.139.250",5440,10,1022,8664,0,0,10,1022,0,0,89.57134,0.00551299999999344,1483040,0
"172.16.133.44",64861,"172.16.139.250",5440,10,1022,8665,0,0,10,1022,0,0,89.579464,0.014773000000005254,553442,0
"172.16.133.207",55961,"172.16.139.250",5440,10,1022,8666,0,0,10,1022,0,0,89.602563,0.014592999999990752,560268,0
"172.16.133.83",57119,"172.16.139.250",5440,12,1142,8667,0,0,12,1142,0,0,89.612736,0.00821000000000538,1112789,0
"172.16.133.109",59064,"96.43.146.176",443,31,13403,8668,0,0,16,1680,15,11723,89.614786,0.357475000000008,37597,262351
"172.16.133.93",60746,"172.16.139.250",5440,10,1022,8669,0,0,10,1022,0,0,89.628115,0.004730000000009227,"",""
"172.16.133.95",56997,"199.59.148.247",80,11,1722,8670,0,0,6,963,5,759,89.636211,36.202648999999994,212,167
"172.16.133.11",55170,"172.16.139.250",5440,10,1022,8671,0,0,10,1022,0,0,89.645655,0.006555999999989126,1247101,0
"172.16.133.55",57609,"172.16.139.250",5440,12,1142,8672,0,0,12,1142,0,0,89.649532,0.017648000000008324,517679,0
"172.16.133.73",60701,"172.16.139.250",5440,12,1142,8673,0,0,12,1142,0,0,89.672761,0.008306000000004587,1099927,0
"172.16.133.53",54127,"172.16.139.250",5440,10,1022,8674,0,0,10,1022,0,0,89.675519,0.008379000000005021,975772,0
"172.16.133.21",53216,"172.16.139.250",5440,12,1142,8675,0,0,12,1142,0,0,89.677651,0.01774000000000342,514994,0
"172.16.133.30",62648,"172.16.139.250",5440,12,1142,8676,0,0,12,1142,0,0,89.681866,0.021397000000007438,426975,0
"172.16.133.25",63485,"172.16.139.250",5440,12,1142,8677,0,0,12,1142,0,0,89.688948,0.010030000000000427,910867,0
"172.16.133.34",50467,"172.16.139.250",5440,12,1142,8678,0,0,12,1142,0,0,89.699233,0.028938999999994053,315698,0
"172.16.133.66",53899,"93.184.216.139",443,36,12279,8679,0,0,17,3239,19,9040,89.706611,184.824948,140,391
"172.16.133.66",53900,"93.184.216.139",443,76,54763,8680,0,0,28,5100,48,49663,89.706845,184.82459,220,2149
"172.16.133.97",59400,"172.16.139.250",5440,12,1142,8681,0,0,12,1142,0,0,89.710097,0.022578999999993243,404623,0
"172.16.133.40",50203,"174.37.29.148",80,10,2606,8682,0,0,6,1855,4,751,89.764742,0.22898999999999603,64806,26236
"172.16.133.40",50204,"4.28.73.137",80,13,7428,8683,0,0,6,2849,7,4579,89.766748,0.13065799999999683,174440,280365
"172.16.133.33",57909,"172.16.139.250",5440,10,1022,8684,0,0,10,1022,0,0,89.784168,0.00547200000001169,1494152,0
"172.16.133.40",50205,"75.126.109.194",80,45,3527,8685,0,0,18,1655,27,1872,89.787581,114.228052,115,131
"172.16.133.40",50206,"23.15.129.231",80,16,4268,8686,0,0,9,1275,7,2993,89.793544,82.520085,123,290
"172.16.133.68",60759,"172.16.139.250",5440,12,1142,8687,0,0,12,1142,0,0,89.815189,0.006401999999994246,1427054,0
"172.16.133.12",59805,"172.16.139.250",5440,12,1142,8688,0,0,12,1142,0,0,89.828504,0.006202000000001817,1473073,0
"172.16.133.63",53908,"172.16.139.250",5440,12,1142,8689,0,0,12,1142,0,0,89.837983,0.005473000000009165,1669285,0
"172.16.133.67",55852,"23.67.242.81",80,1,60,8690,0,0,1,60,0,0,89.846439,0,"",""
"172.16.133.66",53901,"172.16.139.250",5440,10,1022,8691,0,0,10,1022,0,0,89.855276,0.005496999999991203,1487356,0
"172.16.133.82",61375,"172.16.139.250",5440,10,1022,8692,0,0,10,1022,0,0,89.86542,0.006080999999994674,1344515,0
"172.16.133.66",53902,"93.184.216.139",443,18,4814,8693,0,0,9,1244,9,3570,89.867789,64.659916,153,441
"172.16.133.66",53903,"93.184.216.139",443,20,5172,8694,0,0,10,1310,10,3862,89.868033,64.65830199999999,162,477
"172.16.133.66",53904,"93.184.216.139",443,20,5172,8695,0,0,10,1310,10,3862,89.868253,64.65629500000001,162,477
"172.16.133.37",60653,"172.16.139.250",5440,12,1142,8696,0,0,12,1142,0,0,89.880097,0.015290999999990618,597475,0
"172.16.133.132",36673,"96.43.146.48",443,20,6059,8697,0,0,11,1125,9,4934,89.880605,0.23407000000000266,38450,168633
"172.16.133.55",57610,"173.194.75.99",443,56,10035,8698,0,0,28,4848,28,5187,89.90012,183.304668,211,226
"172.16.133.66",53905,"74.125.226.222",443,14,3683,8699,0,0,8,967,6,2716,89.923602,4.584167999999991,1687,4739
"172.16.133.66",53906,"74.125.226.222",443,33,7616,8700,0,0,16,3723,17,3893,89.923737,180.26093499999996,165,172
"172.16.133.66",53907,"74.125.226.222",443,15,3743,8701,0,0,8,967,7,2776,89.926596,4.5981979999999965,1682,4829
"172.16.133.109",48548,"96.43.146.176",443,27,8306,8702,0,0,15,1635,12,6671,89.930061,3.4750290000000064,3763,15357
"172.16.128.233",55243,"172.16.133.233",22,196,29408,8703,0,0,63,4960,133,24448,89.945276,7.998287999999988,4961,24453
"172.16.133.49",55809,"216.115.219.126",443,6,366,8704,0,0,4,246,2,120,89.953517,0.49084200000000067,4009,1955
"172.16.133.44",64862,"138.108.6.20",80,13,4432,8705,0,0,7,3242,6,1190,89.964699,19.195262999999997,1351,495
"172.16.133.44",64863,"64.94.107.14",80,8,2170,8706,0,0,5,1707,3,463,89.971894,0.07212899999998967,189327,51352
"172.16.133.78",59236,"172.16.139.250",5440,10,1022,8707,0,0,10,1022,0,0,90.03605,0.0055759999999906995,1466284,0
"172.16.133.132",36674,"96.43.146.48",443,20,6059,8708,0,0,11,1125,9,4934,90.085459,0.18670000000000186,48205,211419
"172.16.133.113",55627,"172.16.139.250",135,8,492,8709,0,0,8,492,0,0,90.090458,0.0049960000000055516,"",""
"172.16.133.67",56014,"172.16.139.250",5440,10,1022,8710,0,0,10,1022,0,0,90.091151,0.006307000000006724,1296337,0
"172.16.133.113",55628,"172.16.139.250",5462,10,696,8711,0,0,10,696,0,0,90.096912,0.5113879999999966,10888,0
"172.16.133.40",50207,"67.228.244.117",80,11,2343,8712,0,0,6,1945,5,398,90.100891,0.24521099999999763,63455,12984
"172.16.133.49",55810,"68.64.24.250",443,6,366,8713,0,0,4,246,2,120,90.110405,0.09495699999999374,20725,10109
"172.16.133.56",61458,"172.16.139.250",5440,10,1022,8714,0,0,10,1022,0,0,90.114614,0.004792999999992276,"",""
"172.16.133.21",53217,"202.173.28.250",443,6,366,8715,0,0,4,246,2,120,90.119275,0.49182899999999563,4001,1951
"172.16.133.21",53218,"64.74.80.187",443,6,366,8716,0,0,4,246,2,120,90.132125,0.054566999999991594,36065,17593
"172.16.133.21",53219,"67.217.65.244",443,6,366,8717,0,0,4,246,2,120,90.138107,0.06267699999999365,31399,15316
"172.16.133.41",53048,"172.16.139.250",5440,10,1022,8718,0,0,10,1022,0,0,90.17036,0.0161329999999964,506787,0
"172.16.133.42",57155,"172.16.139.250",5440,12,1142,8719,0,0,12,1142,0,0,90.171954,0.08880499999999358,102877,0
"172.16.133.85",52301,"172.16.139.250",5440,12,1142,8720,0,0,12,1142,0,0,90.186945,0.0062860000000029,1453388,0
"172.16.133.116",53456,"96.43.146.22",443,15,1297,8721,0,0,8,748,7,549,90.226678,180.36563999999998,33,24
"172.16.133.132",36675,"96.43.146.48",443,20,6059,8722,0,0,11,1125,9,4934,90.240304,0.1849330000000009,48666,213439
"172.16.133.43",57811,"172.16.139.250",5440,12,1142,8723,0,0,12,1142,0,0,90.240837,0.0061900000000036925,1475928,0
"172.16.133.49",55811,"78.108.118.250",443,6,366,8724,0,0,4,246,2,120,90.255523,0.1941670000000073,10135,4944
"172.16.133.13",53067,"172.16.139.250",5440,10,1022,8725,0,0,10,1022,0,0,90.258705,0.01527299999999343,535323,0
"172.16.133.49",55812,"216.219.118.244",443,6,366,8726,0,0,4,246,2,120,90.272528,0.21903700000000015,8984,4382
"172.16.133.20",62423,"172.16.139.250",5440,10,1022,8727,0,0,10,1022,0,0,90.308273,0.00471400000000699,"",""
"172.16.133.75",50987,"172.16.139.250",5440,10,1022,8728,0,0,10,1022,0,0,90.325024,0.015463999999994371,528711,0
"172.16.133.28",65459,"172.16.139.250",5440,12,1142,8729,0,0,12,1142,0,0,90.338652,0.009045000000000414,1010060,0
"172.16.133.99",56072,"172.16.139.250",5440,10,1022,8730,0,0,10,1022,0,0,90.365584,0.004896999999999707,"",""
"172.16.133.87",60236,"172.16.139.250",5440,10,1022,8731,0,0,10,1022,0,0,90.388462,0.005420999999998344,1508208,0
"172.16.133.39",64239,"23.67.242.67",80,1,60,8732,0,0,1,60,0,0,90.394573,0,"",""
"172.16.133.40",50208,"174.37.29.148",80,11,3680,8733,0,0,6,1871,5,1809,90.396795,0.3260099999999966,45912,44391
"172.16.133.35",50002,"172.16.139.250",5440,12,1142,8734,0,0,12,1142,0,0,90.398157,0.02797100000000796,326624,0
"172.16.133.116",53457,"172.16.139.250",5440,10,1022,8735,0,0,10,1022,0,0,90.40148,0.017872999999994477,457449,0
"172.16.133.116",53458,"172.16.139.250",5440,10,1022,8736,0,0,10,1022,0,0,90.4198,0.005386000000001445,1518009,0
"172.16.133.116",53459,"172.16.139.250",5440,10,1022,8737,0,0,10,1022,0,0,90.425673,0.006441999999992731,1269171,0
"172.16.133.84",58821,"172.16.139.250",5440,12,1142,8738,0,0,12,1142,0,0,90.425675,0.015416999999999348,592592,0
"172.16.133.40",50209,"23.21.215.52",80,13,1316,8739,0,0,7,911,6,405,90.431208,61.88675900000001,117,52
"172.16.133.49",55813,"172.16.139.250",5440,12,1142,8740,0,0,12,1142,0,0,90.501857,0.015541999999996392,587826,0
"172.16.133.153",40105,"141.101.123.194",80,102,83135,8741,0,0,44,3012,58,80123,90.510769,0.2739080000000058,87971,2340143
"172.16.133.95",56998,"172.16.139.250",5440,10,1022,8742,0,0,10,1022,0,0,90.539953,0.017483999999996058,467627,0
"172.16.133.92",57711,"172.16.139.250",5440,12,1142,8743,0,0,12,1142,0,0,90.568162,0.0062680000000057134,1457562,0
"172.16.133.29",60964,"172.16.139.250",5440,10,1022,8744,0,0,10,1022,0,0,90.584814,0.005361000000007721,1525088,0
"172.16.133.44",64864,"172.16.139.250",5440,10,1022,8745,0,0,10,1022,0,0,90.591806,0.005129999999994084,1593762,0
"172.16.133.207",55962,"172.16.139.250",5440,10,1022,8746,0,0,10,1022,0,0,90.616808,0.014253999999993994,573593,0
"172.16.133.29",60965,"208.111.161.254",80,29,23159,8747,0,0,9,2321,20,20838,90.62479,50.472258999999994,367,3302
"172.16.133.83",57120,"172.16.139.250",5440,10,1022,8748,0,0,10,1022,0,0,90.626751,0.007987999999997442,1023535,0
"172.16.133.93",60747,"172.16.139.250",5440,12,1142,8749,0,0,12,1142,0,0,90.642409,0.014455999999995583,631986,0
"172.16.133.11",55171,"172.16.139.250",5440,10,1022,8750,0,0,10,1022,0,0,90.659,0.005565999999987525,1468918,0
"172.16.133.55",57611,"172.16.139.250",5440,10,1022,8751,0,0,10,1022,0,0,90.663548,0.005556999999996037,1471297,0
"172.16.133.40",50210,"67.228.244.117",80,12,2301,8752,0,0,6,1843,6,458,90.68398,0.2238229999999959,65873,16370
"172.16.133.40",50211,"174.37.29.148",80,11,4249,8753,0,0,6,1951,5,2298,90.684197,0.21556599999999548,72404,85282
"172.16.133.73",60702,"172.16.139.250",5440,10,1022,8754,0,0,10,1022,0,0,90.688911,0.0059539999999884685,1373194,0
"172.16.133.53",54128,"172.16.139.250",5440,10,1022,8755,0,0,10,1022,0,0,90.691253,0.007659000000003857,1067502,0
"172.16.133.21",53220,"172.16.139.250",5440,10,1022,8756,0,0,10,1022,0,0,90.691626,0.010761999999999716,759710,0
"172.16.133.30",62649,"172.16.139.250",5440,10,1022,8757,0,0,10,1022,0,0,90.695732,0.010642999999987524,768204,0
"172.16.133.25",63486,"172.16.139.250",5440,10,1022,8758,0,0,10,1022,0,0,90.703013,0.007329999999996062,1115416,0
"172.16.133.34",50468,"172.16.139.250",5440,10,1022,8759,0,0,10,1022,0,0,90.713857,0.005021999999996751,1628036,0
"172.16.133.97",59401,"172.16.139.250",5440,10,1022,8760,0,0,10,1022,0,0,90.722571,0.005409999999997694,1511275,0
"172.16.133.33",57910,"172.16.139.250",5440,10,1022,8761,0,0,10,1022,0,0,90.797888,0.005527000000000726,1479283,0
"172.16.133.68",60760,"172.16.139.250",5440,10,1022,8762,0,0,10,1022,0,0,90.828516,0.005489000000011401,1489524,0
"172.16.133.12",59806,"172.16.139.250",5440,12,1142,8763,0,0,12,1142,0,0,90.84251,0.006106000000002609,1496233,0
"172.16.133.40",50212,"72.21.91.121",80,14,3971,8764,0,0,7,2570,7,1401,90.842996,11.509028,1786,973
"172.16.133.40",50213,"72.21.91.121",80,14,3969,8765,0,0,7,2570,7,1399,90.847009,11.505396000000005,1786,972
"172.16.133.63",53909,"172.16.139.250",5440,10,1022,8766,0,0,10,1022,0,0,90.852463,0.005319999999997549,1536842,0
"172.16.133.66",53908,"172.16.139.250",5440,10,1022,8767,0,0,10,1022,0,0,90.8663,0.005228000000002453,1563886,0
"172.16.133.82",61376,"172.16.139.250",5440,10,1022,8768,0,0,10,1022,0,0,90.880019,0.0063739999999938846,1282711,0
"172.16.133.37",60654,"172.16.139.250",5440,10,1022,8769,0,0,10,1022,0,0,90.894065,0.00533300000000736,1533095,0
"172.16.133.78",59237,"172.16.139.250",5440,10,1022,8770,0,0,10,1022,0,0,91.049994,0.005887999999998783,1388586,0
"172.16.133.40",50214,"204.93.223.146",80,9,2606,8771,0,0,5,2195,4,411,91.103823,36.491883,481,90
"172.16.133.67",56015,"172.16.139.250",5440,10,1022,8772,0,0,10,1022,0,0,91.105477,0.005912000000009243,1382949,0
"172.16.133.121",56536,"72.21.91.97",80,6,372,8773,0,0,4,246,2,126,91.117611,12.843088000000009,153,78
"172.16.133.56",61459,"172.16.139.250",5440,10,1022,8774,0,0,10,1022,0,0,91.127451,0.004690000000010741,"",""
"172.16.133.40",50215,"72.21.91.111",80,14,7277,8775,0,0,6,1348,8,5929,91.147127,11.205376000000001,962,4232
"172.16.133.42",57156,"172.16.139.250",5440,12,1142,8776,0,0,12,1142,0,0,91.178356,0.011566000000001964,789901,0
"172.16.133.41",53049,"172.16.139.250",5440,10,1022,8777,0,0,10,1022,0,0,91.183462,0.014444999999994934,566008,0
"172.16.133.85",52302,"172.16.139.250",5440,10,1022,8778,0,0,10,1022,0,0,91.200029,0.015270000000001005,535428,0
"172.16.133.43",57812,"172.16.139.250",5440,12,1142,8779,0,0,12,1142,0,0,91.25372,0.00612099999999316,1492566,0
"172.16.133.13",53068,"172.16.139.250",5440,12,1142,8780,0,0,12,1142,0,0,91.273778,0.006211000000007516,1470938,0
"172.16.133.20",62424,"172.16.139.250",5440,12,1142,8781,0,0,12,1142,0,0,91.321554,0.005027999999995814,1817024,0
"172.16.133.75",50988,"172.16.139.250",5440,10,1022,8782,0,0,10,1022,0,0,91.338878,0.015100000000003888,541456,0
"172.16.133.28",65460,"172.16.139.250",5440,12,1142,8783,0,0,12,1142,0,0,91.352323,0.0064109999999999445,1425050,0
"172.16.133.99",56073,"172.16.139.250",5440,10,1022,8784,0,0,10,1022,0,0,91.37937,0.014502000000007342,563784,0
"172.16.133.87",60237,"172.16.139.250",5440,10,1022,8785,0,0,10,1022,0,0,91.402414,0.014804000000012252,552283,0
"172.16.133.116",53460,"172.16.139.250",5440,10,1022,8786,0,0,10,1022,0,0,91.415789,0.014440999999990822,566165,0
"172.16.133.35",50003,"172.16.139.250",5440,12,1142,8787,0,0,12,1142,0,0,91.41916,0.01585299999999279,576294,0
"172.16.133.116",53461,"172.16.139.250",5440,10,1022,8788,0,0,10,1022,0,0,91.430863,0.017290000000002692,472874,0
"172.16.133.84",58822,"172.16.139.250",5440,10,1022,8789,0,0,10,1022,0,0,91.439094,0.005423000000007505,1507652,0
"172.16.133.116",53462,"172.16.139.250",5440,10,1022,8790,0,0,10,1022,0,0,91.449123,0.005218999999996754,1566583,0
"172.16.133.49",55814,"172.16.139.250",5440,12,1142,8791,0,0,12,1142,0,0,91.516115,0.00790600000000552,1155578,0
"172.16.133.95",56999,"172.16.139.250",5440,12,1142,8792,0,0,12,1142,0,0,91.553841,0.015546999999997979,587637,0
"172.16.133.92",57712,"172.16.139.250",5440,10,1022,8793,0,0,10,1022,0,0,91.582666,0.005781999999996401,1414043,0
"172.16.133.29",60966,"172.16.139.250",5440,10,1022,8794,0,0,10,1022,0,0,91.598591,0.015418999999994298,530254,0
"172.16.133.44",64865,"172.16.139.250",5440,12,1142,8795,0,0,12,1142,0,0,91.605949,0.01604400000000794,569434,0
"172.16.133.207",55963,"172.16.139.250",5440,10,1022,8796,0,0,10,1022,0,0,91.630736,0.004663000000007855,"",""
"172.16.133.83",57121,"172.16.139.250",5440,12,1142,8797,0,0,12,1142,0,0,91.640975,0.004830999999995811,"",""
"173.194.43.3",80,"172.16.133.84",58509,2,120,8798,0,0,1,60,1,60,91.652965,0.00021500000001140052,"",""
"172.16.133.93",60748,"172.16.139.250",5440,12,1142,8799,0,0,12,1142,0,0,91.656417,0.004979999999989104,"",""
"172.16.133.54",64342,"173.194.43.43",443,35,5397,8800,0,0,18,1608,17,3789,91.661697,175.74883,73,172
"172.16.133.11",55172,"172.16.139.250",5440,12,1142,8801,0,0,12,1142,0,0,91.675924,0.0069179999999988695,1320612,0
"172.16.133.55",57612,"172.16.139.250",5440,10,1022,8802,0,0,10,1022,0,0,91.677449,0.00849200000000394,962788,0
"172.16.133.73",60703,"172.16.139.250",5440,10,1022,8803,0,0,10,1022,0,0,91.700769,0.005783000000008087,1413799,0
"172.16.133.53",54129,"172.16.139.250",5440,10,1022,8804,0,0,10,1022,0,0,91.703724,0.006444999999999368,1268580,0
"172.16.133.21",53221,"172.16.139.250",5440,10,1022,8805,0,0,10,1022,0,0,91.705881,0.008195999999998094,997559,0
"172.16.133.30",62651,"172.16.139.250",5440,10,1022,8806,0,0,10,1022,0,0,91.710222,0.007741999999993254,1056057,0
"172.16.133.25",63487,"172.16.139.250",5440,10,1022,8807,0,0,10,1022,0,0,91.717113,0.00503100000000245,1625124,0
"172.16.133.34",50469,"172.16.139.250",5440,10,1022,8808,0,0,10,1022,0,0,91.72753,0.004886999999996533,"",""
"172.16.133.54",64343,"74.125.226.193",443,39,11015,8809,0,0,20,2926,19,8089,91.729223,175.68100300000003,133,368
"172.16.133.97",59402,"172.16.139.250",5440,10,1022,8810,0,0,10,1022,0,0,91.73763,0.014621000000005324,559195,0
"172.16.133.33",57911,"172.16.139.250",5440,12,1142,8811,0,0,12,1142,0,0,91.810834,0.00624700000000189,1462461,0
"172.16.133.68",60761,"172.16.139.250",5440,10,1022,8812,0,0,10,1022,0,0,91.842493,0.005591999999992936,1462088,0
"172.16.133.63",53910,"107.22.18.198",443,322,178802,8813,0,0,209,134136,113,44666,91.849996,148.643365,7219,2403
"172.16.133.12",59807,"172.16.139.250",5440,10,1022,8814,0,0,10,1022,0,0,91.856553,0.006319999999988113,1293670,0
"172.16.133.63",53911,"172.16.139.250",5440,10,1022,8815,0,0,10,1022,0,0,91.867637,0.014842999999999051,550832,0
"172.16.133.66",53909,"172.16.139.250",5440,10,1022,8816,0,0,10,1022,0,0,91.881446,0.005441000000004692,1502664,0
"172.16.133.82",61377,"172.16.139.250",5440,10,1022,8817,0,0,10,1022,0,0,91.89392,0.01619800000000282,504753,0
"172.16.133.37",60655,"172.16.139.250",5440,10,1022,8818,0,0,10,1022,0,0,91.908115,0.01624999999999943,503138,0
"172.16.133.78",59238,"172.16.139.250",5440,10,1022,8819,0,0,10,1022,0,0,92.065081,0.030418999999994867,268779,0
"172.16.133.67",56016,"172.16.139.250",5440,10,1022,8820,0,0,10,1022,0,0,92.119025,0.00957800000000475,853622,0
"172.16.133.56",61460,"172.16.139.250",5440,12,1142,8821,0,0,12,1142,0,0,92.142252,0.005098000000003822,1792075,0
"172.16.133.54",64344,"173.194.43.47",443,34,5416,8822,0,0,18,1598,16,3818,92.143424,178.221988,71,171
"172.16.133.21",53222,"64.74.80.187",443,7,432,8823,0,0,5,312,2,120,92.160362,3.066763999999992,813,313
"172.16.133.49",55815,"68.64.24.250",443,7,432,8824,0,0,5,312,2,120,92.163519,3.1265929999999997,798,307
"172.16.133.21",53223,"67.217.65.244",443,7,432,8825,0,0,5,312,2,120,92.174337,3.073194000000001,812,312
"172.16.133.42",57157,"172.16.139.250",5440,12,1142,8826,0,0,12,1142,0,0,92.19247,0.01563600000000065,584292,0
"172.16.133.41",53050,"172.16.139.250",5440,12,1142,8827,0,0,12,1142,0,0,92.197525,0.007253000000005727,1259616,0
"172.16.133.85",52303,"172.16.139.250",5440,12,1142,8828,0,0,12,1142,0,0,92.214769,0.015219999999999345,600262,0
"172.16.133.43",57813,"172.16.139.250",5440,12,1142,8829,0,0,12,1142,0,0,92.26741,0.006293999999996913,1451541,0
"172.16.133.13",53069,"172.16.139.250",5440,12,1142,8830,0,0,12,1142,0,0,92.286644,0.0064569999999974925,1414898,0
"172.16.133.20",62425,"172.16.139.250",5440,12,1142,8831,0,0,12,1142,0,0,92.335,0.007855000000006385,1163080,0
"172.16.133.57",60600,"216.219.113.250",443,6,378,8832,0,0,4,258,2,120,92.338828,0.18930299999999534,10903,5071
"172.16.133.57",60601,"216.115.223.200",443,6,378,8833,0,0,4,258,2,120,92.339296,0.08627799999999297,23922,11126
"172.16.133.57",60602,"67.217.64.244",443,6,378,8834,0,0,4,258,2,120,92.339297,0.04960699999999463,41607,19352
"172.16.133.57",60603,"66.151.150.190",443,6,378,8835,0,0,4,258,2,120,92.339299,0.17856199999999944,11559,5376
"172.16.133.75",50989,"172.16.139.250",5440,12,1142,8836,0,0,12,1142,0,0,92.352559,0.006226999999995542,1467159,0
"172.16.133.49",55816,"78.108.118.250",443,6,366,8837,0,0,4,246,2,120,92.353676,0.19130400000000236,10287,5018
"172.16.133.28",65461,"172.16.139.250",5440,10,1022,8838,0,0,10,1022,0,0,92.365632,0.016137999999997987,506630,0
"172.16.133.49",55817,"216.219.118.244",443,6,366,8839,0,0,4,246,2,120,92.387483,0.20067899999999383,9806,4783
"172.16.133.99",56074,"172.16.139.250",5440,10,1022,8840,0,0,10,1022,0,0,92.393268,0.014694999999989022,556379,0
"172.16.133.54",64345,"74.125.226.207",443,29,2732,8841,0,0,15,1533,14,1199,92.395058,176.000356,69,54
"172.16.133.87",60238,"172.16.139.250",5440,10,1022,8842,0,0,10,1022,0,0,92.415672,0.005313000000001011,1538866,0
"172.16.133.35",50004,"172.16.139.250",5440,12,1142,8843,0,0,12,1142,0,0,92.42638,0.028734000000000037,317950,0
"172.16.133.116",53463,"172.16.139.250",5440,10,1022,8844,0,0,10,1022,0,0,92.430048,0.004787000000007424,"",""
"172.16.133.116",53464,"172.16.139.250",5440,12,1142,8845,0,0,12,1142,0,0,92.435688,0.009164999999995871,996835,0
"172.16.133.116",53465,"172.16.139.250",5440,12,1142,8846,0,0,12,1142,0,0,92.446344,0.007294999999999163,1252364,0
"172.16.133.84",58823,"172.16.139.250",5440,10,1022,8847,0,0,10,1022,0,0,92.453242,0.015286000000003241,534868,0
"172.16.133.78",59239,"172.16.128.169",8014,21,7210,8848,0,0,11,4078,10,3132,92.506398,38.53405099999999,846,650
"172.16.133.49",55818,"172.16.139.250",5440,12,1142,8849,0,0,12,1142,0,0,92.529904,0.006320999999999799,1445340,0
"172.16.133.95",57000,"172.16.139.250",5440,10,1022,8850,0,0,10,1022,0,0,92.568149,0.015343999999998914,532846,0
"172.16.133.92",57713,"172.16.139.250",5440,12,1142,8851,0,0,12,1142,0,0,92.595694,0.006011999999998352,1519627,0
"172.16.133.54",64346,"173.194.43.41",443,33,5350,8852,0,0,17,1532,16,3818,92.606086,175.79116199999999,69,173
"172.16.133.29",60967,"172.16.139.250",5440,12,1142,8853,0,0,12,1142,0,0,92.612574,0.005407000000005269,1689661,0
"172.16.133.44",64866,"172.16.139.250",5440,12,1142,8854,0,0,12,1142,0,0,92.620953,0.016101000000006138,567418,0
"172.16.133.207",55964,"172.16.139.250",5440,12,1142,8855,0,0,12,1142,0,0,92.644755,0.005112999999994372,1786817,0
"172.16.133.83",57122,"172.16.139.250",5440,12,1142,8856,0,0,12,1142,0,0,92.655139,0.014589000000000851,626225,0
"172.16.133.93",60749,"172.16.139.250",5440,12,1142,8857,0,0,12,1142,0,0,92.670444,0.015923000000000798,573761,0
"172.16.133.11",55173,"172.16.139.250",5440,12,1142,8858,0,0,12,1142,0,0,92.687542,0.01625900000000513,561904,0
"172.16.133.55",57613,"172.16.139.250",5440,10,1022,8859,0,0,10,1022,0,0,92.693417,0.015354999999999563,532464,0
"172.16.133.73",60704,"172.16.139.250",5440,10,1022,8860,0,0,10,1022,0,0,92.715897,0.006579999999999586,1242553,0
"172.16.133.53",54130,"172.16.139.250",5440,10,1022,8861,0,0,10,1022,0,0,92.717754,0.008031000000002564,1018055,0
"172.16.133.21",53224,"172.16.139.250",5440,12,1142,8862,0,0,12,1142,0,0,92.719613,0.010409000000009883,877701,0
"172.16.133.30",62652,"172.16.139.250",5440,12,1142,8863,0,0,12,1142,0,0,92.723844,0.02286399999999844,399580,0
"172.16.133.25",63488,"172.16.139.250",5440,12,1142,8864,0,0,12,1142,0,0,92.732342,0.004955999999992855,"",""
"172.16.133.34",50470,"172.16.139.250",5440,12,1142,8865,0,0,12,1142,0,0,92.74171,0.008956999999995219,1019984,0
"172.16.133.97",59403,"172.16.139.250",5440,10,1022,8866,0,0,10,1022,0,0,92.752101,0.015385000000009086,531426,0
"172.16.133.33",57912,"172.16.139.250",5440,10,1022,8867,0,0,10,1022,0,0,92.826348,0.005594000000002097,1461565,0
"172.16.133.68",60762,"172.16.139.250",5440,10,1022,8868,0,0,10,1022,0,0,92.856972,0.01593099999999481,513213,0
"172.16.133.12",59808,"172.16.139.250",5440,10,1022,8869,0,0,10,1022,0,0,92.871589,0.005700000000004479,1434385,0
"172.16.133.63",53912,"172.16.139.250",5440,10,1022,8870,0,0,10,1022,0,0,92.879994,0.014801000000005615,552395,0
"172.16.133.66",53910,"172.16.139.250",5440,10,1022,8871,0,0,10,1022,0,0,92.895851,0.005347000000000435,1529081,0
"172.16.133.82",61378,"172.16.139.250",5440,10,1022,8872,0,0,10,1022,0,0,92.907271,0.01470199999999977,556114,0
"172.16.133.37",60656,"172.16.139.250",5440,12,1142,8873,0,0,12,1142,0,0,92.922211,0.007264999999989641,1257536,0
"172.16.133.78",59240,"172.16.139.250",5440,10,1022,8874,0,0,10,1022,0,0,93.078327,0.027062999999998283,302109,0
"172.16.133.67",56017,"172.16.139.250",5440,10,1022,8875,0,0,10,1022,0,0,93.133052,0.0058109999999942374,1406986,0
"172.16.133.56",61461,"172.16.139.250",5440,12,1142,8876,0,0,12,1142,0,0,93.155846,0.0050420000000030996,1811979,0
"172.16.133.42",57158,"172.16.139.250",5440,12,1142,8877,0,0,12,1142,0,0,93.210045,0.02911100000000033,313833,0
"172.16.133.41",53051,"172.16.139.250",5440,10,1022,8878,0,0,10,1022,0,0,93.2113,0.006249000000011051,1308369,0
"172.16.133.55",57614,"173.201.252.207",80,10,636,8879,0,0,6,378,4,258,93.215942,14.320465999999996,211,144
"172.16.133.55",57615,"173.201.252.207",80,11,1874,8880,0,0,6,982,5,892,93.216164,4.3166769999999985,1819,1653
"172.16.133.85",52304,"172.16.139.250",5440,10,1022,8881,0,0,10,1022,0,0,93.228336,0.01060700000000736,770811,0
"172.16.133.43",57814,"172.16.139.250",5440,10,1022,8882,0,0,10,1022,0,0,93.281905,0.005417000000008443,1509322,0
"172.16.133.13",53070,"172.16.139.250",5440,10,1022,8883,0,0,10,1022,0,0,93.299471,0.005349000000009596,1528510,0
"172.16.139.250",4191,"69.42.109.196",443,2,120,8884,0,0,1,60,1,60,93.33915,0.06674399999999991,7191,7191
"172.16.133.20",62426,"172.16.139.250",5440,12,1142,8885,0,0,12,1142,0,0,93.350487,0.23415500000000122,39016,0
"172.16.133.109",59711,"96.43.146.176",443,23,7303,8886,0,0,13,1499,10,5804,93.363848,0.24149799999999289,49656,192266
"172.16.133.75",50990,"172.16.139.250",5440,10,1022,8887,0,0,10,1022,0,0,93.368315,0.2206510000000037,37053,0
"172.16.133.28",65462,"172.16.139.250",5440,10,1022,8888,0,0,10,1022,0,0,93.37982,0.2127710000000036,38426,0
"172.16.133.99",56075,"172.16.139.250",5440,12,1142,8889,0,0,12,1142,0,0,93.406505,0.19124300000000005,47771,0
"172.16.133.55",57616,"69.59.149.117",80,14,2741,8890,0,0,8,1449,6,1292,93.416593,149.089927,77,69
"172.16.133.55",57617,"69.59.149.117",80,6,372,8891,0,0,3,186,3,186,93.41686,14.114360000000005,105,105
"172.16.133.55",57618,"69.59.149.117",80,6,372,8892,0,0,3,186,3,186,93.41707,14.114254000000003,105,105
"172.16.133.55",57619,"173.194.43.36",80,19,4413,8893,0,0,11,3163,8,1250,93.41904099999999,201.06935800000002,125,49
"172.16.133.55",57620,"173.194.43.36",80,6,372,8894,0,0,4,246,2,126,93.419275,14.048206000000008,140,71
"172.16.133.55",57621,"173.194.43.36",80,19,4413,8895,0,0,11,3163,8,1250,93.41948,201.07943000000003,125,49
"172.16.133.55",57622,"173.194.43.57",80,6,372,8896,0,0,4,246,2,126,93.421072,14.047390000000007,140,71
"172.16.133.55",57623,"173.194.43.57",80,18,4159,8897,0,0,10,1956,8,2203,93.421239,201.07786699999997,77,87
"172.16.133.55",57624,"173.194.43.57",80,6,372,8898,0,0,4,246,2,126,93.4214,14.046158999999989,140,71
"172.16.133.87",60239,"172.16.139.250",5440,12,1142,8899,0,0,12,1142,0,0,93.429886,0.17215900000000772,53067,0
"172.16.133.35",50005,"172.16.139.250",5440,12,1142,8900,0,0,12,1142,0,0,93.442529,0.18731100000000822,48774,0
"172.16.133.116",53466,"172.16.139.250",5440,10,1022,8901,0,0,10,1022,0,0,93.444106,0.1267429999999905,64508,0
"172.16.133.55",57625,"72.32.11.141",80,5,312,8902,0,0,3,186,2,126,93.463547,14.047517,105,71
"172.16.133.55",57626,"72.32.11.141",80,5,312,8903,0,0,3,186,2,126,93.463854,14.047154000000006,105,71
"172.16.133.55",57627,"204.13.194.137",80,7,432,8904,0,0,4,246,3,186,93.465101,14.001402999999996,140,106
"172.16.133.55",57628,"204.13.194.137",80,7,432,8905,0,0,4,246,3,186,93.465551,14.001471999999993,140,106
"172.16.133.55",57629,"204.13.194.137",80,18,8609,8906,0,0,9,4562,9,4047,93.46619,14.000132000000008,2606,2312
"172.16.133.55",57630,"173.201.252.207",80,38,20245,8907,0,0,18,10202,20,10043,93.46644,14.077075999999991,5797,5707
"172.16.133.55",57631,"173.201.252.207",80,40,23177,8908,0,0,17,7681,23,15496,93.46666,14.067634999999996,4368,8812
"172.16.133.55",57632,"173.201.252.207",80,51,32101,8909,0,0,23,10854,28,21247,93.466878,14.075688,6168,12075
"172.16.133.55",57633,"173.201.252.207",80,33,15825,8910,0,0,17,9364,16,6461,93.467098,14.075574000000003,5322,3672
"172.16.133.55",57634,"173.201.252.207",80,31,12537,8911,0,0,16,9210,15,3327,93.467312,14.075007,5234,1891
"172.16.133.84",58824,"172.16.139.250",5440,12,1142,8912,0,0,12,1142,0,0,93.467313,0.10907399999999257,83759,0
"172.16.133.55",57635,"173.201.252.207",80,14,5031,8913,0,0,7,1141,7,3890,93.467525,14.068965000000006,648,2211
"172.16.133.55",57636,"72.32.20.62",80,7,432,8914,0,0,4,246,3,186,93.467764,14.043105999999995,140,105
"172.16.133.55",57637,"72.32.20.62",80,12,6177,8915,0,0,6,1952,6,4225,93.467979,3.9886609999999934,3915,8474
"172.16.133.55",57638,"174.35.22.19",80,7,432,8916,0,0,4,246,3,186,93.468211,13.998584000000008,140,106
"172.16.133.55",57639,"174.35.22.19",80,7,432,8917,0,0,4,246,3,186,93.468421,13.998722999999998,140,106
"172.16.133.55",57640,"98.139.225.43",80,7,432,8918,0,0,4,246,3,186,93.468653,14.018912,140,106
"172.16.133.55",57641,"98.139.225.43",80,7,432,8919,0,0,4,246,3,186,93.468875,14.016199,140,106
"172.16.133.55",57642,"75.125.82.68",80,7,2198,8920,0,0,4,639,3,1559,93.497897,34.687858000000006,147,359
"172.16.133.55",57643,"75.125.82.68",80,5,312,8921,0,0,3,186,2,126,93.498117,14.026425000000003,106,71
"172.16.139.250",4193,"69.42.109.196",443,2,120,8922,0,0,1,60,1,60,93.538343,0.06569799999999759,7306,7306
"172.16.139.250",4204,"69.42.109.196",443,18,5664,8923,0,0,9,1359,9,4305,93.539091,120.082477,90,286
"172.16.133.49",55819,"172.16.139.250",5440,10,1022,8924,0,0,10,1022,0,0,93.544092,0.036142999999995595,226212,0
"172.16.133.109",38619,"96.43.146.176",443,23,7071,8925,0,0,13,1524,10,5547,93.563248,0.3602340000000055,33844,123186
"172.16.133.116",53467,"172.16.139.250",5440,12,1142,8926,0,0,12,1142,0,0,93.571904,0.043038999999993166,212272,0
"172.16.133.95",57001,"172.16.139.250",5440,12,1142,8927,0,0,12,1142,0,0,93.5824,0.03646399999999517,250548,0
"172.16.133.92",57714,"172.16.139.250",5440,10,1022,8928,0,0,10,1022,0,0,93.610471,0.012233999999992307,668301,0
"172.16.133.116",53468,"172.16.139.250",5440,10,1022,8929,0,0,10,1022,0,0,93.616244,0.012035000000011564,679351,0
"172.16.133.29",60968,"172.16.139.250",5440,10,1022,8930,0,0,10,1022,0,0,93.62828,0.006289999999992801,1299841,0
"172.16.133.44",64867,"172.16.139.250",5440,12,1142,8931,0,0,12,1142,0,0,93.633538,0.005225999999993292,1748182,0
"172.16.133.207",55965,"172.16.139.250",5440,12,1142,8932,0,0,12,1142,0,0,93.65867,0.019470999999995797,469210,0
"172.16.133.83",57123,"172.16.139.250",5440,10,1022,8933,0,0,10,1022,0,0,93.667825,0.005105000000000359,1601567,0
"172.16.133.93",60750,"172.16.139.250",5440,10,1022,8934,0,0,10,1022,0,0,93.684378,0.014689000000004171,556606,0
"172.16.133.11",55174,"172.16.139.250",5440,10,1022,8935,0,0,10,1022,0,0,93.701632,0.015298999999998841,534414,0
"172.16.133.55",57644,"172.16.139.250",5440,10,1022,8936,0,0,10,1022,0,0,93.705586,0.015077000000005114,542282,0
"172.16.133.73",60705,"172.16.139.250",5440,12,1142,8937,0,0,12,1142,0,0,93.729784,0.006239000000007877,1464337,0
"172.16.133.53",54131,"172.16.139.250",5440,12,1142,8938,0,0,12,1142,0,0,93.731978,0.008302000000000476,1100457,0
"172.16.133.21",53225,"172.16.139.250",5440,10,1022,8939,0,0,10,1022,0,0,93.733731,0.010401999999999134,786002,0
"172.16.133.30",62653,"172.16.139.250",5440,10,1022,8940,0,0,10,1022,0,0,93.737831,0.009668000000004895,845676,0
"172.16.133.25",63489,"172.16.139.250",5440,12,1142,8941,0,0,12,1142,0,0,93.745966,0.014685999999997534,622089,0
"172.16.133.68",60764,"216.219.113.250",443,6,366,8942,0,0,4,246,2,120,93.754993,0.25030499999999734,7862,3835
"172.16.133.68",60765,"67.217.64.244",443,6,366,8943,0,0,4,246,2,120,93.754995,0.1603330000000085,12274,5987
"172.16.133.34",50471,"172.16.139.250",5440,12,1142,8944,0,0,12,1142,0,0,93.755333,0.016111000000009312,567065,0
"172.16.133.68",60766,"216.115.223.200",443,6,366,8945,0,0,4,246,2,120,93.756705,0.16825599999999952,11696,5705
"172.16.133.68",60767,"66.151.150.190",443,6,366,8946,0,0,4,246,2,120,93.756769,0.24582699999999136,8005,3905
"172.16.133.97",59404,"172.16.139.250",5440,12,1142,8947,0,0,12,1142,0,0,93.765621,0.01722300000000132,530453,0
"172.16.133.33",57913,"172.16.139.250",5440,12,1142,8948,0,0,12,1142,0,0,93.839512,0.009625999999997248,949096,0
"172.16.133.109",33979,"96.43.146.176",443,25,8037,8949,0,0,14,1575,11,6462,93.864729,0.23638700000000767,53302,218692
"172.16.133.68",60768,"172.16.139.250",5440,12,1142,8950,0,0,12,1142,0,0,93.870415,0.015337000000002377,595683,0
"172.16.133.12",59809,"172.16.139.250",5440,12,1142,8951,0,0,12,1142,0,0,93.884691,0.0062590000000000146,1459658,0
"172.16.133.63",53913,"172.16.139.250",5440,10,1022,8952,0,0,10,1022,0,0,93.895572,0.015655999999992787,522227,0
"172.16.133.66",53911,"172.16.139.250",5440,10,1022,8953,0,0,10,1022,0,0,93.909443,0.005986000000007152,1365853,0
"172.16.133.82",61379,"172.16.139.250",5440,12,1142,8954,0,0,12,1142,0,0,93.921481,0.0063140000000032614,1446943,0
"172.16.133.37",60657,"172.16.139.250",5440,12,1142,8955,0,0,12,1142,0,0,93.935037,0.006404000000003407,1426608,0
"172.16.133.54",64347,"173.194.75.104",80,106,75628,8956,0,0,48,23192,58,52436,93.951477,172.28405299999997,1076,2434
"172.16.133.109",37935,"96.43.146.176",443,23,7373,8957,0,0,13,1504,10,5869,94.060578,0.23991699999999128,50150,195701
"172.16.133.78",59241,"172.16.139.250",5440,10,1022,8958,0,0,10,1022,0,0,94.09237,0.005786999999997988,1412821,0
"172.16.133.48",60519,"184.73.197.44",443,17,5459,8959,0,0,9,2021,8,3438,94.103717,14.324876000000003,1128,1920
"172.16.133.67",56018,"172.16.139.250",5440,10,1022,8960,0,0,10,1022,0,0,94.146313,0.0052349999999989905,1561795,0
"172.16.133.54",64348,"12.130.48.50",80,64,40682,8961,0,0,27,4504,37,36178,94.149789,14.690897000000007,2452,19700
"172.16.133.56",61462,"172.16.139.250",5440,10,1022,8962,0,0,10,1022,0,0,94.170339,0.00501800000000685,1629334,0
"172.16.133.42",57159,"172.16.139.250",5440,12,1142,8963,0,0,12,1142,0,0,94.222061,0.01862599999999759,490497,0
"172.16.133.41",53052,"172.16.139.250",5440,10,1022,8964,0,0,10,1022,0,0,94.225638,0.007322999999999524,1116482,0
"172.16.133.47",56558,"173.194.43.41",80,10,2454,8965,0,0,6,1283,4,1171,94.234881,118.008287,86,79
"172.16.133.85",52305,"172.16.139.250",5440,10,1022,8966,0,0,10,1022,0,0,94.242779,0.00563700000000722,1450416,0
"172.16.133.109",42881,"96.43.146.176",443,23,7486,8967,0,0,13,1504,10,5982,94.253041,0.22467400000000737,53553,213001
"172.16.133.54",64349,"12.130.48.50",80,102,81594,8968,0,0,39,4961,63,76633,94.282873,14.560707000000008,2725,42103
"172.16.133.54",64350,"12.130.48.50",80,109,90288,8969,0,0,40,4713,69,85575,94.283345,14.560440999999997,2589,47017
"172.16.133.54",64351,"12.130.48.50",80,196,175421,8970,0,0,68,6880,128,168541,94.284138,14.559788999999995,3780,92606
"172.16.133.54",64352,"12.130.48.50",80,116,99184,8971,0,0,42,4863,74,94321,94.284383,14.55965599999999,2672,51825
"172.16.133.54",64353,"12.130.48.50",80,108,90376,8972,0,0,38,4549,70,85827,94.285254,14.184902000000008,2565,48404
"172.16.133.43",57815,"172.16.139.250",5440,10,1022,8973,0,0,10,1022,0,0,94.295501,0.016205999999996834,504504,0
"172.16.133.47",56559,"173.194.43.8",80,22,13056,8974,0,0,11,3321,11,9735,94.297793,117.94424300000001,225,660
"172.16.133.13",53071,"172.16.139.250",5440,12,1142,8975,0,0,12,1142,0,0,94.313448,0.015281000000001654,597866,0
"172.16.133.54",64354,"23.62.104.251",80,33,25783,8976,0,0,14,2136,19,23647,94.319138,123.897676,137,1526
"172.16.133.54",64355,"12.130.48.51",80,41,22770,8977,0,0,19,2531,22,20239,94.32272,7.579663999999994,2671,21361
"172.16.133.54",64356,"12.130.48.51",80,28,13304,8978,0,0,13,3038,15,10266,94.322899,15.060442999999992,1613,5453
"172.16.133.54",64357,"23.62.104.251",80,6,372,8979,0,0,4,246,2,126,94.323039,5.473452000000009,359,184
"172.16.133.54",64358,"208.47.254.81",80,11,1806,8980,0,0,6,1258,5,548,94.329254,63.99960900000001,157,68
"172.16.133.54",64359,"208.47.254.81",80,51,22183,8981,0,0,31,18164,20,4019,94.329481,132.08810899999997,1100,243
"172.16.133.54",64360,"75.98.93.51",80,24,9698,8982,0,0,11,2885,13,6813,94.330477,117.926625,195,462
"172.16.133.54",64361,"75.98.93.51",80,5,312,8983,0,0,3,186,2,126,94.355278,5.484553000000005,271,183
"172.16.133.57",60604,"67.217.64.244",443,6,378,8984,0,0,4,258,2,120,94.363366,0.052491000000003396,39321,18288
"172.16.133.20",62427,"172.16.139.250",5440,12,1142,8985,0,0,12,1142,0,0,94.363561,0.004936999999998193,"",""
"172.16.133.57",60605,"216.115.223.200",443,6,378,8986,0,0,4,258,2,120,94.37973,0.08002400000000875,25792,11996
"172.16.133.75",50991,"172.16.139.250",5440,10,1022,8987,0,0,10,1022,0,0,94.381072,0.014579999999995152,560768,0
"172.16.133.28",65463,"172.16.139.250",5440,10,1022,8988,0,0,10,1022,0,0,94.393339,0.014618999999996163,559272,0
"172.16.133.99",56076,"172.16.139.250",5440,12,1142,8989,0,0,12,1142,0,0,94.421213,0.00518300000000238,1762685,0
"172.16.133.109",56634,"23.33.81.213",443,42,26138,8990,0,0,19,1965,23,24173,94.429315,0.31192500000000223,50396,619969
"172.16.133.57",60606,"66.151.150.190",443,6,378,8991,0,0,4,258,2,120,94.429474,0.1908109999999965,10816,5031
"172.16.133.57",60607,"216.219.113.250",443,6,378,8992,0,0,4,258,2,120,94.432122,0.2051659999999913,10060,4679
"172.16.133.87",60240,"172.16.139.250",5440,10,1022,8993,0,0,10,1022,0,0,94.444848,0.005412000000006856,1510716,0
"172.16.133.35",50006,"172.16.139.250",5440,12,1142,8994,0,0,12,1142,0,0,94.455385,0.02721299999998905,335721,0
"172.16.133.116",53469,"172.16.139.250",5440,10,1022,8995,0,0,10,1022,0,0,94.458344,0.0048799999999999955,"",""
"172.16.133.116",53470,"172.16.139.250",5440,10,1022,8996,0,0,10,1022,0,0,94.464247,0.005465999999998417,1495792,0
"172.16.133.116",53471,"172.16.139.250",5440,10,1022,8997,0,0,10,1022,0,0,94.470538,0.019624999999990678,416611,0
"172.16.133.84",58825,"172.16.139.250",5440,10,1022,8998,0,0,10,1022,0,0,94.47997,0.005737000000010539,1425135,0
"172.16.133.49",55820,"172.16.139.250",5440,10,1022,8999,0,0,10,1022,0,0,94.557429,0.0055669999999992115,1468654,0
"172.16.133.68",60769,"157.55.145.210",443,13,2569,9000,0,0,6,1176,7,1393,94.580969,61.48395900000001,153,181
"172.16.133.95",57002,"172.16.139.250",5440,12,1142,9001,0,0,12,1142,0,0,94.59798,0.008463999999989369,1079395,0
"172.16.133.113",55629,"172.16.139.250",135,8,492,9002,0,0,8,492,0,0,94.611152,0.015097999999994727,260696,0
"172.16.133.92",57715,"172.16.139.250",5440,10,1022,9003,0,0,10,1022,0,0,94.624876,0.005819000000002461,1405052,0
"172.16.133.113",55630,"172.16.139.250",5462,10,696,9004,0,0,10,696,0,0,94.628359,0.5204449999999952,10698,0
"172.16.133.29",60969,"172.16.139.250",5440,10,1022,9005,0,0,10,1022,0,0,94.64123,0.005662000000000944,1444012,0
"172.16.133.44",64868,"172.16.139.250",5440,12,1142,9006,0,0,12,1142,0,0,94.647863,0.006090000000000373,1500164,0
"172.16.133.54",64362,"107.20.206.100",80,12,3186,9007,0,0,6,724,6,2462,94.668878,59.742710999999986,96,329
"172.16.133.54",64363,"107.20.206.100",80,6,372,9008,0,0,4,246,2,126,94.669121,5.102869999999996,385,197
"172.16.133.54",64364,"107.20.206.100",80,12,3082,9009,0,0,6,654,6,2428,94.669499,59.741894,87,325
"172.16.133.54",64365,"107.20.206.100",80,6,372,9010,0,0,4,246,2,126,94.669652,5.103251999999998,385,197
"172.16.133.207",55966,"172.16.139.250",5440,12,1142,9011,0,0,12,1142,0,0,94.672805,0.014439000000010083,632730,0
"172.16.133.83",57124,"172.16.139.250",5440,10,1022,9012,0,0,10,1022,0,0,94.682043,0.013779000000013752,593366,0
"172.16.133.93",60751,"172.16.139.250",5440,12,1142,9013,0,0,12,1142,0,0,94.698194,0.015057999999996241,606720,0
"172.16.133.55",57645,"172.16.128.169",8014,9,1412,9014,0,0,6,1050,3,362,94.699458,10.211766999999995,822,283
"172.16.133.29",60970,"208.47.254.83",80,6,372,9015,0,0,4,246,2,126,94.71048,16.395478999999995,120,61
"172.16.133.29",60971,"64.94.107.46",80,7,428,9016,0,0,4,246,3,182,94.710658,16.393476000000007,120,88
"172.16.133.29",60972,"64.94.107.46",80,7,428,9017,0,0,4,246,3,182,94.710804,16.39352600000001,120,88
"172.16.133.29",60973,"23.0.49.244",80,7,432,9018,0,0,4,246,3,186,94.711202,16.400268999999994,119,90
"172.16.133.29",60974,"23.0.49.244",80,6,372,9019,0,0,4,246,2,126,94.711353,16.401935999999992,119,61
"172.16.133.29",60975,"216.52.242.80",80,6,372,9020,0,0,4,246,2,126,94.71154,16.480720000000005,119,61
"172.16.133.29",60976,"208.111.161.254",80,8,492,9021,0,0,4,246,4,246,94.713968,16.39664300000001,120,120
"172.16.133.29",60977,"208.111.161.254",80,8,492,9022,0,0,4,246,4,246,94.714161,16.396451999999996,120,120
"172.16.133.29",60978,"208.111.161.254",80,8,492,9023,0,0,4,246,4,246,94.71433999999999,16.396043000000006,120,120
"172.16.133.29",60979,"208.111.161.254",80,8,492,9024,0,0,4,246,4,246,94.714467,16.395917999999995,120,120
"172.16.133.11",55175,"172.16.139.250",5440,10,1022,9025,0,0,10,1022,0,0,94.71561,0.005617000000000871,1455581,0
"172.16.133.55",57646,"172.16.139.250",5440,10,1022,9026,0,0,10,1022,0,0,94.719595,0.01538200000000245,531530,0
"172.16.133.109",55916,"23.33.81.213",443,53,38288,9027,0,0,23,2261,30,36027,94.723019,0.2823990000000123,64051,1020598
"172.16.133.73",60706,"172.16.139.250",5440,10,1022,9028,0,0,10,1022,0,0,94.742838,0.009374999999991473,872106,0
"172.16.133.53",54132,"172.16.139.250",5440,10,1022,9029,0,0,10,1022,0,0,94.744672,0.011425000000002683,715623,0
"172.16.133.21",53226,"172.16.139.250",5440,10,1022,9030,0,0,10,1022,0,0,94.747887,0.01647799999999222,496176,0
"172.16.133.30",62654,"172.16.139.250",5440,10,1022,9031,0,0,10,1022,0,0,94.753111,0.007292999999990002,1121075,0
"172.16.133.25",63490,"172.16.139.250",5440,12,1142,9032,0,0,12,1142,0,0,94.758766,0.015374000000008436,594250,0
"172.16.133.54",64366,"54.235.184.94",80,15,3218,9033,0,0,8,1621,7,1597,94.769112,118.179315,109,108
"172.16.133.54",64367,"54.235.184.94",80,12,2117,9034,0,0,6,833,6,1284,94.769365,59.18714600000001,112,173
"172.16.133.34",50472,"172.16.139.250",5440,10,1022,9035,0,0,10,1022,0,0,94.769506,0.008332999999993262,981159,0
"172.16.133.97",59405,"172.16.139.250",5440,12,1142,9036,0,0,12,1142,0,0,94.778776,0.006128000000003908,1490861,0
"172.16.133.29",60980,"72.32.20.63",80,9,1419,9037,0,0,5,975,4,444,94.782925,0.33603899999999953,23211,10570
"172.16.133.54",64368,"173.204.219.5",80,10,2877,9038,0,0,6,1805,4,1072,94.791489,0.16881899999999916,85535,50799
"172.16.133.54",64369,"216.52.121.177",80,9,1329,9039,0,0,5,718,4,611,94.793056,0.16898699999998712,33990,28925
"172.16.133.54",64370,"23.21.118.18",80,65,43724,9040,0,0,33,12486,32,31238,94.793983,116.50044600000001,857,2145
"172.16.133.54",64371,"54.235.184.94",80,6,372,9041,0,0,4,246,2,126,94.813134,5.954357000000002,330,169
"172.16.133.54",64372,"23.21.118.18",80,12,1992,9042,0,0,6,1072,6,920,94.813607,60.471489000000005,141,121
"172.16.133.54",64373,"216.52.121.177",80,9,1992,9043,0,0,5,1417,4,575,94.813773,4.185872000000003,2708,1098
"172.16.133.54",64374,"173.204.219.5",80,8,2079,9044,0,0,5,1067,3,1012,94.813937,0.6254470000000083,13647,12944
"172.16.133.29",60981,"23.62.193.244",80,7,432,9045,0,0,4,246,3,186,94.819249,16.315008000000006,120,91
"172.16.133.29",60982,"23.62.193.244",80,8,504,9046,0,0,5,312,3,192,94.819352,16.315759,152,94
"172.16.133.132",40029,"96.43.146.22",443,811,765916,9047,0,0,277,41100,534,724816,94.842845,45.42130999999999,7238,127660
"172.16.133.54",64375,"204.13.194.136",80,45,21303,9048,0,0,21,10649,24,10654,94.846441,21.090176,4039,4041
"172.16.133.33",57914,"172.16.139.250",5440,10,1022,9049,0,0,10,1022,0,0,94.853105,0.00549999999999784,1486545,0
"172.16.133.68",60770,"172.16.139.250",5440,10,1022,9050,0,0,10,1022,0,0,94.884287,0.0054980000000028895,1487086,0
"172.16.133.55",57647,"173.194.74.95",80,12,2156,9051,0,0,5,683,7,1473,94.893119,0.10607699999999909,51509,111089
"172.16.133.12",59810,"172.16.139.250",5440,12,1142,9052,0,0,12,1142,0,0,94.898669,0.00624700000000189,1462461,0
"172.16.133.63",53914,"172.16.139.250",5440,10,1022,9053,0,0,10,1022,0,0,94.909314,0.015509000000008655,527177,0
"172.16.133.54",64376,"204.13.194.137",80,6,372,9054,0,0,4,246,2,126,94.911288,5.851968999999997,336,172
"172.16.133.54",64377,"107.21.214.225",80,41,17678,9055,0,0,24,10752,17,6926,94.916429,122.199331,703,453
"172.16.133.29",60983,"173.194.43.60",80,6,372,9056,0,0,4,246,2,126,94.916484,16.188645000000008,121,62
"172.16.133.29",60984,"173.194.43.60",80,6,372,9057,0,0,4,246,2,126,94.917246,16.187884999999994,121,62
"172.16.133.66",53912,"172.16.139.250",5440,10,1022,9058,0,0,10,1022,0,0,94.923868,0.005989999999997053,1364941,0
"172.16.133.82",61380,"172.16.139.250",5440,10,1022,9059,0,0,10,1022,0,0,94.935508,0.005509000000003539,1484116,0
"172.16.133.54",64378,"107.21.214.225",80,40,16838,9060,0,0,23,11092,17,5746,94.946272,117.179877,757,392
"172.16.133.37",60658,"172.16.139.250",5440,10,1022,9061,0,0,10,1022,0,0,94.949222,0.00536299999998846,1524519,0
"172.16.133.54",64379,"107.22.214.3",80,26,7343,9062,0,0,16,4013,10,3330,94.949289,116.98914200000002,274,227
"172.16.133.54",64380,"107.22.214.3",80,6,372,9063,0,0,4,246,2,126,94.949472,5.819496000000001,338,173
"172.16.133.54",64381,"173.194.43.60",80,28,15105,9064,0,0,13,3758,15,11347,95.051981,118.13228099999999,254,768
"172.16.133.78",59242,"172.16.139.250",5440,10,1022,9065,0,0,10,1022,0,0,95.107351,0.00561300000001097,1456618,0
"172.16.133.67",56019,"172.16.139.250",5440,10,1022,9066,0,0,10,1022,0,0,95.160076,0.005567999999996687,1468390,0
"172.16.133.101",51138,"96.43.146.149",443,19,4790,9067,0,0,11,3876,8,914,95.167138,116.044554,267,63
"172.16.133.56",61463,"172.16.139.250",5440,12,1142,9068,0,0,12,1142,0,0,95.183836,0.01551200000000108,588963,0
"172.16.133.41",53053,"172.16.139.250",5440,12,1142,9069,0,0,12,1142,0,0,95.238496,0.015359000000003675,594830,0
"172.16.133.42",57160,"172.16.139.250",5440,12,1142,9070,0,0,12,1142,0,0,95.254106,0.18083700000001102,50520,0
"172.16.133.85",52306,"172.16.139.250",5440,12,1142,9071,0,0,12,1142,0,0,95.257063,0.006310999999996625,1447631,0
"172.16.133.54",64382,"74.125.226.218",80,65,25935,9072,0,0,41,14220,24,11715,95.276844,164.93249200000002,689,568
"172.16.133.43",57816,"172.16.139.250",5440,10,1022,9073,0,0,10,1022,0,0,95.311222,0.00565399999999272,1446055,0
"172.16.133.54",64383,"108.170.193.53",80,11,3700,9074,0,0,6,2181,5,1519,95.325566,0.25092600000000687,69534,48428
"172.16.133.54",64384,"108.170.193.53",80,12,4161,9075,0,0,7,2642,5,1519,95.325772,0.7726619999999969,27354,15727
"172.16.133.54",64385,"108.170.193.53",80,12,3764,9076,0,0,6,2181,6,1583,95.325931,0.26091000000000975,66873,48537
"172.16.133.54",64386,"108.170.193.53",80,11,3700,9077,0,0,6,2181,5,1519,95.326056,0.2602100000000007,67053,46700
"172.16.133.54",64387,"108.170.193.53",80,11,3705,9078,0,0,6,2182,5,1523,95.326371,0.26028700000000526,67064,46809
"172.16.133.54",64388,"108.170.193.53",80,11,3704,9079,0,0,6,2181,5,1523,95.326519,0.26020499999999913,67054,46824
"172.16.133.54",64389,"50.116.194.23",80,6,366,9080,0,0,4,246,2,120,95.326979,5.456237999999999,360,175
"172.16.133.54",64390,"50.116.194.23",80,11,1561,9081,0,0,6,838,5,723,95.32714,5.195549,1290,1113
"172.16.133.54",64391,"204.144.141.26",80,8,2543,9082,0,0,4,918,4,1625,95.327288,92.72431000000002,79,140
"172.16.133.54",64392,"204.144.141.26",80,7,432,9083,0,0,4,246,3,186,95.327438,5.483847999999995,358,271
"172.16.133.13",53072,"172.16.139.250",5440,10,1022,9084,0,0,10,1022,0,0,95.327933,0.005430000000004043,1505709,0
"172.16.133.54",64393,"74.121.142.248",80,11,1942,9085,0,0,6,1043,5,899,95.349618,5.187076999999988,1608,1386
"172.16.133.54",64394,"74.121.142.248",80,6,372,9086,0,0,4,246,2,126,95.349815,5.414435999999995,363,186
"172.16.133.54",64395,"208.71.125.131",80,6,366,9087,0,0,4,246,2,120,95.349963,5.418593999999999,363,177
"172.16.133.54",64396,"208.71.125.131",80,9,2085,9088,0,0,6,849,3,1236,95.350646,60.872145,111,162
"172.16.133.29",60985,"138.108.7.20",80,8,1722,9089,0,0,4,1064,4,658,95.361153,11.014949999999999,772,477
"172.16.133.29",60986,"64.94.107.11",80,8,1714,9090,0,0,5,1251,3,463,95.374129,0.17662500000000136,56662,20970
"172.16.133.20",62428,"172.16.139.250",5440,12,1142,9091,0,0,12,1142,0,0,95.378469,0.0048019999999979746,"",""
"172.16.133.54",64397,"23.13.208.74",80,25,7474,9092,0,0,16,5008,9,2466,95.392707,171.85601,233,114
"172.16.133.54",64398,"23.13.208.74",80,6,372,9093,0,0,4,246,2,126,95.394557,5.374164999999991,366,187
"172.16.133.75",50992,"172.16.139.250",5440,10,1022,9094,0,0,10,1022,0,0,95.395557,0.00532200000000671,1536264,0
"172.16.133.28",65464,"172.16.139.250",5440,10,1022,9095,0,0,10,1022,0,0,95.407524,0.005628000000001521,1452736,0
"172.16.133.99",56077,"172.16.139.250",5440,12,1142,9096,0,0,12,1142,0,0,95.436014,0.00524799999999459,1740853,0
"172.16.133.87",60242,"172.16.139.250",5440,10,1022,9097,0,0,10,1022,0,0,95.457885,0.005580999999992287,1464970,0
"172.16.133.35",50007,"172.16.139.250",5440,12,1142,9098,0,0,12,1142,0,0,95.470332,0.025682000000003313,355735,0
"172.16.133.116",53472,"172.16.139.250",5440,10,1022,9099,0,0,10,1022,0,0,95.472013,0.00565199999999777,1446567,0
"172.16.133.116",53473,"172.16.139.250",5440,10,1022,9100,0,0,10,1022,0,0,95.478615,0.008225999999993405,993921,0
"172.16.133.116",53474,"172.16.139.250",5440,10,1022,9101,0,0,10,1022,0,0,95.488178,0.005978999999996404,1367452,0
"172.16.133.84",58826,"172.16.139.250",5440,10,1022,9102,0,0,10,1022,0,0,95.494079,0.01449800000000323,563939,0
"172.16.133.54",64399,"173.194.43.58",80,34,13271,9103,0,0,22,9359,12,3912,95.498965,173.72891800000002,430,180
"172.16.133.54",64400,"173.194.43.58",80,31,11971,9104,0,0,20,8473,11,3498,95.512083,172.70905599999998,392,162
"172.16.133.54",64401,"108.170.193.53",80,11,3700,9105,0,0,6,2181,5,1519,95.51526,0.2234240000000085,78093,54389
"172.16.133.54",64402,"98.138.49.43",80,43,20540,9106,0,0,22,11265,21,9275,95.516755,37.80880499999999,2383,1962
"172.16.133.54",64403,"108.170.193.53",80,11,3704,9107,0,0,6,2181,5,1523,95.524577,0.21429799999999943,81419,56855
"172.16.133.54",64404,"98.138.49.43",80,43,20448,9108,0,0,22,11265,21,9183,95.524764,37.80185799999998,2384,1943
"172.16.133.54",64405,"108.170.193.53",80,11,3708,9109,0,0,6,2181,5,1527,95.527056,0.21202499999999702,82292,57615
"172.16.133.54",64406,"108.170.193.53",80,11,3700,9110,0,0,6,2181,5,1519,95.527528,0.21267799999999681,82039,57138
"172.16.133.54",64407,"98.138.49.43",80,43,20574,9111,0,0,22,11265,21,9309,95.527971,37.80057700000002,2384,1970
"172.16.133.54",64408,"108.170.193.53",80,11,3704,9112,0,0,6,2181,5,1523,95.528406,0.22926099999999394,76105,53144
"172.16.133.54",64409,"98.138.49.43",80,43,20619,9113,0,0,22,11280,21,9339,95.529904,37.796869,2387,1976
"172.16.133.54",64410,"98.138.49.43",80,43,20731,9114,0,0,22,11340,21,9391,95.530763,37.79491700000001,2400,1987
"172.16.133.54",64411,"98.138.49.43",80,56,28158,9115,0,0,28,14613,28,13545,95.530968,37.865928999999994,3087,2861
"172.16.133.54",64412,"23.15.128.66",80,6,372,9116,0,0,4,246,2,126,95.541593,5.227244999999996,376,192
"172.16.133.54",64413,"23.15.128.66",80,54,44626,9117,0,0,22,4327,32,40299,95.541824,164.671831,210,1957
"172.16.133.54",64414,"216.137.33.81",80,6,372,9118,0,0,4,246,2,126,95.542159,5.226889,376,192
"172.16.133.54",64415,"216.137.33.81",80,58,43417,9119,0,0,28,13255,30,30162,95.542358,169.726715,624,1421
"172.16.133.49",55821,"172.16.139.250",5440,10,1022,9120,0,0,10,1022,0,0,95.571102,0.007715000000004579,1059753,0
"172.16.133.54",64416,"208.71.125.1",443,18,6852,9121,0,0,8,1434,10,5418,95.57774,0.4354359999999957,26346,99541
"172.16.133.95",57003,"172.16.139.250",5440,10,1022,9122,0,0,10,1022,0,0,95.609266,0.005840999999989549,1399760,0
"172.16.133.92",57716,"172.16.139.250",5440,12,1142,9123,0,0,12,1142,0,0,95.636862,0.006707000000005792,1362158,0
"172.16.133.29",60987,"172.16.139.250",5440,10,1022,9124,0,0,10,1022,0,0,95.654715,0.006118000000000734,1336384,0
"172.16.133.44",64869,"172.16.139.250",5440,10,1022,9125,0,0,10,1022,0,0,95.660989,0.005234000000001515,1562094,0
"172.16.133.54",64417,"108.170.193.53",80,11,3704,9126,0,0,6,2181,5,1523,95.666877,0.18735300000000166,93129,65032
"172.16.133.54",64418,"108.170.193.53",80,11,3695,9127,0,0,6,2168,5,1527,95.671787,0.1967430000000121,88155,62091
"172.16.133.54",64419,"12.130.48.51",80,48,35462,9128,0,0,20,3913,28,31549,95.674302,13.709168000000005,2283,18410
"172.16.133.54",64420,"74.125.226.205",80,43,19608,9129,0,0,26,9888,17,9720,95.679612,172.54289899999998,458,450
"172.16.133.54",64421,"74.125.226.205",80,45,20431,9130,0,0,27,10030,18,10401,95.681516,172.54017600000003,465,482
"172.16.133.207",55967,"172.16.139.250",5440,12,1142,9131,0,0,12,1142,0,0,95.686976,0.014433999999994285,632949,0
"172.16.133.54",64422,"199.7.54.72",80,21,6572,9132,0,0,9,1470,12,5102,95.695588,116.556686,100,350
"172.16.133.83",57125,"172.16.139.250",5440,12,1142,9133,0,0,12,1142,0,0,95.695883,0.01406599999999969,649509,0
"172.16.133.132",40030,"96.43.146.22",443,39,17306,9134,0,0,23,8299,16,9007,95.703617,2.4696150000000046,26883,29177
"172.16.133.54",64423,"199.7.54.72",80,6,366,9135,0,0,4,246,2,120,95.704385,6.133087000000003,320,156
"172.16.133.54",64424,"173.194.43.45",80,38,16976,9136,0,0,23,8618,15,8358,95.704604,172.516885,399,387
"172.16.133.54",64425,"173.194.43.45",80,40,18368,9137,0,0,24,9329,16,9039,95.705813,172.51506199999997,432,419
"172.16.133.93",60752,"172.16.139.250",5440,10,1022,9138,0,0,10,1022,0,0,95.712292,0.004809999999991987,"",""
"172.16.133.54",64426,"173.194.43.45",80,42,18556,9139,0,0,26,9525,16,9031,95.720463,172.501712,441,418
"172.16.133.54",64427,"173.194.43.45",80,6,372,9140,0,0,4,246,2,126,95.728061,6.040796999999998,325,166
"172.16.133.11",55176,"172.16.139.250",5440,10,1022,9141,0,0,10,1022,0,0,95.729342,0.0055490000000020245,1473418,0
"172.16.133.55",57648,"172.16.139.250",5440,10,1022,9142,0,0,10,1022,0,0,95.733971,0.005580000000009022,1465232,0
"172.16.133.54",64428,"12.130.48.51",80,7,432,9143,0,0,4,246,3,186,95.739277,6.038779000000005,325,246
"172.16.133.54",64429,"12.130.48.51",80,7,432,9144,0,0,4,246,3,186,95.744648,6.0330220000000025,326,246
"172.16.133.54",64430,"12.130.48.51",80,7,432,9145,0,0,4,246,3,186,95.746723,6.031266000000002,326,246
"172.16.133.54",64431,"74.125.226.217",80,41,17680,9146,0,0,25,10448,16,7232,95.747001,172.47270099999997,484,335
"172.16.133.54",64432,"74.125.226.217",80,39,16499,9147,0,0,24,9809,15,6690,95.747194,172.47806300000002,454,310
"172.16.133.54",64433,"205.210.187.172",80,10,1415,9148,0,0,5,928,5,487,95.750331,0.22073600000000226,33632,17650
"172.16.133.54",64434,"205.210.187.172",80,8,504,9149,0,0,5,312,3,192,95.750597,6.03519,413,254
"172.16.133.73",60707,"172.16.139.250",5440,10,1022,9150,0,0,10,1022,0,0,95.757616,0.005718000000001666,1429870,0
"172.16.133.53",54133,"172.16.139.250",5440,10,1022,9151,0,0,10,1022,0,0,95.759702,0.007294999999999163,1120767,0
"172.16.133.21",53227,"172.16.139.250",5440,10,1022,9152,0,0,10,1022,0,0,95.761924,0.009234000000006404,885423,0
"172.16.133.30",62655,"172.16.139.250",5440,10,1022,9153,0,0,10,1022,0,0,95.765969,0.008851000000007048,923737,0
"172.16.133.54",64435,"173.194.43.58",80,37,15833,9154,0,0,23,9685,14,6148,95.770672,172.451575,449,285
"172.16.133.54",64436,"173.194.43.58",80,37,16542,9155,0,0,23,10394,14,6148,95.771009,172.450287,482,285
"172.16.133.25",63491,"172.16.139.250",5440,10,1022,9156,0,0,10,1022,0,0,95.772979,0.005533999999997263,1477412,0
"172.16.133.54",64437,"205.210.187.119",80,55,39658,9157,0,0,25,15669,30,23989,95.778746,7.134667000000007,17569,26898
"172.16.133.54",64438,"205.210.187.119",80,9,552,9158,0,0,4,246,5,306,95.779508,5.149033999999986,382,475
"172.16.133.54",64439,"173.194.43.58",80,58,28627,9159,0,0,35,17653,23,10974,95.780275,172.441526,818,509
"172.16.133.54",64440,"173.194.43.58",80,39,16720,9160,0,0,25,10572,14,6148,95.780478,172.44188099999997,490,285
"172.16.133.34",50473,"172.16.139.250",5440,10,1022,9161,0,0,10,1022,0,0,95.781654,0.004960999999994442,"",""
"172.16.133.97",59406,"172.16.139.250",5440,10,1022,9162,0,0,10,1022,0,0,95.793774,0.014515000000002942,563279,0
"172.16.133.54",64441,"107.22.3.252",80,8,1289,9163,0,0,5,761,3,528,95.838444,0.1668420000000026,36489,25317
"172.16.133.54",64442,"107.22.3.252",80,7,632,9164,0,0,4,246,3,386,95.838718,5.087699999999998,386,606
"172.16.133.68",60771,"67.217.64.244",443,6,366,9165,0,0,4,246,2,120,95.867038,0.14655000000000484,13428,6550
"172.16.133.68",60772,"216.115.223.200",443,7,426,9166,0,0,4,246,3,180,95.867899,0.15145700000000772,12993,9507
"172.16.133.33",57915,"172.16.139.250",5440,10,1022,9167,0,0,10,1022,0,0,95.868113,0.005583999999998923,1464183,0
"172.16.133.68",60773,"172.16.139.250",5440,10,1022,9168,0,0,10,1022,0,0,95.898478,0.005546000000009599,1474215,0
"172.16.133.68",60774,"216.219.113.250",443,6,366,9169,0,0,4,246,2,120,95.900959,0.26599600000000123,7398,3609
"172.16.133.68",60775,"66.151.150.190",443,6,366,9170,0,0,4,246,2,120,95.90096,0.256219999999999,7680,3746
"172.16.133.12",59811,"172.16.139.250",5440,10,1022,9171,0,0,10,1022,0,0,95.912598,0.00541099999999517,1510996,0
"172.16.133.63",53915,"172.16.139.250",5440,10,1022,9172,0,0,10,1022,0,0,95.922206,0.016059999999995966,509090,0
"172.16.133.66",53913,"172.16.139.250",5440,10,1022,9173,0,0,10,1022,0,0,95.937548,0.0056869999999946685,1437664,0
"172.16.133.82",61381,"172.16.139.250",5440,12,1142,9174,0,0,12,1142,0,0,95.94963,0.006579999999999586,1388449,0
"172.16.133.37",60659,"172.16.139.250",5440,12,1142,9175,0,0,12,1142,0,0,95.964099,0.006427999999999656,1421281,0
"172.16.133.54",64443,"23.21.118.18",443,21,6503,9176,0,0,10,1902,11,4601,96.017747,74.165162,205,496
"172.16.133.54",64444,"173.194.43.58",80,65,22448,9177,0,0,42,13023,23,9425,96.02548,173.202273,601,435
"172.16.133.54",64445,"173.194.43.58",80,6,372,9178,0,0,4,246,2,126,96.029187,5.739843000000008,342,175
"172.16.133.54",64446,"69.172.216.156",80,13,4993,9179,0,0,7,3578,6,1415,96.055095,0.5450730000000021,52514,20767
"172.16.133.54",64447,"69.172.216.156",80,40,34237,9180,0,0,15,3103,25,31134,96.0553,0.3090119999999956,80333,806026
"172.16.133.78",59243,"172.16.139.250",5440,10,1022,9181,0,0,10,1022,0,0,96.124411,0.005581000000006497,1464970,0
"172.16.133.54",64448,"205.210.187.119",80,14,4531,9182,0,0,6,2591,8,1940,96.136555,7.132997000000003,2905,2175
"172.16.133.54",64449,"205.210.187.119",80,15,4533,9183,0,0,7,2642,8,1891,96.136864,5.168543999999997,4089,2926
"172.16.133.54",64450,"74.125.226.218",80,217,218213,9184,0,0,68,8408,149,209805,96.164281,170.05544499999996,395,9869
"172.16.133.54",64451,"157.56.134.97",80,8,1085,9185,0,0,5,694,3,391,96.165815,0.09561800000000176,58064,32713
"172.16.133.67",56020,"172.16.139.250",5440,12,1142,9186,0,0,12,1142,0,0,96.174242,0.010030999999997903,910776,0
"172.16.133.54",64452,"157.56.134.97",80,18,10364,9187,0,0,11,6502,7,3862,96.179525,1.5658180000000073,33219,19731
"172.16.133.54",64453,"173.194.43.45",80,6,372,9188,0,0,4,246,2,126,96.179793,5.589334999999991,352,180
"172.16.133.56",61464,"172.16.139.250",5440,10,1022,9189,0,0,10,1022,0,0,96.197531,0.014696999999998184,556304,0
"172.16.133.54",64454,"8.18.45.80",80,19,8573,9190,0,0,12,4431,7,4142,96.245431,84.569019,419,391
"172.16.133.54",64455,"8.18.45.80",80,10,2457,9191,0,0,6,1169,4,1288,96.245805,84.76789799999999,110,121
"172.16.133.41",53054,"172.16.139.250",5440,12,1142,9192,0,0,12,1142,0,0,96.25275,0.006448999999989269,1416653,0
"172.16.133.42",57161,"172.16.139.250",5440,12,1142,9193,0,0,12,1142,0,0,96.256991,0.014994999999998981,609269,0
"172.16.133.54",64456,"65.54.81.133",80,8,492,9194,0,0,4,246,4,246,96.266863,5.509101000000001,357,357
"172.16.133.54",64457,"65.54.81.133",80,54,43281,9195,0,0,22,4927,32,38354,96.26728,5.067098999999999,7778,60553
"172.16.133.85",52307,"172.16.139.250",5440,10,1022,9196,0,0,10,1022,0,0,96.27027,0.007079000000004498,1154965,0
"172.16.133.43",57817,"172.16.139.250",5440,10,1022,9197,0,0,10,1022,0,0,96.323693,0.00544999999999618,1500183,0
"172.16.133.54",64458,"23.33.85.215",80,10,2186,9198,0,0,6,921,4,1265,96.338674,115.85807700000001,63,87
"172.16.133.54",64459,"23.33.85.215",80,17,8835,9199,0,0,8,1574,9,7261,96.338901,115.844689,108,501
"172.16.133.54",64460,"23.33.85.215",80,6,372,9200,0,0,4,246,2,126,96.339066,5.428879999999992,362,185
"172.16.133.54",64461,"23.33.85.215",80,12,4779,9201,0,0,6,884,6,3895,96.339228,115.84344499999999,61,268
"172.16.133.54",64462,"23.33.85.215",80,10,1653,9202,0,0,6,900,4,753,96.3394,115.84431,62,52
"172.16.133.54",64463,"23.33.85.215",80,6,372,9203,0,0,4,246,2,126,96.339564,5.428260000000009,362,185
"172.16.133.54",64464,"8.18.45.81",80,10,3047,9204,0,0,6,1206,4,1841,96.339726,5.43732,1774,2708
"172.16.133.54",64465,"8.18.45.81",80,6,366,9205,0,0,4,246,2,120,96.339897,5.4373410000000035,361,176
"172.16.133.13",53073,"172.16.139.250",5440,10,1022,9206,0,0,10,1022,0,0,96.342692,0.10325799999999674,79180,0
"172.16.133.57",60608,"67.217.64.244",443,6,378,9207,0,0,4,258,2,120,96.391059,0.07072399999999845,29183,13573
"172.16.133.20",62429,"172.16.139.250",5440,12,1142,9208,0,0,12,1142,0,0,96.39267,0.06479500000000371,140998,0
"172.16.133.55",57649,"68.67.159.186",80,11,1449,9209,0,0,6,723,5,726,96.406226,11.060469999999995,522,525
"172.16.133.75",50993,"172.16.139.250",5440,10,1022,9210,0,0,10,1022,0,0,96.408075,0.054094000000006304,151144,0
"172.16.133.57",60609,"216.115.223.200",443,6,378,9211,0,0,4,258,2,120,96.419848,0.1167429999999996,17679,8223
"172.16.133.28",65465,"172.16.139.250",5440,10,1022,9212,0,0,10,1022,0,0,96.421653,0.04476499999999817,182642,0
"172.16.133.54",64466,"173.194.43.34",80,10,1104,9213,0,0,6,730,4,374,96.448273,115.735559,50,25
"172.16.133.99",56078,"172.16.139.250",5440,10,1022,9214,0,0,10,1022,0,0,96.449427,0.02020899999999415,404572,0
"172.16.133.87",60243,"172.16.139.250",5440,10,1022,9215,0,0,10,1022,0,0,96.47197,0.005532999999999788,1477679,0
"172.16.133.54",64467,"173.194.43.39",80,14,3740,9216,0,0,8,2264,6,1476,96.479171,115.700048,156,102
"172.16.133.35",50008,"172.16.139.250",5440,12,1142,9217,0,0,12,1142,0,0,96.481466,0.012678000000008183,720618,0
"172.16.133.12",59812,"54.240.160.90",80,8,1659,9218,0,0,5,731,3,928,96.485345,65.07132899999999,89,114
"172.16.133.116",53475,"172.16.139.250",5440,12,1142,9219,0,0,12,1142,0,0,96.486382,0.01600899999999683,570678,0
"172.16.133.116",53476,"172.16.139.250",5440,12,1142,9220,0,0,12,1142,0,0,96.503371,0.0057469999999995025,1589698,0
"172.16.133.84",58827,"172.16.139.250",5440,12,1142,9221,0,0,12,1142,0,0,96.508103,0.01543399999999906,591939,0
"172.16.133.116",53477,"172.16.139.250",5440,12,1142,9222,0,0,12,1142,0,0,96.510052,0.005574999999993224,1638744,0
"172.16.133.57",60610,"66.151.150.190",443,6,378,9223,0,0,4,258,2,120,96.524609,0.18399399999999844,11217,5217
"172.16.133.57",60611,"216.219.113.250",443,6,378,9224,0,0,4,258,2,120,96.529326,0.19320700000000102,10682,4968
"172.16.133.54",64468,"8.18.45.81",80,11,2588,9225,0,0,7,1352,4,1236,96.53373,5.243411999999992,2062,1885
"172.16.133.54",64469,"8.18.45.81",80,6,366,9226,0,0,4,246,2,120,96.533985,5.243343999999993,375,183
"172.16.133.49",55822,"172.16.139.250",5440,12,1142,9227,0,0,12,1142,0,0,96.585129,0.005597000000008734,1632303,0
"172.16.133.95",57004,"172.16.139.250",5440,12,1142,9228,0,0,12,1142,0,0,96.624341,0.015150000000005548,603036,0
"172.16.133.54",64470,"208.47.254.42",80,16,5998,9229,0,0,9,1208,7,4790,96.632017,117.560951,82,325
"172.16.133.54",64471,"208.47.254.42",80,6,372,9230,0,0,4,246,2,126,96.633453,5.129348999999991,383,196
"172.16.133.92",57717,"172.16.139.250",5440,10,1022,9231,0,0,10,1022,0,0,96.650841,0.007970000000000255,1025846,0
"172.16.133.29",60988,"172.16.139.250",5440,12,1142,9232,0,0,12,1142,0,0,96.668816,0.01626299999999503,561765,0
"172.16.133.44",64870,"172.16.139.250",5440,12,1142,9233,0,0,12,1142,0,0,96.674833,0.006152000000000157,1485045,0
"172.16.133.82",61382,"157.56.232.214",443,23,10207,9234,0,0,10,1980,13,8227,96.682039,0.49887699999999313,31751,131928
"172.16.133.207",55968,"172.16.139.250",5440,12,1142,9235,0,0,12,1142,0,0,96.700974,0.014352999999999838,636521,0
"172.16.133.83",57126,"172.16.139.250",5440,12,1142,9236,0,0,12,1142,0,0,96.710066,0.013823999999999614,660879,0
"172.16.133.54",64472,"64.236.101.12",80,18,8626,9237,0,0,10,2887,8,5739,96.724313,122.35079100000002,188,375
"172.16.133.93",60753,"172.16.139.250",5440,12,1142,9238,0,0,12,1142,0,0,96.726276,0.009026000000005752,1012187,0
"172.16.133.11",55177,"172.16.139.250",5440,12,1142,9239,0,0,12,1142,0,0,96.743392,0.006388999999998646,1429957,0
"172.16.133.55",57650,"172.16.139.250",5440,12,1142,9240,0,0,12,1142,0,0,96.748236,0.01579199999999048,578520,0
"172.16.133.73",60708,"172.16.139.250",5440,10,1022,9241,0,0,10,1022,0,0,96.772233,0.007506000000006452,1089261,0
"172.16.133.53",54134,"172.16.139.250",5440,10,1022,9242,0,0,10,1022,0,0,96.773932,0.008302000000000476,984822,0
"172.16.133.21",53228,"172.16.139.250",5440,10,1022,9243,0,0,10,1022,0,0,96.776023,0.016468000000003258,496478,0
"172.16.133.30",62656,"172.16.139.250",5440,10,1022,9244,0,0,10,1022,0,0,96.779316,0.007390000000000896,1106359,0
"172.16.133.25",63492,"172.16.139.250",5440,10,1022,9245,0,0,10,1022,0,0,96.788246,0.00785600000000386,1040733,0
"172.16.133.34",50474,"172.16.139.250",5440,10,1022,9246,0,0,10,1022,0,0,96.795111,0.016695999999996047,489698,0
"172.16.133.97",59407,"172.16.139.250",5440,10,1022,9247,0,0,10,1022,0,0,96.806614,0.014693000000008283,556455,0
"172.16.133.33",57916,"172.16.139.250",5440,12,1142,9248,0,0,12,1142,0,0,96.881012,0.04102299999999559,222704,0
"172.16.133.68",60776,"172.16.139.250",5440,10,1022,9249,0,0,10,1022,0,0,96.91256,0.015568000000001803,525179,0
"172.16.128.233",55246,"172.16.133.233",22,210,22936,9250,0,0,61,4918,149,18018,96.923279,9.963064000000003,3948,14467
"172.16.133.12",59813,"172.16.139.250",5440,10,1022,9251,0,0,10,1022,0,0,96.92588,0.009193999999993707,889275,0
"172.16.133.63",53916,"172.16.139.250",5440,10,1022,9252,0,0,10,1022,0,0,96.937283,0.005421000000012555,1508208,0
"172.16.133.55",57651,"173.194.43.57",80,8,498,9253,0,0,5,312,3,186,96.943996,20.573857000000004,121,72
"172.16.133.66",53914,"172.16.139.250",5440,10,1022,9254,0,0,10,1022,0,0,96.951249,0.01561199999999019,523699,0
"172.16.133.82",61383,"172.16.139.250",5440,12,1142,9255,0,0,12,1142,0,0,96.963817,0.0062360000000012406,1465041,0
"172.16.133.37",60660,"172.16.139.250",5440,10,1022,9256,0,0,10,1022,0,0,96.978221,0.006920999999991295,1181332,0
"172.16.133.78",59244,"172.16.139.250",5440,10,1022,9257,0,0,10,1022,0,0,97.134166,0.006140000000002033,1331596,0
"172.16.133.67",56021,"172.16.139.250",5440,12,1142,9258,0,0,12,1142,0,0,97.188652,0.006326999999998861,1443970,0
"172.16.133.55",57652,"173.194.43.57",80,22,6036,9259,0,0,12,4442,10,1594,97.191169,197.372456,180,64
"172.16.133.56",61465,"172.16.139.250",5440,12,1142,9260,0,0,12,1142,0,0,97.210906,0.005321000000009235,1716970,0
"172.16.133.55",57653,"173.194.43.57",80,14,2197,9261,0,0,8,1069,6,1128,97.242232,180.19050399999998,47,50
"172.16.133.54",64473,"205.210.187.180",80,10,1413,9262,0,0,5,926,5,487,97.259081,0.12503200000000447,59248,31160
"172.16.133.54",64474,"205.210.187.180",80,8,504,9263,0,0,5,312,3,192,97.259336,5.511522999999997,452,278
"172.16.133.41",53055,"172.16.139.250",5440,10,1022,9264,0,0,10,1022,0,0,97.26758,0.0055240000000083,1480086,0
"172.16.133.42",57162,"172.16.139.250",5440,12,1142,9265,0,0,12,1142,0,0,97.269927,0.01013600000000281,901341,0
"172.16.133.85",52308,"172.16.139.250",5440,12,1142,9266,0,0,12,1142,0,0,97.283753,0.006113999999996622,1494275,0
"172.16.133.43",57818,"172.16.139.250",5440,10,1022,9267,0,0,10,1022,0,0,97.337453,0.005403000000001157,1513233,0
"172.16.133.55",57654,"68.67.159.224",80,15,4793,9268,0,0,8,3646,7,1147,97.339234,10.127174999999994,2880,906
"172.16.133.13",53074,"172.16.139.250",5440,10,1022,9269,0,0,10,1022,0,0,97.356791,0.006174999999998931,1324048,0
"172.16.133.120",53453,"96.43.146.22",443,38,16645,9270,0,0,21,14382,17,2263,97.360142,83.14857700000002,1383,217
"172.16.133.120",53454,"96.43.146.22",443,25,9422,9271,0,0,15,7933,10,1489,97.360511,177.76700000000002,357,67
"172.16.133.54",64475,"173.194.43.60",80,183,128169,9272,0,0,71,35140,112,93029,97.360578,170.861484,1645,4355
"172.16.133.54",64476,"208.91.175.36",80,6,368,9273,0,0,4,246,2,122,97.366044,5.394535000000005,364,180
"172.16.133.54",64477,"208.91.175.36",80,9,2096,9274,0,0,6,951,3,1145,97.36628,15.355498999999995,495,596
"172.16.133.20",62430,"172.16.139.250",5440,12,1142,9275,0,0,12,1142,0,0,97.40557,0.005026999999998338,1817386,0
"172.16.133.75",50994,"172.16.139.250",5440,10,1022,9276,0,0,10,1022,0,0,97.423309,0.005454000000000292,1499083,0
"172.16.133.28",65466,"172.16.139.250",5440,12,1142,9277,0,0,12,1142,0,0,97.435405,0.0060599999999908505,1507590,0
"172.16.133.99",56079,"172.16.139.250",5440,12,1142,9278,0,0,12,1142,0,0,97.463596,0.014844000000010737,615467,0
"172.16.133.87",60244,"172.16.139.250",5440,10,1022,9279,0,0,10,1022,0,0,97.485975,0.015437000000005696,529636,0
"172.16.133.35",50009,"172.16.139.250",5440,12,1142,9280,0,0,12,1142,0,0,97.496656,0.010850000000004911,842027,0
"172.16.133.54",64478,"173.194.43.60",80,10,2009,9281,0,0,6,1634,4,375,97.499486,115.683793,112,25
"172.16.133.54",64479,"54.243.145.248",80,41,30983,9282,0,0,18,7549,23,23434,97.500332,61.29830199999999,985,3058
"172.16.133.116",53478,"172.16.139.250",5440,10,1022,9283,0,0,10,1022,0,0,97.500444,0.008935999999991395,914950,0
"172.16.133.54",64480,"54.243.145.248",80,26,17470,9284,0,0,11,4581,15,12889,97.507762,61.289688999999996,597,1682
"172.16.133.54",64481,"173.194.43.60",80,142,130723,9285,0,0,54,8263,88,122460,97.5091,169.734983,389,5771
"172.16.133.116",53479,"172.16.139.250",5440,10,1022,9286,0,0,10,1022,0,0,97.510266,0.005473999999992429,1493606,0
"172.16.133.116",53480,"172.16.139.250",5440,10,1022,9287,0,0,10,1022,0,0,97.516754,0.006619999999998072,1235045,0
"172.16.133.84",58828,"172.16.139.250",5440,10,1022,9288,0,0,10,1022,0,0,97.522129,0.0053319999999956735,1533383,0
"172.16.133.49",55823,"172.16.139.250",5440,10,1022,9289,0,0,10,1022,0,0,97.599182,0.005590999999995461,1462350,0
"172.16.133.54",64482,"54.243.192.249",80,34,20322,9290,0,0,17,9054,17,11268,97.619864,115.49196599999999,627,780
"172.16.133.54",64483,"209.190.70.254",80,14,5797,9291,0,0,7,2195,7,3602,97.630295,0.42907900000000154,40924,67157
"172.16.133.95",57005,"172.16.139.250",5440,12,1142,9292,0,0,12,1142,0,0,97.638146,0.006000999999997703,1522412,0
"172.16.133.54",64484,"54.243.192.249",80,6,372,9293,0,0,4,246,2,126,97.640888,5.118853999999999,384,196
"172.16.133.54",64485,"209.190.70.254",80,12,4255,9294,0,0,6,3211,6,1044,97.641085,0.5258549999999929,48849,15882
"172.16.133.92",57718,"172.16.139.250",5440,10,1022,9295,0,0,10,1022,0,0,97.664935,0.0459069999999997,178099,0
"172.16.133.29",60989,"172.16.139.250",5440,10,1022,9296,0,0,10,1022,0,0,97.68263,0.032533999999998287,251306,0
"172.16.133.44",64871,"172.16.139.250",5440,12,1142,9297,0,0,12,1142,0,0,97.691927,0.02897899999999254,315262,0
"172.16.133.54",64486,"205.210.187.222",80,10,1416,9298,0,0,5,929,5,487,97.696504,0.10951999999998918,67859,35573
"172.16.133.54",64487,"205.210.187.222",80,8,504,9299,0,0,5,312,3,192,97.696888,6.1001739999999955,409,251
"172.16.133.207",55969,"172.16.139.250",5440,10,1022,9300,0,0,10,1022,0,0,97.714708,0.009343000000001211,875093,0
"172.16.133.83",57127,"172.16.139.250",5440,12,1142,9301,0,0,12,1142,0,0,97.72421,0.004720000000006053,"",""
"172.16.133.93",60754,"172.16.139.250",5440,10,1022,9302,0,0,10,1022,0,0,97.740282,0.004752000000010526,"",""
"172.16.133.11",55178,"172.16.139.250",5440,10,1022,9303,0,0,10,1022,0,0,97.757761,0.005565000000004261,1469182,0
"172.16.133.54",64488,"208.47.254.57",80,6,372,9304,0,0,4,246,2,126,97.757825,6.019576999999998,326,167
"172.16.133.55",57655,"172.16.139.250",5440,10,1022,9305,0,0,10,1022,0,0,97.761701,0.014521000000002005,563046,0
"172.16.133.73",60709,"172.16.139.250",5440,12,1142,9306,0,0,12,1142,0,0,97.785762,0.016291999999992868,560766,0
"172.16.133.53",54135,"172.16.139.250",5440,10,1022,9307,0,0,10,1022,0,0,97.787677,0.0077940000000040754,1049012,0
"172.16.133.21",53229,"172.16.139.250",5440,10,1022,9308,0,0,10,1022,0,0,97.789815,0.02003700000000208,408045,0
"172.16.133.30",62657,"172.16.139.250",5440,10,1022,9309,0,0,10,1022,0,0,97.793458,0.020365999999995665,401453,0
"172.16.133.25",63493,"172.16.139.250",5440,10,1022,9310,0,0,10,1022,0,0,97.801102,0.004773000000000138,"",""
"172.16.133.34",50475,"172.16.139.250",5440,10,1022,9311,0,0,10,1022,0,0,97.809609,0.00812300000001187,1006524,0
"172.16.133.97",59408,"172.16.139.250",5440,10,1022,9312,0,0,10,1022,0,0,97.820745,0.014557999999993854,561615,0
"172.16.133.54",64489,"64.27.99.250",80,7,432,9313,0,0,4,246,3,186,97.842946,5.088628,386,292
"172.16.133.54",64490,"64.27.99.250",80,10,2106,9314,0,0,6,814,4,1292,97.843405,115.34208199999999,56,89
"172.16.133.54",64491,"23.21.81.234",80,22,7881,9315,0,0,12,4201,10,3680,97.843971,106.353538,316,276
"172.16.133.54",64492,"23.21.81.234",80,24,9660,9316,0,0,13,5913,11,3747,97.844151,115.349315,410,259
"172.16.133.33",57917,"172.16.139.250",5440,10,1022,9317,0,0,10,1022,0,0,97.895949,0.014856999999992127,550312,0
"172.16.133.68",60777,"172.16.139.250",5440,10,1022,9318,0,0,10,1022,0,0,97.926101,0.006101000000001022,1340108,0
"172.16.133.12",59814,"172.16.139.250",5440,12,1142,9319,0,0,12,1142,0,0,97.939741,0.006315000000000737,1446714,0
"172.16.133.63",53917,"172.16.139.250",5440,12,1142,9320,0,0,12,1142,0,0,97.950382,0.04094099999998946,223150,0
"172.16.133.66",53915,"172.16.139.250",5440,10,1022,9321,0,0,10,1022,0,0,97.964252,0.03162600000000282,258521,0
"172.16.133.68",60778,"67.217.64.244",443,6,366,9322,0,0,4,246,2,120,97.973153,0.1252500000000083,15712,7664
"172.16.133.68",60779,"216.115.223.200",443,6,366,9323,0,0,4,246,2,120,97.974018,0.1406819999999982,13988,6823
"172.16.133.82",61384,"172.16.139.250",5440,12,1142,9324,0,0,12,1142,0,0,97.978744,0.021981999999994173,415612,0
"172.16.133.37",60661,"172.16.139.250",5440,10,1022,9325,0,0,10,1022,0,0,97.993479,0.010045000000005189,813937,0
"172.16.133.68",60780,"66.151.150.190",443,6,366,9326,0,0,4,246,2,120,98.054096,0.2093409999999949,9400,4585
"172.16.133.68",60781,"216.219.113.250",443,6,366,9327,0,0,4,246,2,120,98.056923,0.21510800000000074,9148,4462
"172.16.133.54",64493,"23.60.224.191",80,6,372,9328,0,0,4,246,2,126,98.061243,5.739435,342,175
"172.16.133.54",64494,"23.60.224.191",80,16,8037,9329,0,0,8,1255,8,6782,98.061505,116.15160300000001,86,467
"172.16.133.54",64495,"67.69.174.113",80,10,2548,9330,0,0,6,1177,4,1371,98.06169,116.152727,81,94
"172.16.133.54",64496,"67.69.174.113",80,6,372,9331,0,0,4,246,2,126,98.061874,5.7389069999999975,342,175
"172.16.133.78",59245,"172.16.139.250",5440,12,1142,9332,0,0,12,1142,0,0,98.148394,0.01634200000000874,559050,0
"172.16.133.67",56022,"172.16.139.250",5440,10,1022,9333,0,0,10,1022,0,0,98.202841,0.005583999999998923,1464183,0
"172.16.133.56",61466,"172.16.139.250",5440,10,1022,9334,0,0,10,1022,0,0,98.22502,0.004936999999998193,"",""
"172.16.133.41",53056,"172.16.139.250",5440,10,1022,9335,0,0,10,1022,0,0,98.281615,0.015719000000004257,520134,0
"172.16.133.42",57163,"172.16.139.250",5440,12,1142,9336,0,0,12,1142,0,0,98.294046,0.009191999999998757,993907,0
"172.16.133.85",52309,"172.16.139.250",5440,12,1142,9337,0,0,12,1142,0,0,98.298811,0.007349000000004935,1243162,0
"172.16.133.54",64497,"54.243.105.25",80,14,3980,9338,0,0,7,1968,7,2012,98.311308,60.007577,262,268
"172.16.133.54",64498,"54.243.105.25",80,6,372,9339,0,0,4,246,2,126,98.312531,5.486774999999994,358,183
"172.16.133.54",64499,"173.193.240.138",80,8,1608,9340,0,0,5,1362,3,246,98.315019,0.10239599999999882,106410,19219
"172.16.133.54",64500,"173.193.240.138",80,6,553,9341,0,0,4,246,2,307,98.316427,5.463360999999992,360,449
"172.16.133.54",64501,"8.19.18.18",80,7,432,9342,0,0,4,246,3,186,98.317302,5.534609000000003,355,268
"172.16.133.54",64502,"8.19.18.18",80,10,2205,9343,0,0,6,1372,4,833,98.317994,115.95344800000001,94,57
"172.16.133.54",64503,"199.38.164.155",80,10,1988,9344,0,0,6,1449,4,539,98.328963,115.86385700000001,100,37
"172.16.133.54",64504,"199.38.164.155",80,7,432,9345,0,0,4,246,3,186,98.329823,5.446331999999998,361,273
"172.16.133.43",57819,"172.16.139.250",5440,10,1022,9346,0,0,10,1022,0,0,98.352048,0.005929000000008955,1378984,0
"172.16.133.54",64505,"209.190.106.126",80,12,4181,9347,0,0,6,3260,6,921,98.358932,0.6099080000000043,42760,12080
"172.16.133.54",64506,"209.190.106.126",80,14,4359,9348,0,0,7,3334,7,1025,98.359319,0.6485820000000047,41123,12642
"172.16.133.54",64507,"209.190.106.126",80,12,4216,9349,0,0,6,3262,6,954,98.370309,0.615407999999988,42404,12401
"172.16.133.13",53075,"172.16.139.250",5440,12,1142,9350,0,0,12,1142,0,0,98.370881,0.015209999999996171,600657,0
"172.16.133.54",64508,"209.190.106.126",80,7,428,9351,0,0,4,246,3,182,98.38811,5.412670000000006,363,268
"172.16.133.54",64509,"209.190.106.126",80,6,368,9352,0,0,4,246,2,122,98.388924,5.411853999999991,363,180
"172.16.133.54",64510,"209.190.106.126",80,12,4195,9353,0,0,6,3262,6,933,98.391009,0.6035559999999975,43237,12366
"172.16.133.20",62431,"172.16.139.250",5440,12,1142,9354,0,0,12,1142,0,0,98.418448,0.00480299999999545,"",""
"172.16.133.57",60612,"67.217.64.244",443,6,378,9355,0,0,4,258,2,120,98.425253,0.06050899999999615,34110,15865
"172.16.133.75",50995,"172.16.139.250",5440,10,1022,9356,0,0,10,1022,0,0,98.436555,0.005516999999997552,1481964,0
"172.16.133.28",65467,"172.16.139.250",5440,10,1022,9357,0,0,10,1022,0,0,98.449681,0.005380999999999858,1519420,0
"172.16.133.99",56080,"172.16.139.250",5440,12,1142,9358,0,0,12,1142,0,0,98.476349,0.005189999999998918,1760308,0
"172.16.133.57",60613,"216.115.223.200",443,6,378,9359,0,0,4,258,2,120,98.476403,0.07770699999998953,26561,12354
"172.16.133.87",60245,"172.16.139.250",5440,10,1022,9360,0,0,10,1022,0,0,98.500182,0.015501999999997906,527415,0
"172.16.133.35",50010,"172.16.139.250",5440,12,1142,9361,0,0,12,1142,0,0,98.509941,0.011611999999999512,786772,0
"172.16.133.116",53481,"172.16.139.250",5440,10,1022,9362,0,0,10,1022,0,0,98.514104,0.010131999999998698,806948,0
"172.16.133.116",53482,"172.16.139.250",5440,10,1022,9363,0,0,10,1022,0,0,98.524702,0.005618999999995822,1455063,0
"172.16.133.116",53483,"172.16.139.250",5440,10,1022,9364,0,0,10,1022,0,0,98.531369,0.005924000000007368,1380148,0
"172.16.133.84",58829,"172.16.139.250",5440,12,1142,9365,0,0,12,1142,0,0,98.536203,0.0053920000000005075,1694362,0
"172.16.133.49",55824,"172.16.139.250",5440,12,1142,9366,0,0,12,1142,0,0,98.613056,0.005488999999997191,1664419,0
"172.16.133.57",60614,"66.151.150.190",443,6,378,9367,0,0,4,258,2,120,98.620412,0.1808369999999968,11413,5308
"172.16.133.57",60615,"216.219.113.250",443,6,378,9368,0,0,4,258,2,120,98.625741,0.18782299999999452,10989,5111
"172.16.133.95",57006,"172.16.139.250",5440,12,1142,9369,0,0,12,1142,0,0,98.652455,0.006371999999998934,1433772,0
"172.16.133.92",57719,"172.16.139.250",5440,12,1142,9370,0,0,12,1142,0,0,98.677968,0.01497799999999927,609961,0
"172.16.133.29",60990,"172.16.139.250",5440,12,1142,9371,0,0,12,1142,0,0,98.700167,0.007053000000013299,1295335,0
"172.16.133.44",64872,"172.16.139.250",5440,12,1142,9372,0,0,12,1142,0,0,98.703428,0.015794999999997117,578410,0
"172.16.133.207",55970,"172.16.139.250",5440,12,1142,9373,0,0,12,1142,0,0,98.728913,0.004973999999990042,"",""
"172.16.133.83",57128,"172.16.139.250",5440,12,1142,9374,0,0,12,1142,0,0,98.738079,0.004712999999995304,"",""
"172.16.133.93",60755,"172.16.139.250",5440,10,1022,9375,0,0,10,1022,0,0,98.754307,0.0146090000000072,559655,0
"172.16.133.11",55179,"172.16.139.250",5440,10,1022,9376,0,0,10,1022,0,0,98.770615,0.005723999999986518,1428371,0
"172.16.133.55",57656,"172.16.139.250",5440,12,1142,9377,0,0,12,1142,0,0,98.776656,0.006107000000000085,1495988,0
"172.16.133.73",60710,"172.16.139.250",5440,10,1022,9378,0,0,10,1022,0,0,98.79891,0.006392999999988547,1278898,0
"172.16.133.53",54136,"172.16.139.250",5440,10,1022,9379,0,0,10,1022,0,0,98.800641,0.01626100000000008,502798,0
"172.16.133.21",53230,"172.16.139.250",5440,12,1142,9380,0,0,12,1142,0,0,98.80371,0.018249000000011506,500630,0
"172.16.133.30",62658,"172.16.139.250",5440,10,1022,9381,0,0,10,1022,0,0,98.807432,0.005544999999997913,1474481,0
"172.16.133.25",63494,"172.16.139.250",5440,12,1142,9382,0,0,12,1142,0,0,98.815247,0.009811999999996601,931104,0
"172.16.133.75",50996,"78.108.118.250",443,6,366,9383,0,0,4,246,2,120,98.822152,0.21944799999999987,8967,4374
"172.16.133.75",50997,"216.219.118.244",443,6,366,9384,0,0,4,246,2,120,98.822324,0.22012700000000507,8940,4361
"172.16.133.34",50476,"172.16.139.250",5440,10,1022,9385,0,0,10,1022,0,0,98.823281,0.014856000000008862,550350,0
"172.16.133.97",59409,"172.16.139.250",5440,10,1022,9386,0,0,10,1022,0,0,98.834843,0.015341999999989753,532916,0
"172.16.133.75",50998,"68.64.24.250",443,6,366,9387,0,0,4,246,2,120,98.871846,0.10663299999998799,18455,9002
"172.16.133.75",50999,"216.115.219.126",443,6,366,9388,0,0,4,246,2,120,98.876954,0.4750280000000089,4142,2020
"172.16.133.33",57918,"172.16.139.250",5440,12,1142,9389,0,0,12,1142,0,0,98.91,0.006158999999996695,1483357,0
"172.16.133.68",60782,"172.16.139.250",5440,12,1142,9390,0,0,12,1142,0,0,98.940565,0.015620999999995888,584853,0
"172.16.133.12",59815,"172.16.139.250",5440,12,1142,9391,0,0,12,1142,0,0,98.953634,0.006460000000004129,1414241,0
"172.16.133.63",53918,"172.16.139.250",5440,12,1142,9392,0,0,12,1142,0,0,98.964356,0.005496000000007939,1662299,0
"172.16.133.44",64873,"64.94.107.14",80,10,2494,9393,0,0,6,1971,4,523,98.966481,0.06785599999999192,232374,61659
"172.16.133.54",64511,"209.190.70.254",80,17,7670,9394,0,0,8,4047,9,3623,98.977097,0.6757729999999924,47909,42890
"172.16.133.66",53916,"172.16.139.250",5440,10,1022,9395,0,0,10,1022,0,0,98.979634,0.005647999999993658,1447592,0
"172.16.133.82",61385,"172.16.139.250",5440,10,1022,9396,0,0,10,1022,0,0,98.991738,0.005758999999997627,1419690,0
"172.16.133.37",60662,"172.16.139.250",5440,10,1022,9397,0,0,10,1022,0,0,99.005264,0.005515000000002601,1482502,0
"172.16.133.54",64512,"72.21.194.32",80,6,372,9398,0,0,4,246,2,126,99.094723,5.658118999999999,347,178
"172.16.133.54",64513,"72.21.194.32",80,6,372,9399,0,0,4,246,2,126,99.095393,5.658079999999998,347,178
"172.16.133.54",64514,"72.21.194.32",80,6,372,9400,0,0,4,246,2,126,99.096018,5.6568829999999934,347,178
"172.16.133.113",55631,"172.16.139.250",135,8,492,9401,0,0,8,492,0,0,99.150828,0.008432999999996582,466737,0
"172.16.133.113",55632,"172.16.139.250",5462,12,816,9402,0,0,12,816,0,0,99.160774,0.5144360000000034,12689,0
"172.16.133.78",59246,"172.16.139.250",5440,12,1142,9403,0,0,12,1142,0,0,99.161909,0.015430000000009159,592093,0
"172.16.133.67",56023,"172.16.139.250",5440,10,1022,9404,0,0,10,1022,0,0,99.216513,0.01469999999999061,556190,0
"172.16.133.56",61467,"172.16.139.250",5440,12,1142,9405,0,0,12,1142,0,0,99.238684,0.00500499999999704,1825374,0
"172.16.133.41",53057,"172.16.139.250",5440,12,1142,9406,0,0,12,1142,0,0,99.294719,0.006071000000005711,1504859,0
"172.16.133.42",57164,"172.16.139.250",5440,12,1142,9407,0,0,12,1142,0,0,99.304988,0.020386000000002014,448150,0
"172.16.133.85",52310,"172.16.139.250",5440,10,1022,9408,0,0,10,1022,0,0,99.312111,0.015393000000003099,531150,0
"172.16.133.43",57820,"172.16.139.250",5440,10,1022,9409,0,0,10,1022,0,0,99.365828,0.005423000000007505,1507652,0
"172.16.133.13",53076,"172.16.139.250",5440,12,1142,9410,0,0,12,1142,0,0,99.383661,0.04545000000000243,201012,0
"172.16.133.121",56537,"96.43.146.49",443,302,219478,9411,0,0,121,27451,181,192027,99.401707,29.160984999999997,7530,52680
"172.16.133.20",62432,"172.16.139.250",5440,12,1142,9412,0,0,12,1142,0,0,99.433577,0.004901000000003819,"",""
"172.16.133.75",51000,"172.16.139.250",5440,12,1142,9413,0,0,12,1142,0,0,99.451202,0.006219999999999004,1468810,0
"172.16.133.28",65468,"172.16.139.250",5440,12,1142,9414,0,0,12,1142,0,0,99.463488,0.006113999999996622,1494275,0
"172.16.133.93",60756,"199.48.204.30",80,16,8331,9415,0,0,7,1106,9,7225,99.481898,8.075577999999993,1095,7157
"172.16.133.99",56081,"172.16.139.250",5440,12,1142,9416,0,0,12,1142,0,0,99.492128,0.005146000000010531,1775359,0
"172.16.133.87",60246,"172.16.139.250",5440,12,1142,9417,0,0,12,1142,0,0,99.513079,0.016072999999991566,568406,0
"172.16.133.35",50011,"172.16.139.250",5440,12,1142,9418,0,0,12,1142,0,0,99.524155,0.015453000000007933,591212,0
"172.16.133.116",53484,"172.16.139.250",5440,12,1142,9419,0,0,12,1142,0,0,99.528044,0.007355000000003997,1242148,0
"172.16.133.116",53485,"172.16.139.250",5440,12,1142,9420,0,0,12,1142,0,0,99.535296,0.01702299999999468,536685,0
"172.16.133.84",58830,"172.16.139.250",5440,12,1142,9421,0,0,12,1142,0,0,99.550322,0.015274000000005117,598140,0
"172.16.133.116",53486,"172.16.139.250",5440,12,1142,9422,0,0,12,1142,0,0,99.552936,0.0075590000000005375,1208625,0
"65.54.50.214",443,"172.16.133.24",55809,4,252,9423,0,0,2,120,2,132,99.581662,120.115712,7,8
"172.16.133.49",55825,"172.16.139.250",5440,10,1022,9424,0,0,10,1022,0,0,99.627191,0.005762000000004264,1418951,0
"172.16.133.95",57007,"172.16.139.250",5440,12,1142,9425,0,0,12,1142,0,0,99.667335,0.006426000000004706,1421724,0
"172.16.133.92",57721,"172.16.139.250",5440,10,1022,9426,0,0,10,1022,0,0,99.693784,0.005497000000005414,1487356,0
"172.16.133.29",60991,"172.16.139.250",5440,12,1142,9427,0,0,12,1142,0,0,99.712066,0.006685000000004493,1366641,0
"172.16.133.44",64874,"172.16.139.250",5440,10,1022,9428,0,0,10,1022,0,0,99.717164,0.005509000000003539,1484116,0
"172.16.133.207",55971,"172.16.139.250",5440,12,1142,9429,0,0,12,1142,0,0,99.743148,0.01418299999998851,644151,0
"172.16.133.83",57129,"172.16.139.250",5440,12,1142,9430,0,0,12,1142,0,0,99.751102,0.013880999999997812,658165,0
"172.16.133.93",60757,"172.16.139.250",5440,10,1022,9431,0,0,10,1022,0,0,99.768426,0.014265999999992118,573110,0
"172.16.133.11",55180,"172.16.139.250",5440,10,1022,9432,0,0,10,1022,0,0,99.785403,0.005541999999991276,1475279,0
"172.16.133.55",57657,"172.16.139.250",5440,10,1022,9433,0,0,10,1022,0,0,99.789667,0.014543000000003303,562194,0
"172.16.133.25",63495,"216.219.112.250",443,6,366,9434,0,0,4,246,2,120,99.789669,0.20290899999999112,9698,4731
"172.16.133.25",63496,"216.115.222.200",443,6,366,9435,0,0,4,246,2,120,99.790086,0.09351699999999141,21044,10265
"172.16.133.25",63497,"202.173.24.200",443,6,366,9436,0,0,4,246,2,120,99.791663,0.4869429999999966,4041,1971
"172.16.133.25",63498,"66.151.158.187",443,6,366,9437,0,0,4,246,2,120,99.792065,0.19353000000000975,10168,4960
"172.16.133.73",60711,"172.16.139.250",5440,10,1022,9438,0,0,10,1022,0,0,99.813114,0.016047000000000367,509503,0
"172.16.133.53",54137,"172.16.139.250",5440,10,1022,9439,0,0,10,1022,0,0,99.814947,0.005746000000002027,1422902,0
"172.16.133.21",53232,"172.16.139.250",5440,12,1142,9440,0,0,12,1142,0,0,99.818043,0.016506999999990057,553462,0
"172.16.133.30",62659,"172.16.139.250",5440,10,1022,9441,0,0,10,1022,0,0,99.820831,0.02057999999999538,397278,0
"172.16.133.25",63499,"172.16.139.250",5440,10,1022,9442,0,0,10,1022,0,0,99.829357,0.008672000000004232,942804,0
"172.16.133.34",50477,"172.16.139.250",5440,10,1022,9443,0,0,10,1022,0,0,99.837604,0.015847000000007938,515933,0
"172.16.133.97",59410,"172.16.139.250",5440,10,1022,9444,0,0,10,1022,0,0,99.849995,0.00705899999999815,1158237,0
"172.16.133.33",57919,"172.16.139.250",5440,12,1142,9445,0,0,12,1142,0,0,99.924758,0.04907300000000703,186171,0
"172.16.133.68",60783,"172.16.139.250",5440,12,1142,9446,0,0,12,1142,0,0,99.954671,0.06114699999999118,149410,0
"172.16.133.12",59816,"172.16.139.250",5440,12,1142,9447,0,0,12,1142,0,0,99.968336,0.05107000000000994,178891,0
"172.16.133.63",53919,"172.16.139.250",5440,12,1142,9448,0,0,12,1142,0,0,99.977664,0.04488800000000026,203528,0
"172.16.133.66",53917,"172.16.139.250",5440,10,1022,9449,0,0,10,1022,0,0,99.993701,0.03214400000000239,254355,0
"172.16.133.82",61386,"172.16.139.250",5440,12,1142,9450,0,0,12,1142,0,0,100.005583,0.024936999999994214,366363,0
"172.16.133.68",60784,"67.217.64.244",443,6,366,9451,0,0,4,246,2,120,100.005969,0.06110800000000438,32205,15709
"172.16.133.37",60663,"172.16.139.250",5440,10,1022,9452,0,0,10,1022,0,0,100.019906,0.017468999999991297,468029,0
"172.16.133.68",60785,"216.115.223.200",443,6,366,9453,0,0,4,246,2,120,100.068103,0.08630600000000754,22802,11123
"172.16.133.68",60786,"66.151.150.190",443,6,366,9454,0,0,4,246,2,120,100.172091,0.19574700000001144,10053,4904
"172.16.133.68",60787,"216.219.113.250",443,6,366,9455,0,0,4,246,2,120,100.17496,0.22569900000000587,8719,4253
"172.16.133.78",59247,"172.16.139.250",5440,10,1022,9456,0,0,10,1022,0,0,100.176208,0.006312999999991575,1295105,0
"172.16.133.67",56024,"172.16.139.250",5440,12,1142,9457,0,0,12,1142,0,0,100.230365,0.006100999999986811,1497459,0
"172.16.133.56",61468,"172.16.139.250",5440,12,1142,9458,0,0,12,1142,0,0,100.252927,0.00523300000000404,1745843,0
"172.16.133.116",53487,"96.43.146.48",443,25,8019,9459,0,0,14,2662,11,5357,100.300873,87.97778600000001,242,487
"172.16.133.41",53058,"172.16.139.250",5440,10,1022,9460,0,0,10,1022,0,0,100.309892,0.005309999999994375,1539736,0
"172.16.133.42",57165,"172.16.139.250",5440,12,1142,9461,0,0,12,1142,0,0,100.314825,0.04638699999999574,196951,0
"172.16.133.85",52311,"172.16.139.250",5440,10,1022,9462,0,0,10,1022,0,0,100.325889,0.014543000000003303,562194,0
"172.16.133.43",57821,"172.16.139.250",5440,12,1142,9463,0,0,12,1142,0,0,100.3796,0.006185999999999581,1476883,0
"172.16.133.13",53077,"172.16.139.250",5440,10,1022,9464,0,0,10,1022,0,0,100.39896,0.00525899999999524,1554668,0
"172.16.133.20",62433,"172.16.139.250",5440,12,1142,9465,0,0,12,1142,0,0,100.446727,0.004946000000003892,"",""
"172.16.133.57",60616,"67.217.64.244",443,6,378,9466,0,0,4,258,2,120,100.45318,0.053860999999997716,38320,17823
"172.16.133.75",51001,"172.16.139.250",5440,10,1022,9467,0,0,10,1022,0,0,100.465267,0.005493999999998778,1488168,0
"172.16.133.28",65469,"172.16.139.250",5440,10,1022,9468,0,0,10,1022,0,0,100.477697,0.005337999999994736,1531659,0
"172.16.133.99",56082,"172.16.139.250",5440,12,1142,9469,0,0,12,1142,0,0,100.506103,0.005091000000007284,1794539,0
"172.16.133.57",60617,"216.115.223.200",443,6,378,9470,0,0,4,258,2,120,100.5152,0.07616100000001325,27100,12604
"172.16.133.93",60758,"168.215.63.101",80,9,1186,9471,0,0,5,771,4,415,100.515859,0.196842999999987,31334,16866
"172.16.133.36",65079,"54.243.254.190",443,31,11831,9472,0,0,17,5887,14,5944,100.523061,74.031729,636,642
"172.16.133.87",60247,"172.16.139.250",5440,10,1022,9473,0,0,10,1022,0,0,100.527065,0.005657000000013568,1445289,0
"172.16.133.63",53920,"180.153.31.250",443,6,366,9474,0,0,4,246,2,120,100.540803,0.47131000000000256,4175,2036
"172.16.133.116",53488,"172.16.139.250",5440,10,1022,9475,0,0,10,1022,0,0,100.542752,0.004962000000006128,"",""
"172.16.133.35",50012,"172.16.139.250",5440,12,1142,9476,0,0,12,1142,0,0,100.545082,0.010471000000009667,872505,0
"172.16.133.116",53489,"172.16.139.250",5440,10,1022,9477,0,0,10,1022,0,0,100.548753,0.008234999999999104,992835,0
"172.16.133.116",53490,"172.16.139.250",5440,10,1022,9478,0,0,10,1022,0,0,100.557884,0.01660900000000254,492263,0
"172.16.133.84",58831,"172.16.139.250",5440,10,1022,9479,0,0,10,1022,0,0,100.565305,0.005481000000003178,1491698,0
"172.16.133.49",55826,"172.16.139.250",5440,12,1142,9480,0,0,12,1142,0,0,100.641396,0.006427999999999656,1421281,0
"172.16.133.95",57008,"172.16.139.250",5440,10,1022,9481,0,0,10,1022,0,0,100.679375,0.01470000000000482,556190,0
"172.16.133.92",57722,"172.16.139.250",5440,10,1022,9482,0,0,10,1022,0,0,100.707913,0.005516000000000076,1482233,0
"172.16.133.57",60618,"66.151.150.190",443,6,378,9483,0,0,4,258,2,120,100.709538,0.18760800000001154,11001,5117
"172.16.133.57",60619,"216.219.113.250",443,6,378,9484,0,0,4,258,2,120,100.718641,0.19692299999999818,10481,4875
"172.16.133.29",60992,"172.16.139.250",5440,10,1022,9485,0,0,10,1022,0,0,100.726146,0.01542499999999336,530048,0
"172.16.133.44",64875,"172.16.139.250",5440,10,1022,9486,0,0,10,1022,0,0,100.731152,0.015315999999998553,533820,0
"172.16.133.54",64311,"96.43.146.48",443,6,394,9487,0,0,3,197,3,197,100.744562,0.04064800000000446,38771,38771
"172.16.133.207",55972,"172.16.139.250",5440,12,1142,9488,0,0,12,1142,0,0,100.757084,0.0176179999999988,518560,0
"172.16.133.83",57130,"172.16.139.250",5440,12,1142,9489,0,0,12,1142,0,0,100.766224,0.004632000000000858,"",""
"65.55.71.93",443,"172.16.133.82",50083,4,252,9490,0,0,2,120,2,132,100.77805,120.083026,7,8
"172.16.133.93",60759,"172.16.139.250",5440,12,1142,9491,0,0,12,1142,0,0,100.782309,0.01467200000000446,622682,0
"172.16.133.11",55181,"172.16.139.250",5440,10,1022,9492,0,0,10,1022,0,0,100.798829,0.015243999999995594,536342,0
"172.16.133.55",57658,"172.16.139.250",5440,12,1142,9493,0,0,12,1142,0,0,100.803835,0.015323999999992566,596188,0
"172.16.133.73",60712,"172.16.139.250",5440,10,1022,9494,0,0,10,1022,0,0,100.826958,0.00561499999999171,1456099,0
"172.16.133.53",54138,"172.16.139.250",5440,12,1142,9495,0,0,12,1142,0,0,100.828783,0.015300999999993792,597085,0
"172.16.133.21",53233,"172.16.139.250",5440,10,1022,9496,0,0,10,1022,0,0,100.832058,0.005675999999994019,1440451,0
"172.16.133.30",62660,"172.16.139.250",5440,10,1022,9497,0,0,10,1022,0,0,100.835128,0.01678700000000788,487043,0
"172.16.133.25",63500,"172.16.139.250",5440,12,1142,9498,0,0,12,1142,0,0,100.843165,0.0050829999999990605,1797363,0
"172.16.133.34",50478,"172.16.139.250",5440,10,1022,9499,0,0,10,1022,0,0,100.852714,0.004940999999988094,"",""
"172.16.133.97",59411,"172.16.139.250",5440,10,1022,9500,0,0,10,1022,0,0,100.862759,0.014632000000005974,558775,0
"172.16.133.75",51002,"68.64.24.250",443,6,366,9501,0,0,4,246,2,120,100.929852,0.10129799999999989,19427,9476
"172.16.133.33",57920,"172.16.139.250",5440,12,1142,9502,0,0,12,1142,0,0,100.936938,0.017316000000008103,527604,0
"172.16.133.75",51003,"216.219.118.244",443,6,366,9503,0,0,4,246,2,120,100.940708,0.22087999999999397,8909,4346
"172.16.133.75",51004,"78.108.118.250",443,6,366,9504,0,0,4,246,2,120,100.941782,0.21018899999999974,9363,4567
"172.16.133.68",60788,"172.16.139.250",5440,10,1022,9505,0,0,10,1022,0,0,100.968495,0.014697999999995659,556266,0
"172.16.133.12",59817,"172.16.139.250",5440,12,1142,9506,0,0,12,1142,0,0,100.981674,0.0062309999999996535,1466217,0
"172.16.133.63",53921,"172.16.139.250",5440,10,1022,9507,0,0,10,1022,0,0,100.992502,0.005470000000002528,1494698,0
"172.16.133.66",53918,"172.16.139.250",5440,10,1022,9508,0,0,10,1022,0,0,101.007369,0.005312000000003536,1539156,0
"172.16.133.82",61387,"172.16.139.250",5440,10,1022,9509,0,0,10,1022,0,0,101.020798,0.005610000000004334,1457397,0
"172.16.133.37",60664,"172.16.139.250",5440,12,1142,9510,0,0,12,1142,0,0,101.033735,0.006713000000004854,1360941,0
"172.16.133.75",51005,"216.115.219.126",443,6,366,9511,0,0,4,246,2,120,101.11483,0.4835130000000021,4070,1985
"172.16.133.78",59248,"172.16.139.250",5440,10,1022,9512,0,0,10,1022,0,0,101.191526,0.005569000000008373,1468127,0
"172.16.133.67",56025,"172.16.139.250",5440,12,1142,9513,0,0,12,1142,0,0,101.244326,0.005920000000003256,1543243,0
"172.16.133.56",61469,"172.16.139.250",5440,10,1022,9514,0,0,10,1022,0,0,101.26775,0.004724999999993429,"",""
"172.16.133.41",53059,"172.16.139.250",5440,12,1142,9515,0,0,12,1142,0,0,101.322646,0.006425999999990495,1421724,0
"172.16.133.42",57166,"172.16.139.250",5440,12,1142,9516,0,0,12,1142,0,0,101.331012,0.0514129999999966,177698,0
"172.16.133.85",52312,"172.16.139.250",5440,10,1022,9517,0,0,10,1022,0,0,101.340297,0.005530999999990627,1478213,0
"172.16.133.43",57822,"172.16.139.250",5440,10,1022,9518,0,0,10,1022,0,0,101.39429,0.00514599999999632,1588806,0
"172.16.133.13",53078,"172.16.139.250",5440,10,1022,9519,0,0,10,1022,0,0,101.411914,0.015183000000007496,538497,0
"172.16.133.20",62434,"172.16.139.250",5440,10,1022,9520,0,0,10,1022,0,0,101.462108,0.004919000000001006,"",""
"172.16.133.75",51006,"172.16.139.250",5440,10,1022,9521,0,0,10,1022,0,0,101.47943,0.004944000000008941,"",""
"172.16.133.28",65470,"172.16.139.250",5440,10,1022,9522,0,0,10,1022,0,0,101.491395,0.0057929999999970505,1411358,0
"172.16.133.99",56083,"172.16.139.250",5440,12,1142,9523,0,0,12,1142,0,0,101.519578,0.015731000000002382,580764,0
"172.16.133.87",60248,"172.16.139.250",5440,10,1022,9524,0,0,10,1022,0,0,101.541102,0.005732000000008952,1426378,0
"172.16.133.116",53491,"172.16.139.250",5440,10,1022,9525,0,0,10,1022,0,0,101.55604,0.004845000000003097,"",""
"172.16.133.35",50013,"172.16.139.250",5440,12,1142,9526,0,0,12,1142,0,0,101.56159099999999,0.029963000000009288,304909,0
"172.16.133.116",53492,"172.16.139.250",5440,10,1022,9527,0,0,10,1022,0,0,101.561808,0.005496000000007939,1487627,0
"172.16.133.116",53493,"172.16.139.250",5440,10,1022,9528,0,0,10,1022,0,0,101.56825,0.005185999999994806,1576552,0
"172.16.133.84",58832,"172.16.139.250",5440,10,1022,9529,0,0,10,1022,0,0,101.578093,0.00715900000000147,1142058,0
"172.16.133.49",55827,"172.16.139.250",5440,12,1142,9530,0,0,12,1142,0,0,101.655191,0.016607999999990852,550096,0
"172.16.133.95",57009,"172.16.139.250",5440,10,1022,9531,0,0,10,1022,0,0,101.69364,0.009080999999994788,900341,0
"172.16.133.92",57723,"172.16.139.250",5440,10,1022,9532,0,0,10,1022,0,0,101.720882,0.0070750000000003865,1155618,0
"172.16.133.29",60993,"172.16.139.250",5440,10,1022,9533,0,0,10,1022,0,0,101.738769,0.007753999999991379,1054423,0
"172.16.133.44",64876,"172.16.139.250",5440,10,1022,9534,0,0,10,1022,0,0,101.745283,0.006484000000000378,1260950,0
"172.16.133.207",55973,"172.16.139.250",5440,12,1142,9535,0,0,12,1142,0,0,101.770899,0.01782900000000609,512423,0
"172.16.133.83",57131,"172.16.139.250",5440,10,1022,9536,0,0,10,1022,0,0,101.780234,0.004652000000007206,"",""
"172.16.133.93",60760,"172.16.139.250",5440,12,1142,9537,0,0,12,1142,0,0,101.795589,0.00494199999999978,"",""
"172.16.133.11",55182,"172.16.139.250",5440,10,1022,9538,0,0,10,1022,0,0,101.813676,0.0063880000000011705,1279899,0
"172.16.133.55",57659,"172.16.139.250",5440,12,1142,9539,0,0,12,1142,0,0,101.818629,0.006421000000003119,1422831,0
"172.16.133.73",60713,"172.16.139.250",5440,12,1142,9540,0,0,12,1142,0,0,101.840759,0.006744999999995116,1354484,0
"172.16.133.25",63501,"216.115.222.200",443,6,366,9541,0,0,4,246,2,120,101.841881,0.07324699999999496,26867,13106
"172.16.133.53",54139,"172.16.139.250",5440,12,1142,9542,0,0,12,1142,0,0,101.843837,0.006962000000001467,1312266,0
"172.16.133.21",53234,"172.16.139.250",5440,10,1022,9543,0,0,10,1022,0,0,101.846126,0.00866999999999507,943021,0
"172.16.133.30",62661,"172.16.139.250",5440,10,1022,9544,0,0,10,1022,0,0,101.848845,0.009696000000005256,843234,0
"172.16.133.25",63502,"172.16.139.250",5440,12,1142,9545,0,0,12,1142,0,0,101.857451,0.005177000000003318,1764728,0
"172.16.133.34",50479,"172.16.139.250",5440,10,1022,9546,0,0,10,1022,0,0,101.866418,0.014879000000007636,549499,0
"172.16.133.97",59412,"172.16.139.250",5440,10,1022,9547,0,0,10,1022,0,0,101.876962,0.007967999999991093,1026104,0
"172.16.133.25",63503,"216.219.112.250",443,6,366,9548,0,0,4,246,2,120,101.892882,0.21003899999999476,9369,4570
"172.16.133.25",63504,"66.151.158.187",443,6,366,9549,0,0,4,246,2,120,101.89572,0.19244400000000894,10226,4988
"172.16.133.33",57921,"172.16.139.250",5440,12,1142,9550,0,0,12,1142,0,0,101.950993,0.006229000000004703,1466688,0
"172.16.133.68",60789,"172.16.139.250",5440,10,1022,9551,0,0,10,1022,0,0,101.982761,0.015731999999999857,519705,0
"172.16.133.12",59818,"172.16.139.250",5440,12,1142,9552,0,0,12,1142,0,0,101.995732,0.008812999999989302,1036650,0
"172.16.133.63",53922,"172.16.139.250",5440,12,1142,9553,0,0,12,1142,0,0,102.005423,0.0054750000000041155,1668675,0
"172.16.133.66",53919,"172.16.139.250",5440,10,1022,9554,0,0,10,1022,0,0,102.021933,0.005341999999998848,1530512,0
"172.16.133.82",61388,"172.16.139.250",5440,12,1142,9555,0,0,12,1142,0,0,102.033649,0.005672000000004118,1610719,0
"172.16.133.25",63505,"202.173.24.200",443,6,366,9556,0,0,4,246,2,120,102.038851,0.49157800000000407,4003,1952
"172.16.133.68",60790,"67.217.64.244",443,6,366,9557,0,0,4,246,2,120,102.041157,0.07659300000000258,25694,12533
"172.16.133.37",60665,"172.16.139.250",5440,12,1142,9558,0,0,12,1142,0,0,102.048425,0.022421000000008462,407475,0
"172.16.133.54",64515,"12.130.48.51",80,32,24258,9559,0,0,13,2370,19,21888,102.076135,7.307702000000006,2594,23961
"172.16.133.54",64516,"12.130.48.51",80,59,43191,9560,0,0,26,5564,33,37627,102.076903,7.3070379999999915,6091,41195
"172.16.133.54",64517,"12.130.48.51",80,20,9660,9561,0,0,9,2909,11,6751,102.077974,7.3061150000000055,3185,7392
"172.16.133.54",64518,"12.130.48.51",80,9,1655,9562,0,0,5,1103,4,552,102.079845,7.304331999999988,1208,604
"172.16.133.68",60791,"216.115.223.200",443,6,366,9563,0,0,4,246,2,120,102.115194,0.09498999999999569,20717,10106
"172.16.133.54",64519,"173.194.43.4",80,12,3736,9564,0,0,7,1478,5,2258,102.128448,116.057767,101,155
"172.16.133.54",64520,"72.21.91.196",80,13,4808,9565,0,0,6,1355,7,3453,102.197242,5.1626289999999955,2099,5350
"172.16.133.54",64521,"72.21.91.196",80,6,372,9566,0,0,4,246,2,126,102.198462,5.619510999999989,350,179
"172.16.133.78",59249,"172.16.139.250",5440,12,1142,9567,0,0,12,1142,0,0,102.204926,0.006085999999996261,1501150,0
"172.16.133.235",2698,"172.16.131.10",8080,39,16121,9568,0,0,20,13871,19,2250,102.254927,18.413809999999998,6026,977
"172.16.133.67",56026,"172.16.139.250",5440,12,1142,9569,0,0,12,1142,0,0,102.258786,0.005722000000005778,1596644,0
"172.16.133.68",60792,"66.151.150.190",443,6,366,9570,0,0,4,246,2,120,102.274243,0.27330700000000263,7200,3512
"172.16.133.56",61470,"172.16.139.250",5440,10,1022,9571,0,0,10,1022,0,0,102.280801,0.014769000000001142,553591,0
"172.16.133.68",60793,"216.219.113.250",443,6,366,9572,0,0,4,246,2,120,102.287101,0.26401399999998887,7454,3636
"172.16.133.41",53060,"172.16.139.250",5440,12,1142,9573,0,0,12,1142,0,0,102.337637,0.005641999999994596,1619283,0
"172.16.133.85",52313,"172.16.139.250",5440,10,1022,9574,0,0,10,1022,0,0,102.355046,0.005434999999991419,1504323,0
"172.16.133.42",57167,"172.16.139.250",5440,12,1142,9575,0,0,12,1142,0,0,102.360044,0.019671000000002437,464440,0
"172.16.133.43",57823,"172.16.139.250",5440,12,1142,9576,0,0,12,1142,0,0,102.4078,0.0062040000000109785,1472598,0
"172.16.133.13",53079,"172.16.139.250",5440,10,1022,9577,0,0,10,1022,0,0,102.426994,0.005557000000010248,1471297,0
"172.16.133.55",57660,"72.32.20.57",80,23,16853,9578,0,0,9,1251,14,15602,102.46984,0.2948849999999936,33938,423270
"172.16.133.20",62435,"172.16.139.250",5440,12,1142,9579,0,0,12,1142,0,0,102.475586,0.004910999999992782,"",""
"172.16.133.75",51007,"172.16.139.250",5440,10,1022,9581,0,0,10,1022,0,0,102.492223,0.005289000000004762,1545849,0
"172.16.133.28",65471,"172.16.139.250",5440,10,1022,9582,0,0,10,1022,0,0,102.505279,0.005720999999994092,1429120,0
"172.16.133.99",56084,"172.16.139.250",5440,10,1022,9583,0,0,10,1022,0,0,102.534253,0.017277999999990357,473202,0
"172.16.133.87",60249,"172.16.139.250",5440,10,1022,9584,0,0,10,1022,0,0,102.557036,0.014717000000004532,555548,0
"172.16.133.35",50014,"172.16.139.250",5440,12,1142,9585,0,0,12,1142,0,0,102.568003,0.015568000000001803,586844,0
"172.16.133.116",53494,"172.16.139.250",5440,10,1022,9586,0,0,10,1022,0,0,102.570291,0.015370000000004325,531945,0
"172.16.133.116",53495,"172.16.139.250",5440,10,1022,9587,0,0,10,1022,0,0,102.586642,0.005069000000005985,1612941,0
"172.16.133.84",58833,"172.16.139.250",5440,12,1142,9588,0,0,12,1142,0,0,102.592299,0.01606999999999914,568512,0
"172.16.133.116",53496,"172.16.139.250",5440,10,1022,9589,0,0,10,1022,0,0,102.592527,0.005341999999998848,1530512,0
"172.16.133.54",64522,"173.204.219.5",80,8,2335,9590,0,0,5,1113,3,1222,102.621462,0.09221900000000005,96552,106008
"172.16.133.54",64523,"216.52.121.177",80,9,1445,9591,0,0,5,834,4,611,102.622138,0.09797399999999357,68099,49890
"172.16.133.54",64524,"216.52.121.177",80,7,432,9592,0,0,4,246,3,186,102.652826,5.170998999999995,380,287
"172.16.133.49",55828,"172.16.139.250",5440,10,1022,9593,0,0,10,1022,0,0,102.669119,0.016227000000000658,503851,0
"172.16.133.54",64525,"199.27.74.193",80,6,372,9594,0,0,4,246,2,126,102.681661,6.108699999999999,322,165
"172.16.133.54",64526,"199.27.74.193",80,6,372,9595,0,0,4,246,2,126,102.681947,6.107669000000001,322,165
"172.16.133.18",50294,"174.129.20.55",443,28,9770,9596,0,0,15,2516,13,7254,102.699533,10.36806,1941,5597
"172.16.133.95",57010,"172.16.139.250",5440,10,1022,9597,0,0,10,1022,0,0,102.707803,0.00623400000000629,1311517,0
"65.54.48.76",443,"172.16.133.40",53331,7,1043,9598,0,0,3,732,4,311,102.718108,177.52606799999998,32,14
"172.16.133.92",57724,"172.16.139.250",5440,10,1022,9599,0,0,10,1022,0,0,102.735668,0.016787999999991143,487014,0
"172.16.133.16",59334,"174.129.250.132",80,8,1578,9600,0,0,5,985,3,593,102.747132,0.11228499999999997,70178,42249
"172.16.133.16",59335,"208.92.52.90",80,10,1775,9601,0,0,5,965,5,810,102.751578,0.10851300000000208,71143,59716
"172.16.133.29",60994,"172.16.139.250",5440,10,1022,9602,0,0,10,1022,0,0,102.754039,0.005322999999989975,1535975,0
"172.16.133.44",64877,"172.16.139.250",5440,12,1142,9603,0,0,12,1142,0,0,102.758951,0.015326999999999202,596072,0
"172.16.133.207",55974,"172.16.139.250",5440,10,1022,9604,0,0,10,1022,0,0,102.78487,0.004860000000007858,"",""
"172.16.133.63",53923,"180.153.31.250",443,6,366,9605,0,0,4,246,2,120,102.786124,0.4656169999999946,4226,2061
"172.16.133.83",57132,"172.16.139.250",5440,12,1142,9606,0,0,12,1142,0,0,102.794379,0.00494199999999978,"",""
"172.16.133.93",60761,"172.16.139.250",5440,12,1142,9607,0,0,12,1142,0,0,102.809536,0.014414000000002147,633828,0
"172.16.133.11",55183,"172.16.139.250",5440,10,1022,9608,0,0,10,1022,0,0,102.8288,0.005624999999994884,1453511,0
"172.16.133.55",57661,"172.16.139.250",5440,12,1142,9609,0,0,12,1142,0,0,102.831612,0.015668999999988387,583062,0
"172.16.133.73",60714,"172.16.139.250",5440,10,1022,9610,0,0,10,1022,0,0,102.85439,0.005076999999999998,1610399,0
"172.16.133.53",54140,"172.16.139.250",5440,12,1142,9611,0,0,12,1142,0,0,102.858106,0.01605699999998933,568973,0
"172.16.133.21",53235,"172.16.139.250",5440,10,1022,9612,0,0,10,1022,0,0,102.860092,0.01729900000000839,472628,0
"172.16.133.30",62663,"172.16.139.250",5440,10,1022,9613,0,0,10,1022,0,0,102.863206,0.005457999999990193,1497984,0
"172.16.133.25",63506,"172.16.139.250",5440,10,1022,9614,0,0,10,1022,0,0,102.871501,0.009647999999998547,847429,0
"172.16.133.34",50480,"172.16.139.250",5440,10,1022,9615,0,0,10,1022,0,0,102.879836,0.005825999999998999,1403364,0
"172.16.133.97",59413,"172.16.139.250",5440,10,1022,9616,0,0,10,1022,0,0,102.892022,0.015551000000002091,525753,0
"172.16.133.33",57922,"172.16.139.250",5440,10,1022,9617,0,0,10,1022,0,0,102.964136,0.0062130000000024665,1315950,0
"172.16.133.30",62664,"157.56.237.150",443,23,11264,9618,0,0,10,3134,13,8130,102.982192,2.2535570000000007,11125,28861
"172.16.133.75",51008,"68.64.24.250",443,6,366,9619,0,0,4,246,2,120,102.988713,0.09822799999999177,20035,9773
"172.16.133.68",60794,"172.16.139.250",5440,10,1022,9620,0,0,10,1022,0,0,102.996596,0.014729000000002657,555095,0
"172.16.133.54",64527,"108.170.193.53",80,11,3859,9621,0,0,6,2328,5,1531,103.004381,0.18850100000000225,98800,64975
"172.16.133.54",64528,"108.170.193.53",80,11,3859,9622,0,0,6,2328,5,1531,103.006991,0.187334000000007,99416,65380
"172.16.133.54",64529,"108.170.193.53",80,11,3855,9623,0,0,6,2328,5,1527,103.008725,0.18931500000000767,98375,64527
"172.16.133.54",64530,"108.170.193.53",80,11,3851,9624,0,0,6,2328,5,1523,103.00992,0.18862100000001192,98737,64595
"172.16.133.54",64531,"108.170.193.53",80,11,3856,9625,0,0,6,2329,5,1527,103.010407,0.1879289999999969,99143,65003
"172.16.133.54",64532,"108.170.193.53",80,12,3903,9626,0,0,6,2328,6,1575,103.010882,0.18591800000000092,100173,67771
"172.16.133.12",59819,"172.16.139.250",5440,10,1022,9627,0,0,10,1022,0,0,103.011889,0.01610300000000109,507731,0
"172.16.133.63",53924,"172.16.139.250",5440,10,1022,9628,0,0,10,1022,0,0,103.020482,0.015602000000001226,524035,0
"172.16.133.66",53920,"172.16.139.250",5440,10,1022,9629,0,0,10,1022,0,0,103.034664,0.005472999999994954,1493879,0
"172.16.133.82",61389,"172.16.139.250",5440,10,1022,9630,0,0,10,1022,0,0,103.047932,0.005749999999991928,1421913,0
"172.16.133.75",51009,"78.108.118.250",443,6,366,9631,0,0,4,246,2,120,103.053784,0.195052000000004,10089,4921
"172.16.133.37",60666,"172.16.139.250",5440,10,1022,9632,0,0,10,1022,0,0,103.061218,0.015720000000001733,520101,0
"172.16.133.75",51010,"216.219.118.244",443,8,486,9633,0,0,5,306,3,180,103.063786,3.209251000000009,762,448
"172.16.133.54",64533,"108.170.193.53",80,11,3851,9634,0,0,6,2328,5,1523,103.130098,0.18428999999999007,101058,66113
"172.16.133.54",64534,"108.170.193.53",80,14,5270,9635,0,0,8,2454,6,2816,103.141561,0.48787800000000914,40239,46175
"172.16.133.54",64535,"108.170.193.53",80,15,5330,9636,0,0,8,2454,7,2876,103.144893,0.558985000000007,35120,41160
"172.16.133.54",64536,"108.170.193.53",80,14,5254,9637,0,0,8,2454,6,2800,103.145138,0.48559500000000355,40428,46128
"172.16.133.54",64537,"108.170.193.53",80,12,3911,9638,0,0,7,2388,5,1523,103.145368,0.485367999999994,39359,25102
"172.16.133.54",64538,"108.170.193.53",80,14,5262,9639,0,0,8,2454,6,2808,103.145592,0.4851430000000079,40466,46303
"172.16.133.78",59250,"172.16.139.250",5440,12,1142,9640,0,0,12,1142,0,0,103.217441,0.006537000000008675,1397582,0
"172.16.133.54",64539,"108.170.193.53",80,13,5915,9641,0,0,8,4384,5,1531,103.259727,0.5467409999999973,64147,22401
"172.16.133.67",56027,"172.16.139.250",5440,12,1142,9642,0,0,12,1142,0,0,103.272844,0.006267999999991503,1457562,0
"172.16.133.25",63507,"173.194.43.47",80,7,438,9643,0,0,5,312,2,126,103.289871,14.489968999999988,172,69
"172.16.133.56",61471,"172.16.139.250",5440,10,1022,9644,0,0,10,1022,0,0,103.29542000000001,0.019659999999987576,415869,0
"172.16.133.41",53061,"172.16.139.250",5440,12,1142,9645,0,0,12,1142,0,0,103.350596,0.015438000000003171,591786,0
"172.16.133.42",57168,"172.16.139.250",5440,12,1142,9646,0,0,12,1142,0,0,103.357815,0.06796400000000347,134424,0
"172.16.133.75",51011,"216.115.219.126",443,7,432,9647,0,0,5,312,2,120,103.361836,3.561616000000001,700,269
"172.16.133.85",52314,"172.16.139.250",5440,10,1022,9648,0,0,10,1022,0,0,103.367891,0.01478899999999328,552843,0
"172.16.133.43",57824,"172.16.139.250",5440,12,1142,9649,0,0,12,1142,0,0,103.421694,0.0062360000000012406,1465041,0
"172.16.133.13",53080,"172.16.139.250",5440,12,1142,9650,0,0,12,1142,0,0,103.439739,0.014746999999999844,619515,0
"172.16.133.20",62436,"172.16.139.250",5440,12,1142,9651,0,0,12,1142,0,0,103.488768,0.005105000000000359,1789618,0
"172.16.133.25",63508,"173.194.43.47",80,17,1972,9652,0,0,9,1078,8,894,103.498762,180.14892400000002,47,39
"172.16.133.75",51012,"172.16.139.250",5440,12,1142,9653,0,0,12,1142,0,0,103.507179,0.0066050000000075215,1383194,0
"172.16.133.28",65472,"172.16.139.250",5440,12,1142,9654,0,0,12,1142,0,0,103.519548,0.005493000000001302,1663207,0
"172.16.133.99",56085,"172.16.139.250",5440,12,1142,9655,0,0,12,1142,0,0,103.546818,0.014910000000000423,612743,0
"172.16.133.87",60250,"172.16.139.250",5440,12,1142,9656,0,0,12,1142,0,0,103.570193,0.006292999999999438,1451771,0
"172.16.133.116",53497,"172.16.139.250",5440,10,1022,9657,0,0,10,1022,0,0,103.585263,0.005650000000002819,1447079,0
"172.16.133.116",53498,"172.16.139.250",5440,10,1022,9658,0,0,10,1022,0,0,103.593505,0.006954000000007454,1175726,0
"172.16.133.116",53499,"172.16.139.250",5440,12,1142,9659,0,0,12,1142,0,0,103.601531,0.00634900000000016,1438966,0
"172.16.133.35",50015,"172.16.139.250",5440,12,1142,9660,0,0,12,1142,0,0,103.605488,0.03939000000001158,231937,0
"172.16.133.84",58834,"172.16.139.250",5440,10,1022,9661,0,0,10,1022,0,0,103.607574,0.018957000000000335,431291,0
"172.16.133.113",55633,"172.16.139.250",135,8,492,9662,0,0,8,492,0,0,103.676789,0.006966000000005579,565030,0
"172.16.133.49",55829,"172.16.139.250",5440,10,1022,9663,0,0,10,1022,0,0,103.683501,0.01566599999999596,521894,0
"172.16.133.113",55634,"172.16.139.250",5462,10,696,9664,0,0,10,696,0,0,103.686943,0.516695999999996,10776,0
"172.16.133.95",57011,"172.16.139.250",5440,10,1022,9665,0,0,10,1022,0,0,103.721884,0.01769399999999166,462077,0
"172.16.133.92",57725,"172.16.139.250",5440,10,1022,9666,0,0,10,1022,0,0,103.749944,0.01562699999999495,523197,0
"172.16.133.29",60995,"172.16.139.250",5440,12,1142,9667,0,0,12,1142,0,0,103.76792,0.015500000000002956,589419,0
"172.16.133.44",64878,"172.16.139.250",5440,12,1142,9668,0,0,12,1142,0,0,103.773088,0.015416000000001873,592631,0
"172.16.133.207",55975,"172.16.139.250",5440,12,1142,9669,0,0,12,1142,0,0,103.799193,0.017749999999992383,514704,0
"172.16.133.83",57133,"172.16.139.250",5440,10,1022,9670,0,0,10,1022,0,0,103.808343,0.004611000000011245,"",""
"172.16.133.93",60762,"172.16.139.250",5440,10,1022,9671,0,0,10,1022,0,0,103.823408,0.004665000000002806,"",""
"172.16.133.11",55184,"172.16.139.250",5440,12,1142,9672,0,0,12,1142,0,0,103.840858,0.006516000000004851,1402087,0
"172.16.133.55",57662,"172.16.139.250",5440,12,1142,9673,0,0,12,1142,0,0,103.845641,0.006269000000003189,1457329,0
"172.16.133.73",60715,"172.16.139.250",5440,10,1022,9674,0,0,10,1022,0,0,103.867889,0.005426999999997406,1506541,0
"172.16.133.53",54141,"172.16.139.250",5440,12,1142,9675,0,0,12,1142,0,0,103.871817,0.01592900000001407,573545,0
"172.16.133.21",53236,"172.16.139.250",5440,10,1022,9676,0,0,10,1022,0,0,103.87403,0.00586899999998991,1393082,0
"172.16.133.30",62665,"172.16.139.250",5440,10,1022,9677,0,0,10,1022,0,0,103.877375,0.00650100000000009,1257652,0
"172.16.133.25",63509,"216.115.222.200",443,6,366,9678,0,0,4,246,2,120,103.877871,0.0815900000000056,24120,11766
"172.16.133.25",63510,"172.16.139.250",5440,10,1022,9679,0,0,10,1022,0,0,103.885258,0.0064109999999999445,1275308,0
"172.16.133.34",50481,"172.16.139.250",5440,12,1142,9680,0,0,12,1142,0,0,103.893622,0.005152000000009593,1773291,0
"172.16.133.97",59414,"172.16.139.250",5440,12,1142,9681,0,0,12,1142,0,0,103.906154,0.006187999999994531,1476405,0
"172.16.133.54",64540,"74.121.139.112",80,27,15361,9682,0,0,14,7258,13,8103,103.91554,12.969463000000005,4476,4998
"172.16.133.54",64541,"74.121.139.112",80,15,6198,9683,0,0,7,2036,8,4162,103.915766,12.250233999999992,1329,2717
"172.16.133.33",57923,"172.16.139.250",5440,12,1142,9684,0,0,12,1142,0,0,103.977991,0.006444000000001893,1417752,0
"172.16.133.54",64542,"216.157.106.190",80,10,630,9685,0,0,6,378,4,252,103.978373,4.434073999999995,681,454
"172.16.133.54",64543,"216.157.106.190",80,11,1620,9686,0,0,6,873,5,747,103.978603,1.0934839999999895,6386,5465
"172.16.133.25",63511,"66.151.158.187",443,6,366,9687,0,0,4,246,2,120,103.992943,0.1759710000000041,11183,5455
"172.16.133.25",63512,"216.219.112.250",443,6,366,9688,0,0,4,246,2,120,104.002899,0.22957999999999856,8572,4181
"172.16.133.68",60795,"172.16.139.250",5440,10,1022,9689,0,0,10,1022,0,0,104.011473,0.015140999999999849,539990,0
"172.16.133.12",59820,"172.16.139.250",5440,12,1142,9690,0,0,12,1142,0,0,104.023966,0.00726099999999974,1258228,0
"172.16.133.63",53925,"172.16.139.250",5440,12,1142,9691,0,0,12,1142,0,0,104.033788,0.00586699999999496,1557184,0
"172.16.133.66",53921,"172.16.139.250",5440,10,1022,9692,0,0,10,1022,0,0,104.049666,0.01256099999999094,650903,0
"172.16.133.82",61390,"172.16.139.250",5440,12,1142,9693,0,0,12,1142,0,0,104.062853,0.015772999999995818,579217,0
"172.16.133.37",60667,"172.16.139.250",5440,10,1022,9694,0,0,10,1022,0,0,104.076123,0.016041000000001304,509693,0
"172.16.133.78",59251,"172.16.139.250",5440,10,1022,9695,0,0,10,1022,0,0,104.231731,0.004959999999996967,"",""
"172.16.133.54",64544,"74.125.226.47",80,124,117590,9696,0,0,42,5096,82,112494,104.234264,116.97811999999999,348,7693
"172.16.133.54",64545,"74.125.226.47",80,6,372,9697,0,0,4,246,2,126,104.254082,5.523019000000005,356,182
"172.16.133.25",63513,"202.173.24.200",443,6,366,9698,0,0,4,246,2,120,104.286932,0.5030760000000072,3911,1908
"172.16.133.67",56028,"172.16.139.250",5440,12,1142,9699,0,0,12,1142,0,0,104.286934,0.0064109999999999445,1425050,0
"172.16.133.56",61472,"172.16.139.250",5440,10,1022,9700,0,0,10,1022,0,0,104.309701,0.0048889999999914835,"",""
"172.16.133.54",64546,"216.157.106.190",80,9,564,9701,0,0,5,312,4,252,104.328036,4.695515,531,429
"172.16.133.54",64547,"157.56.134.97",80,13,6208,9702,0,0,7,2568,6,3640,104.357244,0.11821100000000229,173790,246339
"172.16.133.41",53062,"172.16.139.250",5440,10,1022,9703,0,0,10,1022,0,0,104.36581,0.005409999999997694,1511275,0
"172.16.133.42",57169,"172.16.139.250",5440,12,1142,9704,0,0,12,1142,0,0,104.368107,0.019040000000003943,479831,0
"172.16.133.85",52315,"172.16.139.250",5440,10,1022,9705,0,0,10,1022,0,0,104.382251,0.015062000000000353,542822,0
"172.16.133.43",57825,"172.16.139.250",5440,10,1022,9706,0,0,10,1022,0,0,104.435466,0.014705999999989672,555963,0
"172.16.133.13",53081,"172.16.139.250",5440,10,1022,9707,0,0,10,1022,0,0,104.454014,0.0053510000000045466,1527938,0
"172.16.133.54",64548,"208.47.254.57",80,6,372,9708,0,0,4,246,2,126,104.455124,5.300466,371,190
"172.16.133.54",64549,"65.54.81.133",80,139,128837,9709,0,0,53,12256,86,116581,104.486076,5.869633000000007,16704,158893
"172.16.133.20",62437,"172.16.139.250",5440,10,1022,9710,0,0,10,1022,0,0,104.50342,0.004595999999992273,"",""
"172.16.133.75",51013,"172.16.139.250",5440,10,1022,9711,0,0,10,1022,0,0,104.52092,0.0053319999999956735,1533383,0
"172.16.133.28",65474,"172.16.139.250",5440,10,1022,9712,0,0,10,1022,0,0,104.535336,0.005324000000001661,1535687,0
"172.16.133.54",64550,"65.54.81.133",80,8,492,9713,0,0,4,246,4,246,104.555367,5.20168799999999,378,378
"172.16.133.54",64551,"184.84.36.46",80,41,20497,9714,0,0,24,12950,17,7547,104.5566,150.678097,687,400
"172.16.133.54",64552,"184.84.36.46",80,6,372,9715,0,0,4,246,2,126,104.556998,5.228632000000005,376,192
"172.16.133.54",64553,"23.60.159.231",80,6,372,9716,0,0,4,246,2,126,104.557238,5.2205160000000035,376,193
"172.16.133.54",64554,"23.60.159.231",80,30,19899,9717,0,0,18,9393,12,10506,104.557454,155.671762,482,539
"172.16.133.99",56086,"172.16.139.250",5440,10,1022,9718,0,0,10,1022,0,0,104.559594,0.007978999999991743,1024689,0
"172.16.133.54",64555,"157.56.134.97",80,8,2799,9719,0,0,5,1434,3,1365,104.563339,0.1311060000000026,87501,83291
"172.16.133.54",64556,"157.56.134.97",80,13,6270,9720,0,0,7,2602,6,3668,104.574278,1.278700999999998,16279,22948
"172.16.133.87",60251,"172.16.139.250",5440,10,1022,9721,0,0,10,1022,0,0,104.58346,0.015191999999998984,538177,0
"172.16.133.35",50016,"172.16.139.250",5440,12,1142,9722,0,0,12,1142,0,0,104.596843,0.014111999999997238,647392,0
"172.16.133.116",53500,"172.16.139.250",5440,10,1022,9723,0,0,10,1022,0,0,104.596844,0.005883999999994671,1389530,0
"172.16.133.116",53501,"172.16.139.250",5440,10,1022,9724,0,0,10,1022,0,0,104.603242,0.008397000000002208,973681,0
"172.16.133.116",53502,"172.16.139.250",5440,12,1142,9725,0,0,12,1142,0,0,104.612121,0.014985999999993282,609635,0
"172.16.133.84",58835,"172.16.139.250",5440,12,1142,9726,0,0,12,1142,0,0,104.620197,0.014758000000000493,619054,0
"172.16.133.233",21295,"184.73.225.104",80,75,19902,9727,0,0,42,2532,33,17370,104.638083,0.19998999999999967,101285,694834
"172.16.133.233",28241,"172.16.125.220",80,7,420,9728,0,0,4,240,3,180,104.640496,0.20591799999999694,9324,6993
"172.16.133.163",3534,"68.64.24.250",443,6,366,9729,0,0,4,246,2,120,104.652025,0.10174800000000062,19341,9435
"172.16.133.163",3533,"216.219.118.244",443,6,366,9730,0,0,4,246,2,120,104.652027,0.20578499999999167,9563,4665
"172.16.133.163",3535,"78.108.118.250",443,6,366,9731,0,0,4,246,2,120,104.653219,0.20430700000000002,9632,4698
"172.16.133.163",3536,"216.115.219.126",443,6,366,9732,0,0,4,246,2,120,104.654382,0.496262999999999,3965,1934
"172.16.133.49",55830,"172.16.139.250",5440,12,1142,9733,0,0,12,1142,0,0,104.697123,0.07331399999999633,124614,0
"172.16.133.95",57012,"172.16.139.250",5440,10,1022,9734,0,0,10,1022,0,0,104.73579,0.03753000000000384,217852,0
"172.16.133.92",57726,"172.16.139.250",5440,12,1142,9735,0,0,12,1142,0,0,104.764045,0.013946000000004233,655098,0
"172.16.133.29",60996,"172.16.139.250",5440,12,1142,9736,0,0,12,1142,0,0,104.782433,0.006196000000002755,1474499,0
"172.16.133.44",64879,"172.16.139.250",5440,10,1022,9737,0,0,10,1022,0,0,104.787496,0.015309000000002015,534064,0
"172.16.133.54",64557,"173.194.75.104",80,28,11404,9738,0,0,16,7230,12,4174,104.792451,161.442191,358,206
"172.16.133.54",64558,"74.125.142.95",80,13,3064,9739,0,0,8,1588,5,1476,104.793252,116.442811,109,101
"172.16.133.54",64559,"74.125.142.95",80,70,57736,9740,0,0,25,4591,45,53145,104.79364,121.45303,302,3500
"172.16.133.54",64560,"74.125.142.95",80,18,7536,9741,0,0,9,2076,9,5460,104.793995,116.44288900000001,142,375
"172.16.133.6",1655,"172.16.128.203",1026,3,180,9742,0,0,2,120,1,60,104.797859,95.26430599999999,10,5
"172.16.133.207",55976,"172.16.139.250",5440,12,1142,9743,0,0,12,1142,0,0,104.81297,0.004892999999995595,"",""
"172.16.133.83",57134,"172.16.139.250",5440,12,1142,9744,0,0,12,1142,0,0,104.822269,0.014018999999990456,651686,0
"172.16.133.54",64561,"74.125.142.95",80,6,372,9745,0,0,4,246,2,126,104.832985,5.936214000000007,331,169
"172.16.133.93",60763,"172.16.139.250",5440,12,1142,9746,0,0,12,1142,0,0,104.837469,0.004931999999996606,"",""
"172.16.133.54",64562,"74.125.142.95",80,6,372,9747,0,0,4,246,2,126,104.837471,5.930785,331,169
"172.16.133.54",64563,"204.154.111.33",80,11,2594,9748,0,0,6,2068,5,526,104.853497,0.0702269999999885,235578,59919
"172.16.133.54",64564,"204.154.111.33",80,11,2862,9749,0,0,6,2336,5,526,104.853728,1.0381629999999973,18001,4053
"172.16.133.11",55185,"172.16.139.250",5440,12,1142,9750,0,0,12,1142,0,0,104.856031,0.016017000000005055,570393,0
"172.16.133.55",57663,"172.16.139.250",5440,10,1022,9751,0,0,10,1022,0,0,104.859384,0.01567499999998745,521594,0
"172.16.133.73",60716,"172.16.139.250",5440,10,1022,9752,0,0,10,1022,0,0,104.882022,0.004784999999998263,"",""
"172.16.133.53",54142,"172.16.139.250",5440,10,1022,9753,0,0,10,1022,0,0,104.885854,0.015129000000001724,540419,0
"172.16.133.21",53237,"172.16.139.250",5440,12,1142,9754,0,0,12,1142,0,0,104.88795,0.01788299999999765,510876,0
"172.16.133.30",62666,"172.16.139.250",5440,12,1142,9755,0,0,12,1142,0,0,104.8911,0.006864000000007309,1331002,0
"172.16.133.25",63518,"172.16.139.250",5440,10,1022,9756,0,0,10,1022,0,0,104.899387,0.009563999999997463,854872,0
"172.16.133.55",57664,"172.16.139.250",5440,10,1016,9757,0,0,10,1016,0,0,104.906959,0.005471999999997479,1485380,0
"172.16.133.34",50482,"172.16.139.250",5440,10,1022,9758,0,0,10,1022,0,0,104.907916,0.007542999999998301,1083918,0
"172.16.133.97",59415,"172.16.139.250",5440,10,1022,9759,0,0,10,1022,0,0,104.919325,0.016533999999992943,494496,0
"172.16.133.54",64565,"67.69.174.129",80,25,14321,9760,0,0,13,7152,12,7169,104.922666,142.30987299999998,402,403
"172.16.133.54",64566,"67.69.174.129",80,25,17111,9761,0,0,12,6656,13,10455,104.922902,142.30746100000002,374,587
"172.16.133.33",57924,"172.16.139.250",5440,10,1022,9762,0,0,10,1022,0,0,104.992561,0.005558000000007723,1471032,0
"172.16.133.63",53926,"180.153.31.250",443,6,366,9763,0,0,4,246,2,120,105.024216,0.47648399999999924,4130,2014
"172.16.133.68",60796,"172.16.139.250",5440,10,1022,9764,0,0,10,1022,0,0,105.025672,0.005542000000005487,1475279,0
"172.16.133.25",63519,"96.43.146.22",443,41,19296,9765,0,0,24,16446,17,2850,105.037845,168.602714,780,135
"172.16.133.12",59821,"172.16.139.250",5440,12,1142,9766,0,0,12,1142,0,0,105.037947,0.006293999999996913,1451541,0
"172.16.133.25",63520,"96.43.146.22",443,34,13936,9767,0,0,20,11586,14,2350,105.037949,193.903109,478,96
"172.16.133.25",63521,"96.43.146.22",443,15,1297,9768,0,0,8,748,7,549,105.038084,180.28539200000003,33,24
"172.16.133.75",51014,"68.64.24.250",443,6,366,9769,0,0,4,246,2,120,105.041885,0.1102210000000099,17855,8709
"172.16.133.63",53927,"172.16.139.250",5440,10,1022,9770,0,0,10,1022,0,0,105.047738,0.005316000000007648,1537998,0
"172.16.133.66",53922,"172.16.139.250",5440,10,1022,9771,0,0,10,1022,0,0,105.065706,0.005344999999991273,1529653,0
"172.16.133.82",61391,"172.16.139.250",5440,10,1022,9772,0,0,10,1022,0,0,105.075888,0.01576799999999423,518518,0
"172.16.133.37",60668,"172.16.139.250",5440,10,1022,9773,0,0,10,1022,0,0,105.090438,0.006080999999994674,1344515,0
"172.16.133.75",51015,"78.108.118.250",443,6,366,9774,0,0,4,246,2,120,105.15482,0.20533600000000263,9584,4675
"172.16.133.75",51016,"216.219.118.244",443,6,366,9775,0,0,4,246,2,120,105.178864,0.20561999999999614,9571,4668
"172.16.133.78",59252,"172.16.139.250",5440,10,1022,9776,0,0,10,1022,0,0,105.245516,0.005519000000006713,1481427,0
"172.16.133.67",56029,"172.16.139.250",5440,12,1142,9777,0,0,12,1142,0,0,105.300552,0.006048000000006937,1510582,0
"172.16.133.54",64567,"23.21.75.80",80,20,6769,9778,0,0,12,6109,8,660,105.322871,94.814588,515,55
"172.16.133.56",61473,"172.16.139.250",5440,10,1022,9779,0,0,10,1022,0,0,105.322992,0.004812000000001149,"",""
"172.16.133.54",64568,"23.21.75.80",80,23,7528,9780,0,0,14,6757,9,771,105.323206,99.797618,541,61
"172.16.133.54",64569,"74.125.226.1",80,12,2278,9781,0,0,7,980,5,1298,105.324864,115.891881,67,89
"172.16.133.54",64570,"74.125.226.1",80,28,24362,9782,0,0,9,1028,19,23334,105.325174,115.891449,70,1610
"172.16.133.54",64571,"74.125.226.1",80,28,24844,9783,0,0,9,1026,19,23818,105.325364,115.89025100000002,70,1644
"172.16.133.54",64572,"74.125.226.1",80,6,372,9784,0,0,4,246,2,126,105.325515,5.430381000000011,362,185
"172.16.133.54",64573,"74.125.226.1",80,6,372,9785,0,0,4,246,2,126,105.325731,5.430166999999997,362,185
"172.16.133.54",64574,"74.125.226.1",80,23,17023,9786,0,0,8,973,15,16050,105.325891,115.88534399999999,67,1107
"172.16.133.54",64575,"74.125.226.1",80,13,5887,9787,0,0,6,851,7,5036,105.326317,115.89066000000001,58,347
"172.16.133.54",64576,"74.125.226.1",80,10,1862,9788,0,0,6,853,4,1009,105.326574,115.89028300000001,58,69
"172.16.133.54",64577,"74.125.226.1",80,20,15260,9789,0,0,7,912,13,14348,105.326876,115.885717,62,990
"172.16.133.54",64578,"74.125.226.1",80,18,11567,9790,0,0,7,910,11,10657,105.32712,115.888615,62,735
"172.16.133.54",64579,"74.125.226.1",80,14,8072,9791,0,0,6,849,8,7223,105.327371,115.885366,58,498
"172.16.133.54",64580,"74.125.226.1",80,43,40689,9792,0,0,13,1271,30,39418,105.327618,115.884974,87,2721
"172.16.133.28",65475,"172.16.139.250",5440,10,1022,9793,0,0,10,1022,0,0,105.350807,0.005450999999993655,1499908,0
"172.16.133.41",53063,"172.16.139.250",5440,12,1142,9794,0,0,12,1142,0,0,105.378551,0.006210999999993305,1470938,0
"172.16.133.54",64581,"50.116.194.21",80,12,1981,9795,0,0,6,798,6,1183,105.384602,5.151557999999994,1239,1837
"172.16.133.54",64582,"50.116.194.21",80,6,366,9796,0,0,4,246,2,120,105.385009,5.372128000000004,366,178
"172.16.133.85",52316,"172.16.139.250",5440,10,1022,9797,0,0,10,1022,0,0,105.397521,0.0054800000000057025,1491970,0
"172.16.133.42",57170,"172.16.139.250",5440,12,1142,9798,0,0,12,1142,0,0,105.401034,0.08062499999999773,113314,0
"172.16.133.43",57826,"172.16.139.250",5440,10,1022,9799,0,0,10,1022,0,0,105.450981,0.015125999999995088,540526,0
"172.16.133.13",53082,"172.16.139.250",5440,10,1022,9800,0,0,10,1022,0,0,105.469077,0.005339000000006422,1531372,0
"172.16.133.20",62438,"172.16.139.250",5440,12,1142,9801,0,0,12,1142,0,0,105.516776,0.01486500000000035,614598,0
"172.16.133.75",51017,"172.16.139.250",5440,10,1022,9802,0,0,10,1022,0,0,105.534294,0.005352999999999497,1527367,0
"172.16.133.28",65476,"172.16.139.250",5440,12,1142,9803,0,0,12,1142,0,0,105.548582,0.006090999999997848,1499917,0
"172.16.133.99",56087,"172.16.139.250",5440,12,1142,9804,0,0,12,1142,0,0,105.574279,0.005311999999989325,1719879,0
"172.16.133.87",60252,"172.16.139.250",5440,10,1022,9805,0,0,10,1022,0,0,105.598857,0.005394000000009669,1515758,0
"172.16.133.35",50017,"172.16.139.250",5440,12,1142,9806,0,0,12,1142,0,0,105.61053,0.03546599999999955,257598,0
"172.16.133.116",53503,"172.16.139.250",5440,10,1022,9807,0,0,10,1022,0,0,105.611075,0.005488999999997191,1489524,0
"172.16.133.116",53504,"172.16.139.250",5440,10,1022,9808,0,0,10,1022,0,0,105.617668,0.005341000000001372,1530799,0
"172.16.133.116",53505,"172.16.139.250",5440,10,1022,9809,0,0,10,1022,0,0,105.623888,0.006433000000001243,1270946,0
"172.16.133.96",53345,"173.194.43.53",443,36,11649,9810,0,0,20,6299,16,5350,105.625343,30.557253999999986,1649,1400
"172.16.133.84",58836,"172.16.139.250",5440,10,1022,9811,0,0,10,1022,0,0,105.634497,0.005413000000004331,1510437,0
"172.16.133.54",64583,"209.190.70.254",80,13,7409,9812,0,0,6,3043,7,4366,105.659448,0.6315139999999957,38548,55308
"172.16.133.49",55831,"172.16.139.250",5440,10,1022,9813,0,0,10,1022,0,0,105.711328,0.005591000000009672,1462350,0
"172.16.133.95",57013,"172.16.139.250",5440,12,1142,9814,0,0,12,1142,0,0,105.749688,0.006176999999993882,1479035,0
"172.16.133.92",57727,"172.16.139.250",5440,10,1022,9815,0,0,10,1022,0,0,105.777178,0.005784999999988827,1413310,0
"172.16.133.29",60997,"172.16.139.250",5440,10,1022,9816,0,0,10,1022,0,0,105.795775,0.0055069999999943775,1484655,0
"172.16.133.44",64880,"172.16.139.250",5440,10,1022,9817,0,0,10,1022,0,0,105.801235,0.015388000000001512,531323,0
"172.16.133.207",55977,"172.16.139.250",5440,12,1142,9818,0,0,12,1142,0,0,105.826123,0.0146000000000015,625753,0
"172.16.133.83",57135,"172.16.139.250",5440,12,1142,9819,0,0,12,1142,0,0,105.836376,0.007921999999993545,1153244,0
"172.16.133.93",60764,"172.16.139.250",5440,10,1022,9820,0,0,10,1022,0,0,105.85169,0.004703999999989605,"",""
"172.16.133.11",55186,"172.16.139.250",5440,12,1142,9821,0,0,12,1142,0,0,105.872022,0.006212000000004991,1470701,0
"172.16.133.55",57665,"172.16.139.250",5440,10,1022,9822,0,0,10,1022,0,0,105.873811,0.007481999999995992,1092755,0
"172.16.133.73",60717,"172.16.139.250",5440,10,1022,9823,0,0,10,1022,0,0,105.896187,0.005261000000004401,1554077,0
"172.16.133.54",64584,"74.217.253.61",80,10,1693,9824,0,0,6,801,4,892,105.898122,115.300739,55,61
"172.16.133.54",64585,"74.217.253.61",80,7,432,9825,0,0,4,246,3,186,105.898446,5.819104999999993,338,255
"172.16.133.53",54143,"172.16.139.250",5440,10,1022,9826,0,0,10,1022,0,0,105.900299,0.005578999999997336,1465495,0
"172.16.133.21",53238,"172.16.139.250",5440,10,1022,9827,0,0,10,1022,0,0,105.901123,0.014707999999998833,555887,0
"172.16.133.30",62667,"172.16.139.250",5440,10,1022,9828,0,0,10,1022,0,0,105.905307,0.004666000000000281,"",""
"172.16.133.25",63522,"172.16.139.250",5440,12,1142,9829,0,0,12,1142,0,0,105.913267,0.01751199999999642,521699,0
"172.16.133.34",50483,"172.16.139.250",5440,10,1022,9830,0,0,10,1022,0,0,105.921879,0.004970000000000141,"",""
"172.16.133.25",63523,"216.115.222.200",443,6,366,9831,0,0,4,246,2,120,105.923444,0.09424400000000333,20881,10186
"172.16.133.97",59416,"172.16.139.250",5440,10,1022,9832,0,0,10,1022,0,0,105.932908,0.014592000000007488,560307,0
"172.16.133.54",64586,"206.165.250.99",80,8,2955,9833,0,0,5,1530,3,1425,105.93657,0.3122729999999905,39196,36506
"172.16.133.54",64587,"206.165.250.99",80,7,632,9834,0,0,4,246,3,386,105.936879,5.853787999999994,336,527
"172.16.133.54",64588,"64.215.255.57",80,8,1454,9835,0,0,5,1133,3,321,105.937433,0.08392200000000116,108005,30599
"172.16.133.54",64589,"64.215.255.57",80,7,632,9836,0,0,4,246,3,386,105.937735,5.778357999999997,340,534
"172.16.133.41",53064,"216.52.121.204",80,12,4012,9837,0,0,7,3436,5,576,105.943446,0.16293600000000197,168704,28281
"172.16.128.233",55251,"172.16.133.233",22,166,19508,9838,0,0,49,4120,117,15388,105.966003,8.066571999999994,4085,15261
"172.16.133.54",64590,"74.125.239.15",80,10,1268,9839,0,0,6,813,4,455,106.005326,116.26741100000001,55,31
"172.16.133.33",57925,"172.16.139.250",5440,10,1022,9840,0,0,10,1022,0,0,106.005906,0.014645000000001573,558279,0
"172.16.133.54",64591,"74.125.239.15",80,12,1680,9841,0,0,7,956,5,724,106.016726,116.25659199999998,65,49
"172.16.133.68",60797,"172.16.139.250",5440,12,1142,9842,0,0,12,1142,0,0,106.039888,0.006321999999997274,1445112,0
"172.16.133.12",59822,"172.16.139.250",5440,10,1022,9843,0,0,10,1022,0,0,106.051939,0.005409999999997694,1511275,0
"172.16.133.63",53928,"172.16.139.250",5440,10,1022,9844,0,0,10,1022,0,0,106.062839,0.0062769999999972015,1302533,0
"172.16.133.66",53923,"172.16.139.250",5440,10,1022,9845,0,0,10,1022,0,0,106.075631,0.005415999999996757,1509601,0
"172.16.133.25",63524,"66.151.158.187",443,6,366,9846,0,0,4,246,2,120,106.080937,0.18058599999999103,10897,5316
"172.16.133.82",61392,"172.16.139.250",5440,10,1022,9847,0,0,10,1022,0,0,106.09315,0.00557600000000491,1466284,0
"172.16.133.37",60669,"172.16.139.250",5440,10,1022,9848,0,0,10,1022,0,0,106.105058,0.006642999999996846,1230769,0
"172.16.133.25",63525,"216.219.112.250",443,6,366,9849,0,0,4,246,2,120,106.130835,0.19552000000000191,10065,4909
"172.16.133.184",55165,"204.14.235.101",443,62,26540,9850,0,0,32,5551,30,20989,106.193435,20.974608000000003,2117,8005
"172.16.133.184",48315,"205.216.16.228",80,439,381266,9851,0,0,173,16994,266,364272,106.223471,4.656701999999996,29194,625802
"172.16.133.54",64592,"209.190.70.254",80,14,5421,9852,0,0,7,4145,7,1276,106.252021,0.17895699999999692,185295,57041
"172.16.133.78",59253,"172.16.139.250",5440,10,1022,9853,0,0,10,1022,0,0,106.260398,0.005500000000012051,1486545,0
"172.16.133.54",64593,"209.190.70.254",80,17,7736,9854,0,0,8,3394,9,4342,106.266062,0.4934909999999917,55020,70388
"172.16.133.54",64594,"157.56.134.97",80,13,6284,9855,0,0,7,2609,6,3675,106.26782,0.10793599999999515,193373,272383
"172.16.133.54",64595,"157.56.134.97",80,5,312,9856,0,0,3,186,2,126,106.270869,5.446293999999995,273,185
"172.16.133.54",64596,"204.154.111.33",80,11,2865,9857,0,0,6,2339,5,526,106.288345,0.06462599999998986,289542,65113
"172.16.133.54",64597,"204.154.111.33",80,5,306,9858,0,0,3,186,2,120,106.293594,5.423362999999995,274,177
"172.16.133.54",64598,"205.188.93.194",80,9,1395,9859,0,0,5,701,4,694,106.309498,0.07920299999999258,70805,70098
"172.16.133.54",64599,"205.188.93.194",80,9,2294,9860,0,0,5,1601,4,693,106.309715,0.1960679999999968,65324,28275
"172.16.133.67",56030,"172.16.139.250",5440,12,1142,9861,0,0,12,1142,0,0,106.31484,0.016257999999993444,561938,0
"172.16.133.54",64600,"216.38.163.167",80,10,1569,9862,0,0,6,763,4,806,106.316215,2.116322999999994,2884,3046
"172.16.133.54",64601,"216.38.163.167",80,12,1551,9863,0,0,7,835,5,716,106.316508,2.3630019999999945,2826,2424
"172.16.133.56",61474,"172.16.139.250",5440,12,1142,9864,0,0,12,1142,0,0,106.338074,0.00494399999999473,"",""
"172.16.133.41",53065,"172.16.139.250",5440,12,1142,9865,0,0,12,1142,0,0,106.393481,0.015503000000009592,589305,0
"172.16.133.42",57171,"172.16.139.250",5440,12,1142,9866,0,0,12,1142,0,0,106.404163,0.09796599999999955,93256,0
"172.16.133.85",52317,"172.16.139.250",5440,10,1022,9867,0,0,10,1022,0,0,106.409837,0.014591000000010013,560345,0
"172.16.133.184",48316,"205.216.16.228",80,470,407613,9868,0,0,183,23470,287,384143,106.410857,25.39168600000002,7394,121029
"172.16.133.184",48317,"205.216.16.228",80,529,437591,9869,0,0,220,26849,309,410742,106.412856,16.776674999999997,12803,195863
"172.16.133.184",48318,"205.216.16.228",80,553,485280,9870,0,0,216,21962,337,463318,106.414452,7.458229000000003,23557,496973
"172.16.133.184",48319,"205.216.16.228",80,315,273718,9871,0,0,121,18313,194,255405,106.416067,7.466961999999995,19620,273637
"172.16.133.184",48320,"205.216.16.228",80,302,245711,9872,0,0,125,18367,177,227344,106.417531,25.384883000000002,5788,71647
"172.16.133.43",57827,"172.16.139.250",5440,10,1022,9873,0,0,10,1022,0,0,106.463763,0.005510999999998489,1483578,0
"172.16.133.48",60520,"50.16.236.32",80,10,1392,9874,0,0,5,907,5,485,106.477136,0.07744900000000143,93687,50097
"172.16.133.13",53083,"172.16.139.250",5440,12,1142,9875,0,0,12,1142,0,0,106.481846,0.006123000000002321,1492079,0
"172.16.133.54",64602,"209.190.106.126",80,14,5055,9876,0,0,7,4074,7,981,106.487107,0.3447180000000003,94546,22766
"172.16.133.20",62439,"172.16.139.250",5440,12,1142,9877,0,0,12,1142,0,0,106.531015,0.014501000000009867,630025,0
"172.16.133.54",64603,"206.165.250.99",80,8,2527,9878,0,0,5,1305,3,1222,106.533719,0.35536499999999194,29378,27509
"172.16.133.54",64604,"206.165.250.99",80,7,632,9879,0,0,4,246,3,386,106.534062,5.256502999999995,374,587
"172.16.133.75",51018,"172.16.139.250",5440,10,1022,9880,0,0,10,1022,0,0,106.548409,0.005455999999995242,1498533,0
"172.16.133.54",64605,"74.217.78.158",80,13,2813,9881,0,0,7,2258,6,555,106.549375,65.31927200000001,276,67
"172.16.133.54",64606,"74.217.78.158",80,6,372,9882,0,0,4,246,2,126,106.549584,5.23581200000001,375,192
"172.16.133.25",63526,"202.173.24.200",443,6,366,9883,0,0,4,246,2,120,106.553015,0.4890929999999969,4023,1962
"172.16.133.28",65477,"172.16.139.250",5440,12,1142,9884,0,0,12,1142,0,0,106.562628,0.00586899999998991,1556653,0
"172.16.133.99",56088,"172.16.139.250",5440,12,1142,9885,0,0,12,1142,0,0,106.58865,0.01501899999999523,608296,0
"172.16.133.87",60253,"172.16.139.250",5440,10,1022,9886,0,0,10,1022,0,0,106.612271,0.014676999999991835,557062,0
"172.16.133.35",50018,"172.16.139.250",5440,12,1142,9887,0,0,12,1142,0,0,106.621234,0.02411100000000488,378914,0
"172.16.133.116",53506,"172.16.139.250",5440,10,1022,9888,0,0,10,1022,0,0,106.62502,0.01607199999999409,508710,0
"172.16.133.116",53507,"172.16.139.250",5440,12,1142,9889,0,0,12,1142,0,0,106.641781,0.01705800000000579,535584,0
"172.16.133.84",58837,"172.16.139.250",5440,10,1022,9890,0,0,10,1022,0,0,106.648642,0.00569099999999878,1436654,0
"172.16.133.54",64607,"67.69.196.24",80,10,2644,9891,0,0,6,1766,4,878,106.656385,115.568547,122,60
"172.16.133.54",64608,"67.69.196.24",80,7,432,9892,0,0,4,246,3,186,106.658267,6.0821750000000065,323,244
"172.16.133.116",53508,"172.16.139.250",5440,10,1022,9893,0,0,10,1022,0,0,106.659715,0.005553999999989401,1472092,0
"172.16.133.54",64609,"23.21.204.69",80,10,2380,9894,0,0,5,1671,5,709,106.659839,0.15895499999999174,84099,35683
"172.16.133.54",64610,"23.21.204.69",80,6,554,9895,0,0,4,246,2,308,106.660553,6.06048100000001,324,406
"172.16.133.54",64611,"107.22.183.9",80,11,2441,9896,0,0,6,1684,5,757,106.663769,15.278848999999994,881,396
"172.16.133.54",64612,"107.22.183.9",80,6,372,9897,0,0,4,246,2,126,106.664305,6.056820999999999,324,166
"172.16.133.54",64613,"209.190.70.254",80,14,5149,9898,0,0,7,4007,7,1142,106.688725,0.2409940000000006,133015,37909
"172.16.133.184",55172,"204.14.235.101",443,24,7647,9899,0,0,14,1704,10,5943,106.702167,20.465042999999994,666,2323
"172.16.133.184",55173,"204.14.235.101",443,28,8380,9900,0,0,15,2118,13,6262,106.704412,20.46440299999999,827,2447
"172.16.133.184",55174,"204.14.235.101",443,25,7662,9901,0,0,13,1658,12,6004,106.70601,20.461793,648,2347
"172.16.133.184",55175,"204.14.235.101",443,21,6146,9902,0,0,12,1224,9,4922,106.707472,20.460791,478,1924
"172.16.133.163",3537,"68.64.24.250",443,6,366,9903,0,0,4,246,2,120,106.707922,0.15862500000000068,12406,6052
"172.16.133.49",55832,"172.16.139.250",5440,12,1142,9904,0,0,12,1142,0,0,106.728927,0.006433000000001243,1420177,0
"172.16.133.71",57536,"132.245.2.22",443,3,180,9905,0,0,2,120,1,60,106.740526,0.0670949999999948,14308,7154
"172.16.133.71",57535,"132.245.1.150",443,3,180,9906,0,0,2,120,1,60,106.741048,0.050225999999995,19113,9556
"172.16.133.71",57534,"132.245.2.70",443,3,180,9907,0,0,2,120,1,60,106.74105,0.05632500000000107,17043,8521
"172.16.133.71",57517,"157.56.232.182",443,3,180,9908,0,0,2,120,1,60,106.741051,0.05119200000000035,18752,9376
"172.16.133.71",57547,"132.245.2.22",443,69,26870,9909,0,0,37,13946,32,12924,106.741052,15.081716,7397,6855
"172.16.133.163",3538,"216.219.118.244",443,6,366,9910,0,0,4,246,2,120,106.762803,0.22444799999999532,8768,4277
"172.16.133.163",3539,"78.108.118.250",443,6,366,9911,0,0,4,246,2,120,106.762861,0.2238229999999959,8792,4289
"172.16.133.95",57014,"172.16.139.250",5440,10,1022,9912,0,0,10,1022,0,0,106.763938,0.01564199999999971,522695,0
"172.16.133.54",64614,"209.190.70.254",80,6,368,9913,0,0,4,246,2,122,106.774349,5.9662819999999925,329,163
"172.16.133.54",64615,"72.21.194.32",80,6,372,9914,0,0,4,246,2,126,106.790158,5.9304679999999905,331,169
"172.16.133.92",57728,"172.16.139.250",5440,10,1022,9915,0,0,10,1022,0,0,106.79152,0.014891999999989025,549019,0
"172.16.133.54",64616,"209.190.106.126",80,14,5250,9916,0,0,7,4261,7,989,106.79235,0.28553600000000756,119382,27709
"172.16.133.54",64617,"209.190.106.126",80,14,5255,9917,0,0,7,4262,7,993,106.796573,0.2813680000000005,121179,28233
"172.16.133.54",64618,"209.190.106.126",80,14,5011,9918,0,0,7,4248,7,763,106.806785,0.2973519999999894,114288,20527
"172.16.133.29",60998,"172.16.139.250",5440,10,1022,9919,0,0,10,1022,0,0,106.809006,0.006903000000008319,1184412,0
"172.16.133.44",64881,"172.16.139.250",5440,10,1022,9920,0,0,10,1022,0,0,106.815128,0.005408000000002744,1511834,0
"172.16.133.54",64619,"209.190.106.126",80,6,368,9921,0,0,4,246,2,122,106.831034,5.909476999999995,333,165
"172.16.133.54",64620,"209.190.106.126",80,14,5352,9922,0,0,7,4371,7,981,106.832277,0.5630629999999996,62103,13938
"172.16.133.54",64621,"209.190.106.126",80,6,368,9923,0,0,4,246,2,122,106.834142,5.9065590000000014,333,165
"172.16.133.207",55978,"172.16.139.250",5440,12,1142,9924,0,0,12,1142,0,0,106.840184,0.014773000000005254,618425,0
"172.16.133.83",57136,"172.16.139.250",5440,12,1142,9925,0,0,12,1142,0,0,106.850969,0.007602999999988924,1201630,0
"172.16.133.184",55176,"204.14.235.101",443,21,6146,9926,0,0,12,1224,9,4922,106.851268,20.31734999999999,481,1938
"172.16.133.93",60765,"172.16.139.250",5440,12,1142,9927,0,0,12,1142,0,0,106.865584,0.004959999999996967,"",""
"172.16.133.11",55187,"172.16.139.250",5440,10,1022,9928,0,0,10,1022,0,0,106.884051,0.0059269999999997935,1379449,0
"172.16.133.55",57666,"172.16.139.250",5440,10,1022,9929,0,0,10,1022,0,0,106.887247,0.0063829999999995835,1280902,0
"172.16.133.163",3540,"216.115.219.126",443,6,366,9930,0,0,4,246,2,120,106.906924,0.5236400000000003,3758,1833
"172.16.133.53",54144,"172.16.139.250",5440,10,1022,9931,0,0,10,1022,0,0,106.914045,0.005729999999999791,1426876,0
"172.16.133.184",42130,"173.194.43.35",80,43,23917,9932,0,0,25,5853,18,18064,106.914497,24.823803000000012,1886,5821
"172.16.133.73",60718,"172.16.139.250",5440,10,1022,9933,0,0,10,1022,0,0,106.914651,0.00914999999999111,893551,0
"172.16.133.21",53239,"172.16.139.250",5440,10,1022,9934,0,0,10,1022,0,0,106.915461,0.012512000000000967,653452,0
"172.16.133.30",62668,"172.16.139.250",5440,10,1022,9935,0,0,10,1022,0,0,106.918549,0.012590000000002988,649404,0
"172.16.133.25",63527,"172.16.139.250",5440,12,1142,9936,0,0,12,1142,0,0,106.9278,0.007264999999989641,1257536,0
"172.16.133.34",50484,"172.16.139.250",5440,10,1022,9937,0,0,10,1022,0,0,106.935952,0.004915999999994369,"",""
"172.16.133.184",52205,"208.71.125.129",80,131,87940,9938,0,0,66,10863,65,77077,106.942715,24.800021,3504,24863
"172.16.133.113",55636,"63.147.189.115",80,17,6418,9939,0,0,8,1418,9,5000,106.94781,25.285464999999988,448,1581
"172.16.133.97",59417,"172.16.139.250",5440,10,1022,9940,0,0,10,1022,0,0,106.948062,0.014491000000006693,564212,0
"172.16.133.113",55635,"63.147.189.115",80,15,6286,9941,0,0,7,1352,8,4934,106.94822,0.40752200000000016,26540,96858
"172.16.133.53",54145,"78.108.118.250",443,6,366,9942,0,0,4,246,2,120,106.964183,0.23672799999999938,8313,4055
"172.16.133.53",54146,"216.219.118.244",443,6,366,9943,0,0,4,246,2,120,106.965171,0.2321370000000087,8477,4135
"172.16.133.53",54147,"68.64.24.250",443,6,366,9944,0,0,4,246,2,120,106.965975,0.11561500000000535,17022,8303
"172.16.133.53",54148,"216.115.219.126",443,6,366,9945,0,0,4,246,2,120,106.967624,0.5018440000000055,3921,1912
"172.16.133.33",57926,"172.16.139.250",5440,12,1142,9946,0,0,12,1142,0,0,107.019919,0.0158699999999925,575677,0
"172.16.133.68",60798,"172.16.139.250",5440,10,1022,9947,0,0,10,1022,0,0,107.052905,0.006680000000002906,1223952,0
"172.16.133.12",59823,"172.16.139.250",5440,10,1022,9948,0,0,10,1022,0,0,107.065892,0.005707000000001017,1432626,0
"172.16.133.63",53929,"172.16.139.250",5440,10,1022,9949,0,0,10,1022,0,0,107.076755,0.005563999999992575,1469446,0
"172.16.133.54",64622,"174.129.2.251",80,18,6507,9950,0,0,10,3217,8,3290,107.079228,105.187952,244,250
"172.16.133.54",64623,"174.129.2.251",80,6,372,9951,0,0,4,246,2,126,107.079499,5.643485999999996,348,178
"172.16.133.54",64624,"8.30.199.67",80,10,2342,9952,0,0,5,1425,5,917,107.080616,0.13171799999999223,86548,55694
"172.16.133.54",64625,"8.30.199.67",80,7,426,9953,0,0,4,246,3,180,107.080995,2.100100999999995,937,685
"172.16.133.54",64626,"209.94.144.19",80,10,2045,9954,0,0,6,1478,4,567,107.081257,115.112809,102,39
"172.16.133.54",64627,"209.94.144.19",80,7,432,9955,0,0,4,246,3,186,107.081456,5.638075000000001,349,263
"172.16.133.54",64628,"54.243.97.248",80,19,8090,9956,0,0,10,3902,9,4188,107.081638,105.808728,295,316
"172.16.133.54",64629,"54.243.97.248",80,6,372,9957,0,0,4,246,2,126,107.081867,5.639257000000001,348,178
"172.16.133.66",53924,"172.16.139.250",5440,10,1022,9958,0,0,10,1022,0,0,107.090675,0.005275999999994951,1549658,0
"172.16.133.75",51019,"68.64.24.250",443,6,366,9959,0,0,4,246,2,120,107.097888,0.11464000000000851,17166,8374
"172.16.133.82",61393,"172.16.139.250",5440,10,1022,9960,0,0,10,1022,0,0,107.103271,0.005705999999989331,1432877,0
"172.16.133.37",60670,"172.16.139.250",5440,10,1022,9961,0,0,10,1022,0,0,107.119485,0.00563900000000217,1449902,0
"172.16.133.71",57548,"184.73.225.104",443,41,14723,9962,0,0,19,3783,22,10940,107.15499,6.167850999999999,4906,14189
"172.16.133.184",52206,"208.71.125.129",80,39,21519,9963,0,0,22,3384,17,18135,107.203152,24.538540999999995,1103,5912
"172.16.133.16",59336,"66.220.152.19",443,334,216749,9964,0,0,119,32571,215,184178,107.215834,192.529754,1353,7652
"172.16.133.184",35335,"64.208.138.244",80,10,1724,9965,0,0,5,676,5,1048,107.238596,0.09942399999999907,54393,84325
"172.16.133.184",35336,"64.208.138.244",80,10,2258,9966,0,0,5,1203,5,1055,107.252642,0.0972849999999994,98925,86755
"172.16.133.184",46742,"208.71.125.1",80,11,2565,9967,0,0,6,1246,5,1319,107.253103,0.10710500000000422,93067,98520
"172.16.133.75",51020,"78.108.118.250",443,6,366,9968,0,0,4,246,2,120,107.264789,0.2268110000000121,8676,4232
"172.16.133.63",53930,"180.153.31.250",443,6,366,9969,0,0,4,246,2,120,107.268269,0.5435269999999974,3620,1766
"172.16.133.78",59254,"172.16.139.250",5440,12,1142,9970,0,0,12,1142,0,0,107.273546,0.006675000000001319,1368689,0
"172.16.133.184",44077,"63.116.244.89",80,13,2934,9971,0,0,8,1836,5,1098,107.278583,24.458861000000013,600,359
"172.16.133.75",51021,"216.219.118.244",443,6,366,9972,0,0,4,246,2,120,107.287786,0.21126499999999737,9315,4544
"172.16.133.184",46744,"208.71.125.1",80,10,1777,9973,0,0,5,839,5,938,107.302586,0.09173199999999326,73169,81803
"172.16.133.184",46745,"208.71.125.1",80,10,1683,9974,0,0,5,791,5,892,107.304153,0.10883099999999502,58145,65569
"172.16.133.184",55155,"64.208.138.244",443,17,4791,9975,0,0,9,1403,8,3388,107.309172,0.1897249999999957,59159,142859
"172.16.133.184",46567,"96.43.148.26",443,42,21396,9976,0,0,20,3387,22,18009,107.317035,19.78189499999999,1369,7283
"172.16.133.184",46568,"96.43.148.26",443,38,17569,9977,0,0,21,3025,17,14544,107.31895,19.780236000000002,1223,5882
"172.16.133.184",35344,"64.208.138.244",80,10,1939,9978,0,0,5,836,5,1103,107.322186,0.0885770000000008,75504,99619
"172.16.133.184",46750,"208.71.125.1",80,11,2316,9979,0,0,6,891,5,1425,107.32549,0.09885199999999372,72107,115323
"172.16.133.67",56031,"172.16.139.250",5440,12,1142,9980,0,0,12,1142,0,0,107.327751,0.006349999999997635,1438740,0
"172.16.133.184",46751,"208.71.125.1",80,11,2239,9981,0,0,6,1337,5,902,107.327814,0.09661199999999326,110710,74690
"172.16.133.184",55161,"64.208.138.244",443,17,5015,9982,0,0,9,1627,8,3388,107.330158,0.18268700000000138,71247,148363
"172.16.133.56",61475,"172.16.139.250",5440,10,1022,9983,0,0,10,1022,0,0,107.350762,0.005465999999998417,1495792,0
"172.16.133.41",53066,"172.16.139.250",5440,12,1142,9984,0,0,12,1142,0,0,107.406624,0.006358000000005859,1436929,0
"172.16.133.42",57172,"172.16.139.250",5440,12,1142,9985,0,0,12,1142,0,0,107.41738,0.010913000000002171,837166,0
"172.16.133.85",52318,"172.16.139.250",5440,10,1022,9986,0,0,10,1022,0,0,107.428007,0.005046000000007211,1620293,0
"172.16.133.43",57828,"172.16.139.250",5440,10,1022,9987,0,0,10,1022,0,0,107.477887,0.005504999999999427,1485195,0
"172.16.133.13",53084,"172.16.139.250",5440,10,1022,9988,0,0,10,1022,0,0,107.496303,0.005493000000001302,1488439,0
"172.16.133.20",62440,"172.16.139.250",5440,12,1142,9989,0,0,12,1142,0,0,107.544479,0.004558000000002949,"",""
"172.16.133.75",51022,"172.16.139.250",5440,10,1022,9990,0,0,10,1022,0,0,107.562535,0.015768000000008442,518518,0
"172.16.133.184",48468,"23.33.47.60",443,292,288942,9991,0,0,99,7677,193,281265,107.568641,19.524504000000007,3145,115245
"172.16.133.184",48469,"23.33.47.60",443,20,4380,9992,0,0,12,1514,8,2866,107.568835,19.524131999999994,620,1174
"172.16.133.184",48470,"23.33.47.60",443,67,46446,9993,0,0,32,3239,35,43207,107.568967,19.524831000000006,1327,17703
"172.16.133.184",48471,"23.33.47.60",443,87,76864,9994,0,0,32,2834,55,74030,107.569093,19.524174000000002,1161,30333
"172.16.133.184",48472,"23.33.47.60",443,17,3340,9995,0,0,10,977,7,2363,107.569222,19.524248999999998,400,968
"172.16.133.184",48473,"23.33.47.60",443,17,3340,9996,0,0,10,977,7,2363,107.569356,19.527896,400,968
"172.16.133.28",65478,"172.16.139.250",5440,12,1142,9997,0,0,12,1142,0,0,107.575817,0.006687999999996919,1366028,0
"172.16.133.99",56089,"172.16.139.250",5440,12,1142,9998,0,0,12,1142,0,0,107.60212,0.014449999999996521,632249,0
"172.16.133.87",60254,"172.16.139.250",5440,10,1022,9999,0,0,10,1022,0,0,107.626521,0.005262000000001876,1553781,0
"172.16.133.16",59337,"208.47.254.27",80,6,372,10000,0,0,4,246,2,126,107.629688,11.326775999999995,173,88
"172.16.133.16",59338,"208.47.254.27",80,6,372,10001,0,0,4,246,2,126,107.631003,11.325569999999999,173,89
"172.16.133.35",50019,"172.16.139.250",5440,12,1142,10002,0,0,12,1142,0,0,107.635995,0.10758000000001289,84922,0
"172.16.133.116",53509,"172.16.139.250",5440,12,1142,10003,0,0,12,1142,0,0,107.641358,0.015332999999998265,595839,0
"172.16.133.116",53510,"172.16.139.250",5440,10,1022,10004,0,0,10,1022,0,0,107.657629,0.006316999999995687,1294285,0
"172.16.133.84",58838,"172.16.139.250",5440,10,1022,10005,0,0,10,1022,0,0,107.661573,0.00636399999999071,1284726,0
"172.16.133.116",53511,"172.16.139.250",5440,10,1022,10006,0,0,10,1022,0,0,107.664781,0.006884999999996921,1187509,0
"172.16.133.18",50258,"96.43.146.176",443,8,562,10007,0,0,5,341,3,221,107.729569,0.2032650000000018,13420,8698
"172.16.133.18",50273,"96.43.146.22",443,8,562,10008,0,0,5,341,3,221,107.730089,0.2027479999999997,13455,8720
"172.16.133.18",50272,"96.43.146.22",443,9,622,10009,0,0,5,341,4,281,107.730091,0.2526709999999923,10796,8896
"172.16.133.184",46759,"208.71.125.1",80,11,1450,10010,0,0,6,988,5,462,107.736336,0.1630220000000122,48484,22671
"172.16.133.49",55833,"172.16.139.250",5440,12,1142,10011,0,0,12,1142,0,0,107.739268,0.006506000000001677,1404242,0
"172.16.133.184",46760,"208.71.125.1",80,11,1884,10012,0,0,6,982,5,902,107.746593,0.17374199999999007,45216,41532
"172.16.133.184",46761,"208.71.125.1",80,11,1404,10013,0,0,6,942,5,462,107.750644,0.1610820000000075,46783,22944
"172.16.133.95",57015,"172.16.139.250",5440,12,1142,10014,0,0,12,1142,0,0,107.779218,0.005352000000002022,1707025,0
"172.16.133.92",57729,"172.16.139.250",5440,10,1022,10015,0,0,10,1022,0,0,107.805066,0.005604000000005271,1458957,0
"172.16.133.29",60999,"172.16.139.250",5440,12,1142,10016,0,0,12,1142,0,0,107.823117,0.11099699999999757,82308,0
"172.16.133.44",64882,"172.16.139.250",5440,10,1022,10017,0,0,10,1022,0,0,107.829708,0.13097299999999734,62425,0
"172.16.133.184",46269,"173.194.43.60",443,26,10414,10018,0,0,15,3406,11,7008,107.84096,23.901945000000012,1139,2345
"172.16.133.207",55979,"172.16.139.250",5440,12,1142,10019,0,0,12,1142,0,0,107.854057,0.11038899999999785,82761,0
"172.16.133.184",46583,"96.43.148.26",443,21,6254,10020,0,0,12,1218,9,5036,107.86335,19.234965000000003,506,2094
"172.16.133.184",46584,"96.43.148.26",443,21,6254,10021,0,0,12,1218,9,5036,107.865512,19.232985,506,2094
"172.16.133.83",57137,"172.16.139.250",5440,10,1022,10022,0,0,10,1022,0,0,107.865943,0.08692999999999529,94052,0
"172.16.133.93",60766,"172.16.139.250",5440,12,1142,10023,0,0,12,1142,0,0,107.879765,0.07719099999999912,118355,0
"172.16.133.11",55188,"172.16.139.250",5440,12,1142,10024,0,0,12,1142,0,0,107.896912,0.0759039999999942,120362,0
"172.16.133.55",57667,"172.16.139.250",5440,12,1142,10025,0,0,12,1142,0,0,107.902903,0.07619900000000257,119896,0
"172.16.133.184",46585,"96.43.148.26",443,21,6254,10026,0,0,12,1218,9,5036,107.922667,19.175456999999994,508,2101
"172.16.133.73",60719,"172.16.139.250",5440,12,1142,10027,0,0,12,1142,0,0,107.923874,0.05912100000000464,154530,0
"172.16.133.53",54149,"172.16.139.250",5440,10,1022,10028,0,0,10,1022,0,0,107.926957,0.07603000000000293,107536,0
"172.16.133.21",53240,"172.16.139.250",5440,12,1142,10029,0,0,12,1142,0,0,107.929038,0.07439399999999807,122805,0
"172.16.133.30",62669,"172.16.139.250",5440,10,1022,10030,0,0,10,1022,0,0,107.936004,0.05747800000000325,142245,0
"172.16.133.25",63528,"172.16.139.250",5440,12,1142,10031,0,0,12,1142,0,0,107.941234,0.06380000000000052,143197,0
"172.16.133.34",50485,"172.16.139.250",5440,10,1022,10032,0,0,10,1022,0,0,107.951114,0.057152999999999565,143054,0
"172.16.133.97",59418,"172.16.139.250",5440,12,1142,10033,0,0,12,1142,0,0,107.960401,0.029789999999991323,306680,0
"172.16.133.33",57927,"78.108.118.250",443,6,366,10034,0,0,4,246,2,120,107.969927,0.21426599999999496,9184,4480
"172.16.133.33",57928,"68.64.24.250",443,6,366,10035,0,0,4,246,2,120,107.970046,0.11111300000000313,17711,8639
"172.16.133.33",57929,"216.219.118.244",443,6,366,10036,0,0,4,246,2,120,107.971332,0.21871699999999805,8997,4389
"172.16.133.33",57930,"216.115.219.126",443,6,366,10037,0,0,4,246,2,120,107.972589,0.49287499999999795,3992,1947
"172.16.133.25",63529,"216.115.222.200",443,6,366,10038,0,0,4,246,2,120,107.981979,0.1072330000000079,18352,8952
"172.16.133.33",57931,"172.16.139.250",5440,12,1142,10039,0,0,12,1142,0,0,108.034306,0.006427999999999656,1421281,0
"172.16.133.68",60801,"172.16.139.250",5440,12,1142,10040,0,0,12,1142,0,0,108.067065,0.007215000000002192,1266250,0
"172.16.133.12",59824,"172.16.139.250",5440,12,1142,10041,0,0,12,1142,0,0,108.080088,0.006278999999992152,1455008,0
"172.16.133.184",42344,"70.42.13.101",443,20,7663,10042,0,0,10,2013,10,5650,108.084818,11.630133,1384,3886
"172.16.133.63",53931,"172.16.139.250",5440,12,1142,10043,0,0,12,1142,0,0,108.08965,0.0061429999999944584,1487221,0
"172.16.133.66",53925,"172.16.139.250",5440,12,1142,10044,0,0,12,1142,0,0,108.104212,0.006294999999994388,1451310,0
"172.16.133.82",61394,"172.16.139.250",5440,12,1142,10045,0,0,12,1142,0,0,108.116878,0.006607999999999947,1382566,0
"172.16.133.41",53067,"216.52.121.204",80,12,4657,10046,0,0,7,4100,5,557,108.118775,0.14938300000000027,219569,29829
"172.16.133.41",53068,"199.102.234.31",80,12,4999,10047,0,0,6,3084,6,1915,108.11943,0.1209570000000042,203973,126656
"172.16.133.37",60671,"172.16.139.250",5440,10,1022,10048,0,0,10,1022,0,0,108.133252,0.005671000000006643,1441721,0
"172.16.133.184",36974,"173.194.43.59",443,23,8116,10049,0,0,14,2957,9,5159,108.151658,23.585644000000002,1002,1749
"172.16.133.25",63530,"66.151.158.187",443,6,366,10050,0,0,4,246,2,120,108.172323,0.19135199999999486,10284,5016
"172.16.133.113",55637,"172.16.139.250",135,8,492,10051,0,0,8,492,0,0,108.205116,0.008234000000001629,478017,0
"172.16.133.113",55638,"172.16.139.250",5462,10,696,10052,0,0,10,696,0,0,108.213771,0.5040870000000126,11045,0
"172.16.133.25",63531,"216.219.112.250",443,6,366,10053,0,0,4,246,2,120,108.230009,0.21921600000000296,8977,4379
"172.16.133.41",53069,"184.84.3.53",80,84,68046,10054,0,0,33,15080,51,52966,108.242831,3.7994520000000023,31751,111523
"172.16.133.71",57549,"157.56.236.89",443,2,138,10055,0,0,1,78,1,60,108.244068,0.09336400000000822,6683,5141
"172.16.133.78",59255,"172.16.139.250",5440,12,1142,10056,0,0,12,1142,0,0,108.287925,0.015232999999994945,599750,0
"172.16.133.184",54072,"107.22.223.184",443,22,8101,10057,0,0,12,1538,10,6563,108.290247,0.2996820000000042,41056,175199
"172.16.133.184",46562,"205.210.187.119",443,32,12320,10058,0,0,16,3367,16,8953,108.291461,23.479578000000004,1147,3050
"172.16.133.184",55928,"173.194.43.45",443,20,5889,10059,0,0,12,2123,8,3766,108.294275,23.443092000000007,724,1285
"172.16.133.184",40598,"38.126.130.199",443,26,8413,10060,0,0,14,1643,12,6770,108.329272,0.34927600000000325,37632,155063
"172.16.133.184",58433,"50.22.198.102",443,24,7653,10061,0,0,14,1720,10,5933,108.330074,23.414244999999994,587,2027
"172.16.133.184",44822,"98.139.225.43",443,33,9561,10062,0,0,16,2070,17,7491,108.339808,15.74546699999999,1051,3806
"172.16.133.71",57550,"157.56.240.137",443,2,138,10063,0,0,1,78,1,60,108.340603,0.025452999999998838,24515,18858
"172.16.133.67",56032,"172.16.139.250",5440,10,1022,10064,0,0,10,1022,0,0,108.341708,0.005584999999996398,1463921,0
"172.16.133.56",61476,"172.16.139.250",5440,10,1022,10065,0,0,10,1022,0,0,108.365229,0.005199000000004617,1572610,0
"172.16.133.71",57551,"157.56.244.217",443,2,138,10066,0,0,1,78,1,60,108.367243,0.056023999999993634,11138,8567
"172.16.133.48",60521,"184.73.197.44",443,17,5459,10067,0,0,9,2021,8,3438,108.390623,12.769120999999998,1266,2153
"172.16.133.41",53070,"172.16.139.250",5440,10,1022,10068,0,0,10,1022,0,0,108.421755,0.016531999999997993,494556,0
"172.16.133.71",57552,"157.56.234.137",443,2,138,10069,0,0,1,78,1,60,108.424462,0.07482399999999245,8339,6415
"172.16.133.42",57173,"172.16.139.250",5440,12,1142,10070,0,0,12,1142,0,0,108.431462,0.010081999999997038,906169,0
"172.16.133.85",52319,"172.16.139.250",5440,10,1022,10071,0,0,10,1022,0,0,108.438646,0.015974999999997408,511799,0
"172.16.133.184",41472,"66.235.146.171",443,29,14122,10072,0,0,16,5914,13,8208,108.464094,18.639557999999994,2538,3522
"172.16.133.23",55045,"172.16.139.250",5440,10,1022,10073,0,0,10,1022,0,0,108.476185,0.0051799999999957436,1578378,0
"172.16.133.184",55933,"173.194.43.45",443,20,6083,10074,0,0,12,2410,8,3673,108.487231,23.252415999999997,829,1263
"172.16.133.43",57829,"172.16.139.250",5440,10,1022,10075,0,0,10,1022,0,0,108.492458,0.005521999999999139,1480622,0
"172.16.133.71",57553,"157.56.236.89",80,8,926,10076,0,0,5,574,3,352,108.503112,0.34309000000000367,13384,8207
"172.16.133.13",53085,"172.16.139.250",5440,10,1022,10077,0,0,10,1022,0,0,108.510953,0.015472000000002595,528438,0
"172.16.133.39",64263,"174.129.24.9",443,234,234073,10078,0,0,74,8012,160,226061,108.552762,11.769458999999998,5445,153659
"172.16.133.20",62441,"172.16.139.250",5440,12,1142,10079,0,0,12,1142,0,0,108.559055,0.004884000000004107,"",""
"172.16.133.184",55185,"64.208.138.244",443,17,4951,10080,0,0,9,1515,8,3436,108.570616,0.17149600000000476,70672,160283
"172.16.133.75",51023,"172.16.139.250",5440,10,1022,10081,0,0,10,1022,0,0,108.575607,0.015379999999993288,531599,0
"172.16.133.28",65479,"172.16.139.250",5440,12,1142,10082,0,0,12,1142,0,0,108.589931,0.006177999999991357,1478795,0
"172.16.133.184",40681,"173.194.43.58",443,17,4988,10083,0,0,10,1613,7,3375,108.600508,23.143312999999992,557,1166
"172.16.133.99",56090,"172.16.139.250",5440,12,1142,10084,0,0,12,1142,0,0,108.615979,0.014668999999997823,622810,0
"172.16.133.87",60255,"172.16.139.250",5440,10,1022,10085,0,0,10,1022,0,0,108.641075,0.005509000000003539,1484116,0
"172.16.133.35",50020,"172.16.139.250",5440,12,1142,10086,0,0,12,1142,0,0,108.648486,0.009619999999998186,949688,0
"172.16.133.116",53512,"172.16.139.250",5440,10,1022,10087,0,0,10,1022,0,0,108.654267,0.006168000000002394,1325551,0
"172.16.133.116",53513,"172.16.139.250",5440,12,1142,10088,0,0,12,1142,0,0,108.661256,0.006125000000011482,1491591,0
"172.16.133.75",51024,"216.115.219.126",443,6,366,10089,0,0,4,246,2,120,108.665012,0.502718999999999,3914,1909
"172.16.133.116",53514,"172.16.139.250",5440,10,1022,10090,0,0,10,1022,0,0,108.668226,0.005200000000002092,1572307,0
"172.16.133.84",58839,"172.16.139.250",5440,10,1022,10091,0,0,10,1022,0,0,108.677099,0.005504999999999427,1485195,0
"172.16.133.184",35533,"64.215.255.94",443,22,7383,10092,0,0,11,1503,11,5880,108.702337,0.22422400000000664,53624,209790
"172.16.133.184",43012,"76.13.234.33",443,15,3433,10093,0,0,8,1329,7,2104,108.717626,0.21895700000000318,48557,76873
"172.16.133.184",43117,"107.22.223.184",80,10,1409,10094,0,0,5,662,5,747,108.723395,0.17563200000000734,30153,34025
"172.16.133.71",57554,"157.56.241.118",443,25,8363,10095,0,0,14,1549,11,6814,108.752226,1.6355860000000035,7576,33328
"172.16.133.49",55835,"172.16.139.250",5440,12,1142,10096,0,0,12,1142,0,0,108.753325,0.01577499999999077,579144,0
"172.16.133.184",58442,"50.22.198.102",443,23,7485,10097,0,0,13,1768,10,5717,108.759329,22.984863000000004,615,1989
"172.16.133.95",57016,"172.16.139.250",5440,10,1022,10098,0,0,10,1022,0,0,108.79217,0.005273000000002526,1550540,0
"172.16.133.25",63532,"202.173.24.200",443,6,366,10099,0,0,4,246,2,120,108.793124,0.5187219999999968,3793,1850
"172.16.133.163",3542,"68.64.24.250",443,6,366,10100,0,0,4,246,2,120,108.808911,0.12993000000000166,15146,7388
"172.16.133.92",57730,"172.16.139.250",5440,12,1142,10101,0,0,12,1142,0,0,108.819045,0.01602900000000318,569966,0
"172.16.133.29",61000,"172.16.139.250",5440,10,1022,10102,0,0,10,1022,0,0,108.838309,0.006065000000006648,1348062,0
"172.16.133.44",64883,"172.16.139.250",5440,10,1022,10103,0,0,10,1022,0,0,108.843785,0.005431999999998993,1505154,0
"172.16.133.184",44041,"173.194.43.45",80,16,3988,10104,0,0,10,1703,6,2285,108.855298,22.883294000000006,595,798
"172.16.133.207",55980,"172.16.139.250",5440,10,1022,10105,0,0,10,1022,0,0,108.868119,0.01462400000001196,559080,0
"172.16.133.83",57138,"172.16.139.250",5440,12,1142,10106,0,0,12,1142,0,0,108.878449,0.008406999999991172,1086713,0
"172.16.133.163",3544,"78.108.118.250",443,6,366,10107,0,0,4,246,2,120,108.886957,0.2146809999999988,9167,4471
"172.16.133.163",3543,"216.219.118.244",443,6,366,10108,0,0,4,246,2,120,108.886959,0.20040999999999087,9819,4790
"172.16.133.93",60767,"172.16.139.250",5440,10,1022,10109,0,0,10,1022,0,0,108.894071,0.01384000000000185,590751,0
"172.16.133.11",55189,"172.16.139.250",5440,10,1022,10110,0,0,10,1022,0,0,108.910376,0.015009000000006267,544739,0
"172.16.133.55",57668,"172.16.139.250",5440,10,1022,10111,0,0,10,1022,0,0,108.916172,0.005340000000003897,1531086,0
"172.16.133.73",60720,"172.16.139.250",5440,10,1022,10112,0,0,10,1022,0,0,108.939408,0.005627000000004045,1452994,0
"172.16.133.184",44042,"173.194.43.45",80,16,3997,10113,0,0,10,2129,6,1868,108.940167,22.798280000000005,747,655
"172.16.133.53",54150,"172.16.139.250",5440,10,1022,10114,0,0,10,1022,0,0,108.941433,0.0073139999999938254,1117856,0
"172.16.133.21",53241,"172.16.139.250",5440,10,1022,10115,0,0,10,1022,0,0,108.943224,0.009636000000000422,848484,0
"172.16.133.30",62670,"172.16.139.250",5440,10,1022,10116,0,0,10,1022,0,0,108.947521,0.009103000000010297,898165,0
"172.16.133.25",63533,"172.16.139.250",5440,12,1142,10117,0,0,12,1142,0,0,108.955643,0.005482000000000653,1666545,0
"172.16.133.34",50486,"172.16.139.250",5440,10,1022,10118,0,0,10,1022,0,0,108.964819,0.00485499999999206,"",""
"172.16.133.97",59419,"172.16.139.250",5440,10,1022,10119,0,0,10,1022,0,0,108.975014,0.014854999999997176,550387,0
"172.16.133.53",54151,"68.64.24.250",443,6,366,10120,0,0,4,246,2,120,109.024709,0.10045699999999158,19590,9556
"172.16.133.33",57932,"172.16.139.250",5440,12,1142,10121,0,0,12,1142,0,0,109.047991,0.006641000000001895,1375696,0
"172.16.133.68",60802,"172.16.139.250",5440,10,1022,10122,0,0,10,1022,0,0,109.08084,0.005572999999998274,1467073,0
"172.16.133.53",54152,"216.219.118.244",443,6,366,10123,0,0,4,246,2,120,109.082576,0.1990770000000026,9885,4822
"172.16.133.53",54153,"78.108.118.250",443,6,366,10124,0,0,4,246,2,120,109.089601,0.19815199999999322,9931,4844
"172.16.133.12",59826,"172.16.139.250",5440,10,1022,10125,0,0,10,1022,0,0,109.094017,0.005607000000011908,1458177,0
"172.16.133.63",53933,"172.16.139.250",5440,10,1022,10126,0,0,10,1022,0,0,109.105205,0.005476000000001591,1493060,0
"172.16.133.66",53926,"172.16.139.250",5440,10,1022,10127,0,0,10,1022,0,0,109.117701,0.006579999999999586,1242553,0
"172.16.133.82",61395,"172.16.139.250",5440,10,1022,10128,0,0,10,1022,0,0,109.132208,0.015363999999991051,532153,0
"172.16.133.37",60672,"172.16.139.250",5440,10,1022,10129,0,0,10,1022,0,0,109.14678,0.0056819999999930815,1438929,0
"172.16.133.163",3545,"216.115.219.126",443,6,366,10130,0,0,4,246,2,120,109.179877,0.49938399999999206,3940,1922
"172.16.133.53",54154,"216.115.219.126",443,6,366,10131,0,0,4,246,2,120,109.222627,0.4823519999999917,4080,1990
"172.16.133.41",53071,"184.84.3.53",80,52,34315,10132,0,0,22,7599,30,26716,109.229009,180.598143,336,1183
"172.16.133.41",53072,"184.84.3.53",80,73,61293,10133,0,0,26,9399,47,51894,109.231048,180.63116000000002,416,2298
"172.16.133.41",53073,"184.84.3.53",80,95,94427,10134,0,0,27,6350,68,88077,109.23122,180.630116,281,3900
"172.16.133.41",53074,"184.84.3.53",80,88,74200,10135,0,0,33,16953,55,57247,109.232094,3.13747699999999,43227,145969
"172.16.133.41",53075,"184.84.3.53",80,62,49426,10136,0,0,23,7711,39,41715,109.232252,180.609402,341,1847
"172.16.133.78",59256,"172.16.139.250",5440,10,1022,10137,0,0,10,1022,0,0,109.302358,0.006850000000000023,1193576,0
"172.16.133.67",56033,"172.16.139.250",5440,10,1022,10138,0,0,10,1022,0,0,109.356021,0.005510999999998489,1483578,0
"172.16.133.56",61477,"172.16.139.250",5440,10,1022,10139,0,0,10,1022,0,0,109.380251,0.004758999999992852,"",""
"172.16.133.41",53076,"172.16.139.250",5440,12,1142,10140,0,0,12,1142,0,0,109.435627,0.006374000000008095,1433322,0
"172.16.133.42",57174,"172.16.139.250",5440,12,1142,10141,0,0,12,1142,0,0,109.444029,0.24896800000000496,36695,0
"172.16.133.85",52320,"172.16.139.250",5440,12,1142,10142,0,0,12,1142,0,0,109.452073,0.015393000000003099,593516,0
"172.16.133.43",57830,"172.16.139.250",5440,12,1142,10143,0,0,12,1142,0,0,109.505853,0.007145999999991659,1278477,0
"172.16.133.63",53934,"180.153.31.250",443,6,366,10144,0,0,4,246,2,120,109.514357,0.47927899999999113,4106,2003
"172.16.133.13",53086,"172.16.139.250",5440,12,1142,10145,0,0,12,1142,0,0,109.524336,0.07954099999999187,114859,0
"172.16.133.41",53077,"23.0.60.101",80,22,8881,10146,0,0,11,3856,11,5025,109.541392,90.461524,341,444
"172.16.133.20",62442,"172.16.139.250",5440,12,1142,10147,0,0,12,1142,0,0,109.573133,0.03407500000000141,268114,0
"172.16.133.75",51025,"172.16.139.250",5440,10,1022,10148,0,0,10,1022,0,0,109.590371,0.020117999999996528,406402,0
"172.16.133.28",65480,"172.16.139.250",5440,10,1022,10149,0,0,10,1022,0,0,109.604764,0.009485999999995443,861901,0
"172.16.133.99",56091,"172.16.139.250",5440,12,1142,10150,0,0,12,1142,0,0,109.629811,0.015013999999993644,608498,0
"172.16.133.41",53078,"23.0.60.101",80,20,4952,10151,0,0,10,2219,10,2733,109.630794,150.37294500000002,118,145
"172.16.133.41",53079,"23.0.60.101",80,19,4415,10152,0,0,10,2229,9,2186,109.631553,180.201194,98,97
"172.16.133.41",53080,"23.0.60.101",80,63,51586,10153,0,0,23,4596,40,46990,109.632413,180.51147300000002,203,2082
"172.16.133.41",53081,"23.0.60.101",80,49,42697,10154,0,0,16,2563,33,40134,109.634273,70.370321,291,4562
"172.16.133.87",60256,"172.16.139.250",5440,10,1022,10155,0,0,10,1022,0,0,109.653643,0.005628000000001521,1452736,0
"172.16.133.35",50021,"172.16.139.250",5440,12,1142,10156,0,0,12,1142,0,0,109.666081,0.028894999999991455,316179,0
"172.16.133.116",53515,"172.16.139.250",5440,10,1022,10157,0,0,10,1022,0,0,109.667554,0.004946000000003892,"",""
"172.16.133.116",53516,"172.16.139.250",5440,10,1022,10158,0,0,10,1022,0,0,109.673445,0.006122000000004846,1335511,0
"172.16.133.116",53517,"172.16.139.250",5440,12,1142,10159,0,0,12,1142,0,0,109.680575,0.006626999999994609,1378602,0
"172.16.133.84",58840,"172.16.139.250",5440,10,1022,10160,0,0,10,1022,0,0,109.690096,0.008113000000008697,1007765,0
"172.16.133.18",50295,"157.56.238.6",443,38,18580,10161,0,0,19,5916,19,12664,109.696498,91.14537800000001,519,1111
"172.16.133.41",53082,"208.47.254.34",80,6,372,10162,0,0,4,246,2,126,109.765241,10.246813000000003,192,98
"172.16.133.41",53083,"208.47.254.34",80,6,372,10163,0,0,4,246,2,126,109.765351,10.236204,192,98
"172.16.133.49",55836,"172.16.139.250",5440,10,1022,10164,0,0,10,1022,0,0,109.767414,0.005687999999992144,1437412,0
"172.16.133.41",53084,"23.33.82.110",443,13,1206,10165,0,0,6,632,7,574,109.793859,22.139115000000004,228,207
"172.16.133.41",53085,"23.33.82.110",443,13,1206,10166,0,0,6,632,7,574,109.793967,22.139988000000002,228,207
"172.16.133.95",57017,"172.16.139.250",5440,10,1022,10167,0,0,10,1022,0,0,109.807313,0.015797000000006278,517566,0
"172.16.133.92",57731,"172.16.139.250",5440,12,1142,10168,0,0,12,1142,0,0,109.833257,0.006332000000000448,1442830,0
"172.16.133.29",61001,"172.16.139.250",5440,10,1022,10169,0,0,10,1022,0,0,109.851892,0.005344999999991273,1529653,0
"172.16.133.44",64884,"172.16.139.250",5440,12,1142,10170,0,0,12,1142,0,0,109.857417,0.00614500000000362,1486737,0
"172.16.133.207",55981,"172.16.139.250",5440,12,1142,10171,0,0,12,1142,0,0,109.882148,0.014893999999998186,613401,0
"172.16.133.83",57139,"172.16.139.250",5440,10,1022,10172,0,0,10,1022,0,0,109.892633,0.014780999999999267,553142,0
"172.16.133.93",60768,"172.16.139.250",5440,12,1142,10173,0,0,12,1142,0,0,109.907544,0.0047280000000000655,"",""
"172.16.133.11",55190,"172.16.139.250",5440,10,1022,10174,0,0,10,1022,0,0,109.92523,0.005645999999998708,1448104,0
"172.16.133.55",57669,"172.16.139.250",5440,12,1142,10175,0,0,12,1142,0,0,109.93,0.014914999999987799,612537,0
"172.16.133.73",60721,"172.16.139.250",5440,10,1022,10176,0,0,10,1022,0,0,109.953576,0.006776000000002114,1206611,0
"172.16.133.53",54155,"172.16.139.250",5440,10,1022,10177,0,0,10,1022,0,0,109.956038,0.007494999999991592,1090860,0
"172.16.133.21",53242,"172.16.139.250",5440,10,1022,10178,0,0,10,1022,0,0,109.957352,0.00962099999999566,849807,0
"172.16.133.30",62671,"172.16.139.250",5440,10,1022,10179,0,0,10,1022,0,0,109.961618,0.009282999999996377,880749,0
"172.16.133.25",63534,"172.16.139.250",5440,10,1022,10180,0,0,10,1022,0,0,109.968421,0.006335999999990349,1290404,0
"172.16.133.34",50487,"172.16.139.250",5440,10,1022,10181,0,0,10,1022,0,0,109.97893,0.0049399999999906186,"",""
"172.16.133.97",59420,"172.16.139.250",5440,10,1022,10182,0,0,10,1022,0,0,109.989306,0.015551000000002091,525753,0
"172.16.133.33",57933,"68.64.24.250",443,6,366,10183,0,0,4,246,2,120,110.028604,0.10298699999999883,19109,9321
"172.16.133.33",57934,"172.16.139.250",5440,12,1142,10184,0,0,12,1142,0,0,110.062076,0.009323999999992338,979836,0
"172.16.133.33",57935,"78.108.118.250",443,6,366,10185,0,0,4,246,2,120,110.081621,0.23723700000000747,8295,4046
"172.16.133.33",57936,"216.219.118.244",443,6,366,10186,0,0,4,246,2,120,110.090403,0.23121799999999837,8511,4151
"172.16.133.68",60803,"172.16.139.250",5440,10,1022,10187,0,0,10,1022,0,0,110.094727,0.0055499999999995,1473153,0
"172.16.133.12",59827,"172.16.139.250",5440,10,1022,10188,0,0,10,1022,0,0,110.108612,0.005458000000004404,1497984,0
"172.16.133.63",53935,"172.16.139.250",5440,10,1022,10189,0,0,10,1022,0,0,110.118821,0.015194000000008145,538107,0
"172.16.133.66",53927,"172.16.139.250",5440,10,1022,10190,0,0,10,1022,0,0,110.13196,0.005728999999988105,1427125,0
"172.16.133.82",61396,"172.16.139.250",5440,10,1022,10191,0,0,10,1022,0,0,110.146515,0.016273000000012416,502427,0
"172.16.133.37",60673,"172.16.139.250",5440,10,1022,10192,0,0,10,1022,0,0,110.159489,0.007145000000008395,1144296,0
"172.16.133.40",50216,"172.16.139.250",5440,12,1142,10193,0,0,12,1142,0,0,110.217647,0.006071000000005711,1504859,0
"172.16.133.33",57937,"216.115.219.126",443,6,366,10194,0,0,4,246,2,120,110.223581,0.49191600000000335,4000,1951
"172.16.133.29",61002,"138.108.6.20",80,8,1674,10195,0,0,4,1016,4,658,110.28159,11.467233000000007,708,459
"172.16.133.29",61003,"64.94.107.11",80,8,1666,10196,0,0,5,1203,3,463,110.303861,0.08012999999999693,120104,46224
"172.16.133.78",59257,"172.16.139.250",5440,10,1022,10197,0,0,10,1022,0,0,110.316623,0.005522999999996614,1480354,0
"172.16.133.71",57555,"157.56.241.118",443,24,8207,10198,0,0,13,1906,11,6301,110.358214,1.0205199999999905,14941,49394
"172.16.133.41",53086,"66.235.138.2",80,17,11467,10199,0,0,10,7706,7,3761,110.362462,9.21338200000001,6691,3265
"172.16.133.67",56034,"172.16.139.250",5440,10,1022,10200,0,0,10,1022,0,0,110.369882,0.005467999999993367,1495245,0
"172.16.133.132",40031,"96.43.146.22",443,70,34415,10201,0,0,42,19045,28,15370,110.380958,29.88393999999998,5098,4114
"172.16.133.56",61478,"172.16.139.250",5440,10,1022,10202,0,0,10,1022,0,0,110.392845,0.005080000000006635,1609448,0
"172.16.133.41",53087,"172.16.139.250",5440,10,1022,10203,0,0,10,1022,0,0,110.448915,0.006183000000007155,1322335,0
"172.16.133.85",52321,"172.16.139.250",5440,10,1022,10204,0,0,10,1022,0,0,110.465737,0.014952999999991334,546779,0
"172.16.133.42",57175,"172.16.139.250",5440,12,1142,10205,0,0,12,1142,0,0,110.479032,0.010893999999993298,838626,0
"172.16.133.43",57831,"172.16.139.250",5440,10,1022,10206,0,0,10,1022,0,0,110.518924,0.005339000000006422,1531372,0
"172.16.133.13",53087,"172.16.139.250",5440,10,1022,10207,0,0,10,1022,0,0,110.538019,0.00546299999999178,1496613,0
"172.16.133.20",62443,"172.16.139.250",5440,10,1022,10208,0,0,10,1022,0,0,110.587912,0.00448599999999999,"",""
"172.16.133.75",51026,"172.16.139.250",5440,10,1022,10209,0,0,10,1022,0,0,110.603654,0.0054609999999968295,1497161,0
"172.16.133.28",65481,"172.16.139.250",5440,12,1142,10210,0,0,12,1142,0,0,110.618975,0.006065999999989913,1506099,0
"172.16.133.184",48180,"96.43.146.48",443,197,139344,10211,0,0,87,23638,110,115706,110.625658,16.49852,11461,56104
"172.16.133.99",56092,"172.16.139.250",5440,10,1022,10212,0,0,10,1022,0,0,110.644774,0.01741200000000731,469561,0
"172.16.133.87",60257,"172.16.139.250",5440,10,1022,10213,0,0,10,1022,0,0,110.668523,0.015785000000008154,517960,0
"172.16.133.35",50022,"172.16.139.250",5440,12,1142,10214,0,0,12,1142,0,0,110.678292,0.01920800000000611,475635,0
"172.16.133.116",53518,"172.16.139.250",5440,10,1022,10215,0,0,10,1022,0,0,110.681238,0.006751000000008389,1211079,0
"172.16.133.116",53519,"172.16.139.250",5440,10,1022,10216,0,0,10,1022,0,0,110.688861,0.008640999999997234,946186,0
"172.16.133.116",53520,"172.16.139.250",5440,10,1022,10217,0,0,10,1022,0,0,110.696624,0.01712100000000305,477542,0
"172.16.133.84",58841,"172.16.139.250",5440,12,1142,10218,0,0,12,1142,0,0,110.704654,0.015664999999998486,583210,0
"172.16.133.49",55837,"184.73.225.104",443,22,7276,10219,0,0,11,1982,11,5294,110.708541,5.3573570000000075,2959,7905
"172.16.133.49",55838,"172.16.139.250",5440,12,1142,10220,0,0,12,1142,0,0,110.781387,0.006455000000002542,1415336,0
"172.16.133.184",48374,"205.216.16.228",80,414,352752,10221,0,0,166,17643,248,335109,110.801653,21.000536999999994,6720,127657
"172.16.133.95",57018,"172.16.139.250",5440,12,1142,10222,0,0,12,1142,0,0,110.819967,0.015495999999998844,589571,0
"172.16.133.92",57732,"172.16.139.250",5440,10,1022,10223,0,0,10,1022,0,0,110.846965,0.01544700000000887,529293,0
"172.16.133.44",64885,"172.16.139.250",5440,10,1022,10224,0,0,10,1022,0,0,110.871767,0.0151299999999992,540383,0
"172.16.133.29",61004,"172.16.139.250",5440,10,1022,10225,0,0,10,1022,0,0,110.893807,0.005616000000003396,1455840,0
"172.16.133.163",3546,"68.64.24.250",443,6,366,10226,0,0,4,246,2,120,110.893872,0.17454100000000494,11275,5500
"172.16.133.207",55982,"172.16.139.250",5440,12,1142,10227,0,0,12,1142,0,0,110.89631,0.014649000000005685,623660,0
"172.16.133.83",57140,"172.16.139.250",5440,12,1142,10228,0,0,12,1142,0,0,110.906536,0.008169999999992683,1118237,0
"172.16.133.184",42907,"96.43.146.178",443,27,9929,10229,0,0,16,3487,11,6442,110.920012,16.206093999999993,1721,3180
"172.16.133.93",60769,"172.16.139.250",5440,12,1142,10230,0,0,12,1142,0,0,110.921587,0.014662000000001285,623107,0
"172.16.133.75",51027,"216.115.219.126",443,6,366,10231,0,0,4,246,2,120,110.926055,0.5227689999999967,3764,1836
"172.16.133.11",55191,"172.16.139.250",5440,10,1022,10232,0,0,10,1022,0,0,110.938874,0.005693000000007942,1436149,0
"172.16.133.55",57670,"172.16.139.250",5440,12,1142,10233,0,0,12,1142,0,0,110.943997,0.006067000000001599,1505851,0
"172.16.133.73",60722,"172.16.139.250",5440,10,1022,10234,0,0,10,1022,0,0,110.969117,0.016141000000004624,506536,0
"172.16.133.53",54156,"172.16.139.250",5440,10,1022,10235,0,0,10,1022,0,0,110.969242,0.005611000000001809,1457137,0
"172.16.133.21",53243,"172.16.139.250",5440,10,1022,10236,0,0,10,1022,0,0,110.971347,0.017869000000004576,457552,0
"172.16.133.30",62672,"172.16.139.250",5440,12,1142,10237,0,0,12,1142,0,0,110.976178,0.005882999999997196,1552949,0
"172.16.133.25",63535,"172.16.139.250",5440,10,1022,10238,0,0,10,1022,0,0,110.982678,0.009952999999995882,821460,0
"172.16.133.163",3547,"216.219.118.244",443,6,366,10239,0,0,4,246,2,120,110.987866,0.21630799999999795,9098,4438
"172.16.133.34",50488,"172.16.139.250",5440,10,1022,10240,0,0,10,1022,0,0,110.992849,0.014639999999999986,558469,0
"172.16.133.163",3548,"78.108.118.250",443,6,366,10241,0,0,4,246,2,120,110.995747,0.22136900000000992,8890,4336
"172.16.133.97",59421,"172.16.139.250",5440,10,1022,10242,0,0,10,1022,0,0,111.003122,0.008077000000000112,1012257,0
"172.16.133.49",55839,"157.56.240.137",443,6,374,10243,0,0,3,194,3,180,111.075846,1.1282819999999987,1375,1276
"172.16.133.33",57938,"172.16.139.250",5440,10,1022,10244,0,0,10,1022,0,0,111.07612,0.0056409999999971205,1449388,0
"172.16.133.53",54157,"68.64.24.250",443,6,366,10245,0,0,4,246,2,120,111.080817,0.11187499999999773,17591,8581
"172.16.133.68",60804,"172.16.139.250",5440,10,1022,10246,0,0,10,1022,0,0,111.108909,0.015415000000004397,530392,0
"172.16.133.41",53088,"107.23.217.190",80,16,3782,10247,0,0,8,2798,8,984,111.111642,68.89392299999999,324,114
"172.16.133.12",59828,"172.16.139.250",5440,10,1022,10248,0,0,10,1022,0,0,111.121857,0.005758000000000152,1419937,0
"172.16.133.63",53936,"172.16.139.250",5440,10,1022,10249,0,0,10,1022,0,0,111.132858,0.0047650000000061254,"",""
"172.16.133.66",53928,"172.16.139.250",5440,10,1022,10250,0,0,10,1022,0,0,111.146882,0.014718000000002007,555510,0
"172.16.133.82",61397,"172.16.139.250",5440,10,1022,10251,0,0,10,1022,0,0,111.160154,0.005699999999990268,1434385,0
"172.16.133.37",60674,"172.16.139.250",5440,10,1022,10252,0,0,10,1022,0,0,111.173388,0.005719999999996617,1429370,0
"172.16.133.53",54158,"216.219.118.244",443,6,366,10253,0,0,4,246,2,120,111.186739,0.2056740000000019,9568,4667
"172.16.133.184",35382,"64.208.138.244",80,10,1941,10254,0,0,5,818,5,1123,111.192137,0.0859129999999908,76170,104570
"172.16.133.53",54159,"78.108.118.250",443,6,366,10255,0,0,4,246,2,120,111.192865,0.2068050000000028,9516,4642
"172.16.133.184",46788,"208.71.125.1",80,11,1878,10256,0,0,6,976,5,902,111.236861,0.10563700000000154,73913,68309
"172.16.133.27",60748,"173.194.73.105",80,7,3292,10257,0,0,4,2439,3,853,111.248068,0.20427499999999554,95518,33405
"172.16.133.27",60750,"173.194.73.105",80,14,6815,10258,0,0,7,2636,7,4179,111.248598,1.1912169999999946,17702,28065
"172.16.133.184",35384,"64.208.138.244",80,11,2089,10259,0,0,6,966,5,1123,111.256491,0.07703100000000518,100323,116628
"172.16.133.25",63536,"74.125.170.42",80,1724,1880124,10260,0,0,496,31693,1228,1848431,111.290007,36.595833999999996,6928,404074
"172.16.133.78",59258,"172.16.139.250",5440,10,1022,10261,0,0,10,1022,0,0,111.329651,0.005731999999994741,1426378,0
"172.16.128.169",3386,"172.16.139.250",21,9,565,10262,0,0,4,242,5,323,111.351381,2.7646139999999946,700,934
"172.16.133.67",56035,"172.16.139.250",5440,10,1022,10263,0,0,10,1022,0,0,111.38346,0.006136999999995396,1332247,0
"172.16.133.71",57556,"157.56.242.198",443,37,12392,10264,0,0,20,3895,17,8497,111.39223,10.328463999999997,3016,6581
"172.16.133.56",61479,"172.16.139.250",5440,12,1142,10265,0,0,12,1142,0,0,111.406959,0.004997000000003027,"",""
"172.16.133.163",3549,"216.115.219.126",443,6,366,10266,0,0,4,246,2,120,111.426934,0.4992280000000022,3942,1922
"172.16.133.53",54160,"216.115.219.126",443,6,366,10267,0,0,4,246,2,120,111.460677,0.48749499999999557,4036,1969
"172.16.133.41",53089,"172.16.139.250",5440,10,1022,10268,0,0,10,1022,0,0,111.462624,0.005692999999993731,1436149,0
"172.16.133.42",57176,"172.16.139.250",5440,12,1142,10269,0,0,12,1142,0,0,111.476306,0.03741600000000744,244173,0
"172.16.133.85",52322,"172.16.139.250",5440,12,1142,10270,0,0,12,1142,0,0,111.479894,0.015664999999998486,583210,0
"172.16.133.43",57832,"172.16.139.250",5440,12,1142,10271,0,0,12,1142,0,0,111.532917,0.007097000000001685,1287304,0
"172.16.133.13",53088,"172.16.139.250",5440,10,1022,10272,0,0,10,1022,0,0,111.551813,0.0053510000000045466,1527938,0
"172.16.133.54",64630,"12.130.48.50",80,8,498,10273,0,0,5,312,3,186,111.600784,9.060265000000001,275,164
"172.16.133.20",62444,"172.16.139.250",5440,10,1022,10274,0,0,10,1022,0,0,111.60092,0.004848999999992998,"",""
"172.16.133.54",64631,"12.130.48.50",80,8,498,10275,0,0,5,312,3,186,111.601707,9.058370999999994,275,164
"172.16.133.54",64632,"12.130.48.50",80,8,498,10276,0,0,5,312,3,186,111.602934,9.058195999999995,275,164
"172.16.133.54",64633,"12.130.48.50",80,8,498,10277,0,0,5,312,3,186,111.603556,9.057091,275,164
"172.16.133.54",64634,"12.130.48.50",80,8,498,10278,0,0,5,312,3,186,111.60374,9.056629000000001,275,164
"172.16.133.54",64635,"12.130.48.50",80,8,498,10279,0,0,5,312,3,186,111.60395,9.056527000000003,275,164
"172.16.133.75",51028,"172.16.139.250",5440,10,1022,10280,0,0,10,1022,0,0,111.618489,0.005512000000010175,1483309,0
"172.16.133.28",65482,"172.16.139.250",5440,10,1022,10281,0,0,10,1022,0,0,111.631941,0.00532200000000671,1536264,0
"172.16.133.99",56093,"172.16.139.250",5440,10,1022,10282,0,0,10,1022,0,0,111.659126,0.014599000000004025,560038,0
"172.16.133.87",60258,"172.16.139.250",5440,10,1022,10283,0,0,10,1022,0,0,111.683293,0.006223999999988905,1313624,0
"172.16.133.35",50023,"172.16.139.250",5440,12,1142,10284,0,0,12,1142,0,0,111.694415,0.009269999999986567,985544,0
"172.16.133.116",53521,"172.16.139.250",5440,10,1022,10285,0,0,10,1022,0,0,111.695343,0.009835000000009586,831316,0
"172.16.133.184",48186,"96.43.146.48",443,182,149125,10286,0,0,74,20645,108,128480,111.695791,15.428132000000005,10705,66621
"172.16.133.184",48187,"96.43.146.48",443,180,160370,10287,0,0,66,16426,114,143944,111.697726,15.425870000000003,8518,74650
"172.16.133.184",48188,"96.43.146.48",443,235,188467,10288,0,0,94,26187,141,162280,111.699556,15.425498000000005,13581,84161
"172.16.133.184",48189,"96.43.146.48",443,274,264004,10289,0,0,84,18090,190,245914,111.701389,15.422973999999996,9383,127557
"172.16.133.184",48190,"96.43.146.48",443,106,68907,10290,0,0,54,12260,52,56647,111.70318,15.421436,6359,29386
"172.16.133.116",53522,"172.16.139.250",5440,10,1022,10291,0,0,10,1022,0,0,111.706149,0.005420000000000869,1508487,0
"172.16.133.116",53523,"172.16.139.250",5440,10,1022,10292,0,0,10,1022,0,0,111.71274,0.016328999999998928,500704,0
"172.16.133.84",58842,"172.16.139.250",5440,10,1022,10293,0,0,10,1022,0,0,111.718432,0.005503999999987741,1485465,0
"172.16.133.49",55840,"172.16.139.250",5440,10,1022,10294,0,0,10,1022,0,0,111.795197,0.015404000000003748,530771,0
"172.16.133.28",65483,"54.243.68.206",80,6,372,10295,0,0,4,246,2,126,111.814788,17.822091,110,56
"172.16.133.28",65484,"54.243.68.206",80,6,372,10296,0,0,4,246,2,126,111.815006,17.822767000000013,110,56
"172.16.133.28",65485,"23.15.129.231",80,6,372,10297,0,0,4,246,2,126,111.815216,17.821727999999993,110,56
"172.16.133.28",65486,"23.15.129.231",80,6,372,10298,0,0,4,246,2,126,111.815368,17.821511999999984,110,56
"172.16.133.28",65487,"23.15.129.231",80,7,432,10299,0,0,4,246,3,186,111.815515,17.822307999999992,110,83
"172.16.133.28",65488,"23.15.129.231",80,6,372,10300,0,0,4,246,2,126,111.815653,17.821290000000005,110,56
"172.16.133.28",65489,"23.62.196.46",80,6,372,10301,0,0,4,246,2,126,111.815858,17.843930999999984,110,56
"172.16.133.28",65490,"23.62.196.46",80,6,372,10302,0,0,4,246,2,126,111.81606,17.846439000000004,110,56
"172.16.133.28",65491,"50.17.220.219",80,6,366,10303,0,0,4,246,2,120,111.816283,17.82441,110,53
"172.16.133.28",65492,"50.17.220.219",80,6,366,10304,0,0,4,246,2,120,111.816472,17.824290999999988,110,53
"172.16.133.28",65493,"173.194.43.60",80,7,432,10305,0,0,4,246,3,186,111.816684,17.820143000000016,110,83
"172.16.133.28",65494,"173.194.43.60",80,6,372,10306,0,0,4,246,2,126,111.816897,17.819981,110,56
"172.16.133.95",57019,"172.16.139.250",5440,12,1142,10307,0,0,12,1142,0,0,111.834146,0.00624700000000189,1462461,0
"172.16.133.92",57733,"172.16.139.250",5440,12,1142,10308,0,0,12,1142,0,0,111.860914,0.015335000000007426,595761,0
"172.16.133.29",61005,"172.16.139.250",5440,10,1022,10309,0,0,10,1022,0,0,111.877967,0.0163830000000047,499053,0
"172.16.133.44",64886,"172.16.139.250",5440,10,1022,10310,0,0,10,1022,0,0,111.885266,0.005417999999991707,1509043,0
"172.16.133.207",55983,"172.16.139.250",5440,10,1022,10311,0,0,10,1022,0,0,111.910302,0.004715000000004466,"",""
"172.16.133.83",57141,"172.16.139.250",5440,12,1142,10312,0,0,12,1142,0,0,111.92066,0.00619700000000023,1474261,0
"172.16.133.28",65495,"173.194.43.59",80,6,372,10313,0,0,4,246,2,126,111.934636,17.695779,111,56
"172.16.133.28",65496,"173.194.43.59",80,6,372,10314,0,0,4,246,2,126,111.934879,17.69642300000001,111,56
"172.16.133.28",65497,"23.45.65.19",80,7,432,10315,0,0,4,246,3,186,111.935175,17.726443000000003,111,83
"172.16.133.28",65498,"206.33.41.253",80,23,7118,10316,0,0,11,2121,12,4997,111.935489,17.702217000000005,958,2258
"172.16.133.28",65499,"206.33.41.253",80,29,10731,10317,0,0,13,2976,16,7755,111.935716,17.702059000000006,1344,3504
"172.16.133.93",60770,"172.16.139.250",5440,12,1142,10318,0,0,12,1142,0,0,111.935793,0.004831999999993286,"",""
"172.16.133.28",65500,"206.33.41.253",80,22,7068,10319,0,0,10,2076,12,4992,111.935943,17.701962999999992,938,2256
"172.16.133.28",65501,"206.33.41.253",80,23,9508,10320,0,0,10,2061,13,7447,111.936178,17.701346000000015,931,3365
"172.16.133.28",65502,"206.33.41.253",80,36,21243,10321,0,0,15,2346,21,18897,111.936409,17.700343000000004,1060,8540
"172.16.133.28",65503,"206.33.41.253",80,21,6552,10322,0,0,10,2061,11,4491,111.93664,17.70098800000001,931,2029
"172.16.133.28",65504,"64.94.107.62",80,8,2047,10323,0,0,5,1584,3,463,111.93706,0.7937319999999914,15965,4666
"172.16.133.28",65505,"64.94.107.62",80,10,2395,10324,0,0,6,1872,4,523,111.937315,2.9703499999999963,5041,1408
"172.16.133.28",65506,"208.111.160.6",80,8,492,10325,0,0,4,246,4,246,111.937625,17.70406,111,111
"172.16.133.28",65507,"208.111.160.6",80,8,492,10326,0,0,4,246,4,246,111.937871,17.704654000000005,111,111
"172.16.133.28",65508,"208.111.160.6",80,8,492,10327,0,0,4,246,4,246,111.938107,17.70350400000001,111,111
"172.16.133.28",65509,"208.111.160.6",80,8,492,10328,0,0,4,246,4,246,111.938351,17.704175000000006,111,111
"172.16.133.28",65510,"208.111.160.6",80,8,492,10329,0,0,4,246,4,246,111.938591,17.703019000000012,111,111
"172.16.133.28",65511,"208.111.160.6",80,33,25503,10330,0,0,11,3516,22,21987,111.938831,37.719368,745,4663
"172.16.133.28",65512,"138.108.7.20",80,4,252,10331,0,0,2,126,2,126,111.939125,12.891694000000001,78,78
"172.16.133.28",65513,"138.108.7.20",80,4,252,10332,0,0,2,126,2,126,111.939346,9.655761999999996,104,104
"172.16.133.28",65514,"138.108.7.20",80,11,4047,10333,0,0,6,2917,5,1130,111.939576,16.519910999999993,1412,547
"172.16.133.28",65515,"216.52.242.80",80,6,372,10334,0,0,4,246,2,126,111.940035,17.771564000000012,110,56
"172.16.133.28",65516,"216.52.242.80",80,115,95569,10335,0,0,42,18204,73,77365,111.940292,37.52249699999999,3881,16494
"172.16.133.28",65517,"216.52.242.80",80,6,372,10336,0,0,4,246,2,126,111.940501,17.768687000000014,110,56
"172.16.133.28",65518,"216.52.242.80",80,6,372,10337,0,0,4,246,2,126,111.940733,17.77005300000002,110,56
"172.16.133.28",65519,"216.52.242.80",80,6,372,10338,0,0,4,246,2,126,111.940962,17.767286999999996,110,56
"172.16.133.28",65520,"23.62.193.244",80,7,432,10339,0,0,4,246,3,186,111.942362,17.724085000000002,111,83
"172.16.133.28",65521,"23.62.193.244",80,6,372,10340,0,0,4,246,2,126,111.942595,17.723024999999993,111,56
"172.16.133.11",55192,"172.16.139.250",5440,10,1022,10341,0,0,10,1022,0,0,111.952572,0.015298000000001366,534448,0
"172.16.133.55",57671,"172.16.139.250",5440,10,1022,10342,0,0,10,1022,0,0,111.958397,0.005648999999991133,1447335,0
"172.16.133.73",60723,"172.16.139.250",5440,10,1022,10343,0,0,10,1022,0,0,111.980681,0.005682999999990557,1438676,0
"172.16.133.53",54161,"172.16.139.250",5440,10,1022,10344,0,0,10,1022,0,0,111.984479,0.00561300000001097,1456618,0
"172.16.133.21",53244,"172.16.139.250",5440,10,1022,10345,0,0,10,1022,0,0,111.985657,0.015369999999990114,531945,0
"172.16.133.30",62673,"172.16.139.250",5440,12,1142,10346,0,0,12,1142,0,0,111.989177,0.00604300000000535,1511831,0
"172.16.133.54",64636,"12.130.48.50",80,16,3756,10347,0,0,9,2266,7,1490,111.996383,116.22028200000001,155,102
"172.16.133.54",64637,"12.130.48.50",80,16,4076,10348,0,0,9,2265,7,1811,111.99664,116.220026,155,124
"172.16.133.54",64638,"12.130.48.50",80,12,2300,10349,0,0,7,1285,5,1015,111.996824,116.22003799999999,88,69
"172.16.133.25",63537,"172.16.139.250",5440,10,1022,10350,0,0,10,1022,0,0,111.99698,0.018773000000010143,435519,0
"172.16.133.54",64639,"12.130.48.50",80,16,4101,10351,0,0,9,2258,7,1843,111.996982,116.21975799999998,155,126
"172.16.133.54",64640,"12.130.48.50",80,12,2311,10352,0,0,7,1285,5,1026,111.997172,116.219379,88,70
"172.16.133.54",64641,"12.130.48.50",80,24,6443,10353,0,0,14,4358,10,2085,111.997346,144.214783,241,115
"172.16.133.34",50489,"172.16.139.250",5440,10,1022,10354,0,0,10,1022,0,0,112.007056,0.005015999999997689,1629984,0
"172.16.133.97",59422,"172.16.139.250",5440,10,1022,10355,0,0,10,1022,0,0,112.016068,0.005434999999991419,1504323,0
"172.16.133.33",57939,"68.64.24.250",443,6,366,10356,0,0,4,246,2,120,112.083641,0.15658999999999423,12567,6130
"172.16.133.33",57940,"172.16.139.250",5440,12,1142,10357,0,0,12,1142,0,0,112.091112,0.006149000000007732,1485770,0
"172.16.133.68",60806,"172.16.139.250",5440,10,1022,10358,0,0,10,1022,0,0,112.123236,0.005947999999989406,1374579,0
"172.16.133.12",59829,"172.16.139.250",5440,12,1142,10359,0,0,12,1142,0,0,112.13618,0.0061670000000049185,1481433,0
"172.16.133.63",53937,"172.16.139.250",5440,10,1022,10360,0,0,10,1022,0,0,112.14622,0.005269999999995889,1551423,0
"172.16.133.66",53929,"172.16.139.250",5440,10,1022,10361,0,0,10,1022,0,0,112.159727,0.014883999999995012,549314,0
"172.16.133.82",61398,"172.16.139.250",5440,12,1142,10362,0,0,12,1142,0,0,112.17326,0.0063370000000020354,1441691,0
"172.16.133.37",60675,"172.16.139.250",5440,10,1022,10363,0,0,10,1022,0,0,112.187115,0.004837999999992348,"",""
"172.16.133.33",57941,"78.108.118.250",443,6,366,10364,0,0,4,246,2,120,112.195628,0.21546800000000133,9133,4455
"172.16.133.33",57942,"216.219.118.244",443,6,366,10365,0,0,4,246,2,120,112.201523,0.22152499999999975,8883,4333
"172.16.133.49",55841,"157.56.244.217",443,6,374,10366,0,0,3,194,3,180,112.204611,1.1715899999999948,1324,1229
"172.16.133.78",59259,"172.16.139.250",5440,10,1022,10367,0,0,10,1022,0,0,112.344562,0.0062500000000085265,1308159,0
"172.16.133.67",56036,"172.16.139.250",5440,10,1022,10368,0,0,10,1022,0,0,112.397822,0.005417999999991707,1509043,0
"172.16.133.56",61480,"172.16.139.250",5440,10,1022,10369,0,0,10,1022,0,0,112.420052,0.00903300000000229,905125,0
"172.16.133.28",65522,"23.62.193.244",80,6,372,10370,0,0,4,246,2,126,112.473453,17.190999000000005,114,58
"172.16.133.33",57943,"216.115.219.126",443,6,366,10371,0,0,4,246,2,120,112.475653,0.49232700000000307,3997,1949
"172.16.133.41",53090,"172.16.139.250",5440,10,1022,10372,0,0,10,1022,0,0,112.477757,0.005302999999997837,1541768,0
"172.16.133.42",57177,"172.16.139.250",5440,12,1142,10373,0,0,12,1142,0,0,112.487341,0.04098899999999617,222889,0
"172.16.133.85",52323,"172.16.139.250",5440,10,1022,10374,0,0,10,1022,0,0,112.493103,0.005426999999997406,1506541,0
"172.16.133.55",57672,"173.201.252.207",80,147,146549,10375,0,0,44,5411,103,141138,112.536364,5.006567999999987,8646,225524
"172.16.133.43",57833,"172.16.139.250",5440,12,1142,10376,0,0,12,1142,0,0,112.5475,0.006432000000003768,1420398,0
"172.16.133.40",50217,"96.43.146.48",443,16,2507,10377,0,0,9,1594,7,913,112.559362,176.374024,72,41
"172.16.133.13",53089,"172.16.139.250",5440,12,1142,10378,0,0,12,1142,0,0,112.565029,0.0061160000000057835,1493786,0
"172.16.133.20",62445,"172.16.139.250",5440,12,1142,10379,0,0,12,1142,0,0,112.615146,0.004987999999997328,"",""
"172.16.133.75",51029,"172.16.139.250",5440,10,1022,10380,0,0,10,1022,0,0,112.631396,0.005279000000001588,1548778,0
"172.16.133.28",65523,"172.16.139.250",5440,10,1022,10381,0,0,10,1022,0,0,112.645898,0.0074249999999977945,1101144,0
"172.16.133.99",56094,"172.16.139.250",5440,12,1142,10382,0,0,12,1142,0,0,112.673133,0.014326999999994428,637677,0
"172.16.133.87",60259,"172.16.139.250",5440,10,1022,10383,0,0,10,1022,0,0,112.695739,0.018102999999996428,451637,0
"172.16.133.35",50024,"172.16.139.250",5440,12,1142,10384,0,0,12,1142,0,0,112.711665,0.08423000000000513,108464,0
"172.16.133.116",53524,"172.16.139.250",5440,10,1022,10385,0,0,10,1022,0,0,112.712825,0.010451000000003319,782317,0
"172.16.133.116",53525,"172.16.139.250",5440,10,1022,10386,0,0,10,1022,0,0,112.725137,0.005474999999989905,1493333,0
"172.16.133.116",53526,"172.16.139.250",5440,10,1022,10387,0,0,10,1022,0,0,112.731488,0.009831000000005474,831654,0
"172.16.133.84",58843,"172.16.139.250",5440,12,1142,10388,0,0,12,1142,0,0,112.731812,0.006486999999992804,1408355,0
"172.16.133.49",55842,"172.16.139.250",5440,12,1142,10389,0,0,12,1142,0,0,112.809328,0.015563000000000216,587033,0
"172.16.133.95",57020,"172.16.139.250",5440,12,1142,10390,0,0,12,1142,0,0,112.847843,0.0071120000000064465,1284589,0
"172.16.133.92",57734,"172.16.139.250",5440,12,1142,10391,0,0,12,1142,0,0,112.875342,0.01592899999999986,573545,0
"172.16.133.29",61006,"172.16.139.250",5440,10,1022,10392,0,0,10,1022,0,0,112.893535,0.00609500000000196,1341427,0
"172.16.133.41",53091,"199.102.234.31",80,37,30166,10393,0,0,12,2862,25,27304,112.895249,0.8084659999999957,28320,270180
"172.16.133.41",53092,"199.102.234.31",80,18,7804,10394,0,0,8,2662,10,5142,112.896137,1.3639239999999972,15613,30160
"172.16.133.41",53093,"199.102.234.31",80,13,4991,10395,0,0,6,2683,7,2308,112.896414,1.1544370000000015,18592,15993
"172.16.133.41",53094,"23.33.82.110",443,13,1206,10396,0,0,6,632,7,574,112.896663,29.04342100000001,174,158
"172.16.133.44",64887,"172.16.139.250",5440,10,1022,10397,0,0,10,1022,0,0,112.899379,0.01557100000000844,525078,0
"172.16.133.207",55984,"172.16.139.250",5440,12,1142,10398,0,0,12,1142,0,0,112.924416,0.014693000000008283,621792,0
"172.16.133.83",57142,"172.16.139.250",5440,10,1022,10399,0,0,10,1022,0,0,112.934818,0.014600999999998976,559961,0
"172.16.133.93",60771,"172.16.139.250",5440,12,1142,10400,0,0,12,1142,0,0,112.949597,0.005256000000002814,1738203,0
"172.16.133.11",55193,"172.16.139.250",5440,10,1022,10401,0,0,10,1022,0,0,112.967062,0.005296999999998775,1543515,0
"172.16.133.163",3550,"68.64.24.250",443,6,366,10402,0,0,4,246,2,120,112.970009,0.12546499999999128,15685,7651
"172.16.133.55",57673,"172.16.139.250",5440,10,1022,10403,0,0,10,1022,0,0,112.971013,0.005358999999998559,1525657,0
"172.16.133.73",60724,"172.16.139.250",5440,12,1142,10404,0,0,12,1142,0,0,112.996033,0.019177999999996587,476379,0
"172.16.133.53",54162,"172.16.139.250",5440,12,1142,10405,0,0,12,1142,0,0,112.997124,0.020913000000007287,436857,0
"172.16.133.21",53245,"172.16.139.250",5440,10,1022,10406,0,0,10,1022,0,0,113.000407,0.005774999999999864,1415757,0
"172.16.133.30",62674,"172.16.139.250",5440,12,1142,10407,0,0,12,1142,0,0,113.004003,0.007137999999997646,1279910,0
"172.16.133.97",59423,"216.219.113.250",443,7,426,10408,0,0,5,306,2,120,113.010204,0.879649999999998,2782,1091
"172.16.133.97",59424,"67.217.64.244",443,6,366,10409,0,0,4,246,2,120,113.011256,0.18736199999999315,10503,5123
"172.16.133.25",63539,"172.16.139.250",5440,10,1022,10410,0,0,10,1022,0,0,113.011354,0.017521000000002118,466640,0
"172.16.133.97",59425,"216.115.223.200",443,6,366,10411,0,0,4,246,2,120,113.011862,0.2501630000000006,7866,3837
"172.16.133.97",59426,"66.151.150.190",443,7,426,10412,0,0,5,306,2,120,113.013653,0.8272800000000018,2959,1160
"172.16.133.34",50490,"172.16.139.250",5440,12,1142,10413,0,0,12,1142,0,0,113.019991,0.005155000000002019,1772259,0
"172.16.133.97",59427,"172.16.139.250",5440,12,1142,10414,0,0,12,1142,0,0,113.030073,0.006337999999999511,1441464,0
"172.16.133.33",57944,"172.16.139.250",5440,10,1022,10415,0,0,10,1022,0,0,113.103508,0.005218999999996754,1566583,0
"172.16.133.163",3551,"216.219.118.244",443,8,486,10416,0,0,5,306,3,180,113.105963,3.341386,732,430
"172.16.133.163",3552,"78.108.118.250",443,6,366,10417,0,0,4,246,2,120,113.115889,0.31726400000000865,6203,3025
"172.16.133.68",60807,"172.16.139.250",5440,12,1142,10418,0,0,12,1142,0,0,113.136771,0.006223000000005641,1468102,0
"172.16.133.53",54163,"68.64.24.250",443,6,366,10419,0,0,4,246,2,120,113.14283,0.20420799999999417,9637,4701
"172.16.133.12",59830,"172.16.139.250",5440,12,1142,10420,0,0,12,1142,0,0,113.151213,0.011200999999999794,815641,0
"172.16.133.63",53938,"172.16.139.250",5440,10,1022,10421,0,0,10,1022,0,0,113.159854,0.014478000000011093,564718,0
"172.16.133.66",53930,"172.16.139.250",5440,10,1022,10422,0,0,10,1022,0,0,113.173812,0.00548700000000224,1490067,0
"172.16.133.82",61399,"172.16.139.250",5440,10,1022,10423,0,0,10,1022,0,0,113.187168,0.005723000000003253,1428621,0
"172.16.133.37",60676,"172.16.139.250",5440,10,1022,10424,0,0,10,1022,0,0,113.202089,0.005836000000002173,1400959,0
"172.16.133.184",58137,"65.54.81.135",443,124,82244,10425,0,0,55,4900,69,77344,113.262732,4.083026000000004,9600,151542
"172.16.133.53",54164,"216.219.118.244",443,7,426,10426,0,0,5,306,2,120,113.295784,0.6133999999999986,3990,1565
"172.16.133.53",54165,"78.108.118.250",443,7,426,10427,0,0,5,306,2,120,113.300574,0.6241559999999993,3922,1538
"172.16.133.71",57557,"157.56.236.89",443,2,138,10428,0,0,1,78,1,60,113.344527,0.08826500000000692,7069,5438
"172.16.133.78",59260,"172.16.139.250",5440,10,1022,10429,0,0,10,1022,0,0,113.357904,0.0054469999999895435,1501009,0
"172.16.133.49",55843,"157.56.234.137",443,5,314,10430,0,0,3,194,2,120,113.376635,3.6766090000000133,422,261
"172.16.133.67",56037,"172.16.139.250",5440,12,1142,10431,0,0,12,1142,0,0,113.411817,0.01530999999999949,596734,0
"172.16.133.71",57558,"157.56.240.137",443,3,216,10432,0,0,2,156,1,60,113.434156,1.0703840000000042,1165,448
"172.16.133.56",61481,"172.16.139.250",5440,12,1142,10433,0,0,12,1142,0,0,113.435183,0.014564000000007127,627300,0
"172.16.133.41",53095,"172.16.139.250",5440,10,1022,10434,0,0,10,1022,0,0,113.490688,0.004945999999989681,"",""
"172.16.133.42",57178,"172.16.139.250",5440,12,1142,10435,0,0,12,1142,0,0,113.506224,0.0663940000000025,137602,0
"172.16.133.85",52324,"172.16.139.250",5440,10,1022,10436,0,0,10,1022,0,0,113.508178,0.018038000000004217,453265,0
"172.16.133.45",61342,"64.90.204.229",443,17,2870,10437,0,0,8,1795,9,1075,113.534802,2.4954780000000056,5754,3446
"172.16.133.121",56538,"98.129.142.248",80,11,1999,10438,0,0,6,1334,5,665,113.553943,10.46229799999999,1020,508
"172.16.133.121",56539,"98.129.142.248",80,11,1997,10439,0,0,6,1333,5,664,113.556946,10.457418000000004,1019,507
"172.16.133.43",57834,"172.16.139.250",5440,10,1022,10440,0,0,10,1022,0,0,113.560719,0.014668999999997823,557365,0
"172.16.133.13",53090,"172.16.139.250",5440,12,1142,10441,0,0,12,1142,0,0,113.580249,0.007940000000004943,1150629,0
"172.16.133.20",62446,"172.16.139.250",5440,12,1142,10442,0,0,12,1142,0,0,113.629,0.005212999999997692,1752541,0
"172.16.133.75",51030,"172.16.139.250",5440,10,1022,10443,0,0,10,1022,0,0,113.645567,0.005538000000001375,1476345,0
"172.16.133.28",65524,"172.16.139.250",5440,12,1142,10444,0,0,12,1142,0,0,113.659929,0.006028999999998064,1515342,0
"172.16.133.163",3553,"216.115.219.126",443,6,366,10445,0,0,4,246,2,120,113.680991,0.5502249999999975,3576,1744
"172.16.133.99",56095,"172.16.139.250",5440,12,1142,10446,0,0,12,1142,0,0,113.68694,0.13574199999999337,67304,0
"172.16.133.53",54166,"216.115.219.126",443,6,366,10447,0,0,4,246,2,120,113.707861,0.5235850000000113,3758,1833
"172.16.133.87",60260,"172.16.139.250",5440,12,1142,10448,0,0,12,1142,0,0,113.711714,0.11096399999999562,82333,0
"172.16.133.35",50025,"172.16.139.250",5440,12,1142,10449,0,0,12,1142,0,0,113.718672,0.1055070000000029,86591,0
"172.16.133.116",53527,"172.16.139.250",5440,12,1142,10450,0,0,12,1142,0,0,113.727526,0.09515400000000795,96012,0
"172.16.133.84",58844,"172.16.139.250",5440,10,1022,10451,0,0,10,1022,0,0,113.746548,0.07414399999998977,110271,0
"172.16.133.184",48385,"205.216.16.228",80,16,5807,10452,0,0,9,1788,7,4019,113.790405,9.399253999999999,1521,3420
"172.16.133.184",48386,"205.216.16.228",80,23,10053,10453,0,0,12,1976,11,8077,113.791725,9.398013000000006,1682,6875
"172.16.133.49",55844,"172.16.139.250",5440,10,1022,10454,0,0,10,1022,0,0,113.822193,0.014840000000006626,550943,0
"172.16.133.116",53528,"172.16.139.250",5440,12,1142,10455,0,0,12,1142,0,0,113.822749,0.006008999999991715,1520386,0
"172.16.133.116",53529,"172.16.139.250",5440,10,1022,10456,0,0,10,1022,0,0,113.829254,0.01546199999999942,528780,0
"172.16.133.95",57021,"172.16.139.250",5440,10,1022,10457,0,0,10,1022,0,0,113.861129,0.0055949999999995725,1461304,0
"172.16.133.92",57735,"172.16.139.250",5440,10,1022,10458,0,0,10,1022,0,0,113.888086,0.005613999999994235,1456359,0
"172.16.133.29",61007,"172.16.139.250",5440,10,1022,10459,0,0,10,1022,0,0,113.907136,0.00515700000001118,1585417,0
"172.16.133.44",64888,"172.16.139.250",5440,10,1022,10460,0,0,10,1022,0,0,113.913649,0.005309999999994375,1539736,0
"172.16.133.207",55985,"172.16.139.250",5440,10,1022,10461,0,0,10,1022,0,0,113.938153,0.0046679999999952315,"",""
"172.16.133.83",57143,"172.16.139.250",5440,12,1142,10462,0,0,12,1142,0,0,113.947611,0.005278000000004113,1730958,0
"172.16.133.93",60772,"172.16.139.250",5440,10,1022,10463,0,0,10,1022,0,0,113.963671,0.014514999999988731,563279,0
"172.16.133.11",55194,"172.16.139.250",5440,10,1022,10464,0,0,10,1022,0,0,113.980896,0.01619599999999366,504816,0
"172.16.133.41",53096,"199.102.234.31",80,13,4524,10465,0,0,6,2623,7,1901,113.98528,0.11148799999999426,188217,136409
"172.16.133.55",57674,"172.16.139.250",5440,12,1142,10466,0,0,12,1142,0,0,113.986117,0.010901000000004046,838088,0
"172.16.133.73",60725,"172.16.139.250",5440,10,1022,10467,0,0,10,1022,0,0,114.00926,0.006727999999995404,1215219,0
"172.16.133.55",57675,"173.201.252.207",80,27,19164,10468,0,0,11,1730,16,17434,114.01065,3.5338840000000005,3916,39467
"172.16.133.53",54167,"172.16.139.250",5440,10,1022,10469,0,0,10,1022,0,0,114.011074,0.008575000000007549,953469,0
"172.16.133.55",57676,"173.201.252.207",80,11,3131,10470,0,0,6,1404,5,1727,114.011829,3.532589999999999,3179,3911
"172.16.133.55",57677,"173.201.252.207",80,16,8425,10471,0,0,7,1462,9,6963,114.012151,3.5309390000000036,3312,15775
"172.16.133.21",53246,"172.16.139.250",5440,12,1142,10472,0,0,12,1142,0,0,114.0133,0.015986999999995533,571464,0
"172.16.133.30",62675,"172.16.139.250",5440,10,1022,10473,0,0,10,1022,0,0,114.019057,0.005393999999995458,1515758,0
"172.16.133.25",63540,"172.16.139.250",5440,10,1022,10474,0,0,10,1022,0,0,114.024815,0.0075629999999904385,1081052,0
"172.16.133.34",50491,"172.16.139.250",5440,10,1022,10475,0,0,10,1022,0,0,114.034332,0.0050459999999930005,1620293,0
"172.16.133.97",59428,"172.16.139.250",5440,10,1022,10476,0,0,10,1022,0,0,114.044485,0.005389000000008082,1517164,0
"172.16.133.55",57678,"173.194.74.95",80,16,2466,10477,0,0,8,902,8,1564,114.045156,180.22621299999997,40,69
"172.16.133.33",57945,"172.16.139.250",5440,12,1142,10478,0,0,12,1142,0,0,114.118191,0.0058120000000059235,1571920,0
"172.16.133.68",60808,"172.16.139.250",5440,10,1022,10479,0,0,10,1022,0,0,114.151012,0.005762000000004264,1418951,0
"172.16.133.12",59831,"172.16.139.250",5440,10,1022,10480,0,0,10,1022,0,0,114.167787,0.024413999999993052,334889,0
"172.16.133.63",53939,"172.16.139.250",5440,12,1142,10481,0,0,12,1142,0,0,114.173896,0.015794999999997117,578410,0
"172.16.133.33",57946,"68.64.24.250",443,7,426,10482,0,0,4,246,3,180,114.183606,0.14255500000000154,13805,10101
"172.16.133.66",53931,"172.16.139.250",5440,10,1022,10483,0,0,10,1022,0,0,114.187952,0.015719000000004257,520134,0
"172.16.133.82",61400,"172.16.139.250",5440,10,1022,10484,0,0,10,1022,0,0,114.200992,0.014784000000005904,553030,0
"172.16.133.55",57679,"173.201.252.207",80,10,636,10485,0,0,6,378,4,258,114.204519,13.336908999999991,226,154
"172.16.133.37",60677,"172.16.139.250",5440,10,1022,10486,0,0,10,1022,0,0,114.214634,0.006183999999990419,1322121,0
"172.16.133.101",51135,"96.43.146.22",443,6,394,10487,0,0,3,197,3,197,114.227306,0.04794599999999605,32870,32870
"172.16.133.33",57947,"78.108.118.250",443,6,366,10488,0,0,4,246,2,120,114.309617,0.19785299999999495,9946,4852
"172.16.133.33",57948,"216.219.118.244",443,6,366,10489,0,0,4,246,2,120,114.321539,0.2264859999999942,8689,4238
"172.16.133.55",57680,"68.67.159.186",80,11,1488,10490,0,0,6,762,5,726,114.368007,13.088280999999995,465,443
"172.16.133.55",57681,"72.32.20.62",80,11,5510,10491,0,0,5,1285,6,4225,114.36906,0.23473699999999553,43793,143990
"172.16.133.78",59261,"172.16.139.250",5440,10,1022,10492,0,0,10,1022,0,0,114.371742,0.005693000000007942,1436149,0
"172.16.133.55",57682,"204.13.194.137",80,18,8080,10493,0,0,9,4062,9,4018,114.411388,13.043902000000003,2491,2464
"172.16.133.67",56038,"172.16.139.250",5440,12,1142,10494,0,0,12,1142,0,0,114.425856,0.015353000000004613,595062,0
"172.16.133.56",61482,"172.16.139.250",5440,12,1142,10495,0,0,12,1142,0,0,114.447925,0.006050000000001887,1510082,0
"172.16.133.163",3554,"15.217.8.105",80,12,5637,10496,0,0,6,1818,6,3819,114.455669,40.05705800000001,363,762
"172.16.133.78",59262,"72.164.194.2",34615,3,194,10497,0,0,3,194,0,0,114.4595,8.993398999999997,172,0
"172.16.133.78",59263,"76.1.227.84",36607,3,194,10498,0,0,3,194,0,0,114.480015,8.99487400000001,172,0
"172.16.133.78",59264,"192.156.215.1",41496,3,194,10499,0,0,3,194,0,0,114.490803,8.994073999999998,172,0
"172.16.133.78",59265,"134.126.221.147",11541,3,194,10500,0,0,3,194,0,0,114.490975,8.99188199999999,172,0
"172.16.133.78",59266,"66.69.19.126",25565,1051,962708,10501,0,0,377,26373,674,936335,114.491112,182.71162900000002,1154,40997
"172.16.133.41",53097,"172.16.139.250",5440,10,1022,10502,0,0,10,1022,0,0,114.504852,0.005446000000006279,1501285,0
"172.16.133.71",57559,"157.56.244.217",443,2,138,10503,0,0,1,78,1,60,114.505627,0.041111000000000786,15178,11675
"172.16.133.42",57179,"172.16.139.250",5440,12,1142,10504,0,0,12,1142,0,0,114.516293,0.010053999999996677,908693,0
"172.16.133.85",52325,"172.16.139.250",5440,10,1022,10505,0,0,10,1022,0,0,114.521596,0.005507999999991853,1484386,0
"172.16.133.184",37005,"173.194.43.59",443,20,5796,10506,0,0,12,2088,8,3708,114.527742,17.210482,970,1723
"172.16.133.55",57683,"66.220.152.19",443,33,5930,10507,0,0,14,1912,19,4018,114.539188,120.254716,127,267
"172.16.133.71",57560,"157.56.234.137",443,2,138,10508,0,0,1,78,1,60,114.548026,0.07205100000000186,8660,6661
"172.16.133.43",57835,"172.16.139.250",5440,10,1022,10509,0,0,10,1022,0,0,114.575382,0.005504999999999427,1485195,0
"172.16.133.184",54103,"107.22.223.184",443,22,8073,10510,0,0,12,1494,10,6579,114.583052,0.2536479999999983,47120,207500
"172.16.133.184",40627,"38.126.130.199",443,20,8179,10511,0,0,10,1541,10,6638,114.58707,0.1865980000000036,66067,284590
"172.16.133.13",53091,"172.16.139.250",5440,10,1022,10512,0,0,10,1022,0,0,114.593197,0.005313000000001011,1538866,0
"172.16.133.78",59267,"71.9.60.231",56453,658,524266,10513,0,0,258,18943,400,505323,114.613902,181.10970000000003,836,22321
"172.16.133.71",57561,"157.56.236.89",80,8,926,10514,0,0,5,574,3,352,114.624421,0.29876500000000306,15369,9425
"172.16.133.20",62447,"172.16.139.250",5440,12,1142,10515,0,0,12,1142,0,0,114.643071,0.00514599999999632,1775359,0
"172.16.133.75",51031,"172.16.139.250",5440,10,1022,10516,0,0,10,1022,0,0,114.659376,0.014818000000005327,551761,0
"172.16.133.28",65525,"172.16.139.250",5440,10,1022,10517,0,0,10,1022,0,0,114.673923,0.007554999999996426,1082197,0
"172.16.133.99",56096,"172.16.139.250",5440,12,1142,10518,0,0,12,1142,0,0,114.701722,0.015211999999991122,600578,0
"172.16.133.33",57949,"216.115.219.126",443,6,366,10519,0,0,4,246,2,120,114.722522,0.5486319999999978,3587,1749
"172.16.133.87",60261,"172.16.139.250",5440,10,1022,10520,0,0,10,1022,0,0,114.724867,0.01548799999999062,527892,0
"172.16.133.35",50026,"172.16.139.250",5440,12,1142,10521,0,0,12,1142,0,0,114.733704,0.037026999999994814,246738,0
"172.16.133.116",53530,"172.16.139.250",5440,10,1022,10522,0,0,10,1022,0,0,114.738832,0.006621999999993022,1234672,0
"172.16.133.116",53531,"172.16.139.250",5440,10,1022,10523,0,0,10,1022,0,0,114.74606,0.006473999999997204,1262897,0
"172.16.133.116",53532,"172.16.139.250",5440,10,1022,10524,0,0,10,1022,0,0,114.753049,0.014628999999999337,558889,0
"172.16.133.84",58845,"172.16.139.250",5440,10,1022,10525,0,0,10,1022,0,0,114.760632,0.015197000000000571,538000,0
"172.16.133.184",55210,"64.208.138.244",443,15,4803,10526,0,0,8,1417,7,3386,114.813042,0.1449230000000057,78220,186913
"172.16.133.71",57562,"157.56.241.118",443,25,8367,10527,0,0,14,1549,11,6818,114.825368,0.8889230000000055,13940,61359
"172.16.133.49",55845,"172.16.139.250",5440,10,1022,10528,0,0,10,1022,0,0,114.836499,0.00627299999999309,1303363,0
"172.16.133.95",57022,"172.16.139.250",5440,12,1142,10529,0,0,12,1142,0,0,114.876096,0.0060579999999959,1508088,0
"172.16.133.92",57736,"172.16.139.250",5440,10,1022,10530,0,0,10,1022,0,0,114.903267,0.0055499999999995,1473153,0
"172.16.133.29",61008,"172.16.139.250",5440,10,1022,10531,0,0,10,1022,0,0,114.920413,0.015228000000007569,536905,0
"172.16.133.44",64889,"172.16.139.250",5440,10,1022,10532,0,0,10,1022,0,0,114.927464,0.014441000000005033,566165,0
"172.16.133.207",55986,"172.16.139.250",5440,12,1142,10533,0,0,12,1142,0,0,114.952361,0.005012000000007788,1822825,0
"172.16.133.184",43139,"107.22.223.184",80,10,1465,10534,0,0,5,690,5,775,114.960638,0.14071799999999257,39227,44059
"172.16.133.83",57144,"172.16.139.250",5440,12,1142,10535,0,0,12,1142,0,0,114.961711,0.007680000000007681,1189583,0
"172.16.133.93",60773,"172.16.139.250",5440,12,1142,10536,0,0,12,1142,0,0,114.977817,0.005624999999994884,1624177,0
"172.16.133.11",55195,"172.16.139.250",5440,10,1022,10537,0,0,10,1022,0,0,114.994845,0.005694000000005417,1435897,0
"172.16.133.55",57684,"172.16.139.250",5440,10,1022,10538,0,0,10,1022,0,0,115.000255,0.014867000000009511,549942,0
"172.16.133.73",60726,"172.16.139.250",5440,10,1022,10539,0,0,10,1022,0,0,115.022098,0.020623999999997977,396431,0
"172.16.133.53",54168,"172.16.139.250",5440,10,1022,10540,0,0,10,1022,0,0,115.025483,0.005684999999999718,1438170,0
"172.16.133.21",53247,"172.16.139.250",5440,10,1022,10541,0,0,10,1022,0,0,115.027377,0.007885999999999171,1036774,0
"172.16.133.30",62676,"172.16.139.250",5440,10,1022,10542,0,0,10,1022,0,0,115.032067,0.007117000000008034,1148798,0
"172.16.133.25",63541,"172.16.139.250",5440,10,1022,10543,0,0,10,1022,0,0,115.038808,0.008296000000001413,985535,0
"65.54.49.80",443,"172.16.133.49",49515,4,252,10544,0,0,2,120,2,132,115.039186,120.07374899999999,7,8
"172.16.133.34",50492,"172.16.139.250",5440,10,1022,10545,0,0,10,1022,0,0,115.048034,0.011888999999996486,687694,0
"172.16.133.97",59429,"172.16.139.250",5440,10,1022,10546,0,0,10,1022,0,0,115.058249,0.015520999999992569,526770,0
"172.16.133.97",59430,"67.217.64.244",443,6,366,10547,0,0,4,246,2,120,115.070855,0.07485100000000955,26292,12825
"172.16.133.97",59431,"216.115.223.200",443,6,366,10548,0,0,4,246,2,120,115.094837,0.08551300000000595,23014,11226
"172.16.133.33",57950,"172.16.139.250",5440,12,1142,10549,0,0,12,1142,0,0,115.132086,0.015069999999994366,606237,0
"172.16.133.68",60809,"172.16.139.250",5440,10,1022,10550,0,0,10,1022,0,0,115.165165,0.005607999999995172,1457917,0
"172.16.133.63",53940,"172.16.139.250",5440,12,1142,10551,0,0,12,1142,0,0,115.188915,0.006123000000002321,1492079,0
"172.16.133.12",59832,"172.16.139.250",5440,10,1022,10552,0,0,10,1022,0,0,115.20074,0.014829000000005976,551352,0
"172.16.133.66",53932,"172.16.139.250",5440,10,1022,10553,0,0,10,1022,0,0,115.203089,0.005298999999993725,1542932,0
"172.16.133.97",59432,"66.151.150.190",443,6,366,10554,0,0,4,246,2,120,115.208868,0.26634200000000874,7388,3604
"172.16.133.97",59433,"216.219.113.250",443,6,366,10555,0,0,4,246,2,120,115.20887,0.2737410000000011,7189,3506
"172.16.133.82",61401,"172.16.139.250",5440,10,1022,10556,0,0,10,1022,0,0,115.215481,0.0055949999999995725,1461304,0
"172.16.133.37",60678,"172.16.139.250",5440,10,1022,10557,0,0,10,1022,0,0,115.228491,0.014856999999992127,550312,0
"172.16.133.53",54169,"68.64.24.250",443,6,366,10558,0,0,4,246,2,120,115.285894,0.14812100000000328,13286,6481
"172.16.133.78",59268,"24.60.76.75",57259,3,194,10559,0,0,3,194,0,0,115.377056,8.998821000000007,172,0
"172.16.133.78",59269,"172.16.139.250",5440,10,1022,10560,0,0,10,1022,0,0,115.386473,0.00532000000001176,1536842,0
"172.16.133.53",54170,"216.219.118.244",443,6,366,10561,0,0,4,246,2,120,115.42583,0.20963100000000168,9387,4579
"172.16.133.53",54171,"78.108.118.250",443,6,366,10562,0,0,4,246,2,120,115.435833,0.21546800000000133,9133,4455
"172.16.133.67",56039,"172.16.139.250",5440,10,1022,10563,0,0,10,1022,0,0,115.43978,0.014696999999998184,556304,0
"172.16.133.56",61483,"172.16.139.250",5440,12,1142,10564,0,0,12,1142,0,0,115.46316,0.005037999999998988,1813418,0
"172.16.133.41",53098,"172.16.139.250",5440,12,1142,10565,0,0,12,1142,0,0,115.518905,0.006283999999993739,1453851,0
"172.16.133.42",57180,"172.16.139.250",5440,12,1142,10566,0,0,12,1142,0,0,115.533507,0.026713000000000875,342005,0
"172.16.133.85",52326,"172.16.139.250",5440,10,1022,10567,0,0,10,1022,0,0,115.535283,0.00551499999998839,1482502,0
"172.16.133.43",57836,"172.16.139.250",5440,10,1022,10568,0,0,10,1022,0,0,115.589442,0.005490999999992141,1488981,0
"172.16.133.13",53092,"172.16.139.250",5440,10,1022,10569,0,0,10,1022,0,0,115.607243,0.0052700000000101,1551423,0
"172.16.133.20",62448,"172.16.139.250",5440,12,1142,10570,0,0,12,1142,0,0,115.657355,0.01458500000001095,626396,0
"172.16.133.75",51032,"172.16.139.250",5440,10,1022,10571,0,0,10,1022,0,0,115.673516,0.00843799999999817,968949,0
"172.16.133.28",65526,"172.16.139.250",5440,10,1022,10572,0,0,10,1022,0,0,115.687734,0.0056639999999958945,1443502,0
"172.16.133.71",57563,"157.56.241.118",443,24,8207,10573,0,0,13,1906,11,6301,115.691709,0.9893909999999977,15411,50948
"172.16.133.41",53099,"199.102.234.31",80,11,4193,10574,0,0,6,2749,5,1444,115.708227,0.11630600000000868,189087,99324
"172.16.133.99",56097,"172.16.139.250",5440,12,1142,10575,0,0,12,1142,0,0,115.714946,0.005070000000003461,1801972,0
"172.16.133.87",60262,"172.16.139.250",5440,10,1022,10576,0,0,10,1022,0,0,115.74058,0.020193000000006123,404892,0
"172.16.133.35",50027,"172.16.139.250",5440,12,1142,10577,0,0,12,1142,0,0,115.746416,0.012662000000005946,721528,0
"172.16.133.116",53533,"172.16.139.250",5440,10,1022,10578,0,0,10,1022,0,0,115.756037,0.009247999999999479,884083,0
"172.16.133.116",53534,"172.16.139.250",5440,10,1022,10579,0,0,10,1022,0,0,115.767233,0.016520999999997343,494885,0
"172.16.133.84",58846,"172.16.139.250",5440,10,1022,10580,0,0,10,1022,0,0,115.774575,0.005335999999999785,1532233,0
"172.16.133.116",53535,"172.16.139.250",5440,10,1022,10581,0,0,10,1022,0,0,115.784441,0.007102000000003272,1151225,0
"172.16.133.49",55846,"172.16.139.250",5440,10,1022,10582,0,0,10,1022,0,0,115.850633,0.015429999999994948,529876,0
"172.16.133.95",57023,"172.16.139.250",5440,12,1142,10583,0,0,12,1142,0,0,115.889531,0.006362999999993235,1435800,0
"172.16.133.92",57737,"172.16.139.250",5440,10,1022,10584,0,0,10,1022,0,0,115.916133,0.005627000000004045,1452994,0
"172.16.133.29",61009,"172.16.139.250",5440,10,1022,10585,0,0,10,1022,0,0,115.935384,0.015619999999998413,523431,0
"172.16.133.44",64890,"172.16.139.250",5440,10,1022,10586,0,0,10,1022,0,0,115.940859,0.005347000000000435,1529081,0
"172.16.133.53",54172,"216.115.219.126",443,6,366,10587,0,0,4,246,2,120,115.959961,0.5050709999999867,3896,1900
"172.16.133.207",55987,"172.16.139.250",5440,12,1142,10588,0,0,12,1142,0,0,115.966519,0.017760999999993032,514385,0
"172.16.133.83",57145,"172.16.139.250",5440,10,1022,10589,0,0,10,1022,0,0,115.97575,0.004626999999999271,"",""
"172.16.133.41",53100,"199.102.234.31",80,15,6829,10590,0,0,7,2772,8,4057,115.985376,0.10137999999999181,218741,320142
"172.16.133.93",60774,"172.16.139.250",5440,12,1142,10591,0,0,12,1142,0,0,115.991628,0.006567999999987251,1390986,0
"172.16.133.11",55196,"172.16.139.250",5440,10,1022,10592,0,0,10,1022,0,0,116.010243,0.00599300000000369,1364258,0
"172.16.133.55",57685,"172.16.139.250",5440,12,1142,10593,0,0,12,1142,0,0,116.013246,0.0072870000000051505,1253739,0
"172.16.133.73",60727,"172.16.139.250",5440,10,1022,10594,0,0,10,1022,0,0,116.037254,0.006063999999994962,1348284,0
"172.16.133.53",54173,"172.16.139.250",5440,10,1022,10595,0,0,10,1022,0,0,116.038451,0.008407000000005382,972522,0
"172.16.133.21",53248,"172.16.139.250",5440,10,1022,10596,0,0,10,1022,0,0,116.041426,0.022790999999998007,358738,0
"172.16.133.30",62677,"172.16.139.250",5440,10,1022,10597,0,0,10,1022,0,0,116.045771,0.025891999999998916,315773,0
"172.16.133.25",63542,"172.16.139.250",5440,12,1142,10598,0,0,12,1142,0,0,116.052422,0.015820999999988317,577460,0
"172.16.133.34",50493,"172.16.139.250",5440,10,1022,10599,0,0,10,1022,0,0,116.061165,0.01543399999999906,529739,0
"172.16.133.41",53101,"173.194.43.57",80,8,492,10600,0,0,5,306,3,186,116.070906,14.249555,171,104
"172.16.133.41",53102,"173.194.43.57",80,7,432,10601,0,0,5,306,2,126,116.071325,14.247532000000007,171,70
"172.16.133.41",53103,"74.119.118.84",80,15,9665,10602,0,0,7,4692,8,4973,116.072082,16.466703999999993,2279,2416
"172.16.133.97",59434,"172.16.139.250",5440,10,1022,10603,0,0,10,1022,0,0,116.072488,0.007769999999993615,1052252,0
"172.16.133.41",53104,"74.119.118.94",80,23,14605,10604,0,0,12,13150,11,1455,116.073015,12.32266899999999,8537,944
"172.16.133.41",53105,"74.119.118.94",80,4,252,10605,0,0,2,126,2,126,116.073257,9.618117999999996,104,104
"172.16.133.41",53106,"74.119.118.94",80,4,252,10606,0,0,2,126,2,126,116.07344,9.565947999999992,105,105
"172.16.133.41",53107,"74.119.118.94",80,4,252,10607,0,0,2,126,2,126,116.073559,11.103633000000002,90,90
"172.16.133.41",53108,"173.241.242.12",80,7,426,10608,0,0,5,306,2,120,116.075079,14.232118999999997,172,67
"172.16.133.41",53109,"173.241.242.12",80,8,1621,10609,0,0,5,933,3,688,116.075332,0.414599999999993,18002,13275
"172.16.133.41",53110,"173.241.242.12",80,7,426,10610,0,0,5,306,2,120,116.075527,14.235029999999995,171,67
"172.16.133.41",53111,"173.241.242.153",80,7,426,10611,0,0,5,306,2,120,116.075719,14.231410999999994,172,67
"172.16.133.41",53112,"173.241.242.153",80,7,426,10612,0,0,5,306,2,120,116.07613,14.230998,172,67
"172.16.133.41",53113,"173.241.242.153",80,7,426,10613,0,0,5,306,2,120,116.07629,14.23078799999999,172,67
"172.16.133.41",53114,"173.194.43.45",80,7,432,10614,0,0,5,306,2,126,116.076481,14.226369000000005,172,70
"172.16.133.41",53115,"173.194.43.45",80,7,432,10615,0,0,5,306,2,126,116.076596,14.224567000000008,172,70
"172.16.133.33",57951,"172.16.139.250",5440,12,1142,10616,0,0,12,1142,0,0,116.145909,0.006174000000001456,1479753,0
"172.16.133.68",60810,"172.16.139.250",5440,10,1022,10617,0,0,10,1022,0,0,116.179057,0.0055260000000032505,1479551,0
"172.16.133.12",59833,"172.16.139.250",5440,10,1022,10618,0,0,10,1022,0,0,116.19113,0.0055440000000004375,1474747,0
"172.16.133.63",53941,"172.16.139.250",5440,10,1022,10619,0,0,10,1022,0,0,116.202053,0.014459999999999695,565421,0
"172.16.133.41",53116,"98.139.225.43",80,8,492,10620,0,0,5,306,3,186,116.213226,14.10425499999998,173,105
"172.16.133.41",53117,"98.139.225.43",80,8,492,10621,0,0,5,306,3,186,116.213384,14.103728000000004,173,105
"172.16.133.41",53118,"98.139.225.43",80,8,492,10622,0,0,5,306,3,186,116.213487,14.103758000000013,173,105
"172.16.133.41",53119,"98.139.225.43",80,28,11665,10623,0,0,14,7537,14,4128,116.213552,23.805389000000005,2532,1387
"172.16.133.66",53933,"172.16.139.250",5440,10,1022,10624,0,0,10,1022,0,0,116.216916,0.005408000000002744,1511834,0
"172.16.133.41",53120,"67.69.174.17",80,7,432,10625,0,0,5,306,2,126,116.227488,14.106443000000013,173,71
"172.16.133.41",53121,"67.69.174.17",80,7,432,10626,0,0,5,306,2,126,116.227714,14.109047999999987,173,71
"172.16.133.41",53122,"64.208.138.248",80,8,492,10627,0,0,5,306,3,186,116.22839,14.074066000000002,173,105
"172.16.133.41",53123,"64.208.138.248",80,33,18840,10628,0,0,16,11673,17,7167,116.228603,14.073434000000006,6635,4074
"172.16.133.41",53124,"64.208.138.248",80,22,11278,10629,0,0,11,5920,11,5358,116.228776,14.073448999999997,3365,3045
"172.16.133.41",53125,"184.173.89.4",80,11,2425,10630,0,0,6,1804,5,621,116.229017,0.5068459999999959,28474,9801
"172.16.133.41",53126,"184.173.89.4",80,10,1649,10631,0,0,5,1028,5,621,116.229179,0.6005770000000012,13693,8272
"172.16.133.41",53127,"184.173.89.4",80,11,890,10632,0,0,6,372,5,518,116.229324,13.752405999999993,216,301
"172.16.133.82",61402,"172.16.139.250",5440,10,1022,10633,0,0,10,1022,0,0,116.230281,0.015580999999997402,524741,0
"172.16.133.37",60679,"172.16.139.250",5440,10,1022,10634,0,0,10,1022,0,0,116.243623,0.006354000000001747,1286748,0
"172.16.133.33",57952,"68.64.24.250",443,6,366,10635,0,0,4,246,2,120,116.282551,0.21566900000000544,9125,4451
"172.16.133.41",53128,"206.188.4.2",80,13,4879,10636,0,0,7,3525,6,1354,116.284171,0.2563109999999966,110022,42261
"172.16.133.78",59270,"172.16.139.250",5440,10,1022,10637,0,0,10,1022,0,0,116.399692,0.018543999999991456,440897,0
"172.16.133.33",57953,"78.108.118.250",443,6,366,10638,0,0,4,246,2,120,116.404576,0.24613300000000038,7995,3900
"172.16.133.33",57954,"216.219.118.244",443,6,366,10639,0,0,4,246,2,120,116.441687,0.2147860000000037,9162,4469
"172.16.133.67",56040,"172.16.139.250",5440,10,1022,10640,0,0,10,1022,0,0,116.453726,0.005318000000002598,1537420,0
"172.16.133.56",61484,"172.16.139.250",5440,12,1142,10641,0,0,12,1142,0,0,116.477082,0.005116999999998484,1785421,0
"172.16.133.41",53129,"67.69.196.33",80,17,3717,10642,0,0,9,2509,8,1208,116.484159,180.44409399999998,111,53
"172.16.133.41",53130,"67.69.196.33",80,7,432,10643,0,0,5,306,2,126,116.528295,13.810064999999994,177,72
"172.16.133.41",53131,"172.16.139.250",5440,10,1022,10644,0,0,10,1022,0,0,116.532653,0.01472400000000107,555283,0
"172.16.133.42",57181,"172.16.139.250",5440,12,1142,10645,0,0,12,1142,0,0,116.548162,0.008975999999989881,1017825,0
"172.16.133.85",52327,"172.16.139.250",5440,10,1022,10646,0,0,10,1022,0,0,116.549378,0.008904000000001133,918238,0
"172.16.133.184",48199,"96.43.146.48",443,27,9944,10647,0,0,14,2625,13,7319,116.550368,0.2935769999999991,71531,199443
"172.16.133.43",57837,"172.16.139.250",5440,10,1022,10648,0,0,10,1022,0,0,116.602858,0.005580000000009022,1465232,0
"172.16.133.54",64642,"12.130.48.51",80,134,99920,10649,0,0,58,17991,76,81929,116.61139,123.32675599999999,1167,5314
"172.16.133.13",53093,"172.16.139.250",5440,10,1022,10650,0,0,10,1022,0,0,116.621307,0.005315999999993437,1537998,0
"172.16.133.20",62449,"172.16.139.250",5440,12,1142,10651,0,0,12,1142,0,0,116.672142,0.0061990000000093914,1473786,0
"172.16.133.75",51033,"172.16.139.250",5440,10,1022,10652,0,0,10,1022,0,0,116.687774,0.01669099999999446,489844,0
"172.16.133.28",65527,"172.16.139.250",5440,12,1142,10653,0,0,12,1142,0,0,116.701937,0.006219999999999004,1468810,0
"172.16.133.99",56098,"172.16.139.250",5440,12,1142,10654,0,0,12,1142,0,0,116.729039,0.01483899999999494,615674,0
"172.16.133.87",60263,"172.16.139.250",5440,12,1142,10655,0,0,12,1142,0,0,116.752134,0.006254999999995903,1460591,0
"172.16.133.35",50028,"172.16.139.250",5440,12,1142,10656,0,0,12,1142,0,0,116.764802,0.014960999999999558,610654,0
"172.16.133.116",53536,"172.16.139.250",5440,12,1142,10657,0,0,12,1142,0,0,116.76617,0.00610999999999251,1495253,0
"172.16.133.116",53537,"172.16.139.250",5440,12,1142,10658,0,0,12,1142,0,0,116.772886,0.01721700000000226,530638,0
"172.16.133.84",58847,"172.16.139.250",5440,10,1022,10659,0,0,10,1022,0,0,116.787429,0.005862999999990848,1394507,0
"172.16.133.116",53538,"172.16.139.250",5440,10,1022,10660,0,0,10,1022,0,0,116.790902,0.014859999999998763,550201,0
"172.16.133.184",48200,"96.43.146.48",443,27,9568,10661,0,0,14,2636,13,6932,116.807987,0.2643640000000005,79768,209771
"172.16.133.49",55847,"172.16.139.250",5440,12,1142,10662,0,0,12,1142,0,0,116.864176,0.014982000000003382,609798,0
"172.16.133.54",64643,"12.130.48.51",80,32,14631,10663,0,0,17,6958,15,7673,116.876207,28.523601000000014,1951,2152
"172.16.133.54",64644,"12.130.48.51",80,99,73975,10664,0,0,44,14535,55,59440,116.877177,123.06177000000001,944,3864
"172.16.133.54",64645,"12.130.48.51",80,69,55956,10665,0,0,27,9617,42,46339,116.877673,28.530309000000003,2696,12993
"172.16.133.54",64646,"72.21.91.196",80,6,372,10666,0,0,4,246,2,126,116.877916,5.774961000000005,340,174
"172.16.133.54",64647,"12.130.48.51",80,120,100426,10667,0,0,47,13617,73,86809,116.878152,28.44583,3829,24413
"172.16.133.54",64648,"12.130.48.51",80,79,60278,10668,0,0,34,9783,45,50495,116.878983,123.06009,635,3282
"172.16.133.95",57024,"172.16.139.250",5440,12,1142,10669,0,0,12,1142,0,0,116.904251,0.015185999999999922,601606,0
"172.16.133.92",57738,"172.16.139.250",5440,12,1142,10670,0,0,12,1142,0,0,116.930009,0.00650100000000009,1405322,0
"172.16.133.29",61010,"172.16.139.250",5440,12,1142,10671,0,0,12,1142,0,0,116.949031,0.016706999999996697,546836,0
"172.16.133.44",64891,"172.16.139.250",5440,10,1022,10672,0,0,10,1022,0,0,116.955736,0.005388999999993871,1517164,0
"172.16.133.33",57955,"216.115.219.126",443,6,366,10673,0,0,4,246,2,120,116.977657,0.537729000000013,3659,1785
"172.16.133.207",55988,"172.16.139.250",5440,12,1142,10674,0,0,12,1142,0,0,116.980319,0.014492000000004168,630416,0
"172.16.133.83",57146,"172.16.139.250",5440,10,1022,10675,0,0,10,1022,0,0,116.989834,0.013933999999991897,586766,0
"172.16.133.93",60775,"172.16.139.250",5440,10,1022,10676,0,0,10,1022,0,0,117.005914,0.014236999999994282,574278,0
"172.16.133.11",55197,"172.16.139.250",5440,10,1022,10677,0,0,10,1022,0,0,117.022714,0.005464000000003466,1496339,0
"172.16.133.55",57686,"172.16.139.250",5440,10,1022,10678,0,0,10,1022,0,0,117.02753,0.016204000000001884,504566,0
"172.16.133.73",60728,"172.16.139.250",5440,10,1022,10679,0,0,10,1022,0,0,117.0515,0.005729000000002316,1427125,0
"172.16.133.53",54174,"172.16.139.250",5440,12,1142,10680,0,0,12,1142,0,0,117.053194,0.015603999999996176,585490,0
"172.16.133.49",55848,"157.56.236.89",443,6,374,10681,0,0,3,194,3,180,117.053754,1.2850329999999985,1207,1120
"172.16.133.21",53249,"172.16.139.250",5440,12,1142,10682,0,0,12,1142,0,0,117.056608,0.021197999999998274,430984,0
"172.16.133.30",62678,"172.16.139.250",5440,12,1142,10683,0,0,12,1142,0,0,117.059829,0.02578500000001327,354314,0
"172.16.133.25",63543,"172.16.139.250",5440,12,1142,10684,0,0,12,1142,0,0,117.066676,0.014203999999992334,643199,0
"172.16.133.34",50494,"172.16.139.250",5440,12,1142,10685,0,0,12,1142,0,0,117.076426,0.014503000000004818,629938,0
"172.16.133.97",59435,"172.16.139.250",5440,12,1142,10686,0,0,12,1142,0,0,117.086394,0.015200000000007208,601052,0
"172.16.133.97",59436,"67.217.64.244",443,6,366,10687,0,0,4,246,2,120,117.111868,0.06722600000000511,29274,14280
"172.16.133.97",59437,"216.115.223.200",443,6,366,10688,0,0,4,246,2,120,117.137852,0.12095899999999915,16269,7936
"172.16.133.33",57956,"172.16.139.250",5440,12,1142,10689,0,0,12,1142,0,0,117.160205,0.006558999999995763,1392895,0
"172.16.133.68",60811,"172.16.139.250",5440,12,1142,10690,0,0,12,1142,0,0,117.193289,0.006200000000006867,1473548,0
"172.16.133.12",59834,"172.16.139.250",5440,12,1142,10691,0,0,12,1142,0,0,117.205252,0.0064059999999983575,1426162,0
"172.16.133.63",53942,"172.16.139.250",5440,10,1022,10692,0,0,10,1022,0,0,117.216041,0.005369999999999209,1522532,0
"172.16.133.66",53934,"172.16.139.250",5440,12,1142,10693,0,0,12,1142,0,0,117.22996,0.006383999999997059,1431077,0
"172.16.133.82",61403,"172.16.139.250",5440,10,1022,10694,0,0,10,1022,0,0,117.243786,0.005557999999993513,1471032,0
"172.16.133.37",60680,"172.16.139.250",5440,10,1022,10695,0,0,10,1022,0,0,117.257553,0.014720999999994433,555397,0
"172.16.133.54",64649,"199.27.74.193",80,6,372,10696,0,0,4,246,2,126,117.262054,5.4397149999999925,361,185
"172.16.133.184",33851,"96.43.146.22",443,266,237152,10697,0,0,97,18487,169,218665,117.295906,9.817421999999993,15064,178185
"172.16.133.71",57564,"184.73.225.104",443,36,14087,10698,0,0,17,2937,19,11150,117.319815,6.141972999999993,3825,14523
"172.16.133.54",64650,"199.27.74.193",80,6,372,10699,0,0,4,246,2,126,117.333355,5.367691000000008,366,187
"172.16.133.54",64651,"173.204.219.5",80,8,2159,10700,0,0,5,1147,3,1012,117.344611,0.08764499999999487,104695,92372
"172.16.133.54",64652,"216.52.121.177",80,9,1445,10701,0,0,5,834,4,611,117.347241,0.1688350000000014,39517,28951
"172.16.133.54",64653,"173.204.219.5",80,7,634,10702,0,0,4,246,3,388,117.366265,5.089047000000008,386,609
"172.16.133.54",64654,"216.52.121.177",80,7,432,10703,0,0,4,246,3,186,117.366609,5.293157000000008,371,281
"172.16.133.97",59439,"216.219.113.250",443,6,366,10704,0,0,4,246,2,120,117.369986,0.25389099999999587,7751,3781
"172.16.133.97",59438,"66.151.150.190",443,6,366,10705,0,0,4,246,2,120,117.369987,0.24266000000000076,8110,3956
"172.16.133.78",59271,"172.16.139.250",5440,10,1022,10706,0,0,10,1022,0,0,117.414761,0.006214999999997417,1315526,0
"172.16.133.67",56041,"172.16.139.250",5440,10,1022,10707,0,0,10,1022,0,0,117.467852,0.00528500000000065,1547019,0
"172.16.133.56",61485,"172.16.139.250",5440,12,1142,10708,0,0,12,1142,0,0,117.490261,0.005209999999991055,1753550,0
"172.16.133.54",64655,"204.13.194.137",80,21,8869,10709,0,0,10,4359,11,4510,117.491908,15.051682999999997,2316,2397
"172.16.133.41",53132,"172.16.139.250",5440,10,1022,10710,0,0,10,1022,0,0,117.54695,0.0054980000000028895,1487086,0
"172.16.133.42",57182,"172.16.139.250",5440,12,1142,10712,0,0,12,1142,0,0,117.563283,0.01467200000000446,622682,0
"172.16.133.85",52328,"172.16.139.250",5440,10,1022,10713,0,0,10,1022,0,0,117.563521,0.005497000000005414,1487356,0
"172.16.133.43",57838,"172.16.139.250",5440,10,1022,10714,0,0,10,1022,0,0,117.61706,0.005476999999999066,1492788,0
"172.16.133.13",53094,"172.16.139.250",5440,10,1022,10715,0,0,10,1022,0,0,117.635151,0.01475200000000143,554229,0
"172.16.133.20",62450,"172.16.139.250",5440,12,1142,10716,0,0,12,1142,0,0,117.685249,0.014566999999999553,627171,0
"172.16.133.75",51034,"172.16.139.250",5440,10,1022,10717,0,0,10,1022,0,0,117.702483,0.005649000000005344,1447335,0
"172.16.133.28",65528,"172.16.139.250",5440,12,1142,10718,0,0,12,1142,0,0,117.715413,0.01572300000000837,581059,0
"172.16.133.99",56099,"172.16.139.250",5440,10,1022,10719,0,0,10,1022,0,0,117.742713,0.0143810000000002,568527,0
"172.16.133.48",60283,"74.125.226.227",80,1,60,10720,0,0,1,60,0,0,117.743966,0,"",""
"172.16.133.73",60729,"180.153.31.250",443,6,366,10721,0,0,4,246,2,120,117.747269,0.47184899999999175,4170,2034
"172.16.133.87",60264,"172.16.139.250",5440,10,1022,10722,0,0,10,1022,0,0,117.766328,0.005824000000004048,1403846,0
"172.16.133.35",50029,"172.16.139.250",5440,12,1142,10723,0,0,12,1142,0,0,117.775282,0.01658899999999619,550726,0
"172.16.133.116",53539,"172.16.139.250",5440,10,1022,10724,0,0,10,1022,0,0,117.783105,0.007256999999995628,1126636,0
"172.16.133.116",53540,"172.16.139.250",5440,10,1022,10725,0,0,10,1022,0,0,117.791334,0.006377000000000521,1282107,0
"172.16.133.84",58848,"172.16.139.250",5440,10,1022,10726,0,0,10,1022,0,0,117.801606,0.005510999999998489,1483578,0
"172.16.133.116",53541,"172.16.139.250",5440,10,1022,10727,0,0,10,1022,0,0,117.802784,0.007854999999992174,1040865,0
"172.16.133.54",64656,"108.170.193.53",80,11,3901,10728,0,0,6,2362,5,1539,117.87087,0.19237400000000093,98225,64000
"172.16.133.54",64657,"108.170.193.53",80,11,3900,10729,0,0,6,2361,5,1539,117.871887,0.1937029999999993,97510,63561
"172.16.133.54",64658,"108.170.193.53",80,10,3840,10730,0,0,6,2361,4,1479,117.872506,0.1809899999999942,104359,65373
"172.16.133.54",64659,"108.170.193.53",80,10,3840,10731,0,0,6,2361,4,1479,117.87315100000001,0.1913459999999958,98711,61835
"172.16.133.54",64660,"108.170.193.53",80,11,3896,10732,0,0,6,2361,5,1535,117.873452,0.1911489999999958,98812,64243
"172.16.133.54",64661,"108.170.193.53",80,11,3888,10733,0,0,6,2361,5,1527,117.873694,0.19178700000000504,98484,63695
"172.16.133.49",55849,"172.16.139.250",5440,10,1022,10734,0,0,10,1022,0,0,117.879295,0.005532000000002313,1477946,0
"172.16.133.184",33852,"96.43.146.22",443,53,25376,10735,0,0,30,14627,23,10749,117.880551,9.233822000000004,12672,9312
"172.16.133.95",57025,"172.16.139.250",5440,12,1142,10736,0,0,12,1142,0,0,117.917617,0.01600299999999777,570892,0
"172.16.133.92",57739,"172.16.139.250",5440,10,1022,10737,0,0,10,1022,0,0,117.944388,0.0056730000000015934,1441212,0
"172.16.133.29",61011,"172.16.139.250",5440,10,1022,10738,0,0,10,1022,0,0,117.965575,0.0059499999999985675,1374117,0
"172.16.133.44",64892,"172.16.139.250",5440,10,1022,10739,0,0,10,1022,0,0,117.969122,0.006242000000000303,1309836,0
"172.16.133.207",55989,"172.16.139.250",5440,10,1022,10740,0,0,10,1022,0,0,117.994369,0.004834999999999923,"",""
"172.16.133.83",57147,"172.16.139.250",5440,12,1142,10741,0,0,12,1142,0,0,118.003761,0.004706999999996242,"",""
"172.16.133.54",64662,"108.170.193.53",80,11,3900,10742,0,0,6,2361,5,1539,118.012105,0.17858400000000074,105765,68942
"172.16.133.54",64663,"108.170.193.53",80,11,3904,10743,0,0,6,2361,5,1543,118.016079,0.1742179999999962,108415,70853
"172.16.133.54",64664,"108.170.193.53",80,11,3900,10744,0,0,6,2361,5,1539,118.016584,0.17811000000000377,106046,69125
"172.16.133.54",64665,"108.170.193.53",80,11,3900,10745,0,0,6,2361,5,1539,118.017088,0.1735050000000058,108861,70960
"172.16.133.54",64666,"108.170.193.53",80,11,3900,10746,0,0,6,2361,5,1539,118.017566,0.1716430000000031,110042,71730
"172.16.133.54",64667,"108.170.193.53",80,11,3896,10747,0,0,6,2361,5,1535,118.018184,0.17750699999999142,106407,69180
"172.16.133.93",60776,"172.16.139.250",5440,12,1142,10748,0,0,12,1142,0,0,118.019897,0.01477400000000273,618383,0
"172.16.133.11",55198,"172.16.139.250",5440,10,1022,10749,0,0,10,1022,0,0,118.036981,0.005802000000002749,1409169,0
"172.16.133.55",57687,"172.16.139.250",5440,12,1142,10750,0,0,12,1142,0,0,118.042316,0.012235000000003993,746710,0
"172.16.133.73",60730,"172.16.139.250",5440,10,1022,10751,0,0,10,1022,0,0,118.064499,0.01510600000000295,541241,0
"172.16.133.53",54175,"172.16.139.250",5440,10,1022,10752,0,0,10,1022,0,0,118.067533,0.016102000000003613,507763,0
"172.16.133.21",53250,"172.16.139.250",5440,10,1022,10753,0,0,10,1022,0,0,118.069608,0.0055249999999915644,1479819,0
"172.16.133.30",62679,"172.16.139.250",5440,10,1022,10754,0,0,10,1022,0,0,118.074161,0.017127999999999588,477347,0
"172.16.133.25",63544,"172.16.139.250",5440,10,1022,10755,0,0,10,1022,0,0,118.080851,0.006695000000007667,1221209,0
"172.16.133.34",50495,"172.16.139.250",5440,10,1022,10756,0,0,10,1022,0,0,118.090465,0.005552000000008661,1472622,0
"172.16.133.97",59440,"172.16.139.250",5440,10,1022,10757,0,0,10,1022,0,0,118.100213,0.0054060000000077935,1512393,0
"172.16.133.54",64668,"108.170.193.53",80,11,3875,10758,0,0,6,2348,5,1527,118.134829,0.17701399999999978,106115,69011
"172.16.133.33",57957,"172.16.139.250",5440,10,1022,10759,0,0,10,1022,0,0,118.173692,0.005301000000002887,1542350,0
"172.16.133.68",60812,"172.16.139.250",5440,10,1022,10760,0,0,10,1022,0,0,118.207134,0.008237000000008265,992594,0
"172.16.133.12",59835,"172.16.139.250",5440,10,1022,10761,0,0,10,1022,0,0,118.219475,0.0055529999999919255,1472357,0
"172.16.133.63",53943,"172.16.139.250",5440,10,1022,10762,0,0,10,1022,0,0,118.230347,0.005416000000010968,1509601,0
"172.16.133.66",53935,"172.16.139.250",5440,12,1142,10763,0,0,12,1142,0,0,118.244282,0.00620999999999583,1471175,0
"172.16.133.82",61405,"172.16.139.250",5440,10,1022,10764,0,0,10,1022,0,0,118.258287,0.0161200000000008,507196,0
"172.16.133.37",60681,"172.16.139.250",5440,10,1022,10765,0,0,10,1022,0,0,118.271878,0.006068999999996549,1347174,0
"172.16.133.54",64669,"173.194.43.45",80,6,372,10766,0,0,4,246,2,126,118.283247,5.363426000000004,366,187
"172.16.133.49",55850,"157.56.240.137",80,8,884,10767,0,0,5,532,3,352,118.342815,0.10609700000000544,40114,26541
"172.16.133.71",57565,"157.56.236.89",443,2,138,10768,0,0,1,78,1,60,118.349255,0.09465400000000557,6592,5071
"172.16.133.54",64670,"74.121.139.112",80,35,20997,10769,0,0,17,9004,18,11993,118.378678,13.511726999999993,5331,7100
"172.16.133.78",59272,"172.16.139.250",5440,10,1022,10770,0,0,10,1022,0,0,118.427733,0.007990999999989867,1023151,0
"172.16.133.71",57566,"157.56.240.137",443,2,138,10771,0,0,1,78,1,60,118.445311,0.026471999999998275,23572,18132
"172.16.133.71",57567,"157.56.244.217",443,2,138,10772,0,0,1,78,1,60,118.472704,0.08260600000001261,7553,5810
"172.16.133.67",56042,"172.16.139.250",5440,10,1022,10773,0,0,10,1022,0,0,118.48186,0.00569099999999878,1436654,0
"172.16.133.56",61486,"172.16.139.250",5440,12,1142,10774,0,0,12,1142,0,0,118.505409,0.06029800000000307,151514,0
"172.16.133.54",64671,"157.56.134.97",80,13,6213,10775,0,0,7,2570,6,3643,118.51968,0.17670900000000245,116349,164926
"172.16.133.41",53133,"199.102.234.31",80,14,4854,10776,0,0,8,2793,6,2061,118.522167,0.09497400000000766,235264,173605
"172.16.133.71",57568,"157.56.234.137",443,2,138,10777,0,0,1,78,1,60,118.556457,0.07246500000000822,8611,6623
"172.16.133.41",53134,"172.16.139.250",5440,10,1022,10778,0,0,10,1022,0,0,118.560712,0.015309000000002015,534064,0
"172.16.133.54",64673,"157.56.134.97",80,8,2820,10779,0,0,5,1434,3,1386,118.564569,1.8777399999999886,6109,5904
"172.16.133.85",52329,"172.16.139.250",5440,10,1022,10780,0,0,10,1022,0,0,118.57729,0.009493999999989455,861175,0
"172.16.133.42",57183,"172.16.139.250",5440,12,1142,10781,0,0,12,1142,0,0,118.584211,0.010483000000007792,871506,0
"172.16.133.41",53135,"199.102.234.31",80,13,5914,10782,0,0,6,2756,7,3158,118.618723,0.11192699999999434,196985,225718
"172.16.133.30",62680,"96.43.146.176",443,78,54348,10783,0,0,39,27148,39,27200,118.621391,165.28481499999998,1313,1316
"172.16.133.43",57839,"172.16.139.250",5440,10,1022,10784,0,0,10,1022,0,0,118.630826,0.023629999999997153,346000,0
"172.16.133.71",57569,"157.56.236.89",80,8,926,10785,0,0,5,574,3,352,118.632638,0.29345200000000204,15648,9596
"172.16.133.13",53095,"172.16.139.250",5440,10,1022,10786,0,0,10,1022,0,0,118.650238,0.045744999999996594,178729,0
"172.16.133.54",64674,"204.154.111.33",80,11,2615,10787,0,0,6,2089,5,526,118.662187,0.0681939999999912,245065,61706
"172.16.133.54",64675,"173.192.208.195",80,10,1504,10788,0,0,5,703,5,801,118.678331,0.09296799999999905,60493,68926
"172.16.133.54",64676,"173.192.208.195",80,6,372,10789,0,0,4,246,2,126,118.678524,5.976044000000002,329,168
"172.16.133.30",50269,"172.16.139.250",5500,4,396,10790,0,0,4,396,0,0,118.681202,0.006004000000004339,527648,0
"172.16.133.54",64677,"208.47.254.57",80,6,372,10791,0,0,4,246,2,126,118.685105,5.972971000000001,329,168
"172.16.133.20",62451,"172.16.139.250",5440,12,1142,10792,0,0,12,1142,0,0,118.698527,0.03337399999999491,273746,0
"172.16.133.41",53136,"199.102.234.31",80,14,5093,10793,0,0,8,3032,6,2061,118.703465,0.0742050000000063,326878,222195
"172.16.133.75",51035,"172.16.139.250",5440,12,1142,10794,0,0,12,1142,0,0,118.715508,0.020528999999996245,445028,0
"172.16.133.28",65529,"172.16.139.250",5440,12,1142,10795,0,0,12,1142,0,0,118.730379,0.009594000000006986,952261,0
"172.16.133.99",56100,"172.16.139.250",5440,12,1142,10796,0,0,12,1142,0,0,118.7563,0.014718000000002007,620736,0
"172.16.133.41",53137,"199.102.234.31",80,13,5727,10797,0,0,6,2894,7,2833,118.779149,0.09561800000000176,242130,237026
"172.16.133.87",60265,"172.16.139.250",5440,12,1142,10798,0,0,12,1142,0,0,118.77994,0.01613500000000556,566222,0
"172.16.133.116",53542,"172.16.139.250",5440,12,1142,10799,0,0,12,1142,0,0,118.794667,0.005883999999994671,1552685,0
"172.16.133.35",50030,"172.16.139.250",5440,12,1142,10800,0,0,12,1142,0,0,118.795844,0.02744599999999764,332871,0
"172.16.133.116",53543,"172.16.139.250",5440,12,1142,10801,0,0,12,1142,0,0,118.801325,0.006357999999991648,1436929,0
"172.16.133.116",53544,"172.16.139.250",5440,12,1142,10802,0,0,12,1142,0,0,118.808213,0.015317000000010239,596461,0
"172.16.133.84",58849,"172.16.139.250",5440,12,1142,10803,0,0,12,1142,0,0,118.815609,0.01613100000000145,566362,0
"172.16.133.71",57570,"157.56.241.118",443,25,8367,10804,0,0,14,1549,11,6818,118.834877,0.8283889999999872,14959,65843
"172.16.133.41",53138,"199.102.234.31",80,13,5033,10805,0,0,7,2972,6,2061,118.853197,0.060563999999999396,392576,272240
"172.16.133.49",55851,"172.16.139.250",5440,12,1142,10806,0,0,12,1142,0,0,118.893517,0.0063969999999926586,1428169,0
"172.16.133.54",64678,"65.54.81.133",80,184,173474,10807,0,0,69,16118,115,157356,118.894532,8.446511000000001,15265,149037
"172.16.133.41",53139,"199.102.234.31",80,13,5727,10808,0,0,6,2894,7,2833,118.915161,0.1068520000000035,216673,212106
"172.16.133.95",57026,"172.16.139.250",5440,12,1142,10809,0,0,12,1142,0,0,118.931462,0.016925999999997998,539761,0
"172.16.133.92",57740,"172.16.139.250",5440,10,1022,10810,0,0,10,1022,0,0,118.958445,0.037497999999999365,218038,0
"172.16.133.29",61012,"172.16.139.250",5440,10,1022,10811,0,0,10,1022,0,0,118.977634,0.021795000000011555,375131,0
"172.16.133.44",64893,"172.16.139.250",5440,10,1022,10812,0,0,10,1022,0,0,118.982782,0.020293999999992707,402877,0
"172.16.133.41",53140,"199.102.234.31",80,13,5034,10813,0,0,7,2972,6,2062,118.996731,0.06456200000000933,368266,255506
"172.16.133.207",55990,"172.16.139.250",5440,10,1022,10814,0,0,10,1022,0,0,119.008602,0.006315000000000737,1294695,0
"172.16.133.83",57148,"172.16.139.250",5440,12,1142,10815,0,0,12,1142,0,0,119.017899,0.01379900000000589,662076,0
"172.16.133.93",60777,"172.16.139.250",5440,10,1022,10816,0,0,10,1022,0,0,119.034859,0.004682999999999993,"",""
"172.16.133.11",55199,"172.16.139.250",5440,10,1022,10817,0,0,10,1022,0,0,119.050126,0.023922999999996364,341763,0
"172.16.133.55",57688,"172.16.139.250",5440,10,1022,10818,0,0,10,1022,0,0,119.055449,0.015672000000009234,521694,0
"172.16.133.41",53141,"199.102.234.31",80,13,5727,10819,0,0,6,2894,7,2833,119.062786,0.12155500000000075,190465,186450
"172.16.133.73",60731,"172.16.139.250",5440,12,1142,10820,0,0,12,1142,0,0,119.078887,0.00622100000001069,1468574,0
"172.16.133.53",54176,"172.16.139.250",5440,10,1022,10821,0,0,10,1022,0,0,119.081326,0.015087999999991553,541887,0
"172.16.133.21",53251,"172.16.139.250",5440,10,1022,10822,0,0,10,1022,0,0,119.083324,0.017011999999994032,480601,0
"172.16.133.30",62681,"172.16.139.250",5440,12,1142,10823,0,0,12,1142,0,0,119.086598,0.005439000000009742,1679720,0
"172.16.133.25",63545,"172.16.139.250",5440,12,1142,10824,0,0,12,1142,0,0,119.094608,0.009747000000004391,937314,0
"172.16.133.30",62682,"96.43.146.176",443,32,15848,10825,0,0,16,9162,16,6686,119.102588,164.90229200000002,444,324
"172.16.133.34",50496,"172.16.139.250",5440,12,1142,10826,0,0,12,1142,0,0,119.103131,0.005333999999990624,1712785,0
"172.16.133.97",59441,"172.16.139.250",5440,10,1022,10827,0,0,10,1022,0,0,119.114633,0.005403999999998632,1512953,0
"172.16.133.97",59442,"67.217.64.244",443,6,366,10828,0,0,4,246,2,120,119.146942,0.06747500000000173,29166,14227
"172.16.133.41",53142,"199.102.234.31",80,14,5093,10829,0,0,8,3032,6,2061,119.158238,0.06251600000000224,387996,263740
"172.16.133.33",57958,"172.16.139.250",5440,10,1022,10830,0,0,10,1022,0,0,119.188027,0.006380999999990422,1281303,0
"172.16.133.97",59443,"216.115.223.200",443,6,366,10831,0,0,4,246,2,120,119.205986,0.11404500000000439,17256,8417
"172.16.133.68",60813,"172.16.139.250",5440,10,1022,10832,0,0,10,1022,0,0,119.221202,0.015737000000001444,519539,0
"172.16.133.41",53143,"199.102.234.31",80,13,5729,10833,0,0,6,2894,7,2835,119.222231,0.12635900000000788,183223,179488
"172.16.133.12",59836,"172.16.139.250",5440,12,1142,10834,0,0,12,1142,0,0,119.233562,0.007283999999998514,1254255,0
"172.16.133.63",53944,"172.16.139.250",5440,12,1142,10835,0,0,12,1142,0,0,119.244899,0.0061659999999932324,1481673,0
"172.16.133.66",53936,"172.16.139.250",5440,10,1022,10836,0,0,10,1022,0,0,119.258799,0.005621000000004983,1454545,0
"172.16.133.82",61406,"172.16.139.250",5440,10,1022,10837,0,0,10,1022,0,0,119.271577,0.005539000000013061,1476078,0
"172.16.133.37",60682,"172.16.139.250",5440,10,1022,10838,0,0,10,1022,0,0,119.285604,0.0060739999999981364,1346065,0
"172.16.133.41",53144,"199.102.234.31",80,15,5153,10839,0,0,8,3032,7,2121,119.308599,0.11097200000000385,218577,152903
"172.16.133.41",53145,"199.102.234.31",80,13,5728,10840,0,0,6,2894,7,2834,119.389742,0.1049420000000083,220617,216043
"172.16.133.78",59273,"172.16.139.250",5440,10,1022,10841,0,0,10,1022,0,0,119.442825,0.006417999999996482,1273917,0
"172.16.133.41",53146,"199.102.234.31",80,13,5033,10842,0,0,7,2972,6,2061,119.471977,0.07192100000000323,330584,229251
"172.16.133.67",56043,"172.16.139.250",5440,10,1022,10843,0,0,10,1022,0,0,119.496607,0.005711000000005129,1431623,0
"172.16.133.41",52647,"23.67.243.18",80,1,60,10844,0,0,1,60,0,0,119.516176,0,"",""
"172.16.133.56",61487,"172.16.139.250",5440,12,1142,10845,0,0,12,1142,0,0,119.518536,0.0049910000000039645,"",""
"172.16.133.97",59444,"66.151.150.190",443,6,366,10846,0,0,4,246,2,120,119.526061,0.2665719999999965,7382,3601
"172.16.133.97",59445,"216.219.113.250",443,7,426,10847,0,0,4,246,3,180,119.526901,0.2673819999999978,7360,5385
"172.16.133.41",53147,"199.102.234.31",80,13,5730,10848,0,0,6,2895,7,2835,119.545519,0.16927400000000148,136819,133983
"172.16.133.41",53148,"172.16.139.250",5440,12,1142,10849,0,0,12,1142,0,0,119.574163,0.016097000000002026,567559,0
"172.16.133.71",57571,"157.56.241.118",443,24,8207,10850,0,0,13,1906,11,6301,119.591222,1.1058249999999958,13788,45584
"172.16.133.85",52330,"172.16.139.250",5440,10,1022,10851,0,0,10,1022,0,0,119.591364,0.01464800000000821,558164,0
"172.16.133.42",57184,"172.16.139.250",5440,12,1142,10852,0,0,12,1142,0,0,119.593561,0.03280700000000536,278477,0
"172.16.133.43",57840,"172.16.139.250",5440,10,1022,10853,0,0,10,1022,0,0,119.644976,0.006034999999997126,1354763,0
"172.16.133.13",53096,"172.16.139.250",5440,10,1022,10854,0,0,10,1022,0,0,119.664977,0.005631000000008157,1451962,0
"172.16.133.41",53149,"199.102.234.31",80,14,5094,10855,0,0,8,3033,6,2061,119.668515,0.12273000000000422,197702,134343
"172.16.133.20",62452,"172.16.139.250",5440,10,1022,10856,0,0,10,1022,0,0,119.712305,0.0065400000000011005,1250152,0
"172.16.133.75",51036,"172.16.139.250",5440,10,1022,10857,0,0,10,1022,0,0,119.730899,0.00869400000000553,940418,0
"172.16.133.28",65530,"172.16.139.250",5440,10,1022,10858,0,0,10,1022,0,0,119.744798,0.005684999999999718,1438170,0
"172.16.133.163",3555,"15.240.238.52",80,7,432,10859,0,0,4,246,3,186,119.74601,14.572866999999988,135,102
"172.16.133.163",3556,"15.240.238.52",80,7,432,10860,0,0,4,246,3,186,119.747006,14.571932000000004,135,102
"172.16.133.163",3557,"15.240.238.52",80,7,432,10861,0,0,4,246,3,186,119.747263,14.571728000000007,135,102
"172.16.133.163",3558,"66.235.139.153",80,16,9527,10862,0,0,10,7773,6,1754,119.747938,17.227833000000004,3609,814
"172.16.133.163",3559,"66.235.139.153",80,4,252,10863,0,0,2,126,2,126,119.748184,10.814282000000006,93,93
"172.16.133.163",3560,"66.235.139.153",80,4,252,10864,0,0,2,126,2,126,119.748425,12.55576099999999,80,80
"172.16.133.163",3561,"74.125.226.207",443,14,4029,10865,0,0,8,958,6,3071,119.756169,10.08962600000001,759,2434
"172.16.133.99",56101,"172.16.139.250",5440,12,1142,10866,0,0,12,1142,0,0,119.77041,0.014379000000005249,635371,0
"172.16.133.41",53150,"199.102.234.31",80,13,5730,10867,0,0,6,2895,7,2835,119.792782,0.12976799999999855,178472,174773
"172.16.133.87",60266,"172.16.139.250",5440,10,1022,10868,0,0,10,1022,0,0,119.795392,0.005302999999997837,1541768,0
"172.16.133.35",50032,"172.16.139.250",5440,12,1142,10869,0,0,12,1142,0,0,119.803285,0.023143000000004577,394762,0
"172.16.133.116",53545,"172.16.139.250",5440,12,1142,10870,0,0,12,1142,0,0,119.810225,0.013106999999990876,697032,0
"172.16.133.163",3562,"192.221.102.253",80,6,372,10871,0,0,4,246,2,126,119.815282,14.45422400000001,136,69
"172.16.133.163",3563,"192.221.102.253",80,6,372,10872,0,0,4,246,2,126,119.815429,14.453789999999998,136,69
"172.16.133.163",3564,"192.221.102.253",80,6,372,10873,0,0,4,246,2,126,119.815591,14.453131999999997,136,69
"172.16.133.163",3565,"192.221.102.253",80,6,372,10874,0,0,4,246,2,126,119.815696,14.454071999999996,136,69
"172.16.133.163",3566,"63.116.244.155",80,6,372,10875,0,0,4,246,2,126,119.815799,14.44777400000001,136,69
"172.16.133.163",3567,"63.116.244.155",80,6,372,10876,0,0,4,246,2,126,119.815925,14.448232000000019,136,69
"172.16.133.116",53546,"172.16.139.250",5440,12,1142,10877,0,0,12,1142,0,0,119.82395700000001,0.01567899999999156,582690,0
"172.16.133.84",58850,"172.16.139.250",5440,12,1142,10878,0,0,12,1142,0,0,119.8295,0.015595000000004688,585828,0
"172.16.133.116",53547,"172.16.139.250",5440,10,1022,10879,0,0,10,1022,0,0,119.840177,0.008167999999997733,1000979,0
"172.16.133.41",53151,"199.102.234.31",80,14,5094,10880,0,0,8,3033,6,2061,119.897191,0.06547099999998807,370606,251836
"172.16.133.49",55852,"172.16.139.250",5440,12,1142,10881,0,0,12,1142,0,0,119.90731,0.006427999999999656,1421281,0
"172.16.133.95",57027,"172.16.139.250",5440,12,1142,10882,0,0,12,1142,0,0,119.946326,0.006698000000000093,1363989,0
"172.16.133.54",64679,"67.69.174.8",80,32,14164,10883,0,0,18,3907,14,10257,119.961606,148.28103699999997,210,553
"172.16.133.41",53152,"199.102.234.31",80,13,5730,10884,0,0,6,2895,7,2835,119.964151,0.19201800000000446,120613,118113
"172.16.133.92",57741,"172.16.139.250",5440,10,1022,10885,0,0,10,1022,0,0,119.972686,0.015696000000005483,520897,0
"172.16.133.73",60732,"180.153.31.250",443,8,486,10886,0,0,5,306,3,180,119.985565,1.486212000000009,1647,968
"172.16.133.29",61013,"172.16.139.250",5440,12,1142,10887,0,0,12,1142,0,0,119.990045,0.017418000000006373,524514,0
"172.16.133.44",64894,"172.16.139.250",5440,12,1142,10888,0,0,12,1142,0,0,119.997307,0.006215999999994892,1469755,0
"172.16.133.207",55991,"172.16.139.250",5440,12,1142,10889,0,0,12,1142,0,0,120.022319,0.0146000000000015,625753,0
"172.16.133.83",57149,"172.16.139.250",5440,12,1142,10890,0,0,12,1142,0,0,120.03198,0.015310999999996966,596695,0
"172.16.133.184",33853,"96.43.146.22",443,17,3992,10891,0,0,10,1090,7,2902,120.043676,7.0700140000000005,1233,3283
"172.16.133.184",33854,"96.43.146.22",443,17,3992,10892,0,0,10,1090,7,2902,120.04518,7.068714999999997,1233,3284
"172.16.133.93",60778,"172.16.139.250",5440,10,1022,10893,0,0,10,1022,0,0,120.048831,0.020174999999994725,405254,0
"172.16.133.11",55200,"172.16.139.250",5440,12,1142,10894,0,0,12,1142,0,0,120.065214,0.00895900000000438,1019756,0
"172.16.133.55",57689,"172.16.139.250",5440,10,1022,10895,0,0,10,1022,0,0,120.069795,0.007483000000007678,1092609,0
"172.16.133.73",60733,"172.16.139.250",5440,12,1142,10896,0,0,12,1142,0,0,120.093364,0.006370000000003984,1434222,0
"172.16.133.53",54177,"172.16.139.250",5440,12,1142,10897,0,0,12,1142,0,0,120.095273,0.008444999999994707,1081823,0
"172.16.133.21",53252,"172.16.139.250",5440,10,1022,10898,0,0,10,1022,0,0,120.098434,0.01542299999999841,530117,0
"172.16.133.30",62683,"172.16.139.250",5440,10,1022,10899,0,0,10,1022,0,0,120.102338,0.007390999999998371,1106210,0
"172.16.133.25",63546,"172.16.139.250",5440,10,1022,10900,0,0,10,1022,0,0,120.10864,0.009296000000006188,879518,0
"172.16.133.41",53153,"199.102.234.31",80,14,5094,10901,0,0,7,2973,7,2121,120.110085,0.10801299999999969,220195,157092
"172.16.133.34",50497,"172.16.139.250",5440,12,1142,10902,0,0,12,1142,0,0,120.118533,0.005669999999994957,1611287,0
"172.16.133.97",59446,"172.16.139.250",5440,10,1022,10903,0,0,10,1022,0,0,120.12842,0.014540999999994142,562272,0
"172.16.133.41",53154,"199.102.234.31",80,14,5789,10904,0,0,8,3014,6,2775,120.195918,0.083005,290488,267453
"172.16.133.33",57959,"172.16.139.250",5440,10,1022,10905,0,0,10,1022,0,0,120.202311,0.005396000000004619,1515196,0
"172.16.133.68",60814,"172.16.139.250",5440,10,1022,10906,0,0,10,1022,0,0,120.234521,0.00836400000000026,977522,0
"172.16.133.12",59837,"172.16.139.250",5440,10,1022,10907,0,0,10,1022,0,0,120.24761,0.0058810000000022455,1390239,0
"172.16.133.63",53945,"172.16.139.250",5440,10,1022,10908,0,0,10,1022,0,0,120.257469,0.005454999999997767,1498808,0
"172.16.133.66",53937,"172.16.139.250",5440,10,1022,10909,0,0,10,1022,0,0,120.272007,0.014578999999997677,560806,0
"172.16.133.41",53155,"199.102.234.31",80,14,5095,10910,0,0,7,2973,7,2122,120.280229,0.15693499999999005,151553,108172
"172.16.133.82",61407,"172.16.139.250",5440,10,1022,10911,0,0,10,1022,0,0,120.286339,0.01575300000000368,519012,0
"172.16.133.37",60683,"172.16.139.250",5440,10,1022,10912,0,0,10,1022,0,0,120.299794,0.0064339999999987185,1270749,0
"173.194.43.4",443,"172.16.133.36",64971,7,564,10913,0,0,4,366,3,198,120.396182,0.04186099999999726,69945,37839
"172.16.133.54",64680,"63.146.126.10",80,16,9827,10914,0,0,8,2205,8,7622,120.399865,1.0441589999999934,16893,58397
"172.16.133.54",64681,"63.146.126.10",80,16,8557,10915,0,0,8,2242,8,6315,120.400302,1.8463840000000005,9714,27361
"172.16.133.132",36679,"96.43.146.48",443,57,26441,10916,0,0,32,6593,25,19848,120.423827,20.088496000000006,2625,7904
"172.16.133.67",52206,"172.16.139.250",5500,28,11660,10917,0,0,28,11660,0,0,120.435034,83.516446,1116,0
"172.16.133.78",59274,"172.16.139.250",5440,12,1142,10918,0,0,12,1142,0,0,120.455751,0.028545999999991523,320044,0
"172.16.133.67",56044,"172.16.139.250",5440,10,1022,10919,0,0,10,1022,0,0,120.509908,0.014780999999999267,553142,0
"172.16.133.56",61488,"172.16.139.250",5440,12,1142,10920,0,0,12,1142,0,0,120.533101,0.005027999999995814,1817024,0
"172.16.133.41",53156,"172.16.139.250",5440,12,1142,10921,0,0,12,1142,0,0,120.589177,0.006195999999988544,1474499,0
"172.16.133.235",2699,"172.16.131.10",8080,26,8877,10922,0,0,13,6865,13,2012,120.604992,19.053283000000008,2882,844
"172.16.133.85",52331,"172.16.139.250",5440,12,1142,10923,0,0,12,1142,0,0,120.605384,0.0059040000000010195,1547425,0
"172.16.133.42",57185,"172.16.139.250",5440,12,1142,10924,0,0,12,1142,0,0,120.60647,0.021042999999991707,434158,0
"172.16.133.43",57841,"172.16.139.250",5440,12,1142,10925,0,0,12,1142,0,0,120.659366,0.00660299999999836,1383613,0
"172.16.133.13",53097,"172.16.139.250",5440,12,1142,10926,0,0,12,1142,0,0,120.678105,0.005527999999998201,1652677,0
"172.16.133.49",55853,"157.56.241.118",443,24,9451,10927,0,0,11,2715,13,6736,120.690807,1.6094429999999988,13495,33482
"172.16.133.20",62453,"172.16.139.250",5440,12,1142,10928,0,0,12,1142,0,0,120.727373,0.00489199999999812,"",""
"172.16.133.75",51037,"172.16.139.250",5440,10,1022,10929,0,0,10,1022,0,0,120.744053,0.005399000000011256,1514354,0
"172.16.133.28",65531,"172.16.139.250",5440,12,1142,10931,0,0,12,1142,0,0,120.757254,0.006284999999991214,1453619,0
"172.16.133.99",56102,"172.16.139.250",5440,12,1142,10932,0,0,12,1142,0,0,120.784849,0.004821000000006848,"",""
"172.16.133.54",64682,"173.194.43.45",80,7,432,10933,0,0,4,246,3,186,120.806897,5.834721999999999,337,255
"172.16.133.87",60267,"172.16.139.250",5440,12,1142,10934,0,0,12,1142,0,0,120.807131,0.016175000000004047,564822,0
"172.16.133.35",50033,"172.16.139.250",5440,12,1142,10935,0,0,12,1142,0,0,120.818345,0.008951000000010367,1020668,0
"172.16.133.116",53548,"172.16.139.250",5440,10,1022,10936,0,0,10,1022,0,0,120.822406,0.007846999999998161,1041926,0
"172.16.133.116",53549,"172.16.139.250",5440,12,1142,10937,0,0,12,1142,0,0,120.83084,0.0059360000000054924,1539083,0
"172.16.133.116",53550,"172.16.139.250",5440,10,1022,10938,0,0,10,1022,0,0,120.837318,0.006065000000006648,1348062,0
"172.16.133.84",58851,"172.16.139.250",5440,10,1022,10939,0,0,10,1022,0,0,120.843682,0.0054149999999992815,1509879,0
"172.16.133.49",55854,"172.16.139.250",5440,12,1142,10940,0,0,12,1142,0,0,120.921517,0.006290000000007012,1452464,0
"172.16.133.95",57028,"172.16.139.250",5440,10,1022,10941,0,0,10,1022,0,0,120.960313,0.014697999999995659,556266,0
"172.16.133.54",64683,"173.194.43.58",443,10,2862,10942,0,0,5,480,5,2382,120.962537,0.05031400000000019,76320,378741
"172.16.133.67",56045,"172.16.139.250",5440,10,1022,10943,0,0,10,1022,0,0,120.980637,0.00533500000000231,1532521,0
"172.16.133.92",57742,"172.16.139.250",5440,12,1142,10944,0,0,12,1142,0,0,120.98655,0.015451000000012982,591288,0
"172.16.133.54",64684,"173.194.43.58",443,38,6349,10945,0,0,20,2258,18,4091,120.988326,175.46571400000002,102,186
"172.16.133.29",61014,"172.16.139.250",5440,10,1022,10946,0,0,10,1022,0,0,121.005799,0.006929999999996994,1179797,0
"172.16.133.44",64895,"172.16.139.250",5440,12,1142,10947,0,0,12,1142,0,0,121.011774,0.006089000000002898,1500410,0
"172.16.133.207",55992,"172.16.139.250",5440,12,1142,10948,0,0,12,1142,0,0,121.036572,0.02505099999999061,364696,0
"172.16.133.83",57150,"172.16.139.250",5440,10,1022,10949,0,0,10,1022,0,0,121.045881,0.011917000000011058,686078,0
"172.16.133.93",60779,"172.16.139.250",5440,12,1142,10950,0,0,12,1142,0,0,121.06311,0.005054999999998699,1807319,0
"172.16.133.54",64685,"199.38.164.156",80,7,432,10951,0,0,4,246,3,186,121.064331,5.577122000000003,352,266
"172.16.133.54",64686,"199.38.164.156",80,10,1483,10952,0,0,6,830,4,653,121.064841,115.14196100000001,57,45
"172.16.133.11",55201,"172.16.139.250",5440,10,1022,10953,0,0,10,1022,0,0,121.078014,0.005668999999997482,1442229,0
"172.16.133.55",57690,"172.16.139.250",5440,12,1142,10954,0,0,12,1142,0,0,121.082409,0.00646199999999908,1413803,0
"172.16.133.73",60734,"172.16.139.250",5440,12,1142,10955,0,0,12,1142,0,0,121.10663,0.00639900000000182,1427723,0
"172.16.133.53",54178,"172.16.139.250",5440,10,1022,10956,0,0,10,1022,0,0,121.108804,0.007465999999993755,1095097,0
"172.16.133.21",53253,"172.16.139.250",5440,10,1022,10957,0,0,10,1022,0,0,121.112618,0.00771699999999953,1059479,0
"172.16.133.30",62684,"172.16.139.250",5440,10,1022,10958,0,0,10,1022,0,0,121.116127,0.008380999999999972,975539,0
"172.16.133.25",63547,"172.16.139.250",5440,10,1022,10959,0,0,10,1022,0,0,121.122607,0.006467999999998142,1264069,0
"172.16.133.34",50498,"172.16.139.250",5440,10,1022,10960,0,0,10,1022,0,0,121.132446,0.016970000000000596,481791,0
"172.16.133.97",59447,"172.16.139.250",5440,10,1022,10961,0,0,10,1022,0,0,121.142248,0.014746000000002368,554455,0
"172.16.133.97",59448,"67.217.64.244",443,6,366,10962,0,0,4,246,2,120,121.180043,0.06212200000000223,31679,15453
"172.16.133.33",57960,"172.16.139.250",5440,10,1022,10963,0,0,10,1022,0,0,121.216071,0.01576000000000022,518781,0
"172.16.133.68",60816,"172.16.139.250",5440,10,1022,10964,0,0,10,1022,0,0,121.249201,0.015857999999994377,515575,0
"172.16.133.12",59838,"172.16.139.250",5440,12,1142,10965,0,0,12,1142,0,0,121.261584,0.00730000000000075,1251506,0
"172.16.133.97",59449,"216.115.223.200",443,6,366,10966,0,0,4,246,2,120,121.271024,0.10559100000000399,18637,9091
"172.16.133.63",53946,"172.16.139.250",5440,12,1142,10967,0,0,12,1142,0,0,121.271769,0.006113999999996622,1494275,0
"172.16.133.66",53938,"172.16.139.250",5440,12,1142,10968,0,0,12,1142,0,0,121.285862,0.015495999999998844,589571,0
"172.16.133.82",61408,"172.16.139.250",5440,12,1142,10969,0,0,12,1142,0,0,121.300534,0.006429999999994607,1420839,0
"172.16.133.37",60684,"172.16.139.250",5440,10,1022,10970,0,0,10,1022,0,0,121.312944,0.005656999999999357,1445289,0
"172.16.133.54",64687,"64.208.138.143",80,11,2332,10971,0,0,6,1253,5,1079,121.404105,10.075631999999999,994,856
"172.16.133.54",64688,"64.208.138.143",80,12,2392,10972,0,0,6,1253,6,1139,121.404363,10.640439,942,856
"172.16.133.84",58852,"199.16.156.104",443,24,6963,10973,0,0,10,2362,14,4601,121.438986,30.284796,623,1215
"172.16.133.54",64689,"67.69.174.130",80,77,70300,10974,0,0,29,2703,48,67597,121.465338,135.771358,159,3982
"172.16.133.54",64690,"67.69.174.130",80,6,372,10975,0,0,4,246,2,126,121.465728,5.203254999999999,378,193
"172.16.133.78",59275,"172.16.139.250",5440,8,902,10976,0,0,8,902,0,0,121.469637,0.006325999999987175,1140689,0
"172.16.133.67",56046,"172.16.139.250",5440,10,1022,10977,0,0,10,1022,0,0,121.524066,0.014694999999989022,556379,0
"172.16.133.56",61489,"172.16.139.250",5440,12,1142,10978,0,0,12,1142,0,0,121.547547,0.005172999999999206,1766093,0
"172.16.133.41",53157,"172.16.139.250",5440,10,1022,10979,0,0,10,1022,0,0,121.602868,0.007332000000005223,1115111,0
"172.16.133.42",57186,"172.16.139.250",5440,12,1142,10980,0,0,12,1142,0,0,121.619396,0.027686000000002764,329986,0
"172.16.133.85",52332,"172.16.139.250",5440,10,1022,10981,0,0,10,1022,0,0,121.619616,0.01706500000000233,479109,0
"172.16.133.54",64691,"157.56.134.97",80,13,6222,10982,0,0,7,2577,6,3645,121.651727,0.12347000000001174,166971,236170
"172.16.133.43",57842,"172.16.139.250",5440,10,1022,10983,0,0,10,1022,0,0,121.67304,0.016861000000005788,484905,0
"172.16.133.97",59450,"66.151.150.190",443,6,366,10984,0,0,4,246,2,120,121.673096,0.2392329999999987,8226,4012
"172.16.133.97",59451,"216.219.113.250",443,7,426,10985,0,0,4,246,3,180,121.673936,0.23833400000000893,8257,6041
"172.16.133.13",53098,"172.16.139.250",5440,12,1142,10986,0,0,12,1142,0,0,121.691729,0.006100000000003547,1497704,0
"172.16.133.113",55640,"172.16.139.250",135,8,492,10987,0,0,8,492,0,0,121.724344,0.01681700000000319,234048,0
"172.16.133.54",64692,"204.154.111.33",80,11,2845,10988,0,0,6,2319,5,526,121.724346,0.06876499999999908,269788,61193
"172.16.133.54",64693,"204.154.111.33",80,11,2842,10989,0,0,6,2316,5,526,121.739872,1.1133669999999967,16641,3779
"172.16.133.20",62454,"172.16.139.250",5440,12,1142,10990,0,0,12,1142,0,0,121.741394,0.004982999999995741,"",""
"172.16.133.113",55641,"172.16.139.250",5462,10,696,10991,0,0,10,696,0,0,121.747844,0.530469999999994,10496,0
"172.16.133.75",51038,"172.16.139.250",5440,10,1022,10992,0,0,10,1022,0,0,121.757643,0.005593000000004622,1461827,0
"172.16.133.28",65532,"172.16.139.250",5440,10,1022,10993,0,0,10,1022,0,0,121.770878,0.005425000000002456,1507096,0
"172.16.133.114",55335,"67.217.65.49",443,266,25214,10994,0,0,170,13512,96,11702,121.784672,159.32284399999998,678,587
"172.16.133.99",56103,"172.16.139.250",5440,12,1142,10995,0,0,12,1142,0,0,121.798264,0.15171399999999835,60218,0
"172.16.133.87",60268,"172.16.139.250",5440,10,1022,10996,0,0,10,1022,0,0,121.82236,0.13203599999999938,61922,0
"172.16.133.35",50034,"172.16.139.250",5440,12,1142,10997,0,0,12,1142,0,0,121.832635,0.13705600000000118,66658,0
"172.16.133.116",53551,"172.16.139.250",5440,10,1022,10998,0,0,10,1022,0,0,121.835556,0.07357199999999864,111129,0
"172.16.133.84",58853,"172.16.139.250",5440,12,1142,10999,0,0,12,1142,0,0,121.858598,0.14855199999999513,61500,0
"172.16.133.116",53552,"172.16.139.250",5440,10,1022,11000,0,0,10,1022,0,0,121.910281,0.1402350000000041,58302,0
"172.16.133.49",55855,"172.16.139.250",5440,10,1022,11001,0,0,10,1022,0,0,121.936053,0.12736200000000508,64194,0
"172.16.133.68",50585,"172.16.139.250",5500,8,8844,11002,0,0,8,8844,0,0,121.970346,0.004701999999994655,"",""
"172.16.133.95",57029,"172.16.139.250",5440,10,1022,11003,0,0,10,1022,0,0,121.974611,0.11567100000000607,70683,0
"172.16.133.87",60269,"173.194.73.104",80,19,6198,11004,0,0,11,3856,8,2342,122.000071,137.28794600000003,224,136
"172.16.133.92",57743,"172.16.139.250",5440,10,1022,11005,0,0,10,1022,0,0,122.000652,0.14218599999999526,57502,0
"172.16.133.29",61015,"172.16.139.250",5440,12,1142,11006,0,0,12,1142,0,0,122.018389,0.12811800000000062,71309,0
"172.16.133.44",64896,"172.16.139.250",5440,10,1022,11007,0,0,10,1022,0,0,122.024833,0.12507300000000043,65369,0
"172.16.133.114",55336,"67.217.64.49",443,264,25057,11008,0,0,169,13421,95,11636,122.038813,159.06870399999997,674,585
"172.16.133.207",55993,"172.16.139.250",5440,12,1142,11009,0,0,12,1142,0,0,122.050567,0.05139199999999278,177770,0
"172.16.133.116",53553,"172.16.139.250",5440,12,1142,11010,0,0,12,1142,0,0,122.051551,0.043403999999995335,210487,0
"172.16.133.83",57151,"172.16.139.250",5440,10,1022,11011,0,0,10,1022,0,0,122.059114,0.039092000000010785,209147,0
"172.16.133.93",60780,"172.16.139.250",5440,12,1142,11012,0,0,12,1142,0,0,122.07591,0.1058840000000032,86283,0
"172.16.133.11",55202,"172.16.139.250",5440,12,1142,11013,0,0,12,1142,0,0,122.093402,0.11337500000000489,80582,0
"172.16.133.55",57691,"172.16.139.250",5440,10,1022,11014,0,0,10,1022,0,0,122.096725,0.08862699999998824,92251,0
"172.16.133.73",60735,"172.16.139.250",5440,10,1022,11015,0,0,10,1022,0,0,122.119411,0.08175699999999608,100003,0
"172.16.133.53",54179,"172.16.139.250",5440,10,1022,11016,0,0,10,1022,0,0,122.123477,0.08678500000000611,94209,0
"172.16.133.21",53254,"172.16.139.250",5440,10,1022,11017,0,0,10,1022,0,0,122.126833,0.04754299999999034,171970,0
"172.16.133.30",62685,"172.16.139.250",5440,10,1022,11018,0,0,10,1022,0,0,122.12997,0.07836199999999849,104336,0
"172.16.133.126",61860,"96.43.146.178",443,29,10016,11019,0,0,15,5719,14,4297,122.132227,139.60506299999997,327,246
"172.16.133.25",63548,"172.16.139.250",5440,10,1022,11020,0,0,10,1022,0,0,122.137232,0.07672999999999774,106555,0
"172.16.133.34",50499,"172.16.139.250",5440,10,1022,11021,0,0,10,1022,0,0,122.145233,0.03296899999999425,247990,0
"172.16.133.97",59452,"172.16.139.250",5440,10,1022,11022,0,0,10,1022,0,0,122.156379,0.06090799999999774,134235,0
"172.16.133.33",57961,"172.16.139.250",5440,10,1022,11023,0,0,10,1022,0,0,122.230054,0.005668000000000006,1442484,0
"172.16.133.73",60736,"180.153.31.250",443,6,366,11024,0,0,4,246,2,120,122.231709,0.4680450000000036,4204,2051
"172.16.133.54",64694,"74.121.139.112",80,18,7908,11025,0,0,10,3794,8,4114,122.243924,10.657309999999981,2847,3088
"172.16.133.68",60817,"172.16.139.250",5440,10,1022,11026,0,0,10,1022,0,0,122.262954,0.014890000000008285,549093,0
"172.16.133.114",55337,"67.217.66.49",443,267,25328,11027,0,0,171,13578,96,11750,122.264736,158.84277899999998,683,591
"172.16.133.12",59839,"172.16.139.250",5440,10,1022,11028,0,0,10,1022,0,0,122.275744,0.00646399999999403,1264851,0
"172.16.133.63",53947,"172.16.139.250",5440,10,1022,11029,0,0,10,1022,0,0,122.285204,0.01623300000001393,503665,0
"172.16.133.54",64695,"74.121.139.112",80,6,372,11030,0,0,4,246,2,126,122.290656,5.358620000000002,367,188
"172.16.133.54",64696,"209.190.70.254",80,17,7994,11031,0,0,8,4009,9,3985,122.292641,0.4545129999999915,70563,70141
"172.16.133.66",53939,"172.16.139.250",5440,12,1142,11032,0,0,12,1142,0,0,122.300042,0.11341000000000179,80557,0
"172.16.133.54",64697,"209.190.70.254",80,16,7062,11033,0,0,7,3489,9,3573,122.302289,0.9730050000000006,28686,29377
"172.16.133.49",55856,"132.245.2.22",443,25,16355,11034,0,0,10,1878,15,14477,122.307522,0.8974609999999927,16740,129048
"172.16.133.82",61409,"172.16.139.250",5440,12,1142,11035,0,0,12,1142,0,0,122.314709,0.09028600000000608,101189,0
"172.16.133.37",60685,"172.16.139.250",5440,10,1022,11036,0,0,10,1022,0,0,122.327474,0.08131600000000105,100546,0
"172.16.133.57",60621,"96.43.146.48",443,36,13737,11037,0,0,19,1882,17,11855,122.397442,2.244220999999996,6708,42259
"172.16.133.68",60818,"172.16.139.250",5440,12,1142,11038,0,0,12,1142,0,0,122.402565,0.014980000000008431,609879,0
"172.16.133.54",64698,"64.215.255.57",80,8,1435,11039,0,0,5,1114,3,321,122.412759,0.08905700000001104,100070,28835
"172.16.133.78",59276,"172.16.139.250",5440,12,1142,11040,0,0,12,1142,0,0,122.483698,0.027530999999996197,331844,0
"172.16.133.54",64699,"23.23.139.110",80,6,366,11041,0,0,4,246,2,120,122.516684,5.122092000000009,384,187
"172.16.133.54",64700,"23.23.139.110",80,11,2263,11042,0,0,6,927,5,1336,122.51695,59.818921,123,178
"172.16.133.67",56047,"172.16.139.250",5440,10,1022,11043,0,0,10,1022,0,0,122.53808,0.0055440000000004375,1474747,0
"172.16.133.56",61490,"172.16.139.250",5440,10,1022,11044,0,0,10,1022,0,0,122.560252,0.005274999999997476,1549952,0
"172.16.133.41",53158,"172.16.139.250",5440,12,1142,11045,0,0,12,1142,0,0,122.617012,0.007428000000004431,1229940,0
"172.16.133.42",57187,"172.16.139.250",5440,12,1142,11046,0,0,12,1142,0,0,122.632864,0.009962999999999056,916992,0
"172.16.133.85",52333,"172.16.139.250",5440,10,1022,11047,0,0,10,1022,0,0,122.63341,0.01454999999999984,561924,0
"172.16.133.43",57843,"172.16.139.250",5440,10,1022,11048,0,0,10,1022,0,0,122.686944,0.005814999999998349,1406018,0
"172.16.133.13",53099,"172.16.139.250",5440,10,1022,11049,0,0,10,1022,0,0,122.706606,0.015238000000010743,536553,0
"172.16.133.54",64701,"157.56.134.97",80,13,6202,11050,0,0,7,2570,6,3632,122.731294,0.12682999999999822,162106,229094
"172.16.133.99",56104,"172.16.139.250",5440,12,1142,11051,0,0,12,1142,0,0,122.738769,0.014690000000001646,621919,0
"172.16.133.20",62455,"172.16.139.250",5440,10,1022,11052,0,0,10,1022,0,0,122.755381,0.014679999999998472,556948,0
"172.16.133.99",53420,"96.43.146.48",443,2,120,11053,0,0,1,60,1,60,122.763457,9.299999999257125e-05,"",""
"172.16.133.99",56105,"96.43.146.48",443,21,8622,11054,0,0,11,2636,10,5986,122.764277,2.332127,9042,20534
"172.16.133.75",51039,"172.16.139.250",5440,10,1022,11055,0,0,10,1022,0,0,122.772884,0.01600499999999272,510840,0
"172.16.133.28",65533,"172.16.139.250",5440,10,1022,11056,0,0,10,1022,0,0,122.78621,0.00625999999999749,1306070,0
"172.16.133.99",56106,"172.16.139.250",5440,12,1142,11057,0,0,12,1142,0,0,122.812691,0.01492600000000266,612086,0
"172.16.133.73",60737,"23.21.84.31",443,20,6701,11058,0,0,10,1671,10,5030,122.834444,9.624280999999982,1388,4181
"172.16.133.73",60738,"64.208.138.117",443,31,14166,11059,0,0,15,6017,16,8149,122.835189,19.615990999999994,2453,3323
"172.16.133.73",60739,"72.21.203.149",443,24,9843,11060,0,0,11,1593,13,8250,122.83598,162.642024,78,405
"172.16.133.73",60740,"72.21.203.149",443,19,7209,11061,0,0,9,928,10,6281,122.836226,135.205552,54,371
"172.16.133.87",60270,"172.16.139.250",5440,10,1022,11062,0,0,10,1022,0,0,122.845696,0.005624999999994884,1453511,0
"172.16.133.35",50035,"172.16.139.250",5440,12,1142,11063,0,0,12,1142,0,0,122.846942,0.011020000000002028,829038,0
"172.16.133.116",53554,"172.16.139.250",5440,10,1022,11064,0,0,10,1022,0,0,122.850744,0.008139999999997372,1004422,0
"172.16.133.116",53555,"172.16.139.250",5440,10,1022,11065,0,0,10,1022,0,0,122.859744,0.005306999999987738,1540606,0
"172.16.133.73",60741,"23.61.0.81",443,27,6487,11066,0,0,15,2972,12,3515,122.864867,163.087876,145,172
"172.16.133.73",60742,"23.61.0.81",443,16,3270,11067,0,0,8,875,8,2395,122.865099,29.610175000000012,236,647
"172.16.133.116",53556,"172.16.139.250",5440,10,1022,11068,0,0,10,1022,0,0,122.865765,0.005221000000005915,1565983,0
"172.16.133.84",58854,"172.16.139.250",5440,10,1022,11069,0,0,10,1022,0,0,122.87286,0.005365999999995097,1523667,0
"172.16.133.41",53159,"199.102.234.31",80,14,5071,11070,0,0,7,2950,7,2121,122.878678,0.2411080000000112,97881,70375
"172.16.133.41",53160,"74.119.118.84",80,4,252,11071,0,0,2,126,2,126,122.879221,10.185199000000011,98,98
"172.16.133.41",53161,"208.47.254.34",80,6,372,11072,0,0,4,246,2,126,122.879785,17.124547000000007,114,58
"172.16.133.41",53162,"208.47.254.34",80,6,372,11073,0,0,4,246,2,126,122.879991,17.125095,114,58
"172.16.133.41",53163,"208.47.254.34",80,6,372,11074,0,0,4,246,2,126,122.88019800000001,17.124948999999987,114,58
"172.16.133.41",53164,"199.102.234.31",80,13,5709,11075,0,0,6,2873,7,2836,122.880531,0.295574000000002,77760,76759
"172.16.133.41",53165,"199.102.234.31",80,13,5012,11076,0,0,6,2891,7,2121,122.880727,0.3345030000000122,69141,50726
"172.16.133.41",53166,"199.102.234.31",80,13,5708,11077,0,0,6,2872,7,2836,122.880913,0.16717599999999777,137435,135713
"172.16.133.41",53167,"199.102.234.31",80,13,5709,11078,0,0,6,2873,7,2836,122.881087,0.40391700000000696,56902,56169
"172.16.133.41",53168,"199.102.234.31",80,14,5073,11079,0,0,7,2951,7,2122,122.881309,0.43806800000000123,53891,38751
"172.16.133.41",53169,"173.194.43.41",80,6,372,11080,0,0,4,246,2,126,122.886694,17.116833999999983,114,58
"172.16.133.73",60743,"23.61.0.81",443,6,372,11081,0,0,4,246,2,126,122.912572,15.70900300000001,125,64
"172.16.133.132",40033,"96.43.146.22",443,17,3961,11082,0,0,10,1059,7,2902,122.945709,17.318708000000015,489,1340
"172.16.133.49",55857,"172.16.139.250",5440,10,1022,11083,0,0,10,1022,0,0,122.948356,0.014691999999996597,556493,0
"172.16.133.33",57962,"172.16.139.250",5440,10,1022,11084,0,0,10,1022,0,0,122.948357,0.01855000000000473,440754,0
"172.16.133.95",57030,"172.16.139.250",5440,10,1022,11085,0,0,10,1022,0,0,122.987803,0.005630999999993946,1451962,0
"172.16.133.41",53170,"74.125.226.91",80,6,372,11086,0,0,4,246,2,126,122.99283,17.032910000000015,115,59
"172.16.133.41",53171,"74.125.226.91",80,6,372,11087,0,0,4,246,2,126,122.993075,17.031825999999995,115,59
"172.16.133.73",60744,"23.60.240.63",443,18,6900,11088,0,0,8,1004,10,5896,122.993218,29.481533999999996,272,1599
"172.16.133.73",60745,"23.60.240.63",443,19,6960,11089,0,0,9,1064,10,5896,122.993436,29.481516,288,1599
"172.16.133.33",57963,"96.43.146.48",443,12,2270,11090,0,0,7,1477,5,793,122.993594,0.5755709999999965,20529,11022
"172.16.133.73",60746,"23.60.240.63",443,18,6900,11091,0,0,8,1004,10,5896,122.993647,29.48140099999999,272,1599
"172.16.133.73",60747,"23.60.240.63",443,18,6900,11092,0,0,8,1004,10,5896,122.993795,29.481064000000003,272,1599
"172.16.133.92",57744,"172.16.139.250",5440,10,1022,11093,0,0,10,1022,0,0,123.014652,0.0054149999999992815,1509879,0
"172.16.133.29",61016,"172.16.139.250",5440,12,1142,11094,0,0,12,1142,0,0,123.03255,0.006179000000003043,1478556,0
"172.16.133.44",64897,"172.16.139.250",5440,10,1022,11095,0,0,10,1022,0,0,123.039863,0.024134000000003653,338775,0
"172.16.133.184",33855,"96.43.146.22",443,29,12486,11096,0,0,16,4204,13,8282,123.046948,4.068312000000006,8266,16285
"172.16.133.41",53172,"23.60.159.86",80,6,372,11097,0,0,4,246,2,126,123.05444,16.97130200000001,115,59
"172.16.133.54",64702,"157.56.134.97",80,13,6207,11098,0,0,7,2573,6,3634,123.063302,0.13279200000000912,155009,218928
"172.16.133.207",55994,"172.16.139.250",5440,12,1142,11099,0,0,12,1142,0,0,123.064525,0.018321000000000254,498662,0
"172.16.133.83",57152,"172.16.139.250",5440,12,1142,11100,0,0,12,1142,0,0,123.07411,0.004701999999994655,"",""
"172.16.133.93",60781,"172.16.139.250",5440,10,1022,11101,0,0,10,1022,0,0,123.089185,0.005401000000006206,1513793,0
"172.16.133.54",64703,"157.56.134.97",80,5,312,11102,0,0,3,186,2,126,123.0977,5.531579999999991,269,182
"172.16.133.55",57692,"172.16.139.250",5440,10,1022,11103,0,0,10,1022,0,0,123.113192,0.015173000000004322,538851,0
"172.16.133.11",55203,"172.16.139.250",5440,10,1022,11104,0,0,10,1022,0,0,123.122449,0.01554899999999293,525821,0
"172.16.133.73",60748,"172.16.139.250",5440,12,1142,11105,0,0,12,1142,0,0,123.135704,0.007099999999994111,1286760,0
"172.16.133.53",54180,"172.16.139.250",5440,12,1142,11106,0,0,12,1142,0,0,123.136356,0.010472999999990407,872338,0
"172.16.133.21",53255,"172.16.139.250",5440,10,1022,11107,0,0,10,1022,0,0,123.139411,0.01032700000000375,791711,0
"172.16.133.30",62686,"172.16.139.250",5440,10,1022,11108,0,0,10,1022,0,0,123.144225,0.00969499999999357,843321,0
"172.16.133.54",64704,"204.154.111.33",80,11,2843,11109,0,0,6,2317,5,526,123.148693,0.06852100000000405,270515,61411
"172.16.133.25",63549,"172.16.139.250",5440,12,1142,11110,0,0,12,1142,0,0,123.151741,0.0078079999999971506,1170081,0
"172.16.133.34",50500,"172.16.139.250",5440,12,1142,11111,0,0,12,1142,0,0,123.159657,0.005085000000008222,1796656,0
"172.16.133.54",64705,"204.154.111.33",80,5,306,11112,0,0,3,186,2,120,123.170003,5.454535000000007,272,176
"172.16.133.97",59453,"172.16.139.250",5440,12,1142,11113,0,0,12,1142,0,0,123.17095,0.0061479999999960455,1486011,0
"172.16.133.33",57964,"172.16.139.250",5440,12,1142,11114,0,0,12,1142,0,0,123.243527,0.006246000000004415,1462696,0
"172.16.133.184",58152,"65.54.81.135",443,106,76694,11115,0,0,39,3455,67,73239,123.262641,4.077826000000002,6778,143682
"172.16.133.67",55816,"96.43.146.176",443,4,240,11116,0,0,2,120,2,120,123.271492,0.03858500000001186,24880,24880
"172.16.133.67",56048,"96.43.146.176",443,16,2593,11117,0,0,9,1680,7,913,123.271739,80.204226,167,91
"172.16.133.68",60819,"172.16.139.250",5440,10,1022,11118,0,0,10,1022,0,0,123.27735,0.005552000000008661,1472622,0
"172.16.133.12",59840,"172.16.139.250",5440,12,1142,11119,0,0,12,1142,0,0,123.290252,0.005752999999998565,1588041,0
"172.16.133.41",53173,"199.102.234.31",80,14,5768,11120,0,0,7,2933,7,2835,123.29677,0.10147500000000775,231229,223503
"172.16.133.63",53948,"172.16.139.250",5440,12,1142,11121,0,0,12,1142,0,0,123.299384,0.006121999999990635,1492322,0
"172.16.133.66",53940,"172.16.139.250",5440,12,1142,11122,0,0,12,1142,0,0,123.314286,0.006506000000001677,1404242,0
"172.16.133.82",61410,"172.16.139.250",5440,12,1142,11123,0,0,12,1142,0,0,123.328687,0.006692999999998506,1365008,0
"172.16.133.37",60686,"172.16.139.250",5440,10,1022,11124,0,0,10,1022,0,0,123.344709,0.006510000000005789,1255913,0
"172.16.133.41",53174,"199.102.234.31",80,14,5073,11125,0,0,8,3011,6,2062,123.372968,0.06957500000000039,346216,237096
"172.16.133.41",53175,"199.102.234.31",80,14,5769,11126,0,0,8,2993,6,2776,123.444596,0.08135799999999449,294304,272966
"172.16.133.78",59277,"172.16.139.250",5440,10,1022,11127,0,0,10,1022,0,0,123.497392,0.005679999999998131,1439436,0
"172.16.133.41",53176,"199.102.234.31",80,13,5013,11128,0,0,7,2951,6,2062,123.527857,0.15815800000000024,149268,104300
"172.16.133.67",56049,"172.16.139.250",5440,10,1022,11129,0,0,10,1022,0,0,123.551946,0.006341000000006147,1289386,0
"172.16.133.56",61491,"172.16.139.250",5440,12,1142,11130,0,0,12,1142,0,0,123.574215,0.014777000000009366,618258,0
"172.16.133.41",53177,"172.16.139.250",5440,10,1022,11131,0,0,10,1022,0,0,123.630982,0.014797999999998979,552507,0
"172.16.133.85",52334,"172.16.139.250",5440,10,1022,11132,0,0,10,1022,0,0,123.647891,0.015744999999995457,519275,0
"172.16.133.42",57188,"172.16.139.250",5440,12,1142,11133,0,0,12,1142,0,0,123.647954,0.007835999999997512,1165900,0
"172.16.133.41",53178,"199.102.234.31",80,13,5708,11134,0,0,6,2873,7,2835,123.688174,0.1424949999999967,161296,159163
"172.16.133.43",57844,"172.16.139.250",5440,12,1142,11135,0,0,12,1142,0,0,123.702486,0.0062130000000024665,1470465,0
"172.16.133.13",53100,"172.16.139.250",5440,10,1022,11136,0,0,10,1022,0,0,123.720218,0.007468000000002917,1094804,0
"172.16.133.20",62456,"172.16.139.250",5440,12,1142,11137,0,0,12,1142,0,0,123.769437,0.005418000000005918,1686231,0
"172.16.133.75",51040,"172.16.139.250",5440,12,1142,11138,0,0,12,1142,0,0,123.784962,0.006376000000003046,1432873,0
"172.16.133.41",53179,"199.102.234.31",80,13,5013,11139,0,0,7,2951,6,2062,123.796366,0.07313699999998846,322791,225549
"172.16.133.28",65534,"172.16.139.250",5440,10,1022,11140,0,0,10,1022,0,0,123.79911799999999,0.005395000000007144,1515477,0
"172.16.133.99",56107,"172.16.139.250",5440,12,1142,11141,0,0,12,1142,0,0,123.832223,0.0053549999999944475,1706069,0
"172.16.133.87",60271,"172.16.139.250",5440,10,1022,11142,0,0,10,1022,0,0,123.849665,0.015008999999992056,544739,0
"172.16.133.35",50036,"172.16.139.250",5440,12,1142,11143,0,0,12,1142,0,0,123.859863,0.011248999999992293,812161,0
"172.16.133.116",53557,"172.16.139.250",5440,10,1022,11144,0,0,10,1022,0,0,123.864034,0.008050999999994701,1015526,0
"172.16.133.41",53180,"199.102.234.31",80,13,5708,11145,0,0,6,2873,7,2835,123.870747,0.21395900000000267,107422,106001
"172.16.133.116",53558,"172.16.139.250",5440,10,1022,11146,0,0,10,1022,0,0,123.873171,0.005514000000005126,1482771,0
"172.16.133.116",53559,"172.16.139.250",5440,10,1022,11147,0,0,10,1022,0,0,123.879236,0.006510999999989053,1255721,0
"172.16.133.84",58855,"172.16.139.250",5440,12,1142,11148,0,0,12,1142,0,0,123.887046,0.015107999999997901,604712,0
"172.16.133.49",55858,"172.16.139.250",5440,12,1142,11149,0,0,12,1142,0,0,123.962293,0.006235000000003765,1465276,0
"172.16.133.95",57031,"172.16.139.250",5440,10,1022,11150,0,0,10,1022,0,0,124.001752,0.005516000000000076,1482233,0
"172.16.133.41",53181,"199.102.234.31",80,14,5072,11151,0,0,8,3011,6,2061,124.007465,0.11297900000000993,213207,145938
"172.16.133.92",57745,"172.16.139.250",5440,12,1142,11152,0,0,12,1142,0,0,124.02825,0.015523999999999205,588508,0
"172.16.133.29",61017,"172.16.139.250",5440,10,1022,11153,0,0,10,1022,0,0,124.046842,0.022179000000008386,368636,0
"172.16.133.44",64898,"172.16.139.250",5440,12,1142,11154,0,0,12,1142,0,0,124.052866,0.006206000000005929,1472123,0
"172.16.133.87",60272,"173.194.73.104",80,6,372,11155,0,0,4,246,2,126,124.073487,11.219594999999998,175,89
"172.16.133.207",55995,"172.16.139.250",5440,10,1022,11156,0,0,10,1022,0,0,124.078474,0.004731000000006702,"",""
"172.16.133.116",53560,"208.111.161.254",80,8,492,11157,0,0,4,246,4,246,124.086212,18.069917999999987,108,108
"172.16.133.116",53561,"208.111.161.254",80,8,492,11158,0,0,4,246,4,246,124.086482,18.069547999999983,108,108
"172.16.133.83",57153,"172.16.139.250",5440,12,1142,11159,0,0,12,1142,0,0,124.088021,0.01380299999999579,661885,0
"172.16.133.184",54115,"107.22.223.184",443,22,8089,11160,0,0,12,1510,10,6579,124.091762,0.22680900000000292,53260,232054
"172.16.133.184",40639,"38.126.130.199",443,21,8229,11161,0,0,10,1573,11,6656,124.093729,0.18954500000000962,66390,280925
"172.16.133.93",60782,"172.16.139.250",5440,10,1022,11162,0,0,10,1022,0,0,124.10308,0.014409999999998035,567383,0
"172.16.133.41",53182,"199.102.234.31",80,13,5708,11163,0,0,6,2873,7,2835,124.122202,0.0963079999999934,238650,235494
"172.16.133.11",55204,"172.16.139.250",5440,10,1022,11164,0,0,10,1022,0,0,124.122789,0.005606000000000222,1458437,0
"172.16.133.55",57693,"172.16.139.250",5440,10,1022,11165,0,0,10,1022,0,0,124.125447,0.0068450000000126465,1194448,0
"172.16.133.73",60749,"172.16.139.250",5440,12,1142,11166,0,0,12,1142,0,0,124.149221,0.022288000000003194,409906,0
"172.16.133.21",53256,"172.16.139.250",5440,10,1022,11167,0,0,10,1022,0,0,124.153765,0.005719999999996617,1429370,0
"172.16.133.53",54181,"172.16.139.250",5440,10,1022,11168,0,0,10,1022,0,0,124.153824,0.00936500000000251,873037,0
"172.16.133.30",62688,"172.16.139.250",5440,10,1022,11169,0,0,10,1022,0,0,124.157157,0.010055000000008363,813127,0
"172.16.133.25",63550,"172.16.139.250",5440,12,1142,11170,0,0,12,1142,0,0,124.166262,0.00891099999999767,1025249,0
"172.16.133.87",60273,"173.194.73.104",443,1230,1159605,11171,0,0,302,40838,928,1118767,124.172039,165.927435,1968,53940
"172.16.133.34",50501,"172.16.139.250",5440,10,1022,11172,0,0,10,1022,0,0,124.173284,0.0060050000000018144,1361532,0
"172.16.133.97",59454,"172.16.139.250",5440,10,1022,11173,0,0,10,1022,0,0,124.184689,0.015502999999995382,527381,0
"172.16.133.41",53183,"199.102.234.31",80,14,5072,11174,0,0,8,3011,6,2061,124.193407,0.06732200000000432,357802,244912
"172.16.133.39",64265,"216.115.209.97",443,16,4808,11175,0,0,8,917,8,3891,124.2408,1.163730000000001,6303,26748
"172.16.133.184",44862,"98.139.225.43",443,24,8293,11176,0,0,12,1764,12,6529,124.257146,7.498640999999992,1881,6965
"172.16.133.33",57965,"172.16.139.250",5440,10,1022,11177,0,0,10,1022,0,0,124.25783,0.014967999999996096,546231,0
"172.16.133.41",53184,"199.102.234.31",80,13,5708,11178,0,0,6,2873,7,2835,124.262908,0.09293200000000468,247320,244049
"172.16.133.87",60274,"74.125.226.79",443,17,1901,11179,0,0,9,1145,8,756,124.271779,135.285028,67,44
"172.16.133.68",60820,"172.16.139.250",5440,10,1022,11180,0,0,10,1022,0,0,124.291249,0.005560000000002674,1470503,0
"172.16.133.184",55223,"64.208.138.244",443,18,4989,11181,0,0,10,1537,8,3452,124.299048,0.18031799999999976,68190,153151
"172.16.133.12",59841,"172.16.139.250",5440,10,1022,11182,0,0,10,1022,0,0,124.303747,0.0053230000000041855,1535975,0
"172.16.133.63",53949,"172.16.139.250",5440,10,1022,11183,0,0,10,1022,0,0,124.313966,0.005492000000003827,1488710,0
"172.16.133.66",53941,"172.16.139.250",5440,10,1022,11184,0,0,10,1022,0,0,124.327179,0.00543700000000058,1503770,0
"172.16.133.41",53185,"199.102.234.31",80,13,5012,11185,0,0,7,2950,6,2062,124.336517,0.07170999999999594,329103,230037
"172.16.133.82",61411,"172.16.139.250",5440,10,1022,11186,0,0,10,1022,0,0,124.341997,0.005641999999994596,1449131,0
"172.16.133.37",60687,"172.16.139.250",5440,10,1022,11187,0,0,10,1022,0,0,124.35462,0.005615000000005921,1456099,0
"172.16.133.41",53186,"199.102.234.31",80,13,5709,11188,0,0,6,2873,7,2836,124.409618,0.13036000000001025,176311,174041
"172.16.133.184",43152,"107.22.223.184",80,11,1545,11189,0,0,6,770,5,775,124.468645,0.12343500000000063,49904,50228
"172.16.133.73",60750,"180.153.31.250",443,6,366,11190,0,0,4,246,2,120,124.469692,0.5222570000000104,3768,1838
"172.16.133.41",53187,"199.102.234.31",80,13,5012,11191,0,0,6,2891,7,2121,124.500814,0.09898599999999647,233649,171418
"172.16.133.78",59278,"172.16.139.250",5440,10,1022,11192,0,0,10,1022,0,0,124.51088,0.005763000000001739,1418705,0
"172.16.133.67",56050,"172.16.139.250",5440,12,1142,11193,0,0,12,1142,0,0,124.566415,0.0078119999999870515,1169482,0
"172.16.133.41",53188,"199.102.234.31",80,15,5827,11194,0,0,7,2933,8,2894,124.575789,0.2875540000000001,81598,80513
"172.16.133.56",61492,"172.16.139.250",5440,12,1142,11195,0,0,12,1142,0,0,124.589693,0.005127999999999133,1781591,0
"172.16.133.41",53189,"172.16.139.250",5440,10,1022,11196,0,0,10,1022,0,0,124.645079,0.0055899999999979855,1462611,0
"172.16.133.85",52335,"172.16.139.250",5440,10,1022,11197,0,0,10,1022,0,0,124.661447,0.015222000000008507,537117,0
"172.16.133.99",56108,"216.115.209.97",443,18,4928,11198,0,0,8,917,10,4011,124.664299,1.0199750000000023,7192,31459
"172.16.133.42",57189,"172.16.139.250",5440,12,1142,11199,0,0,12,1142,0,0,124.674672,0.011972000000000094,763113,0
"172.16.133.43",57845,"172.16.139.250",5440,10,1022,11200,0,0,10,1022,0,0,124.714998,0.015441000000009808,529499,0
"172.16.133.13",53101,"172.16.139.250",5440,10,1022,11201,0,0,10,1022,0,0,124.733725,0.005454999999997767,1498808,0
"172.16.133.20",62457,"119.47.118.78",80,20,5814,11202,0,0,10,1596,10,4218,124.746635,11.52425500000001,1107,2928
"172.16.133.20",62458,"172.16.139.250",5440,12,1142,11203,0,0,12,1142,0,0,124.78263,0.0049539999999979045,"",""
"172.16.133.75",51041,"172.16.139.250",5440,10,1022,11204,0,0,10,1022,0,0,124.799744,0.005415999999996757,1509601,0
"172.16.133.28",49155,"172.16.139.250",5440,10,1022,11205,0,0,10,1022,0,0,124.81421,0.005404999999996107,1512673,0
"172.16.133.99",56109,"172.16.139.250",5440,12,1142,11206,0,0,12,1142,0,0,124.839883,0.004830999999995811,"",""
"172.16.133.87",60275,"172.16.139.250",5440,10,1022,11207,0,0,10,1022,0,0,124.864497,0.015334999999993215,533159,0
"172.16.133.116",53562,"172.16.139.250",5440,10,1022,11208,0,0,10,1022,0,0,124.877121,0.006550000000004275,1248244,0
"172.16.133.35",50037,"172.16.139.250",5440,12,1142,11209,0,0,12,1142,0,0,124.878563,0.013277000000002204,688107,0
"172.16.133.116",53563,"172.16.139.250",5440,12,1142,11210,0,0,12,1142,0,0,124.884504,0.01544899999998961,591365,0
"172.16.133.84",58856,"172.16.139.250",5440,10,1022,11211,0,0,10,1022,0,0,124.899631,0.014673000000001934,557213,0
"172.16.133.116",53564,"172.16.139.250",5440,12,1142,11212,0,0,12,1142,0,0,124.900989,0.006311000000010836,1447631,0
"172.16.133.82",61412,"64.56.203.22",443,32,19890,11213,0,0,14,5900,18,13990,124.9256,10.978914000000003,4299,10194
"172.16.133.82",61413,"96.43.146.178",443,60,36742,11214,0,0,31,21150,29,15592,124.927826,139.83443900000003,1210,892
"172.16.133.82",61414,"96.43.146.178",443,16,4066,11215,0,0,9,1073,7,2993,124.928148,135.35486,63,176
"172.16.133.82",61415,"96.43.146.178",443,16,4066,11216,0,0,9,1073,7,2993,124.928273,135.353269,63,176
"172.16.133.82",61416,"96.43.146.178",443,16,4066,11217,0,0,9,1073,7,2993,124.928575,135.35696700000003,63,176
"172.16.133.82",61417,"96.43.146.178",443,16,4066,11218,0,0,9,1073,7,2993,124.928633,135.365021,63,176
"172.16.133.82",61418,"96.43.146.178",443,16,4066,11219,0,0,9,1073,7,2993,124.928887,135.35804499999998,63,176
"172.16.133.82",61419,"75.101.140.131",443,93,46481,11220,0,0,44,21038,49,25443,124.960693,120.81496299999999,1393,1684
"172.16.133.82",61420,"75.101.140.131",443,20,5791,11221,0,0,10,1322,10,4469,124.960695,70.86906599999999,149,504
"172.16.133.132",36681,"96.43.146.48",443,46,21305,11222,0,0,24,6007,22,15298,124.96965,15.543025999999998,3091,7873
"172.16.133.132",36682,"96.43.146.48",443,78,49386,11223,0,0,36,6836,42,42550,124.973348,15.537098999999998,3519,21908
"172.16.133.49",55859,"172.16.139.250",5440,10,1022,11224,0,0,10,1022,0,0,124.976619,0.005966000000000804,1370432,0
"172.16.133.132",36683,"96.43.146.48",443,35,13647,11225,0,0,20,3099,15,10548,124.977331,15.530490999999998,1596,5433
"172.16.133.132",36684,"96.43.146.48",443,76,45873,11226,0,0,40,4393,36,41480,124.980949,15.52710900000001,2263,21371
"172.16.133.132",36685,"96.43.146.48",443,32,10806,11227,0,0,19,4401,13,6405,124.984614,15.523021999999997,2268,3300
"172.16.133.95",57032,"172.16.139.250",5440,12,1142,11228,0,0,12,1142,0,0,125.015683,0.006804000000002475,1342739,0
"172.16.133.92",57746,"172.16.139.250",5440,10,1022,11229,0,0,10,1022,0,0,125.042474,0.017656000000002336,463072,0
"172.16.133.29",61018,"172.16.139.250",5440,12,1142,11230,0,0,12,1142,0,0,125.061774,0.004924000000002593,"",""
"172.16.133.44",64899,"172.16.139.250",5440,12,1142,11231,0,0,12,1142,0,0,125.06752,0.0062999999999959755,1450158,0
"172.16.133.207",55996,"172.16.139.250",5440,10,1022,11232,0,0,10,1022,0,0,125.092854,0.004826999999991699,"",""
"172.16.133.83",57154,"172.16.139.250",5440,12,1142,11233,0,0,12,1142,0,0,125.101232,0.014741999999998256,619725,0
"172.16.133.93",60783,"172.16.139.250",5440,10,1022,11234,0,0,10,1022,0,0,125.117815,0.004680000000007567,"",""
"172.16.133.11",55205,"172.16.139.250",5440,10,1022,11235,0,0,10,1022,0,0,125.133948,0.015517000000002668,526905,0
"172.16.133.55",57694,"172.16.139.250",5440,10,1022,11236,0,0,10,1022,0,0,125.13991,0.005707999999998492,1432375,0
"172.16.133.82",61421,"64.56.203.22",443,20,8129,11237,0,0,11,3480,9,4649,125.143116,10.758577999999986,2587,3456
"172.16.133.82",61422,"64.56.203.22",443,16,4109,11238,0,0,9,3087,7,1022,125.143217,10.76141699999998,2294,759
"172.16.133.82",61423,"64.56.203.22",443,22,9943,11239,0,0,12,3610,10,6333,125.143609,10.760708999999991,2683,4708
"172.16.133.73",60751,"172.16.139.250",5440,12,1142,11240,0,0,12,1142,0,0,125.162242,0.009521999999989816,959462,0
"172.16.133.53",54182,"172.16.139.250",5440,10,1022,11241,0,0,10,1022,0,0,125.165483,0.00984499999999855,830472,0
"172.16.133.21",53257,"172.16.139.250",5440,10,1022,11242,0,0,10,1022,0,0,125.167703,0.011254999999991355,726432,0
"172.16.133.30",62689,"172.16.139.250",5440,10,1022,11243,0,0,10,1022,0,0,125.17221,0.011020999999999503,741856,0
"172.16.133.25",63551,"172.16.139.250",5440,10,1022,11244,0,0,10,1022,0,0,125.179013,0.014634000000000924,558698,0
"172.16.133.82",61424,"216.137.33.81",443,20,7728,11245,0,0,9,958,11,6770,125.186188,30.59842300000001,250,1770
"172.16.133.82",61425,"216.137.33.81",443,20,7728,11246,0,0,9,958,11,6770,125.186261,30.598444999999998,250,1770
"172.16.133.82",61426,"216.137.33.81",443,19,7418,11247,0,0,9,952,10,6466,125.186495,30.597537000000003,248,1690
"172.16.133.82",61427,"216.137.33.81",443,20,7728,11248,0,0,9,958,11,6770,125.186549,30.59777899999999,250,1770
"172.16.133.82",61428,"216.137.33.81",443,18,7358,11249,0,0,8,892,10,6466,125.186784,30.597722999999988,233,1690
"172.16.133.82",61429,"216.137.33.81",443,19,7418,11250,0,0,9,952,10,6466,125.186786,30.59735099999999,248,1690
"172.16.133.34",50502,"172.16.139.250",5440,12,1142,11251,0,0,12,1142,0,0,125.187597,0.015303000000002953,597007,0
"172.16.133.97",59455,"172.16.139.250",5440,12,1142,11252,0,0,12,1142,0,0,125.198559,0.015520999999992569,588621,0
"172.16.133.33",57966,"172.16.139.250",5440,12,1142,11253,0,0,12,1142,0,0,125.271228,0.00633400000000961,1442374,0
"172.16.133.68",60821,"172.16.139.250",5440,12,1142,11254,0,0,12,1142,0,0,125.305479,0.016621000000000663,549666,0
"172.16.133.12",59842,"172.16.139.250",5440,12,1142,11255,0,0,12,1142,0,0,125.317936,0.007924000000002707,1152953,0
"172.16.133.63",53950,"172.16.139.250",5440,12,1142,11256,0,0,12,1142,0,0,125.327604,0.006305000000011773,1449008,0
"172.16.133.66",53942,"172.16.139.250",5440,10,1022,11257,0,0,10,1022,0,0,125.341048,0.005561000000000149,1470239,0
"172.16.133.82",61430,"172.16.139.250",5440,10,1022,11258,0,0,10,1022,0,0,125.35518,0.005401999999989471,1513513,0
"172.16.133.37",60688,"172.16.139.250",5440,10,1022,11259,0,0,10,1022,0,0,125.369844,0.005342999999996323,1530226,0
"172.16.133.57",60622,"157.56.242.198",443,306,244209,11260,0,0,147,121061,159,123148,125.409464,62.625578000000004,15464,15731
"172.16.133.67",56051,"216.219.115.17",443,19,5105,11261,0,0,9,1046,10,4059,125.417831,0.3425239999999974,24430,94802
"172.16.133.39",64266,"216.219.115.17",443,19,5105,11262,0,0,9,1046,10,4059,125.418212,0.34223599999999976,24450,94881
"172.16.133.78",59279,"128.153.206.97",35893,3,194,11263,0,0,3,194,0,0,125.4353,9.002763000000002,172,0
"172.16.133.78",59280,"98.113.167.114",56618,6,374,11264,0,0,3,194,3,180,125.43548,1.0735789999999952,1445,1341
"172.16.133.78",59281,"204.85.83.100",55607,142,13704,11265,0,0,75,6099,67,7605,125.43563,162.64695,299,374
"172.16.133.78",59282,"66.168.57.109",31762,3,194,11266,0,0,3,194,0,0,125.435777,9.002454,172,0
"172.16.133.78",59283,"107.3.185.158",56005,3,194,11267,0,0,3,194,0,0,125.435954,9.001169000000019,172,0
"172.16.133.82",61431,"75.101.140.131",443,20,5778,11268,0,0,10,1146,10,4632,125.463273,70.366256,130,526
"172.16.133.82",61432,"75.101.140.131",443,20,5778,11269,0,0,10,1146,10,4632,125.463409,70.36492500000001,130,526
"172.16.133.82",61433,"75.101.140.131",443,20,5778,11270,0,0,10,1146,10,4632,125.463877,70.36599799999999,130,526
"172.16.133.82",61434,"75.101.140.131",443,21,5838,11271,0,0,10,1146,11,4692,125.463878,70.366097,130,533
"172.16.133.82",61435,"204.93.223.146",443,14,4322,11272,0,0,6,768,8,3554,125.467857,32.692933,187,869
"172.16.133.82",61436,"204.93.223.146",443,19,6844,11273,0,0,9,2980,10,3864,125.467914,33.414787000000004,713,925
"172.16.133.82",61437,"23.22.135.102",443,18,5854,11274,0,0,9,959,9,4895,125.469159,10.330741000000003,742,3790
"172.16.133.82",61438,"23.22.135.102",443,18,5854,11275,0,0,9,959,9,4895,125.469217,10.329606999999996,742,3791
"172.16.133.82",61439,"23.20.26.196",443,20,6033,11276,0,0,10,1025,10,5008,125.469907,10.331741999999991,793,3877
"172.16.133.82",61440,"23.20.26.196",443,19,5973,11277,0,0,9,965,10,5008,125.469908,10.336232999999993,746,3876
"172.16.133.82",61441,"23.20.26.196",443,18,5854,11278,0,0,9,959,9,4895,125.470013,10.33281500000001,742,3789
"172.16.133.82",61442,"23.20.26.196",443,18,5854,11279,0,0,9,959,9,4895,125.470112,10.336030999999991,742,3788
"172.16.133.99",56110,"216.219.115.17",443,19,5105,11280,0,0,9,1046,10,4059,125.471999,0.3043530000000061,27494,106691
"172.16.133.82",61443,"204.232.201.76",443,22,7735,11281,0,0,11,2285,11,5450,125.472145,10.426257000000007,1753,4181
"172.16.133.99",56111,"216.219.115.54",443,19,5105,11282,0,0,9,1046,10,4059,125.472742,0.3109230000000025,26913,104437
"172.16.133.67",56052,"216.115.209.97",443,16,4808,11283,0,0,8,917,8,3891,125.502233,1.0221429999999998,7177,30453
"172.16.133.82",61444,"107.21.93.12",443,21,5908,11284,0,0,10,1326,11,4582,125.503314,70.326746,150,521
"172.16.133.82",61445,"107.21.93.12",443,21,5908,11285,0,0,10,1326,11,4582,125.503374,70.32695300000002,150,521
"172.16.133.82",61446,"216.137.33.1",443,26,8873,11286,0,0,12,1729,14,7144,125.50527,130.27188,106,438
"172.16.133.82",61447,"216.137.33.1",443,20,7695,11287,0,0,9,925,11,6770,125.505322,30.281227,244,1788
"172.16.133.82",61448,"64.208.138.113",443,26,13850,11288,0,0,12,5921,14,7929,125.505706,20.271578000000005,2336,3129
"172.16.133.82",61449,"64.208.138.113",443,17,3862,11289,0,0,9,1083,8,2779,125.505708,60.270375,143,368
"172.16.133.82",61450,"216.137.33.109",443,20,7728,11290,0,0,9,958,11,6770,125.50598600000001,30.277874999999995,253,1788
"172.16.133.82",61451,"216.137.33.109",443,18,7358,11291,0,0,8,892,10,6466,125.505987,30.27824799999999,235,1708
"172.16.133.82",61452,"199.27.72.130",443,21,7409,11292,0,0,9,1078,12,6331,125.506304,60.275239,143,840
"172.16.133.82",61453,"199.27.72.130",443,22,7469,11293,0,0,10,1138,12,6331,125.506482,60.27516,151,840
"172.16.133.82",61454,"199.27.72.130",443,22,7739,11294,0,0,9,1084,13,6655,125.506725,60.27471100000001,143,883
"172.16.133.78",59284,"172.16.139.250",5440,10,1022,11295,0,0,10,1022,0,0,125.52488,0.00622100000001069,1314258,0
"172.16.133.67",56053,"172.16.139.250",5440,12,1142,11296,0,0,12,1142,0,0,125.578876,0.006235000000003765,1465276,0
"172.16.133.57",60623,"157.56.242.198",443,47,18790,11297,0,0,23,6554,24,12236,125.582246,62.369144000000006,840,1569
"172.16.133.56",61493,"172.16.139.250",5440,12,1142,11298,0,0,12,1142,0,0,125.602488,0.005105000000000359,1789618,0
"172.16.133.39",64267,"216.219.115.54",443,13,4541,11299,0,0,7,800,6,3741,125.608912,0.1325700000000012,48276,225752
"172.16.133.41",53190,"172.16.139.250",5440,10,1022,11300,0,0,10,1022,0,0,125.658306,0.005769000000000801,1417230,0
"172.16.133.82",61455,"72.21.215.132",443,22,5815,11301,0,0,10,1783,12,4032,125.67081,10.12951600000001,1408,3184
"172.16.133.85",52336,"172.16.139.250",5440,10,1022,11302,0,0,10,1022,0,0,125.675488,0.01588999999999885,514537,0
"172.16.133.42",57190,"172.16.139.250",5440,12,1142,11303,0,0,12,1142,0,0,125.678479,0.0473259999999982,193043,0
"172.16.133.67",56054,"64.74.80.70",443,16,4863,11304,0,0,8,923,8,3940,125.725521,0.21078400000000386,35031,149536
"172.16.133.82",61456,"72.44.52.222",443,28,12721,11305,0,0,15,6087,13,6634,125.725931,10.074276999999995,4833,5268
"172.16.133.43",57846,"172.16.139.250",5440,10,1022,11306,0,0,10,1022,0,0,125.72944,0.0056090000000068585,1457657,0
"172.16.133.39",64269,"64.74.80.70",443,16,4863,11307,0,0,8,923,8,3940,125.73393,0.2256619999999998,32721,139677
"172.16.133.13",53102,"172.16.139.250",5440,10,1022,11308,0,0,10,1022,0,0,125.747275,0.0054750000000041155,1493333,0
"172.16.133.99",56112,"64.74.80.70",443,16,4863,11309,0,0,8,923,8,3940,125.752605,0.19663400000000308,37552,160297
"172.16.133.20",62459,"172.16.139.250",5440,12,1142,11310,0,0,12,1142,0,0,125.79872399999999,0.005147000000008006,1775014,0
"172.16.133.75",51042,"172.16.139.250",5440,10,1022,11311,0,0,10,1022,0,0,125.81336,0.0054009999999919955,1513793,0
"172.16.133.28",49157,"172.16.139.250",5440,10,1022,11312,0,0,10,1022,0,0,125.827947,0.014671000000006984,557289,0
"172.16.133.20",62460,"173.194.43.36",80,6,372,11313,0,0,4,246,2,126,125.847505,10.21818900000001,192,98
"172.16.133.20",62461,"173.194.43.36",80,6,372,11314,0,0,4,246,2,126,125.84777,10.220924999999994,192,98
"172.16.133.20",62462,"173.194.43.38",80,6,372,11315,0,0,4,246,2,126,125.84807,10.217302999999987,192,98
"172.16.133.20",62463,"173.194.43.55",80,7,432,11316,0,0,4,246,3,186,125.848787,10.21965999999999,192,145
"172.16.133.20",62464,"173.194.43.55",80,6,372,11317,0,0,4,246,2,126,125.849016,10.217725999999999,192,98
"172.16.133.20",62465,"173.194.43.55",80,6,372,11318,0,0,4,246,2,126,125.849221,10.218399000000005,192,98
"172.16.133.20",62466,"173.194.43.55",80,6,372,11319,0,0,4,246,2,126,125.849397,10.21795999999999,192,98
"172.16.133.20",62467,"173.194.43.46",80,6,372,11320,0,0,4,246,2,126,125.849943,10.217355999999995,192,98
"172.16.133.20",62468,"173.194.43.46",80,6,372,11321,0,0,4,246,2,126,125.850263,10.217035999999993,192,98
"172.16.133.20",62469,"173.194.43.46",80,6,372,11322,0,0,4,246,2,126,125.850606,10.216398999999996,192,98
"172.16.133.20",62470,"173.194.43.46",80,6,372,11323,0,0,4,246,2,126,125.850865,10.217828999999995,192,98
"172.16.133.20",62471,"173.194.43.39",80,6,372,11324,0,0,4,246,2,126,125.851055,10.216819999999984,192,98
"172.16.133.20",62472,"173.194.43.39",80,6,372,11325,0,0,4,246,2,126,125.851163,10.216711999999987,192,98
"172.16.133.99",56113,"172.16.139.250",5440,12,1142,11326,0,0,12,1142,0,0,125.853127,0.004937999999995668,"",""
"172.16.133.87",60277,"172.16.139.250",5440,10,1022,11327,0,0,10,1022,0,0,125.878532,0.005456999999992718,1498259,0
"172.16.133.35",50038,"172.16.139.250",5440,12,1142,11328,0,0,12,1142,0,0,125.887346,0.027323000000009756,334370,0
"172.16.133.116",53565,"172.16.139.250",5440,10,1022,11329,0,0,10,1022,0,0,125.890819,0.005087000000003172,1607234,0
"172.16.133.20",62473,"173.194.43.47",80,6,372,11330,0,0,4,246,2,126,125.894747,10.17225400000001,193,99
"172.16.133.20",62474,"173.194.43.47",80,6,372,11331,0,0,4,246,2,126,125.894931,10.173213999999987,193,99
"172.16.133.20",62475,"173.194.43.47",80,7,432,11332,0,0,4,246,3,186,125.895149,10.17304999999999,193,146
"172.16.133.20",62476,"173.194.43.47",80,6,372,11333,0,0,4,246,2,126,125.895273,10.172822999999994,193,99
"172.16.133.116",53566,"172.16.139.250",5440,10,1022,11334,0,0,10,1022,0,0,125.896897,0.00617100000000903,1324906,0
"172.16.133.116",53567,"172.16.139.250",5440,10,1022,11335,0,0,10,1022,0,0,125.904058,0.0066319999999961965,1232810,0
"172.16.133.84",58857,"172.16.139.250",5440,10,1022,11336,0,0,10,1022,0,0,125.913793,0.006239000000007877,1310466,0
"172.16.133.82",61457,"204.232.250.57",443,17,4774,11337,0,0,10,3794,7,980,125.968776,9.831318999999993,3087,797
"172.16.133.49",55860,"172.16.139.250",5440,10,1022,11338,0,0,10,1022,0,0,125.990551,0.005509000000003539,1484116,0
"172.16.133.22",53993,"184.72.243.110",80,9,882,11339,0,0,5,494,4,388,125.993235,0.08407499999999857,47005,36919
"172.16.133.95",57033,"172.16.139.250",5440,10,1022,11340,0,0,10,1022,0,0,126.03018,0.005444999999994593,1501561,0
"172.16.133.92",57747,"172.16.139.250",5440,10,1022,11341,0,0,10,1022,0,0,126.056545,0.016610000000000014,492233,0
"172.16.133.29",61019,"172.16.139.250",5440,10,1022,11342,0,0,10,1022,0,0,126.074535,0.00560199999999611,1459478,0
"172.16.133.44",64900,"172.16.139.250",5440,12,1142,11343,0,0,12,1142,0,0,126.081145,0.006422000000000594,1422609,0
"172.16.133.207",55997,"172.16.139.250",5440,12,1142,11344,0,0,12,1142,0,0,126.105617,0.01821100000000797,501674,0
"172.16.133.83",57155,"172.16.139.250",5440,12,1142,11345,0,0,12,1142,0,0,126.115178,0.0047880000000048994,"",""
"172.16.133.93",60784,"172.16.139.250",5440,10,1022,11346,0,0,10,1022,0,0,126.130938,0.004735999999994078,"",""
"172.16.133.11",55206,"172.16.139.250",5440,10,1022,11347,0,0,10,1022,0,0,126.149328,0.005774000000002388,1416002,0
"172.16.133.55",57695,"172.16.139.250",5440,10,1022,11348,0,0,10,1022,0,0,126.152781,0.01563999999999055,522762,0
"172.16.133.73",60752,"172.16.139.250",5440,10,1022,11349,0,0,10,1022,0,0,126.177967,0.005977000000001453,1367910,0
"172.16.133.53",54183,"172.16.139.250",5440,12,1142,11350,0,0,12,1142,0,0,126.178756,0.009979999999998768,915430,0
"172.16.133.21",53258,"172.16.139.250",5440,10,1022,11351,0,0,10,1022,0,0,126.18177,0.011171000000004483,731895,0
"172.16.133.30",62690,"172.16.139.250",5440,12,1142,11352,0,0,12,1142,0,0,126.185071,0.011082000000001813,824399,0
"172.16.133.25",63552,"172.16.139.250",5440,12,1142,11353,0,0,12,1142,0,0,126.194177,0.005870999999999071,1556123,0
"172.16.133.34",50503,"172.16.139.250",5440,12,1142,11354,0,0,12,1142,0,0,126.201578,0.005036000000004037,1814138,0
"172.16.133.97",59456,"172.16.139.250",5440,10,1022,11355,0,0,10,1022,0,0,126.212606,0.014434000000008496,566440,0
"172.16.133.57",60624,"157.56.242.198",443,37,14042,11356,0,0,19,4900,18,9142,126.220539,61.868247,633,1182
"172.16.133.39",64046,"91.190.216.56",12350,2,120,11357,0,0,1,60,1,60,126.281179,0.00011700000000303135,"",""
"172.16.133.33",57967,"172.16.139.250",5440,12,1142,11358,0,0,12,1142,0,0,126.285376,0.006784999999993602,1346499,0
"172.16.133.113",55642,"172.16.139.250",135,8,492,11359,0,0,8,492,0,0,126.287318,0.009157999999999333,429788,0
"172.16.133.113",55643,"172.16.139.250",5462,12,816,11360,0,0,12,816,0,0,126.29767,0.515268000000006,12669,0
"172.16.133.68",60822,"172.16.139.250",5440,10,1022,11361,0,0,10,1022,0,0,126.318168,0.01506700000000194,542642,0
"172.16.133.12",59843,"172.16.139.250",5440,12,1142,11362,0,0,12,1142,0,0,126.331818,0.006415000000004056,1424162,0
"172.16.133.63",53951,"172.16.139.250",5440,12,1142,11363,0,0,12,1142,0,0,126.342125,0.006295000000008599,1451310,0
"172.16.128.169",3862,"172.16.139.250",80,9,1229,11364,0,0,5,488,4,741,126.348983,0.28378899999999874,13756,20888
"172.16.133.66",53943,"172.16.139.250",5440,12,1142,11365,0,0,12,1142,0,0,126.355135,0.005569999999991637,1640215,0
"172.16.133.82",61458,"172.16.139.250",5440,12,1142,11366,0,0,12,1142,0,0,126.369604,0.005389000000008082,1695305,0
"172.16.133.37",60689,"172.16.139.250",5440,10,1022,11367,0,0,10,1022,0,0,126.383885,0.005432999999996468,1504877,0
"172.16.133.57",60625,"157.56.242.198",443,88,59168,11368,0,0,35,5979,53,53189,126.471808,61.617419,776,6905
"172.16.133.78",59285,"172.16.139.250",5440,12,1142,11369,0,0,12,1142,0,0,126.539992,0.0063279999999963366,1443742,0
"172.16.133.67",56055,"172.16.139.250",5440,12,1142,11370,0,0,12,1142,0,0,126.601053,0.007286000000007675,1253911,0
"172.16.133.56",61494,"172.16.139.250",5440,10,1022,11371,0,0,10,1022,0,0,126.616388,0.005221000000005915,1565983,0
"172.16.133.41",53191,"172.16.139.250",5440,10,1022,11372,0,0,10,1022,0,0,126.67204,0.008811000000008562,927930,0
"172.16.133.85",52337,"172.16.139.250",5440,10,1022,11373,0,0,10,1022,0,0,126.689925,0.005430000000004043,1505709,0
"172.16.133.73",60753,"180.153.31.250",443,6,366,11374,0,0,4,246,2,120,126.714912,0.47075900000000104,4180,2039
"172.16.133.42",57191,"172.16.139.250",5440,12,1142,11375,0,0,12,1142,0,0,126.715806,0.013623999999992975,670581,0
"172.16.133.57",60626,"157.56.242.198",443,1130,920718,11376,0,0,556,473829,574,446889,126.744757,63.68705999999999,59519,56135
"172.16.133.43",57847,"172.16.139.250",5440,10,1022,11377,0,0,10,1022,0,0,126.745682,0.005444999999994593,1501561,0
"172.16.133.13",53103,"172.16.139.250",5440,10,1022,11378,0,0,10,1022,0,0,126.761539,0.09390700000000152,87064,0
"172.16.133.20",62477,"172.16.139.250",5440,12,1142,11379,0,0,12,1142,0,0,126.810619,0.049762000000001194,183593,0
"172.16.133.75",51043,"172.16.139.250",5440,10,1022,11380,0,0,10,1022,0,0,126.827802,0.03696499999999503,221182,0
"172.16.133.28",49158,"172.16.139.250",5440,12,1142,11381,0,0,12,1142,0,0,126.84203,0.027071000000006507,337482,0
"172.16.133.99",56114,"172.16.139.250",5440,10,1022,11382,0,0,10,1022,0,0,126.867933,0.0055170000000117625,1481964,0
"172.16.133.87",60278,"172.16.139.250",5440,12,1142,11383,0,0,12,1142,0,0,126.892266,0.006336999999987825,1441691,0
"172.16.133.35",50039,"172.16.139.250",5440,12,1142,11384,0,0,12,1142,0,0,126.899716,0.008438999999995644,1082592,0
"172.16.133.116",53568,"172.16.139.250",5440,10,1022,11385,0,0,10,1022,0,0,126.905833,0.004885999999999058,"",""
"172.16.133.116",53569,"172.16.139.250",5440,12,1142,11386,0,0,12,1142,0,0,126.912016,0.006606000000004997,1382985,0
"172.16.133.116",53570,"172.16.139.250",5440,12,1142,11387,0,0,12,1142,0,0,126.91961,0.0062769999999972015,1455472,0
"172.16.133.84",58858,"172.16.139.250",5440,10,1022,11388,0,0,10,1022,0,0,126.927874,0.0055490000000020245,1473418,0
"172.16.133.49",55861,"172.16.139.250",5440,12,1142,11389,0,0,12,1142,0,0,127.004416,0.01706699999999728,535302,0
"172.16.133.95",57034,"172.16.139.250",5440,12,1142,11390,0,0,12,1142,0,0,127.043666,0.0131279999999947,695917,0
"172.16.133.92",57748,"172.16.139.250",5440,10,1022,11391,0,0,10,1022,0,0,127.07069,0.015113999999996963,540955,0
"172.16.133.29",61020,"172.16.139.250",5440,10,1022,11392,0,0,10,1022,0,0,127.089857,0.015202999999999633,537788,0
"172.16.133.44",64901,"172.16.139.250",5440,12,1142,11393,0,0,12,1142,0,0,127.095017,0.016225000000005707,563081,0
"172.16.133.207",55998,"172.16.139.250",5440,12,1142,11394,0,0,12,1142,0,0,127.119841,0.018461999999999534,494854,0
"172.16.133.83",57156,"172.16.139.250",5440,12,1142,11395,0,0,12,1142,0,0,127.129332,0.005027999999995814,1817024,0
"172.16.133.93",60785,"172.16.139.250",5440,12,1142,11396,0,0,12,1142,0,0,127.146331,0.005132000000003245,1780202,0
"172.16.133.11",55207,"172.16.139.250",5440,10,1022,11397,0,0,10,1022,0,0,127.16228,0.015405999999998699,530702,0
"172.16.133.87",60279,"74.125.226.67",443,14,3567,11398,0,0,8,969,6,2598,127.165185,0.3156420000000111,24559,65846
"172.16.133.87",60280,"74.125.226.67",443,14,3567,11399,0,0,8,969,6,2598,127.165368,0.3157939999999968,24547,65815
"172.16.133.87",60281,"74.125.226.67",443,14,3567,11400,0,0,8,969,6,2598,127.165503,0.3154859999999928,24571,65879
"172.16.133.87",60282,"74.125.226.67",443,14,3567,11401,0,0,8,969,6,2598,127.165649,0.31567300000000387,24557,65840
"172.16.133.87",60283,"74.125.226.70",443,5080,4425034,11402,0,0,1438,168412,3642,4256622,127.165882,157.27452399999999,8566,216519
"172.16.133.87",60284,"74.125.226.70",443,14,3567,11403,0,0,8,969,6,2598,127.166003,0.31453499999999224,24645,66078
"172.16.133.87",60285,"74.125.226.70",443,14,3567,11404,0,0,8,969,6,2598,127.166124,0.313839999999999,24700,66224
"172.16.133.87",60286,"74.125.226.70",443,15,3822,11405,0,0,9,1224,6,2598,127.166243,8.760263999999992,1117,2372
"172.16.133.87",60287,"74.125.226.70",443,14,3567,11406,0,0,8,969,6,2598,127.166377,0.3138110000000012,24702,66230
"172.16.133.87",60288,"74.125.226.70",443,15,3627,11407,0,0,8,969,7,2658,127.166505,0.35009900000000016,22142,60737
"172.16.133.55",57696,"172.16.139.250",5440,10,1022,11408,0,0,10,1022,0,0,127.167688,0.005554000000003612,1472092,0
"172.16.133.87",60289,"74.125.226.14",443,14,3567,11409,0,0,8,969,6,2598,127.178492,8.747132999999991,886,2376
"172.16.133.87",60290,"74.125.226.14",443,14,3567,11410,0,0,8,969,6,2598,127.178625,8.74673,886,2376
"172.16.133.87",60291,"74.125.226.14",443,1635,1386021,11411,0,0,495,55596,1140,1330425,127.178753,157.207731,2829,67702
"172.16.133.87",60292,"74.125.226.67",443,14,3567,11412,0,0,8,969,6,2598,127.178938,0.30255499999999813,25621,68694
"172.16.133.87",60293,"74.125.226.67",443,14,3567,11413,0,0,8,969,6,2598,127.179063,8.747017000000014,886,2376
"172.16.133.87",60294,"74.125.226.67",443,14,3567,11414,0,0,8,969,6,2598,127.179185,0.30252299999999366,25624,68702
"172.16.133.87",60295,"74.125.226.67",443,14,3567,11415,0,0,8,969,6,2598,127.17931,0.3025559999999956,25621,68694
"172.16.133.87",60296,"74.125.226.67",443,14,3567,11416,0,0,8,969,6,2598,127.17943,8.746869000000004,886,2376
"172.16.133.87",60297,"74.125.226.67",443,14,3567,11417,0,0,8,969,6,2598,127.179548,8.746293999999992,886,2376
"172.16.133.73",60754,"172.16.139.250",5440,10,1022,11418,0,0,10,1022,0,0,127.190224,0.00588000000000477,1390476,0
"172.16.133.53",54184,"172.16.139.250",5440,10,1022,11419,0,0,10,1022,0,0,127.192852,0.007104999999995698,1150738,0
"172.16.133.21",53259,"172.16.139.250",5440,10,1022,11420,0,0,10,1022,0,0,127.19591,0.008064000000004512,1013888,0
"172.16.133.30",62692,"172.16.139.250",5440,10,1022,11421,0,0,10,1022,0,0,127.199635,0.008137000000004946,1004792,0
"172.16.133.25",63553,"172.16.139.250",5440,10,1022,11422,0,0,10,1022,0,0,127.207314,0.016749000000004344,488148,0
"172.16.133.34",50504,"172.16.139.250",5440,10,1022,11423,0,0,10,1022,0,0,127.21559,0.0048799999999999955,"",""
"172.16.133.97",59457,"172.16.139.250",5440,12,1142,11424,0,0,12,1142,0,0,127.22651,0.015395999999995524,593400,0
"172.16.133.87",60298,"74.125.226.14",443,7,432,11425,0,0,4,246,3,186,127.267179,18.059807000000006,108,82
"172.16.133.56",61495,"216.52.242.80",80,12,2858,11426,0,0,9,2213,3,645,127.292069,135.224096,130,38
"172.16.133.33",57968,"172.16.139.250",5440,10,1022,11427,0,0,10,1022,0,0,127.299042,0.005540999999993801,1475545,0
"172.16.133.68",60823,"172.16.139.250",5440,10,1022,11428,0,0,10,1022,0,0,127.333562,0.02109899999999243,387506,0
"172.16.133.12",59844,"172.16.139.250",5440,12,1142,11429,0,0,12,1142,0,0,127.345745,0.022663000000008537,403124,0
"172.16.133.184",42937,"96.43.146.178",443,7,482,11430,0,0,4,272,3,210,127.349137,0.09374700000000757,23211,17920
"172.16.133.97",59458,"172.16.139.250",5440,12,1142,11431,0,0,12,1142,0,0,127.351779,0.007569000000003712,1207028,0
"172.16.133.63",53952,"172.16.139.250",5440,10,1022,11432,0,0,10,1022,0,0,127.355624,0.006840999999994324,1195146,0
"172.16.133.66",53944,"172.16.139.250",5440,12,1142,11433,0,0,12,1142,0,0,127.369021,0.006404000000003407,1426608,0
"172.16.133.97",59459,"96.43.146.176",443,16,2510,11434,0,0,9,1597,7,913,127.375302,94.085721,135,77
"172.16.133.82",61459,"172.16.139.250",5440,12,1142,11435,0,0,12,1142,0,0,127.383353,0.016859999999994102,541874,0
"172.16.133.37",60690,"172.16.139.250",5440,10,1022,11436,0,0,10,1022,0,0,127.396707,0.007371999999989498,1109061,0
"172.16.133.184",55257,"204.14.235.101",443,7,482,11437,0,0,4,272,3,210,127.446224,0.19147499999999695,11364,8773
"172.16.133.78",59286,"172.16.139.250",5440,12,1142,11438,0,0,12,1142,0,0,127.553852,0.0065209999999922275,1401012,0
"172.16.133.67",56058,"172.16.139.250",5440,12,1142,11439,0,0,12,1142,0,0,127.607291,0.006315999999998212,1446485,0
"172.16.133.87",60299,"74.125.226.70",443,434,88600,11440,0,0,215,48454,219,40146,127.620135,156.565538,2475,2051
"172.16.133.56",61496,"172.16.139.250",5440,12,1142,11441,0,0,12,1142,0,0,127.631447,0.0051480000000054815,1774669,0
"172.16.133.184",45605,"96.43.146.176",443,9,614,11442,0,0,5,338,4,276,127.641398,1.3087950000000177,2066,1687
"172.16.133.41",53192,"172.16.139.250",5440,10,1022,11443,0,0,10,1022,0,0,127.686556,0.005920000000003256,1381081,0
"172.16.133.41",53193,"78.108.118.250",443,6,366,11444,0,0,4,246,2,120,127.702694,0.2226140000000072,8840,4312
"172.16.133.85",52338,"172.16.139.250",5440,12,1142,11445,0,0,12,1142,0,0,127.703571,0.01542100000000346,592438,0
"172.16.133.41",53194,"216.219.118.244",443,6,366,11446,0,0,4,246,2,120,127.704378,0.2217989999999901,8872,4328
"172.16.133.41",53195,"216.115.219.126",443,6,366,11447,0,0,4,246,2,120,127.705293,0.5005000000000024,3932,1918
"172.16.133.42",57192,"172.16.139.250",5440,12,1142,11448,0,0,12,1142,0,0,127.70856,0.014483999999995945,630764,0
"172.16.133.41",53196,"68.64.24.250",443,7,426,11449,0,0,5,306,2,120,127.713416,0.40646300000000224,6022,2361
"172.16.133.43",57848,"172.16.139.250",5440,12,1142,11450,0,0,12,1142,0,0,127.757549,0.006229000000004703,1466688,0
"172.16.133.184",41517,"66.235.146.171",443,8,556,11451,0,0,5,346,3,210,127.758463,1.0571039999999812,2618,1589
"172.16.133.13",53104,"172.16.139.250",5440,10,1022,11452,0,0,10,1022,0,0,127.775502,0.005343999999993798,1529940,0
"172.16.133.20",62478,"172.16.139.250",5440,12,1142,11453,0,0,12,1142,0,0,127.824687,0.004844000000005622,"",""
"172.16.133.75",51044,"172.16.139.250",5440,10,1022,11454,0,0,10,1022,0,0,127.84185,0.00533500000000231,1532521,0
"172.16.133.28",49161,"172.16.139.250",5440,12,1142,11455,0,0,12,1142,0,0,127.854974,0.006127000000006433,1491104,0
"172.16.133.99",56115,"172.16.139.250",5440,10,1022,11456,0,0,10,1022,0,0,127.881408,0.01495200000000807,546816,0
"172.16.133.87",60300,"172.16.139.250",5440,8,902,11457,0,0,8,902,0,0,127.90599,0.006191999999998643,1165374,0
"172.16.133.35",50040,"172.16.139.250",5440,12,1142,11458,0,0,12,1142,0,0,127.913718,0.007942999999997369,1150195,0
"172.16.133.116",53571,"172.16.139.250",5440,10,1022,11459,0,0,10,1022,0,0,127.919612,0.005261000000004401,1554077,0
"172.16.133.116",53572,"172.16.139.250",5440,10,1022,11460,0,0,10,1022,0,0,127.925395,0.005465000000000941,1496065,0
"172.16.133.116",53573,"172.16.139.250",5440,10,1022,11461,0,0,10,1022,0,0,127.931468,0.005384000000006495,1518573,0
"172.16.133.84",58859,"172.16.139.250",5440,10,1022,11462,0,0,10,1022,0,0,127.941753,0.009283999999993853,880654,0
"172.16.133.56",61497,"208.111.161.254",80,17,5963,11463,0,0,8,919,9,5044,127.977162,33.837891,217,1192
"172.16.133.56",61498,"208.111.161.254",80,13,3364,11464,0,0,6,788,7,2576,127.979542,33.835615000000004,186,609
"172.16.133.49",55862,"172.16.139.250",5440,10,1022,11465,0,0,10,1022,0,0,128.019658,0.01580800000002114,517206,0
"172.16.133.95",57035,"172.16.139.250",5440,10,1022,11466,0,0,10,1022,0,0,128.058032,0.005444000000011329,1501836,0
"172.16.133.92",57749,"172.16.139.250",5440,12,1142,11467,0,0,12,1142,0,0,128.084714,0.005666000000019267,1612424,0
"172.16.133.29",61021,"172.16.139.250",5440,10,1022,11468,0,0,10,1022,0,0,128.102478,0.005400000000008731,1514074,0
"172.16.133.44",64902,"172.16.139.250",5440,10,1022,11469,0,0,10,1022,0,0,128.10917,0.005716000000006716,1430370,0
"172.16.133.207",55999,"172.16.139.250",5440,12,1142,11470,0,0,12,1142,0,0,128.133678,0.018202999999999747,501895,0
"172.16.133.83",57157,"172.16.139.250",5440,12,1142,11471,0,0,12,1142,0,0,128.143253,0.004737000000005764,"",""
"172.16.133.93",60786,"172.16.139.250",5440,10,1022,11472,0,0,10,1022,0,0,128.159033,0.004693000000003167,"",""
"172.16.133.11",55208,"172.16.139.250",5440,10,1022,11473,0,0,10,1022,0,0,128.176451,0.005546000000009599,1474215,0
"172.16.133.55",57697,"172.16.139.250",5440,12,1142,11474,0,0,12,1142,0,0,128.180656,0.00624899999999684,1461993,0
"172.16.133.73",60755,"172.16.139.250",5440,10,1022,11475,0,0,10,1022,0,0,128.204912,0.005498999999986154,1486815,0
"172.16.133.53",54185,"172.16.139.250",5440,10,1022,11476,0,0,10,1022,0,0,128.206589,0.0077749999999809916,1051575,0
"172.16.133.21",53260,"172.16.139.250",5440,10,1022,11477,0,0,10,1022,0,0,128.208902,0.009372000000013259,872385,0
"172.16.133.30",62693,"172.16.139.250",5440,10,1022,11478,0,0,10,1022,0,0,128.21329,0.008866000000011809,922174,0
"172.16.133.25",63554,"172.16.139.250",5440,12,1142,11479,0,0,12,1142,0,0,128.222438,0.005038999999982252,1813058,0
"172.16.133.34",50505,"172.16.139.250",5440,12,1142,11480,0,0,12,1142,0,0,128.23045,0.005174000000010892,1765751,0
"172.16.133.97",59460,"172.16.139.250",5440,10,1022,11481,0,0,10,1022,0,0,128.239634,0.005371999999994159,1521965,0
"172.16.133.33",57969,"172.16.139.250",5440,10,1022,11482,0,0,10,1022,0,0,128.313094,0.0057879999999954634,1412577,0
"172.16.133.68",60824,"172.16.139.250",5440,12,1142,11483,0,0,12,1142,0,0,128.346304,0.015531000000009954,588242,0
"172.16.133.12",59845,"172.16.139.250",5440,12,1142,11484,0,0,12,1142,0,0,128.359999,0.01633100000000809,559426,0
"172.16.133.63",53953,"172.16.139.250",5440,12,1142,11485,0,0,12,1142,0,0,128.369477,0.010337000000021135,883815,0
"172.16.133.66",53945,"172.16.139.250",5440,12,1142,11486,0,0,12,1142,0,0,128.383127,0.0061709999999948195,1480473,0
"172.16.133.82",61460,"172.16.139.250",5440,12,1142,11487,0,0,12,1142,0,0,128.397866,0.01935299999999529,472071,0
"172.16.133.37",60691,"172.16.139.250",5440,10,1022,11488,0,0,10,1022,0,0,128.4108,0.009609000000011747,850868,0
"172.16.133.121",56540,"96.43.146.49",443,65,25876,11489,0,0,34,11373,31,14503,128.532123,6.158908999999994,14772,18838
"172.16.133.78",59287,"172.16.139.250",5440,10,1022,11490,0,0,10,1022,0,0,128.568112,0.015402999999992062,530805,0
"172.16.133.67",56059,"172.16.139.250",5440,12,1142,11491,0,0,12,1142,0,0,128.621132,0.015328000000010888,596033,0
"172.16.133.56",61499,"172.16.139.250",5440,12,1142,11492,0,0,12,1142,0,0,128.644325,0.005929999999978008,1540640,0
"172.16.133.41",53197,"172.16.139.250",5440,10,1022,11493,0,0,10,1022,0,0,128.701775,0.005391000000003032,1516601,0
"172.16.133.85",52339,"172.16.139.250",5440,10,1022,11494,0,0,10,1022,0,0,128.716544,0.005261999999987665,1553781,0
"172.16.133.42",57193,"172.16.139.250",5440,12,1142,11495,0,0,12,1142,0,0,128.747987,0.04665099999999711,195837,0
"172.16.133.43",57849,"172.16.139.250",5440,10,1022,11496,0,0,10,1022,0,0,128.771043,0.005584999999996398,1463921,0
"172.16.133.13",53105,"172.16.139.250",5440,10,1022,11497,0,0,10,1022,0,0,128.790427,0.005400000000008731,1514074,0
"172.16.133.184",42398,"70.42.13.101",443,6,374,11498,0,0,4,254,2,120,128.817646,0.04881399999999303,41627,19666
"172.16.133.20",62479,"172.16.139.250",5440,10,1022,11499,0,0,10,1022,0,0,128.83903,0.004968999999988455,"",""
"172.16.133.75",51045,"172.16.139.250",5440,10,1022,11500,0,0,10,1022,0,0,128.856199,0.005244000000004689,1559115,0
"172.16.133.28",49162,"172.16.139.250",5440,10,1022,11501,0,0,10,1022,0,0,128.869105,0.007137999999997646,1145418,0
"172.16.133.24",57699,"172.16.139.250",5440,10,1020,11502,0,0,10,1020,0,0,128.878374,120.01078999999999,67,0
"172.16.133.99",56116,"172.16.139.250",5440,10,1022,11503,0,0,10,1022,0,0,128.895374,0.018003999999990583,454121,0
"172.16.133.184",48536,"23.33.47.60",443,6,412,11504,0,0,4,272,2,140,128.90041,0.05758600000001479,37786,19449
"172.16.133.87",60301,"172.16.139.250",5440,12,1142,11505,0,0,12,1142,0,0,128.920221,0.006710999999995693,1361347,0
"172.16.133.35",50041,"172.16.139.250",5440,12,1142,11506,0,0,12,1142,0,0,128.930531,0.010941000000002532,835024,0
"172.16.133.55",57698,"172.16.128.169",8014,14,4838,11507,0,0,7,2018,7,2820,128.930701,37.703101000000004,428,598
"172.16.133.116",53574,"172.16.139.250",5440,10,1022,11508,0,0,10,1022,0,0,128.933101,0.008488999999997304,963128,0
"172.16.133.116",53575,"172.16.139.250",5440,10,1022,11509,0,0,10,1022,0,0,128.942559,0.005536000000006425,1476878,0
"172.16.133.116",53576,"172.16.139.250",5440,10,1022,11510,0,0,10,1022,0,0,128.949244,0.005049000000013848,1619330,0
"172.16.133.84",58860,"172.16.139.250",5440,12,1142,11511,0,0,12,1142,0,0,128.956795,0.01520400000001132,600894,0
"172.16.133.184",46642,"96.43.148.26",443,7,482,11512,0,0,4,272,3,210,128.958906,0.05410799999998517,40215,31049
"172.16.133.49",55863,"172.16.139.250",5440,10,1022,11513,0,0,10,1022,0,0,129.032541,0.0066319999999961965,1232810,0
"172.16.133.95",57036,"172.16.139.250",5440,12,1142,11514,0,0,12,1142,0,0,129.072857,0.015298000000001366,597202,0
"172.16.133.92",57750,"172.16.139.250",5440,10,1022,11515,0,0,10,1022,0,0,129.098596,0.005675000000024966,1440704,0
"172.16.133.29",61022,"172.16.139.250",5440,10,1022,11516,0,0,10,1022,0,0,129.116773,0.015811000000013564,517108,0
"172.16.133.44",64903,"172.16.139.250",5440,10,1022,11517,0,0,10,1022,0,0,129.123307,0.005505999999996902,1484925,0
"172.16.133.207",56000,"172.16.139.250",5440,10,1022,11518,0,0,10,1022,0,0,129.147642,0.004987999999997328,"",""
"172.16.133.83",57158,"172.16.139.250",5440,12,1142,11519,0,0,12,1142,0,0,129.157207,0.013838999999990165,660163,0
"172.16.133.93",60787,"172.16.139.250",5440,10,1022,11520,0,0,10,1022,0,0,129.17295,0.004695000000026539,"",""
"172.16.133.11",55209,"172.16.139.250",5440,10,1022,11521,0,0,10,1022,0,0,129.191574,0.00575399999999604,1420924,0
"172.16.133.55",57699,"172.16.139.250",5440,10,1022,11522,0,0,10,1022,0,0,129.195515,0.006752000000005864,1210900,0
"172.16.133.128",65047,"23.0.49.244",80,14,3708,11523,0,0,7,1152,7,2556,129.195751,135.24698600000002,68,151
"172.16.133.73",60756,"172.16.139.250",5440,12,1142,11524,0,0,12,1142,0,0,129.217622,0.006864000000007309,1331002,0
"172.16.133.53",54186,"172.16.139.250",5440,10,1022,11525,0,0,10,1022,0,0,129.22056,0.0070509999999899264,1159551,0
"172.16.133.21",53261,"172.16.139.250",5440,10,1022,11526,0,0,10,1022,0,0,129.223725,0.014959000000004608,546560,0
"172.16.133.30",62694,"172.16.139.250",5440,10,1022,11527,0,0,10,1022,0,0,129.226505,0.01604199999999878,509662,0
"172.16.133.25",63555,"172.16.139.250",5440,12,1142,11528,0,0,12,1142,0,0,129.235382,0.010915000000011332,837013,0
"172.16.133.34",50506,"172.16.139.250",5440,10,1022,11529,0,0,10,1022,0,0,129.243565,0.006446000000011054,1268383,0
"172.16.133.97",59461,"172.16.139.250",5440,10,1022,11530,0,0,10,1022,0,0,129.253861,0.005369999999999209,1522532,0
"172.16.133.128",65048,"23.0.49.244",80,14,3727,11531,0,0,7,1152,7,2575,129.280281,96.40868499999999,95,213
"172.16.133.128",65049,"23.0.49.244",80,14,4070,11532,0,0,7,1152,7,2918,129.280979,135.27547600000003,68,172
"172.16.133.128",65050,"23.0.49.244",80,14,4006,11533,0,0,7,1152,7,2854,129.281423,135.25234500000002,68,168
"172.16.133.128",65051,"23.0.49.244",80,14,3192,11534,0,0,7,1152,7,2040,129.281732,96.407232,95,169
"172.16.133.33",57970,"172.16.139.250",5440,12,1142,11535,0,0,12,1142,0,0,129.327244,0.00646199999999908,1413803,0
"172.16.133.68",60825,"172.16.139.250",5440,10,1022,11536,0,0,10,1022,0,0,129.360358,0.014866000000012036,549979,0
"172.16.133.12",59846,"172.16.139.250",5440,10,1022,11537,0,0,10,1022,0,0,129.373994,0.005474999999989905,1493333,0
"172.16.133.63",53954,"172.16.139.250",5440,10,1022,11538,0,0,10,1022,0,0,129.383749,0.005392999999997983,1516039,0
"172.16.133.66",53946,"172.16.139.250",5440,10,1022,11539,0,0,10,1022,0,0,129.397549,0.0053269999999940865,1534822,0
"172.16.133.82",61461,"172.16.139.250",5440,10,1022,11540,0,0,10,1022,0,0,129.412106,0.006316999999995687,1294285,0
"172.16.133.37",60692,"172.16.139.250",5440,12,1142,11541,0,0,12,1142,0,0,129.426195,0.006247999999999365,1462227,0
"172.16.133.78",59288,"172.16.139.250",5440,10,1022,11542,0,0,10,1022,0,0,129.582096,0.0055569999999818265,1471297,0
"172.16.133.67",56060,"172.16.139.250",5440,10,1022,11543,0,0,10,1022,0,0,129.635176,0.0053959999999904085,1515196,0
"172.16.133.56",61500,"172.16.139.250",5440,10,1022,11544,0,0,10,1022,0,0,129.658259,0.00471200000001204,"",""
"172.16.133.41",53198,"172.16.139.250",5440,12,1142,11545,0,0,12,1142,0,0,129.714093,0.006273000000021511,1456400,0
"172.16.133.85",52340,"172.16.139.250",5440,10,1022,11546,0,0,10,1022,0,0,129.730951,0.005432999999982258,1504877,0
"172.16.133.42",57194,"172.16.139.250",5440,12,1142,11547,0,0,12,1142,0,0,129.749077,0.0353059999999914,258766,0
"172.16.133.41",53199,"68.64.24.250",443,6,366,11548,0,0,4,246,2,120,129.768795,0.1027729999999849,19148,9340
"172.16.133.43",57850,"172.16.139.250",5440,12,1142,11549,0,0,12,1142,0,0,129.785405,0.006220000000013215,1468810,0
"172.16.133.13",53106,"172.16.139.250",5440,10,1022,11550,0,0,10,1022,0,0,129.803419,0.015313000000020338,533925,0
"172.16.133.41",53200,"78.108.118.250",443,6,366,11551,0,0,4,246,2,120,129.816736,0.25270399999999427,7787,3798
"172.16.133.41",53201,"216.219.118.244",443,6,366,11552,0,0,4,246,2,120,129.817176,0.2545810000000017,7730,3770
"172.16.133.20",62480,"172.16.139.250",5440,12,1142,11553,0,0,12,1142,0,0,129.852662,0.004988999999994803,"",""
"172.16.133.75",51046,"172.16.139.250",5440,10,1022,11554,0,0,10,1022,0,0,129.868896,0.014859000000001288,550238,0
"172.16.133.28",49163,"172.16.139.250",5440,10,1022,11555,0,0,10,1022,0,0,129.884293,0.0202369999999803,404012,0
"172.16.133.99",56117,"172.16.139.250",5440,10,1022,11556,0,0,10,1022,0,0,129.909758,0.014380999999985988,568527,0
"172.16.133.87",60303,"172.16.139.250",5440,10,1022,11557,0,0,10,1022,0,0,129.933673,0.015328000000010888,533402,0
"172.16.133.116",53577,"172.16.139.250",5440,10,1022,11558,0,0,10,1022,0,0,129.946921,0.006805999999983214,1201292,0
"172.16.133.35",50042,"172.16.139.250",5440,12,1142,11559,0,0,12,1142,0,0,129.953837,0.03271499999999605,279260,0
"172.16.133.116",53578,"172.16.139.250",5440,10,1022,11560,0,0,10,1022,0,0,129.954787,0.005140999999980522,1590352,0
"172.16.133.116",53579,"172.16.139.250",5440,10,1022,11561,0,0,10,1022,0,0,129.960827,0.005317000000019334,1537709,0
"172.16.133.41",53202,"216.115.219.126",443,7,426,11562,0,0,4,246,3,180,129.961817,28.917498999999992,68,49
"172.16.133.84",58861,"172.16.139.250",5440,12,1142,11563,0,0,12,1142,0,0,129.969941,0.007581999999985101,1204959,0
"172.16.133.49",55864,"172.16.139.250",5440,10,1022,11564,0,0,10,1022,0,0,130.046285,0.005746999999985292,1422655,0
"172.16.133.95",57037,"172.16.139.250",5440,10,1022,11565,0,0,10,1022,0,0,130.086785,0.00543500000000563,1504323,0
"172.16.133.92",57751,"172.16.139.250",5440,10,1022,11566,0,0,10,1022,0,0,130.113361,0.0146349999999984,558660,0
"172.16.133.29",61023,"172.16.139.250",5440,10,1022,11567,0,0,10,1022,0,0,130.129912,0.0049080000000003565,"",""
"172.16.133.44",64904,"172.16.139.250",5440,10,1022,11568,0,0,10,1022,0,0,130.137222,0.005416999999994232,1509322,0
"172.16.133.207",56001,"172.16.139.250",5440,12,1142,11569,0,0,12,1142,0,0,130.161828,0.014586999999977479,626311,0
"172.16.133.83",57159,"172.16.139.250",5440,12,1142,11570,0,0,12,1142,0,0,130.172366,0.007825999999994337,1167390,0
"172.16.133.40",50219,"202.173.27.250",443,8,486,11571,0,0,5,306,3,180,130.186294,1.5220229999999901,1608,946
"172.16.133.40",50218,"216.219.120.244",443,6,366,11572,0,0,4,246,2,120,130.186522,0.17324500000000853,11359,5541
"172.16.133.40",50220,"216.115.217.254",443,6,366,11573,0,0,4,246,2,120,130.187821,0.058201999999994314,33813,16494
"172.16.133.93",60788,"172.16.139.250",5440,12,1142,11574,0,0,12,1142,0,0,130.188233,0.005489000000011401,1664419,0
"172.16.133.11",55210,"172.16.139.250",5440,10,1022,11575,0,0,10,1022,0,0,130.204546,0.005966999999998279,1370202,0
"172.16.133.55",57700,"172.16.139.250",5440,10,1022,11576,0,0,10,1022,0,0,130.209179,0.005634999999983847,1450931,0
"172.16.133.40",50221,"216.115.220.254",443,6,366,11577,0,0,4,246,2,120,130.212642,0.6332629999999995,3107,1515
"172.16.133.73",60757,"172.16.139.250",5440,10,1022,11578,0,0,10,1022,0,0,130.231869,0.005420000000015079,1508487,0
"172.16.133.53",54187,"172.16.139.250",5440,10,1022,11579,0,0,10,1022,0,0,130.235738,0.005553999999989401,1472092,0
"172.16.133.21",53262,"172.16.139.250",5440,10,1022,11580,0,0,10,1022,0,0,130.237844,0.014923000000010234,547879,0
"172.16.133.30",62695,"172.16.139.250",5440,10,1022,11581,0,0,10,1022,0,0,130.242691,0.017688999999990074,462208,0
"172.16.133.25",63556,"172.16.139.250",5440,12,1142,11582,0,0,12,1142,0,0,130.249569,0.007240999999993392,1261704,0
"172.16.133.34",50507,"172.16.139.250",5440,12,1142,11583,0,0,12,1142,0,0,130.257773,0.006776000000002114,1348288,0
"172.16.133.97",59462,"172.16.139.250",5440,10,1022,11584,0,0,10,1022,0,0,130.267554,0.006289000000009537,1300047,0
"172.16.133.121",56541,"54.241.29.133",80,15,3078,11585,0,0,8,1926,7,1152,130.281108,63.80673300000001,241,144
"172.16.133.33",57971,"172.16.139.250",5440,10,1022,11586,0,0,10,1022,0,0,130.341134,0.005539999999996326,1475812,0
"172.16.133.68",60826,"172.16.139.250",5440,10,1022,11587,0,0,10,1022,0,0,130.374609,0.01552499999999668,526634,0
"172.16.133.12",59847,"172.16.139.250",5440,10,1022,11588,0,0,10,1022,0,0,130.388784,0.006050000000016098,1351404,0
"172.16.133.63",53955,"172.16.139.250",5440,10,1022,11589,0,0,10,1022,0,0,130.398342,0.0053499999999928605,1528224,0
"172.16.133.66",53947,"172.16.139.250",5440,10,1022,11590,0,0,10,1022,0,0,130.411109,0.005434999999977208,1504323,0
"172.16.133.82",61463,"172.16.139.250",5440,10,1022,11591,0,0,10,1022,0,0,130.424968,0.005658999999980097,1444778,0
"172.16.133.37",60693,"172.16.139.250",5440,10,1022,11592,0,0,10,1022,0,0,130.438617,0.01589000000001306,514537,0
"172.16.133.121",56542,"54.241.29.133",80,7,438,11593,0,0,5,312,2,126,130.505862,13.53277399999999,184,74
"172.16.133.121",56543,"54.241.29.133",80,7,438,11594,0,0,5,312,2,126,130.50679,13.53209799999999,184,74
"172.16.133.121",56544,"54.241.29.133",80,235,233430,11595,0,0,73,20554,162,212876,130.507236,63.584923,2586,26783
"172.16.133.121",56545,"54.241.29.133",80,184,164468,11596,0,0,70,18397,114,146071,130.507673,63.58409799999998,2314,18378
"172.16.133.121",56546,"54.241.29.133",80,237,223080,11597,0,0,76,23993,161,199087,130.508053,63.58371500000001,3018,25048
"172.16.133.121",56547,"173.252.100.27",80,7,432,11598,0,0,4,246,3,186,130.508768,13.497706999999991,145,110
"172.16.133.121",56548,"173.252.100.27",80,23,10629,11599,0,0,9,1797,14,8832,130.509243,123.46370200000001,116,572
"172.16.133.121",56549,"74.125.226.207",443,14,4029,11600,0,0,8,958,6,3071,130.510175,2.5916579999999954,2957,9479
"172.16.133.121",56550,"54.241.29.133",443,22,4742,11601,0,0,11,1173,11,3569,130.51088,72.679516,129,392
"172.16.133.121",56551,"54.241.29.133",443,21,4682,11602,0,0,11,1173,10,3509,130.51134,72.678866,129,386
"172.16.133.121",56552,"54.241.29.133",443,22,4742,11603,0,0,11,1173,11,3569,130.511789,72.67974900000002,129,392
"172.16.133.121",56553,"54.241.29.133",443,22,4742,11604,0,0,11,1173,11,3569,130.512265,72.67916699999998,129,392
"172.16.133.121",56554,"54.241.29.133",443,21,4682,11605,0,0,11,1173,10,3509,130.512824,72.677277,129,386
"172.16.133.121",56555,"54.241.29.133",443,22,4742,11606,0,0,11,1173,11,3569,130.51328,72.67794799999999,129,392
"172.16.133.121",56556,"173.252.100.27",443,8,498,11607,0,0,5,312,3,186,130.51389,13.468515999999994,185,110
"172.16.133.78",59289,"172.16.139.250",5440,12,1142,11608,0,0,12,1142,0,0,130.594856,0.0063279999999963366,1443742,0
"172.16.133.67",56061,"172.16.139.250",5440,10,1022,11609,0,0,10,1022,0,0,130.649222,0.006477999999987105,1262117,0
"172.16.133.121",56557,"107.22.194.87",80,14,2144,11610,0,0,7,1176,7,968,130.65832,63.30702099999999,148,122
"172.16.133.121",56558,"107.22.194.87",80,14,2162,11611,0,0,7,1194,7,968,130.658826,63.306207,150,122
"172.16.133.121",56559,"107.22.194.87",80,14,2162,11612,0,0,7,1194,7,968,130.659221,63.30600899999999,150,122
"172.16.133.121",56560,"23.23.107.148",80,19,5627,11613,0,0,11,4585,8,1042,130.65968,63.308131,579,131
"172.16.133.121",56561,"23.23.107.148",80,6,366,11614,0,0,4,246,2,120,130.660089,13.314806000000004,147,72
"172.16.133.121",56562,"208.47.254.26",80,6,372,11615,0,0,4,246,2,126,130.660507,13.314078999999992,147,75
"172.16.133.121",56563,"208.47.254.26",80,7,432,11616,0,0,4,246,3,186,130.6624,13.312328000000008,147,111
"172.16.133.121",56564,"208.47.254.26",80,6,372,11617,0,0,4,246,2,126,130.662864,13.312707999999986,147,75
"172.16.133.56",61501,"172.16.139.250",5440,12,1142,11618,0,0,12,1142,0,0,130.672514,0.007578999999992675,1205436,0
"172.16.133.41",53203,"172.16.139.250",5440,10,1022,11619,0,0,10,1022,0,0,130.729189,0.0056000000000153705,1459999,0
"172.16.133.85",52341,"172.16.139.250",5440,10,1022,11620,0,0,10,1022,0,0,130.744505,0.014667000000002872,557441,0
"172.16.133.42",57195,"172.16.139.250",5440,12,1142,11621,0,0,12,1142,0,0,130.760816,0.009743999999983544,937602,0
"172.16.133.121",56565,"173.252.100.27",443,28,4253,11622,0,0,13,2449,15,1804,130.764242,122.05043900000001,160,118
"172.16.133.43",57851,"172.16.139.250",5440,10,1022,11623,0,0,10,1022,0,0,130.79793,0.00547599999998738,1493060,0
"172.16.133.113",55644,"172.16.139.250",135,8,492,11624,0,0,8,492,0,0,130.816847,0.013183999999995422,298543,0
"172.16.133.13",53107,"172.16.139.250",5440,10,1022,11625,0,0,10,1022,0,0,130.817391,0.015815000000003465,516977,0
"172.16.133.113",55645,"172.16.139.250",5462,12,816,11626,0,0,12,816,0,0,130.831684,0.5251260000000002,12431,0
"172.16.133.20",62481,"172.16.139.250",5440,12,1142,11627,0,0,12,1142,0,0,130.868082,0.014243000000021766,641437,0
"172.16.133.75",51047,"172.16.139.250",5440,10,1022,11628,0,0,10,1022,0,0,130.884138,0.015675999999984924,521561,0
"172.16.133.28",49164,"172.16.139.250",5440,12,1142,11629,0,0,12,1142,0,0,130.896093,0.008155999999985397,1120156,0
"172.16.133.99",56118,"172.16.139.250",5440,10,1022,11630,0,0,10,1022,0,0,130.923888,0.014402999999987287,567659,0
"172.16.133.87",60304,"172.16.139.250",5440,10,1022,11631,0,0,10,1022,0,0,130.947396,0.005698999999992793,1434637,0
"172.16.133.78",59290,"172.16.128.169",8014,9,1412,11632,0,0,6,1050,3,362,130.947639,15.201782999999978,552,190
"172.16.133.35",50043,"172.16.139.250",5440,12,1142,11633,0,0,12,1142,0,0,130.958808,0.024233000000009497,377006,0
"172.16.133.116",53580,"172.16.139.250",5440,10,1022,11634,0,0,10,1022,0,0,130.961808,0.008067000000011149,1013511,0
"172.16.133.116",53581,"172.16.139.250",5440,10,1022,11635,0,0,10,1022,0,0,130.970868,0.00524599999999964,1558520,0
"172.16.133.116",53582,"172.16.139.250",5440,10,1022,11636,0,0,10,1022,0,0,130.977019,0.015143999999992275,539883,0
"172.16.133.84",58862,"172.16.139.250",5440,12,1142,11637,0,0,12,1142,0,0,130.982818,0.0062669999999798165,1457794,0
"172.16.133.121",56566,"54.241.29.133",80,186,165100,11638,0,0,68,20750,118,144350,131.021347,63.070682000000005,2631,18309
"172.16.133.121",56567,"72.21.91.19",80,18,11247,11639,0,0,7,828,11,10419,131.028649,12.946863000000008,511,6438
"172.16.133.121",56568,"173.194.74.95",443,23,5470,11640,0,0,12,1616,11,3854,131.028982,135.343646,95,227
"172.16.133.121",56569,"23.6.20.211",80,27,20003,11641,0,0,10,1017,17,18986,131.053675,42.910776999999996,189,3539
"172.16.133.49",55865,"172.16.139.250",5440,10,1022,11642,0,0,10,1022,0,0,131.061016,0.005720999999994092,1429120,0
"172.16.133.95",57038,"172.16.139.250",5440,12,1142,11643,0,0,12,1142,0,0,131.101778,0.007488999999992529,1219922,0
"172.16.133.92",57752,"172.16.139.250",5440,10,1022,11644,0,0,10,1022,0,0,131.126743,0.04189800000000332,195140,0
"172.16.133.29",61024,"172.16.139.250",5440,10,1022,11645,0,0,10,1022,0,0,131.143688,0.02924600000000055,279559,0
"172.16.133.44",64905,"172.16.139.250",5440,10,1022,11646,0,0,10,1022,0,0,131.151032,0.025616000000013628,319175,0
"172.16.133.207",56002,"172.16.139.250",5440,10,1022,11647,0,0,10,1022,0,0,131.17568,0.00536099999999351,1525088,0
"172.16.133.83",57160,"172.16.139.250",5440,12,1142,11648,0,0,12,1142,0,0,131.18537,0.004948999999982107,"",""
"172.16.133.93",60789,"172.16.139.250",5440,12,1142,11649,0,0,12,1142,0,0,131.201967,0.005010999999996102,1823188,0
"172.16.133.11",55211,"172.16.139.250",5440,10,1022,11650,0,0,10,1022,0,0,131.218665,0.022600000000011278,361769,0
"172.16.133.55",57701,"172.16.139.250",5440,10,1022,11651,0,0,10,1022,0,0,131.222757,0.022324999999995043,366226,0
"172.16.133.73",60758,"172.16.139.250",5440,12,1142,11652,0,0,12,1142,0,0,131.247201,0.006802000000021735,1343134,0
"172.16.133.53",54188,"172.16.139.250",5440,10,1022,11653,0,0,10,1022,0,0,131.249889,0.007340999999996711,1113744,0
"172.16.133.21",53263,"172.16.139.250",5440,12,1142,11654,0,0,12,1142,0,0,131.251954,0.015528999999986581,588318,0
"172.16.133.30",62696,"172.16.139.250",5440,12,1142,11655,0,0,12,1142,0,0,131.256358,0.005671000000006643,1611003,0
"172.16.133.25",63557,"172.16.139.250",5440,12,1142,11656,0,0,12,1142,0,0,131.263075,0.007580000000018572,1205277,0
"172.16.133.34",50508,"172.16.139.250",5440,12,1142,11657,0,0,12,1142,0,0,131.272769,0.005021999999996751,1819195,0
"172.16.133.97",59463,"172.16.139.250",5440,10,1022,11658,0,0,10,1022,0,0,131.281637,0.014630000000011023,558851,0
"172.16.133.33",57972,"172.16.139.250",5440,12,1142,11659,0,0,12,1142,0,0,131.355127,0.006946999999996706,1315100,0
"172.16.133.68",60827,"172.16.139.250",5440,10,1022,11660,0,0,10,1022,0,0,131.388288,0.0150650000000212,542714,0
"172.16.133.12",59848,"172.16.139.250",5440,12,1142,11661,0,0,12,1142,0,0,131.402069,0.017002999999988333,537316,0
"172.16.133.63",53956,"172.16.139.250",5440,10,1022,11662,0,0,10,1022,0,0,131.411822,0.01135400000001141,720098,0
"172.16.133.66",53948,"172.16.139.250",5440,10,1022,11663,0,0,10,1022,0,0,131.425154,0.0054990000000145756,1486815,0
"172.16.133.82",61464,"172.16.139.250",5440,12,1142,11664,0,0,12,1142,0,0,131.439719,0.03566699999998946,256147,0
"172.16.133.37",60694,"172.16.139.250",5440,12,1142,11665,0,0,12,1142,0,0,131.451559,0.027340000000009468,334162,0
"172.16.133.132",36686,"96.43.146.48",443,20,6059,11666,0,0,11,1125,9,4934,131.553285,0.22821799999999826,39435,172957
"172.16.133.121",56570,"173.194.43.62",80,15,4291,11667,0,0,7,795,8,3496,131.579345,135.13897200000002,47,206
"172.16.133.54",64706,"67.69.174.129",80,12,2914,11668,0,0,7,1740,5,1174,131.600219,115.628613,120,81
"172.16.133.78",59291,"172.16.139.250",5440,12,1142,11669,0,0,12,1142,0,0,131.609976,0.006315000000000737,1446714,0
"172.16.133.121",56571,"23.6.17.224",80,19,2617,11670,0,0,10,1301,9,1316,131.621196,152.33590300000003,68,69
"172.16.133.121",56572,"23.33.95.139",80,11,1340,11671,0,0,6,776,5,564,131.621338,52.333945,118,86
"172.16.133.67",56062,"172.16.139.250",5440,10,1022,11672,0,0,10,1022,0,0,131.663657,0.015310999999996966,533995,0
"172.16.133.56",61502,"172.16.139.250",5440,10,1022,11673,0,0,10,1022,0,0,131.686695,0.005157000000025391,1585417,0
"172.16.133.121",56573,"23.61.18.110",443,13,1206,11674,0,0,6,632,7,574,131.706201,21.48467500000001,235,213
"172.16.133.121",56574,"23.61.18.110",443,13,1206,11675,0,0,6,632,7,574,131.706321,21.484657999999996,235,213
"172.16.133.121",56575,"107.20.203.158",80,14,2063,11676,0,0,7,1095,7,968,131.706443,62.26527199999998,140,124
"172.16.133.121",56576,"107.20.203.158",80,6,372,11677,0,0,4,246,2,126,131.706548,12.272120000000001,160,82
"172.16.133.41",53204,"172.16.139.250",5440,10,1022,11678,0,0,10,1022,0,0,131.742415,0.0054980000000171,1487086,0
"172.16.133.132",36687,"96.43.146.48",443,20,6059,11679,0,0,11,1125,9,4934,131.749375,0.23251300000001152,38707,169762
"172.16.133.85",52342,"172.16.139.250",5440,10,1022,11680,0,0,10,1022,0,0,131.758732,0.014697999999981448,556266,0
"172.16.133.42",57196,"172.16.139.250",5440,12,1142,11681,0,0,12,1142,0,0,131.766569,0.026645000000002028,342878,0
"172.16.133.43",57852,"172.16.139.250",5440,10,1022,11682,0,0,10,1022,0,0,131.811992,0.005456000000009453,1498533,0
"172.16.133.41",53205,"68.64.24.250",443,6,366,11683,0,0,4,246,2,120,131.820859,0.08631499999998482,22800,11122
"172.16.133.13",53108,"172.16.139.250",5440,12,1142,11684,0,0,12,1142,0,0,131.83105,0.006251999999989266,1461292,0
"172.16.133.20",62482,"172.16.139.250",5440,10,1022,11685,0,0,10,1022,0,0,131.881769,0.014450000000010732,565813,0
"172.16.133.75",51048,"172.16.139.250",5440,12,1142,11686,0,0,12,1142,0,0,131.897087,0.006619999999998072,1380060,0
"172.16.133.28",49168,"172.16.139.250",5440,10,1022,11687,0,0,10,1022,0,0,131.910054,0.005235999999996466,1561497,0
"172.16.133.121",56577,"74.125.226.47",443,35,17740,11688,0,0,16,1940,19,15800,131.921326,135.3409,114,933
"172.16.133.121",56578,"72.21.91.19",80,11,1446,11689,0,0,6,833,5,613,131.921751,12.048397999999992,553,407
"172.16.133.41",53206,"78.108.118.250",443,6,366,11690,0,0,4,246,2,120,131.928961,0.19827500000002374,9925,4841
"172.16.133.41",53207,"216.219.118.244",443,6,366,11691,0,0,4,246,2,120,131.930622,0.2023670000000095,9724,4743
"172.16.133.99",56119,"172.16.139.250",5440,12,1142,11692,0,0,12,1142,0,0,131.937528,0.015228000000007569,599947,0
"172.16.133.132",36688,"96.43.146.48",443,20,6059,11693,0,0,11,1125,9,4934,131.950605,0.24380700000000388,36914,161898
"172.16.133.87",60305,"172.16.139.250",5440,10,1022,11694,0,0,10,1022,0,0,131.961718,0.015150000000005548,539669,0
"172.16.133.121",56579,"74.125.226.2",443,45,17995,11695,0,0,19,3179,26,14816,131.966889,135.49391699999998,187,874
"172.16.133.35",50044,"172.16.139.250",5440,12,1142,11696,0,0,12,1142,0,0,131.971995,0.02912700000001678,313660,0
"172.16.133.116",53583,"172.16.139.250",5440,10,1022,11697,0,0,10,1022,0,0,131.975987,0.005661000000003469,1444267,0
"172.16.133.116",53584,"172.16.139.250",5440,12,1142,11698,0,0,12,1142,0,0,131.98261,0.005887000000001308,1551894,0
"172.16.133.116",53585,"172.16.139.250",5440,10,1022,11699,0,0,10,1022,0,0,131.989371,0.013465999999993983,607158,0
"172.16.133.84",58863,"172.16.139.250",5440,10,1022,11700,0,0,10,1022,0,0,131.997342,0.01524699999998802,536236,0
"172.16.133.184",55902,"173.194.43.58",80,6,412,11701,0,0,4,272,2,140,132.06511,0.05229299999999171,41611,21417
"172.16.133.49",55866,"172.16.139.250",5440,10,1022,11702,0,0,10,1022,0,0,132.074429,0.005638000000004695,1450159,0
"172.16.133.84",58864,"64.90.204.229",443,17,3143,11703,0,0,8,2060,9,1083,132.111623,4.062964999999991,4056,2132
"172.16.133.95",57039,"172.16.139.250",5440,12,1142,11704,0,0,12,1142,0,0,132.113136,0.00632300000000896,1444883,0
"172.16.133.92",57753,"172.16.139.250",5440,10,1022,11705,0,0,10,1022,0,0,132.140872,0.0061900000000036925,1320840,0
"172.16.133.84",58865,"64.90.204.229",443,38,20458,11706,0,0,17,9917,21,10541,132.144741,8.197778999999997,9677,10286
"172.16.133.184",33724,"63.116.244.83",80,7,478,11707,0,0,4,272,3,206,132.15145,0.04823600000000283,45111,34165
"172.16.133.29",61025,"172.16.139.250",5440,10,1022,11708,0,0,10,1022,0,0,132.15865,0.00543500000000563,1504323,0
"172.16.133.44",64906,"172.16.139.250",5440,10,1022,11709,0,0,10,1022,0,0,132.165632,0.0053690000000017335,1522816,0
"172.16.133.207",56003,"172.16.139.250",5440,10,1022,11710,0,0,10,1022,0,0,132.189716,0.005402000000003682,1513513,0
"172.16.133.83",57161,"172.16.139.250",5440,10,1022,11711,0,0,10,1022,0,0,132.199467,0.004601000000008071,"",""
"172.16.133.184",52292,"208.71.125.129",80,6,374,11712,0,0,4,254,2,120,132.199616,0.05560400000001664,36544,17264
"172.16.133.93",60790,"172.16.139.250",5440,10,1022,11713,0,0,10,1022,0,0,132.21636,0.014262999999999693,573231,0
"172.16.133.40",50222,"216.115.217.254",443,6,366,11714,0,0,4,246,2,120,132.226248,0.057344000000000506,34319,16741
"172.16.133.11",55212,"172.16.139.250",5440,10,1022,11715,0,0,10,1022,0,0,132.232621,0.005729000000002316,1427125,0
"172.16.133.55",57702,"172.16.139.250",5440,10,1022,11716,0,0,10,1022,0,0,132.236904,0.015559999999993579,525449,0
"172.16.133.184",53636,"64.208.138.245",80,6,412,11717,0,0,4,272,2,140,132.258276,0.07160600000000272,30388,15641
"172.16.133.73",60759,"172.16.139.250",5440,12,1142,11718,0,0,12,1142,0,0,132.25957,0.0063140000000032614,1446943,0
"172.16.133.53",54189,"172.16.139.250",5440,10,1022,11719,0,0,10,1022,0,0,132.262688,0.007124000000004571,1147669,0
"172.16.133.21",53264,"172.16.139.250",5440,10,1022,11720,0,0,10,1022,0,0,132.264911,0.015019999999992706,544340,0
"172.16.133.30",62697,"172.16.139.250",5440,12,1142,11721,0,0,12,1142,0,0,132.269403,0.01829799999998727,499289,0
"172.16.133.25",63558,"172.16.139.250",5440,12,1142,11722,0,0,12,1142,0,0,132.276227,0.007465999999993755,1223680,0
"172.16.133.40",50223,"216.219.120.244",443,6,366,11723,0,0,4,246,2,120,132.279205,0.2023590000000013,9725,4744
"172.16.133.34",50509,"172.16.139.250",5440,12,1142,11724,0,0,12,1142,0,0,132.285555,0.014754000000010592,619221,0
"172.16.133.97",59464,"172.16.139.250",5440,12,1142,11725,0,0,12,1142,0,0,132.296176,0.008499000000000478,1074949,0
"172.16.133.41",53208,"216.115.219.126",443,6,366,11726,0,0,4,246,2,120,132.315763,0.5638170000000002,3490,1702
"172.16.133.184",46827,"208.71.125.1",80,6,374,11727,0,0,4,254,2,120,132.331684,0.08241000000001009,24657,11649
"172.16.133.33",57973,"172.16.139.250",5440,10,1022,11728,0,0,10,1022,0,0,132.369577,0.015365000000002738,532118,0
"172.16.133.68",60828,"172.16.139.250",5440,10,1022,11729,0,0,10,1022,0,0,132.402754,0.005662999999998419,1443757,0
"172.16.133.184",49665,"173.194.43.37",80,6,412,11730,0,0,4,272,2,140,132.415834,0.04505800000001159,48293,24856
"172.16.133.12",59849,"172.16.139.250",5440,12,1142,11731,0,0,12,1142,0,0,132.415913,0.006182000000023891,1477838,0
"172.16.133.110",44717,"174.129.20.55",80,10,1098,11732,0,0,6,514,4,584,132.422956,0.10599200000001474,38795,44078
"172.16.133.63",53957,"172.16.139.250",5440,12,1142,11733,0,0,12,1142,0,0,132.426118,0.005493999999998778,1662904,0
"172.16.133.66",53949,"216.52.242.80",80,6,372,11734,0,0,4,246,2,126,132.437393,14.763524000000018,133,68
"172.16.133.66",53950,"173.194.43.60",80,6,372,11735,0,0,4,246,2,126,132.440996,14.683354999999978,134,68
"172.16.133.66",53951,"64.94.107.58",80,7,428,11736,0,0,4,246,3,182,132.442056,14.681072,134,99
"172.16.133.121",56580,"54.240.160.158",80,15,1739,11737,0,0,8,917,7,822,132.442557,121.51875800000002,60,54
"172.16.133.66",53952,"208.111.160.6",80,8,492,11738,0,0,4,246,4,246,132.443223,14.687249000000008,133,133
"172.16.133.66",53953,"208.111.160.6",80,8,492,11739,0,0,4,246,4,246,132.443571,14.690480000000008,133,133
"172.16.133.66",53954,"208.111.160.6",80,8,492,11740,0,0,4,246,4,246,132.443848,14.68830299999999,133,133
"172.16.133.66",53955,"208.111.160.6",80,8,492,11741,0,0,4,246,4,246,132.444132,14.687183000000005,133,133
"172.16.133.66",53956,"208.111.160.6",80,8,492,11742,0,0,4,246,4,246,132.444432,14.688717999999994,133,133
"172.16.133.66",53957,"208.111.160.6",80,8,492,11743,0,0,4,246,4,246,132.444756,14.689364999999981,133,133
"172.16.133.66",53958,"172.16.139.250",5440,10,1022,11744,0,0,10,1022,0,0,132.445355,0.007255999999983942,1126791,0
"172.16.133.66",53959,"64.94.107.25",80,8,2131,11745,0,0,5,1668,3,463,132.448718,0.5815299999999866,22946,6369
"172.16.133.66",53960,"208.111.161.254",80,8,492,11746,0,0,4,246,4,246,132.449155,14.683924000000019,134,134
"172.16.133.66",53961,"208.111.161.254",80,8,492,11747,0,0,4,246,4,246,132.449474,14.683741999999995,134,134
"172.16.133.66",53962,"208.111.161.254",80,8,492,11748,0,0,4,246,4,246,132.449717,14.688693999999998,133,133
"172.16.133.66",53963,"208.111.161.254",80,8,492,11749,0,0,4,246,4,246,132.449925,14.683222,134,134
"172.16.133.66",53964,"208.111.161.254",80,8,492,11750,0,0,4,246,4,246,132.450136,14.684888,134,134
"172.16.133.66",53965,"208.111.161.254",80,8,492,11751,0,0,4,246,4,246,132.45042,14.687989999999985,133,133
"172.16.133.66",53966,"23.0.49.244",80,6,372,11752,0,0,4,246,2,126,132.451485,14.684382,134,68
"172.16.133.66",53967,"23.0.49.244",80,6,372,11753,0,0,4,246,2,126,132.451875,14.684888999999998,134,68
"172.16.133.66",53968,"23.0.49.244",80,6,372,11754,0,0,4,246,2,126,132.452249,14.684448000000003,134,68
"172.16.133.66",53969,"23.0.49.244",80,6,372,11755,0,0,4,246,2,126,132.452683,14.684011999999996,134,68
"172.16.133.82",61465,"172.16.139.250",5440,12,1142,11756,0,0,12,1142,0,0,132.452779,0.014488999999997532,630547,0
"172.16.133.66",53970,"23.0.49.244",80,28,13671,11757,0,0,13,3327,15,10344,132.452937,159.510477,166,518
"172.16.133.66",53971,"23.0.49.244",80,23,10286,11758,0,0,11,2583,12,7703,132.453135,159.590637,129,386
"172.16.133.66",53972,"23.0.49.244",80,24,9749,11759,0,0,11,2583,13,7166,132.453338,159.67867399999997,129,359
"172.16.133.184",57518,"173.194.43.57",80,6,412,11760,0,0,4,272,2,140,132.462591,0.04849699999999757,44868,23094
"172.16.133.66",53973,"208.47.254.81",80,6,372,11761,0,0,4,246,2,126,132.463318,14.661149000000023,134,68
"172.16.133.66",53974,"208.47.254.81",80,44,16052,11762,0,0,25,11575,19,4477,132.463448,104.67711299999999,884,342
"172.16.133.37",60695,"172.16.139.250",5440,12,1142,11763,0,0,12,1142,0,0,132.46697,0.015358999999989464,594830,0
"172.16.133.121",56581,"74.205.116.37",80,11,1842,11764,0,0,6,732,5,1110,132.471173,127.04717400000001,46,69
"172.16.133.66",53975,"138.108.7.20",80,8,2126,11765,0,0,4,1468,4,658,132.479017,14.606401000000005,804,360
"172.16.133.40",50224,"216.115.220.254",443,6,366,11766,0,0,4,246,2,120,132.489253,0.4783610000000067,4114,2006
"172.16.133.66",53976,"23.0.49.244",80,19,7219,11767,0,0,9,1824,10,5395,132.500046,94.617694,154,456
"172.16.133.66",53977,"23.0.49.244",80,19,6859,11768,0,0,9,1824,10,5035,132.500554,159.463853,91,252
"172.16.133.40",50225,"202.173.27.250",443,6,366,11769,0,0,4,246,2,120,132.507174,0.5536519999999996,3554,1733
"172.16.133.121",56582,"74.205.116.37",80,7,432,11770,0,0,4,246,3,186,132.515855,11.49251000000001,171,129
"172.16.133.184",48419,"205.216.16.228",80,6,374,11771,0,0,3,194,3,180,132.521853,0.20979800000000637,7397,6863
"172.16.133.78",59292,"172.16.139.250",5440,12,1142,11772,0,0,12,1142,0,0,132.624094,0.006458999999978232,1414460,0
"172.16.133.121",56583,"173.194.43.58",80,6,372,11773,0,0,4,246,2,126,132.648649,11.319929000000002,173,89
"172.16.133.67",56063,"172.16.139.250",5440,12,1142,11774,0,0,12,1142,0,0,132.677091,0.006154000000009319,1484562,0
"172.16.133.18",50298,"174.129.20.55",443,26,9590,11775,0,0,13,2336,13,7254,132.69505,10.599788999999987,1763,5474
"172.16.133.56",61503,"172.16.139.250",5440,10,1022,11776,0,0,10,1022,0,0,132.700697,0.00468600000002084,"",""
"172.16.133.41",53209,"172.16.139.250",5440,10,1022,11777,0,0,10,1022,0,0,132.756458,0.006416000000001532,1274314,0
"172.16.133.121",56584,"173.252.100.27",80,7,432,11778,0,0,4,246,3,186,132.771634,11.214832000000001,175,132
"172.16.133.121",56585,"173.252.100.27",80,7,432,11779,0,0,4,246,3,186,132.771875,11.215817000000015,175,132
"172.16.133.121",56586,"173.252.100.27",80,7,432,11780,0,0,4,246,3,186,132.772239,11.230447999999996,175,132
"172.16.133.85",52343,"172.16.139.250",5440,10,1022,11781,0,0,10,1022,0,0,132.77276,0.005352999999985286,1527367,0
"172.16.133.121",56587,"69.171.248.16",80,6,372,11782,0,0,4,246,2,126,132.773019,11.210332999999991,175,89
"172.16.133.121",56588,"69.171.248.16",80,6,372,11783,0,0,4,246,2,126,132.773566,11.20990500000002,175,89
"172.16.133.42",57197,"172.16.139.250",5440,12,1142,11784,0,0,12,1142,0,0,132.79097,0.017973000000012007,508318,0
"172.16.133.121",56589,"23.60.246.35",80,13,1572,11785,0,0,7,887,6,685,132.80229,135.22665500000002,52,40
"172.16.133.43",57853,"172.16.139.250",5440,10,1022,11786,0,0,10,1022,0,0,132.82644,0.005523000000010825,1480354,0
"172.16.133.13",53109,"172.16.139.250",5440,12,1142,11787,0,0,12,1142,0,0,132.846352,0.015591999999998052,585941,0
"172.16.133.121",56590,"199.59.148.11",443,28,7305,11788,0,0,12,1922,16,5383,132.870595,30.515683999999993,503,1411
"172.16.133.121",56591,"67.69.196.24",443,14,2362,11789,0,0,7,826,7,1536,132.870763,20.32244399999999,325,604
"172.16.133.121",56592,"67.69.196.24",443,14,2362,11790,0,0,7,826,7,1536,132.870879,20.32059000000001,325,604
"172.16.133.20",62483,"172.16.139.250",5440,10,1022,11791,0,0,10,1022,0,0,132.894782,0.014346000000017511,569914,0
"172.16.133.75",51049,"172.16.139.250",5440,10,1022,11792,0,0,10,1022,0,0,132.911257,0.005393999999995458,1515758,0
"172.16.133.121",56593,"23.60.241.224",80,13,2025,11793,0,0,7,1243,6,782,132.916036,91.06290000000001,109,68
"172.16.133.28",49169,"172.16.139.250",5440,10,1022,11794,0,0,10,1022,0,0,132.925946,0.0053999999999803094,1514074,0
"172.16.133.121",56594,"67.69.174.18",80,6,372,11795,0,0,4,246,2,126,132.932675,11.053654000000023,178,91
"172.16.133.121",56595,"67.69.174.18",80,6,372,11796,0,0,4,246,2,126,132.932985,11.053200000000004,178,91
"172.16.133.121",56596,"67.69.174.18",80,6,372,11797,0,0,4,246,2,126,132.933194,11.052993000000015,178,91
"172.16.133.121",56597,"199.59.148.11",443,6,372,11798,0,0,4,246,2,126,132.933443,11.104152,177,90
"172.16.133.121",56598,"67.69.196.48",80,6,372,11799,0,0,4,246,2,126,132.951721,11.033652000000018,178,91
"172.16.133.121",56599,"67.69.196.48",80,6,372,11800,0,0,4,246,2,126,132.951927,11.037025,178,91
"172.16.133.99",56120,"172.16.139.250",5440,10,1022,11801,0,0,10,1022,0,0,132.951928,0.005057999999991125,1616449,0
"172.16.133.87",60306,"172.16.139.250",5440,10,1022,11802,0,0,10,1022,0,0,132.976461,0.014665000000007922,557517,0
"172.16.133.116",53586,"172.16.139.250",5440,10,1022,11803,0,0,10,1022,0,0,132.990075,0.005359999999996035,1525373,0
"172.16.133.116",53587,"172.16.139.250",5440,10,1022,11804,0,0,10,1022,0,0,132.996458,0.005583000000001448,1464445,0
"172.16.133.116",53588,"172.16.139.250",5440,10,1022,11805,0,0,10,1022,0,0,133.002912,0.015298999999998841,534414,0
"172.16.133.84",58866,"172.16.139.250",5440,12,1142,11806,0,0,12,1142,0,0,133.011878,0.01566199999999185,583322,0
"172.16.133.35",50045,"172.16.139.250",5440,12,1142,11807,0,0,12,1142,0,0,133.021139,0.05473899999998366,166901,0
"172.16.133.121",56600,"31.13.74.7",80,8,492,11808,0,0,4,246,4,246,133.031767,16.99140299999999,115,115
"172.16.133.121",56601,"31.13.74.7",80,8,492,11809,0,0,4,246,4,246,133.032118,18.729254999999995,105,105
"172.16.133.121",56602,"174.129.204.13",80,6,372,11810,0,0,4,246,2,126,133.032436,10.942034000000007,179,92
"172.16.133.121",56603,"174.129.204.13",80,6,372,11811,0,0,4,246,2,126,133.032534,10.942476999999997,179,92
"172.16.133.121",56604,"67.69.196.155",80,6,372,11812,0,0,4,246,2,126,133.032801,10.955055999999985,179,92
"172.16.133.121",56605,"67.69.196.155",80,8,504,11813,0,0,5,312,3,192,133.032964,10.954892000000001,227,140
"172.16.133.121",56606,"31.13.74.10",80,8,492,11814,0,0,4,246,4,246,133.081379,18.71846500000001,105,105
"172.16.133.121",56607,"31.13.74.10",80,8,492,11815,0,0,4,246,4,246,133.081592,19.202920000000006,102,102
"172.16.133.121",56608,"67.69.196.152",80,7,432,11816,0,0,4,246,3,186,133.086327,10.905417999999997,180,136
"172.16.133.121",56609,"67.69.196.152",80,6,372,11817,0,0,4,246,2,126,133.086438,10.904673000000003,180,92
"172.16.133.121",56610,"67.69.196.152",80,6,372,11818,0,0,4,246,2,126,133.086574,10.900840999999986,180,92
"172.16.133.121",56611,"67.69.196.152",80,6,372,11819,0,0,4,246,2,126,133.086712,10.90558999999999,180,92
"172.16.133.121",56612,"67.69.196.152",80,6,372,11820,0,0,4,246,2,126,133.086878,10.905342999999988,180,92
"172.16.133.121",56613,"67.69.196.152",80,9,564,11821,0,0,5,312,4,252,133.087006,10.905096999999984,228,184
"172.16.133.49",55867,"172.16.139.250",5440,12,1142,11822,0,0,12,1142,0,0,133.088459,0.0063370000000020354,1441691,0
"172.16.133.121",56614,"67.69.174.115",80,6,372,11823,0,0,4,246,2,126,133.109658,10.888898000000012,180,92
"172.16.133.121",56615,"67.69.174.115",80,6,372,11824,0,0,4,246,2,126,133.109804,10.882592000000017,180,92
"172.16.133.121",56616,"67.69.174.115",80,6,372,11825,0,0,4,246,2,126,133.109942,10.888682000000017,180,92
"172.16.133.121",56617,"67.69.174.115",80,6,372,11826,0,0,4,246,2,126,133.11007,10.892707999999999,180,92
"172.16.133.121",56618,"67.69.174.115",80,6,372,11827,0,0,4,246,2,126,133.110371,10.884859000000006,180,92
"172.16.133.121",56619,"67.69.174.115",80,6,372,11828,0,0,4,246,2,126,133.110518,10.882251999999994,180,92
"172.16.133.121",56620,"199.59.148.86",443,27,7064,11829,0,0,13,2075,14,4989,133.125491,30.547293999999994,543,1306
"172.16.133.95",57040,"172.16.139.250",5440,10,1022,11830,0,0,10,1022,0,0,133.128308,0.0061709999999948195,1324906,0
"172.16.133.26",53080,"67.217.66.244",443,6,366,11831,0,0,4,246,2,120,133.148516,0.06428099999999404,30615,14934
"172.16.133.26",53079,"68.64.30.250",443,6,366,11832,0,0,4,246,2,120,133.148518,0.09540100000000962,20628,10062
"172.16.133.26",53081,"68.64.13.250",443,6,366,11833,0,0,4,246,2,120,133.149414,0.11733300000000213,16772,8181
"172.16.133.26",53082,"216.219.115.250",443,6,366,11834,0,0,4,246,2,120,133.150141,0.051842000000021926,37961,18517
"172.16.133.92",57754,"172.16.139.250",5440,10,1022,11835,0,0,10,1022,0,0,133.154489,0.005442999999985432,1502112,0
"172.16.133.121",56621,"199.59.148.86",443,7,432,11836,0,0,4,246,3,186,133.165868,10.885621000000015,180,136
"172.16.133.29",61026,"172.16.139.250",5440,10,1022,11837,0,0,10,1022,0,0,133.173041,0.06176800000000071,132366,0
"172.16.133.44",64907,"172.16.139.250",5440,10,1022,11838,0,0,10,1022,0,0,133.179164,0.05909200000002102,138360,0
"172.16.133.207",56004,"172.16.139.250",5440,10,1022,11839,0,0,10,1022,0,0,133.204278,0.037304000000006,219172,0
"172.16.133.83",57162,"172.16.139.250",5440,12,1142,11840,0,0,12,1142,0,0,133.213342,0.032260999999977,283190,0
"172.16.133.93",60791,"172.16.139.250",5440,10,1022,11841,0,0,10,1022,0,0,133.230188,0.01890399999999204,432501,0
"172.16.133.11",55213,"172.16.139.250",5440,10,1022,11842,0,0,10,1022,0,0,133.246326,0.007215999999999667,1133037,0
"172.16.133.55",57703,"172.16.139.250",5440,10,1022,11843,0,0,10,1022,0,0,133.251936,0.006140999999985297,1331379,0
"172.16.133.73",60760,"172.16.139.250",5440,10,1022,11844,0,0,10,1022,0,0,133.274219,0.005823000000020784,1404087,0
"172.16.133.53",54190,"172.16.139.250",5440,10,1022,11845,0,0,10,1022,0,0,133.277133,0.015265999999996893,535569,0
"172.16.133.21",53265,"172.16.139.250",5440,10,1022,11846,0,0,10,1022,0,0,133.279081,0.0056000000000153705,1459999,0
"172.16.133.30",62698,"172.16.139.250",5440,10,1022,11847,0,0,10,1022,0,0,133.283709,0.017910000000000537,456504,0
"172.16.133.34",50510,"172.16.139.250",5440,10,1022,11848,0,0,10,1022,0,0,133.29944,0.006506000000001677,1256686,0
"172.16.133.25",63559,"172.16.139.250",5440,12,1142,11849,0,0,12,1142,0,0,133.301943,0.01508900000001745,605474,0
"172.16.133.97",59465,"172.16.139.250",5440,10,1022,11850,0,0,10,1022,0,0,133.309626,0.014578999999997677,560806,0
"172.16.133.25",63338,"96.43.146.48",443,4,240,11851,0,0,2,120,2,120,133.318557,0.05790700000000015,16578,16578
"172.16.133.25",63560,"96.43.146.48",443,32,8640,11852,0,0,19,5354,13,3286,133.318895,69.36022600000001,617,379
"172.16.133.33",57974,"172.16.139.250",5440,10,1022,11853,0,0,10,1022,0,0,133.383377,0.005514000000005126,1482771,0
"172.16.133.68",60829,"172.16.139.250",5440,10,1022,11854,0,0,10,1022,0,0,133.416606,0.01635699999999929,499847,0
"172.16.133.12",59850,"172.16.139.250",5440,10,1022,11855,0,0,10,1022,0,0,133.429978,0.0071619999999938955,1141580,0
"172.16.133.63",53958,"172.16.139.250",5440,10,1022,11856,0,0,10,1022,0,0,133.439836,0.007013999999998077,1165668,0
"172.16.133.66",53978,"172.16.139.250",5440,10,1022,11857,0,0,10,1022,0,0,133.453559,0.005430999999987307,1505431,0
"172.16.133.82",61466,"172.16.139.250",5440,10,1022,11858,0,0,10,1022,0,0,133.468821,0.015785000000022364,517960,0
"172.16.133.37",60696,"172.16.139.250",5440,10,1022,11859,0,0,10,1022,0,0,133.480843,0.007510999999993828,1088536,0
"172.16.133.109",37905,"96.43.146.176",443,31,13403,11860,0,0,16,1680,15,11723,133.490976,0.2990750000000162,44938,313580
"172.16.133.78",59293,"172.16.139.250",5440,12,1142,11861,0,0,12,1142,0,0,133.637082,0.01672600000000557,546215,0
"172.16.133.67",56064,"172.16.139.250",5440,10,1022,11862,0,0,10,1022,0,0,133.691043,0.005235999999996466,1561497,0
"172.16.133.109",51663,"23.33.81.213",443,45,26330,11863,0,0,20,2025,25,24305,133.71229,0.33509699999999043,48344,580249
"172.16.133.56",61504,"172.16.139.250",5440,12,1142,11864,0,0,12,1142,0,0,133.71333,0.00482900000000086,"",""
"172.16.133.41",53210,"172.16.139.250",5440,10,1022,11865,0,0,10,1022,0,0,133.771343,0.007287999999988415,1121844,0
"172.16.133.85",52344,"172.16.139.250",5440,12,1142,11866,0,0,12,1142,0,0,133.786839,0.006288000000012062,1452926,0
"172.16.133.42",57198,"172.16.139.250",5440,12,1142,11867,0,0,12,1142,0,0,133.799741,0.014657999999997173,623277,0
"172.16.133.43",57854,"172.16.139.250",5440,10,1022,11868,0,0,10,1022,0,0,133.840067,0.00547799999998233,1492515,0
"172.16.133.13",53110,"172.16.139.250",5440,12,1142,11869,0,0,12,1142,0,0,133.85985,0.00633600000000456,1441919,0
"172.16.133.41",53211,"68.64.24.250",443,6,366,11870,0,0,4,246,2,120,133.866877,0.09367700000001378,21008,10247
"172.16.133.20",62484,"172.16.139.250",5440,12,1142,11871,0,0,12,1142,0,0,133.909797,0.0053230000000041855,1716325,0
"172.16.133.75",51050,"172.16.139.250",5440,10,1022,11872,0,0,10,1022,0,0,133.924951,0.005400000000008731,1514074,0
"172.16.133.28",49170,"172.16.139.250",5440,10,1022,11873,0,0,10,1022,0,0,133.939002,0.006953000000009979,1175895,0
"172.16.133.99",56121,"172.16.139.250",5440,10,1022,11874,0,0,10,1022,0,0,133.96567,0.014575000000007776,560960,0
"172.16.133.87",60307,"172.16.139.250",5440,10,1022,11875,0,0,10,1022,0,0,133.98999,0.005398999999982834,1514354,0
"172.16.133.35",50046,"172.16.139.250",5440,12,1142,11876,0,0,12,1142,0,0,134.003482,0.028469999999998663,320899,0
"172.16.133.116",53589,"172.16.139.250",5440,10,1022,11877,0,0,10,1022,0,0,134.005305,0.004949000000010528,"",""
"172.16.133.116",53590,"172.16.139.250",5440,10,1022,11878,0,0,10,1022,0,0,134.011119,0.006989000000004353,1169838,0
"172.16.133.109",36678,"23.33.81.213",443,53,38288,11879,0,0,23,2261,30,36027,134.019007,0.32228400000002466,56124,894291
"172.16.133.116",53591,"172.16.139.250",5440,10,1022,11880,0,0,10,1022,0,0,134.020323,0.008747999999997091,934613,0
"172.16.133.84",58867,"172.16.139.250",5440,12,1142,11881,0,0,12,1142,0,0,134.025083,0.008777000000009139,1040902,0
"172.16.133.41",53212,"78.108.118.250",443,6,366,11882,0,0,4,246,2,120,134.034808,0.2084419999999909,9441,4605
"172.16.133.41",53213,"216.219.118.244",443,6,366,11883,0,0,4,246,2,120,134.039702,0.20512399999998365,9594,4680
"172.16.133.49",55868,"172.16.139.250",5440,10,1022,11884,0,0,10,1022,0,0,134.102592,0.06168800000000374,132537,0
"172.16.133.95",57041,"172.16.139.250",5440,10,1022,11885,0,0,10,1022,0,0,134.142093,0.025613000000021202,319212,0
"172.16.133.92",57755,"172.16.139.250",5440,10,1022,11886,0,0,10,1022,0,0,134.168758,0.005647000000010394,1447848,0
"172.16.133.29",61027,"172.16.139.250",5440,10,1022,11887,0,0,10,1022,0,0,134.185673,0.007451000000003205,1097302,0
"172.16.133.44",64908,"172.16.139.250",5440,12,1142,11888,0,0,12,1142,0,0,134.19437,0.006100000000003547,1497704,0
"172.16.133.207",56005,"172.16.139.250",5440,12,1142,11889,0,0,12,1142,0,0,134.217935,0.014552999999978056,627774,0
"172.16.133.83",57163,"172.16.139.250",5440,12,1142,11890,0,0,12,1142,0,0,134.227461,0.013773999999983744,663278,0
"172.16.133.93",60792,"172.16.139.250",5440,10,1022,11891,0,0,10,1022,0,0,134.244036,0.004805000000004611,"",""
"172.16.133.40",50226,"216.115.217.254",443,7,426,11892,0,0,4,246,3,180,134.252276,0.06212200000001644,31679,23180
"172.16.133.11",55214,"172.16.139.250",5440,10,1022,11893,0,0,10,1022,0,0,134.260698,0.005632000000019843,1451704,0
"172.16.133.55",57704,"172.16.139.250",5440,12,1142,11894,0,0,12,1142,0,0,134.265012,0.006286999999986165,1453157,0
"172.16.133.73",60761,"172.16.139.250",5440,12,1142,11895,0,0,12,1142,0,0,134.287768,0.01666499999998905,548214,0
"172.16.133.53",54191,"172.16.139.250",5440,10,1022,11896,0,0,10,1022,0,0,134.289737,0.021829999999994243,374530,0
"172.16.133.21",53266,"172.16.139.250",5440,10,1022,11897,0,0,10,1022,0,0,134.294041,0.005772000000007438,1416493,0
"172.16.133.30",62699,"172.16.139.250",5440,12,1142,11898,0,0,12,1142,0,0,134.298863,0.009359999999986712,976068,0
"172.16.133.25",63561,"172.16.139.250",5440,12,1142,11899,0,0,12,1142,0,0,134.305267,0.010560000000026548,865151,0
"172.16.133.34",50511,"172.16.139.250",5440,10,1022,11900,0,0,10,1022,0,0,134.314175,0.00697199999999043,1172690,0
"172.16.133.97",59466,"172.16.139.250",5440,12,1142,11901,0,0,12,1142,0,0,134.323866,0.015177999999991698,601923,0
"172.16.133.40",50227,"216.219.120.244",443,6,366,11902,0,0,4,246,2,120,134.38625,0.1745429999999999,11275,5500
"172.16.133.33",57975,"172.16.139.250",5440,12,1142,11903,0,0,12,1142,0,0,134.397026,0.006341999999989412,1440555,0
"172.16.133.121",56622,"184.169.137.94",443,23,6711,11904,0,0,12,3003,11,3708,134.412618,68.77657499999998,349,431
"172.16.133.68",60830,"172.16.139.250",5440,10,1022,11905,0,0,10,1022,0,0,134.430495,0.005734999999987167,1425632,0
"172.16.133.63",53959,"172.16.139.250",5440,10,1022,11906,0,0,10,1022,0,0,134.454002,0.015386000000006561,531392,0
"172.16.133.121",56623,"184.169.137.94",443,6,372,11907,0,0,4,246,2,126,134.464276,19.56383199999999,100,51
"172.16.133.66",53979,"172.16.139.250",5440,10,1022,11908,0,0,10,1022,0,0,134.467352,0.00650299999998083,1257265,0
"172.16.133.82",61467,"172.16.139.250",5440,10,1022,11909,0,0,10,1022,0,0,134.48071,0.016360000000020136,499755,0
"172.16.133.12",59851,"172.16.139.250",5440,12,1142,11910,0,0,12,1142,0,0,134.482184,0.005685999999997193,1606753,0
"172.16.133.37",60697,"172.16.139.250",5440,10,1022,11911,0,0,10,1022,0,0,134.495495,0.005654999999990196,1445800,0
"172.16.133.41",53214,"216.115.219.126",443,7,426,11912,0,0,5,306,2,120,134.593903,1.3052479999999775,1875,735
"172.16.133.121",56624,"96.43.146.49",443,404,260455,11913,0,0,175,48865,229,211590,134.622977,45.99623700000001,8498,36801
"172.16.133.78",59294,"172.16.139.250",5440,10,1022,11914,0,0,10,1022,0,0,134.651105,0.005601000000012846,1459739,0
"172.16.133.67",56065,"172.16.139.250",5440,12,1142,11915,0,0,12,1142,0,0,134.705352,0.006015999999988253,1518617,0
"172.16.133.56",61505,"172.16.139.250",5440,12,1142,11916,0,0,12,1142,0,0,134.729063,0.005266000000005988,1734903,0
"172.16.133.40",50228,"216.115.220.254",443,6,366,11917,0,0,4,246,2,120,134.73524,0.4721020000000067,4168,2033
"172.16.133.40",50229,"202.173.27.250",443,8,492,11918,0,0,5,312,3,180,134.782242,3.5986269999999934,693,400
"172.16.133.41",53215,"172.16.139.250",5440,10,1022,11919,0,0,10,1022,0,0,134.7843,0.00536299999998846,1524519,0
"172.16.133.42",57199,"172.16.139.250",5440,12,1142,11920,0,0,12,1142,0,0,134.815149,0.056825000000003456,160774,0
"172.16.133.85",52345,"172.16.139.250",5440,12,1142,11921,0,0,12,1142,0,0,134.850506,0.0063969999999926586,1428169,0
"172.16.133.43",57855,"172.16.139.250",5440,10,1022,11922,0,0,10,1022,0,0,134.854224,0.00926100000000929,882842,0
"172.16.133.13",53111,"172.16.139.250",5440,10,1022,11923,0,0,10,1022,0,0,134.873964,0.005377000000009957,1520550,0
"172.16.133.20",62485,"172.16.139.250",5440,10,1022,11924,0,0,10,1022,0,0,134.922894,0.014569999999991978,561153,0
"172.16.133.75",51051,"172.16.139.250",5440,10,1022,11925,0,0,10,1022,0,0,134.939442,0.005417999999991707,1509043,0
"172.16.133.28",49171,"172.16.139.250",5440,10,1022,11926,0,0,10,1022,0,0,134.952462,0.005291999999997188,1544973,0
"172.16.133.99",56122,"172.16.139.250",5440,10,1022,11927,0,0,10,1022,0,0,134.979575,0.014844999999979791,550757,0
"172.16.133.87",60308,"172.16.139.250",5440,10,1022,11928,0,0,10,1022,0,0,135.003368,0.0052029999999945176,1571401,0
"172.16.133.116",53592,"172.16.139.250",5440,10,1022,11929,0,0,10,1022,0,0,135.016911,0.004918000000003531,"",""
"172.16.133.35",50047,"172.16.139.250",5440,12,1142,11930,0,0,12,1142,0,0,135.022087,0.012057999999996127,757671,0
"172.16.133.116",53593,"172.16.139.250",5440,10,1022,11931,0,0,10,1022,0,0,135.022603,0.005465999999984206,1495792,0
"172.16.133.116",53594,"172.16.139.250",5440,10,1022,11932,0,0,10,1022,0,0,135.02894,0.006647999999984222,1229843,0
"172.16.133.84",58868,"172.16.139.250",5440,10,1022,11933,0,0,10,1022,0,0,135.039964,0.005279999999999063,1548484,0
"172.16.133.67",56066,"172.16.139.250",5440,10,1074,11934,0,0,10,1074,0,0,135.053436,0.0031099999999923966,"",""
"172.16.133.121",56625,"50.18.252.109",443,86,62703,11935,0,0,35,18789,51,43914,135.101816,68.089282,2207,5159
"172.16.133.49",55869,"172.16.139.250",5440,10,1022,11936,0,0,10,1022,0,0,135.115643,0.005517999999995027,1481696,0
"172.16.133.67",56067,"172.16.139.250",5440,12,1254,11937,0,0,12,1254,0,0,135.130193,1.2540720000000078,7999,0
"172.16.133.121",56626,"50.18.252.109",443,27,10648,11938,0,0,14,4709,13,5939,135.155102,68.03078199999999,553,698
"172.16.133.95",57042,"172.16.139.250",5440,12,1142,11939,0,0,12,1142,0,0,135.156139,0.0061530000000118434,1484804,0
"172.16.133.26",53083,"216.219.115.250",443,6,366,11940,0,0,4,246,2,120,135.178324,0.055835000000001855,35246,17193
"172.16.133.92",57756,"172.16.139.250",5440,10,1022,11941,0,0,10,1022,0,0,135.182046,0.015113999999982752,540955,0
"172.16.133.26",53084,"67.217.66.244",443,6,366,11942,0,0,4,246,2,120,135.184225,0.07172399999998902,27438,13384
"172.16.133.29",61028,"172.16.139.250",5440,10,1022,11943,0,0,10,1022,0,0,135.200696,0.015948000000008733,512666,0
"172.16.133.26",53085,"68.64.30.250",443,6,366,11944,0,0,4,246,2,120,135.202409,0.10940300000001457,17988,8774
"172.16.133.44",64909,"172.16.139.250",5440,10,1022,11945,0,0,10,1022,0,0,135.207547,0.0054609999999968295,1497161,0
"172.16.133.26",53086,"68.64.13.250",443,6,366,11946,0,0,4,246,2,120,135.213484,0.10619700000000876,18531,9039
"172.16.133.207",56006,"172.16.139.250",5440,12,1142,11947,0,0,12,1142,0,0,135.231971,0.01439600000000496,634620,0
"172.16.133.83",57164,"172.16.139.250",5440,12,1142,11948,0,0,12,1142,0,0,135.2416,0.01475399999998217,619221,0
"172.16.133.93",60793,"172.16.139.250",5440,12,1142,11949,0,0,12,1142,0,0,135.25685,0.004570000000001073,"",""
"172.16.133.11",55215,"172.16.139.250",5440,10,1022,11950,0,0,10,1022,0,0,135.274692,0.005684000000002243,1438423,0
"172.16.133.55",57705,"172.16.139.250",5440,10,1022,11951,0,0,10,1022,0,0,135.280538,0.005365999999980886,1523667,0
"172.16.133.73",60762,"172.16.139.250",5440,10,1022,11952,0,0,10,1022,0,0,135.302857,0.0054850000000215005,1490610,0
"172.16.133.53",54192,"172.16.139.250",5440,12,1142,11953,0,0,12,1142,0,0,135.304785,0.008413999999987709,1085809,0
"172.16.133.21",53267,"172.16.139.250",5440,10,1022,11954,0,0,10,1022,0,0,135.307937,0.008668999999997595,943130,0
"172.16.133.30",62700,"172.16.139.250",5440,10,1022,11955,0,0,10,1022,0,0,135.311213,0.010267999999996391,796260,0
"172.16.133.25",63562,"172.16.139.250",5440,12,1142,11956,0,0,12,1142,0,0,135.318084,0.00665300000000002,1373215,0
"172.16.133.34",50512,"172.16.139.250",5440,12,1142,11957,0,0,12,1142,0,0,135.327903,0.005160000000017817,1770542,0
"172.16.133.97",59467,"172.16.139.250",5440,12,1142,11958,0,0,12,1142,0,0,135.337782,0.016086999999998852,567911,0
"172.16.133.113",55646,"172.16.139.250",135,8,492,11959,0,0,8,492,0,0,135.360043,0.044825000000003,87808,0
"172.16.133.113",55647,"172.16.139.250",5462,10,696,11960,0,0,10,696,0,0,135.406806,0.5433400000000006,10247,0
"172.16.133.33",57976,"172.16.139.250",5440,12,1142,11961,0,0,12,1142,0,0,135.411627,0.005633999999986372,1621583,0
"172.16.133.68",60831,"172.16.139.250",5440,10,1022,11962,0,0,10,1022,0,0,135.444827,0.005699999999990268,1434385,0
"172.16.133.12",59852,"172.16.139.250",5440,12,1142,11963,0,0,12,1142,0,0,135.457104,0.0063060000000234595,1448778,0
"172.16.133.63",53960,"172.16.139.250",5440,10,1022,11964,0,0,10,1022,0,0,135.468279,0.005527999999998201,1479015,0
"172.16.133.66",53980,"172.16.139.250",5440,10,1022,11965,0,0,10,1022,0,0,135.48167,0.0058249999999873125,1403605,0
"172.16.133.82",61468,"172.16.139.250",5440,10,1022,11966,0,0,10,1022,0,0,135.494756,0.006200000000006867,1318709,0
"172.16.133.37",60698,"172.16.139.250",5440,10,1022,11967,0,0,10,1022,0,0,135.508482,0.005906000000010181,1384354,0
"172.16.133.78",59295,"172.16.139.250",5440,12,1142,11968,0,0,12,1142,0,0,135.666156,0.01648499999998876,554200,0
"172.16.133.67",56068,"172.16.139.250",5440,10,1022,11969,0,0,10,1022,0,0,135.719184,0.015181999999981599,538532,0
"172.16.133.56",61507,"172.16.139.250",5440,10,1022,11970,0,0,10,1022,0,0,135.742534,0.014712000000002945,555736,0
"172.16.133.41",53216,"172.16.139.250",5440,12,1142,11971,0,0,12,1142,0,0,135.798315,0.0063140000000032614,1446943,0
"172.16.133.42",57200,"172.16.139.250",5440,12,1142,11972,0,0,12,1142,0,0,135.827457,0.09625299999999015,94916,0
"172.16.133.85",52346,"172.16.139.250",5440,12,1142,11973,0,0,12,1142,0,0,135.861783,0.006152999999983422,1484804,0
"172.16.133.43",57856,"172.16.139.250",5440,10,1022,11974,0,0,10,1022,0,0,135.868363,0.005684999999999718,1438170,0
"172.16.133.13",53112,"172.16.139.250",5440,10,1022,11975,0,0,10,1022,0,0,135.886731,0.005479000000008227,1492243,0
"172.16.133.41",53218,"68.64.24.250",443,6,366,11976,0,0,4,246,2,120,135.9159,0.1037290000000155,18972,9254
"172.16.133.20",62486,"172.16.139.250",5440,10,1022,11977,0,0,10,1022,0,0,135.938226,0.004938000000009879,"",""
"172.16.133.75",51052,"172.16.139.250",5440,10,1022,11978,0,0,10,1022,0,0,135.953299,0.00578700000002641,1412821,0
"172.16.133.28",49172,"172.16.139.250",5440,12,1142,11979,0,0,12,1142,0,0,135.967188,0.014476000000001932,631113,0
"172.16.133.99",56123,"172.16.139.250",5440,10,1022,11980,0,0,10,1022,0,0,135.994086,0.004923999999988382,"",""
"172.16.133.87",60309,"172.16.139.250",5440,10,1022,11981,0,0,10,1022,0,0,136.017578,0.005418000000020129,1509043,0
"172.16.133.35",50048,"172.16.139.250",5440,12,1142,11982,0,0,12,1142,0,0,136.031496,0.021754999999984648,419949,0
"172.16.133.116",53595,"172.16.139.250",5440,12,1142,11983,0,0,12,1142,0,0,136.03163,0.006322999999980539,1444883,0
"172.16.133.116",53596,"172.16.139.250",5440,10,1022,11984,0,0,10,1022,0,0,136.038516,0.020349000000010165,401788,0
"172.16.133.84",58869,"172.16.139.250",5440,12,1142,11985,0,0,12,1142,0,0,136.052573,0.010696999999993295,854071,0
"172.16.133.116",53597,"172.16.139.250",5440,10,1022,11986,0,0,10,1022,0,0,136.059812,0.006562000000002399,1245961,0
"172.16.133.84",58870,"64.90.204.229",443,17,3023,11987,0,0,8,1734,9,1289,136.094385,4.24823600000002,3265,2427
"172.16.133.84",58871,"64.90.204.229",443,17,3860,11988,0,0,8,1748,9,2112,136.095303,4.246918999999991,3292,3978
"172.16.133.84",58872,"64.90.204.229",443,17,3030,11989,0,0,8,1746,9,1284,136.095867,4.246552000000008,3289,2418
"172.16.133.84",58873,"64.90.204.229",443,17,3032,11990,0,0,8,1748,9,1284,136.096192,4.246521000000001,3293,2418
"172.16.133.84",58874,"64.90.204.229",443,17,3002,11991,0,0,8,1774,9,1228,136.107637,4.233452999999997,3352,2320
"172.16.133.49",55870,"172.16.139.250",5440,10,1022,11992,0,0,10,1022,0,0,136.130792,0.015505999999987807,527279,0
"172.16.133.41",53219,"78.108.118.250",443,6,366,11993,0,0,4,246,2,120,136.142963,0.2044169999999781,9627,4696
"172.16.133.41",53220,"216.219.118.244",443,6,366,11994,0,0,4,246,2,120,136.144749,0.19459000000000515,10113,4933
"172.16.133.95",57043,"172.16.139.250",5440,10,1022,11995,0,0,10,1022,0,0,136.170205,0.005281999999994014,1547898,0
"172.16.133.92",57757,"172.16.139.250",5440,10,1022,11996,0,0,10,1022,0,0,136.195762,0.015422000000000935,530151,0
"172.16.133.29",61029,"172.16.139.250",5440,10,1022,11997,0,0,10,1022,0,0,136.21486,0.005414000000001806,1510158,0
"172.16.133.44",64910,"172.16.139.250",5440,10,1022,11998,0,0,10,1022,0,0,136.220397,0.006424000000009755,1272727,0
"172.16.133.207",56007,"172.16.139.250",5440,12,1142,11999,0,0,12,1142,0,0,136.245777,0.035916999999983545,254364,0
"172.16.133.83",57165,"172.16.139.250",5440,12,1142,12000,0,0,12,1142,0,0,136.255462,0.029477000000014186,309936,0
"172.16.133.93",60794,"172.16.139.250",5440,10,1022,12001,0,0,10,1022,0,0,136.272372,0.017183000000017046,475819,0
"172.16.133.40",50230,"216.115.217.254",443,7,426,12002,0,0,4,246,3,180,136.287326,0.06935599999999909,28375,20762
"172.16.133.11",55216,"172.16.139.250",5440,12,1142,12003,0,0,12,1142,0,0,136.287578,0.016559999999998354,551690,0
"172.16.133.55",57706,"172.16.139.250",5440,10,1022,12004,0,0,10,1022,0,0,136.29296,0.005604000000005271,1458957,0
"172.16.133.73",60763,"172.16.139.250",5440,12,1142,12005,0,0,12,1142,0,0,136.316102,0.08116200000000617,112564,0
"172.16.133.53",54193,"172.16.139.250",5440,10,1022,12006,0,0,10,1022,0,0,136.31938,0.08068399999999087,101333,0
"172.16.133.21",53268,"172.16.139.250",5440,10,1022,12007,0,0,10,1022,0,0,136.321447,0.06992399999998611,116926,0
"172.16.133.30",62701,"172.16.139.250",5440,10,1022,12008,0,0,10,1022,0,0,136.326388,0.08351199999998471,97902,0
"172.16.133.25",63563,"172.16.139.250",5440,12,1142,12009,0,0,12,1142,0,0,136.333464,0.07091600000001108,128828,0
"172.16.133.34",50513,"172.16.139.250",5440,12,1142,12010,0,0,12,1142,0,0,136.342055,0.07180900000000179,127226,0
"172.16.133.97",59468,"172.16.139.250",5440,10,1022,12011,0,0,10,1022,0,0,136.351738,0.06633899999999926,123245,0
"172.16.133.67",56069,"172.16.139.250",5440,12,1198,12012,0,0,12,1198,0,0,136.422314,0.0033830000000136806,"",""
"172.16.133.33",57977,"172.16.139.250",5440,10,1022,12013,0,0,10,1022,0,0,136.425024,0.014741999999984046,554605,0
"172.16.133.67",56070,"172.16.139.250",5440,10,1134,12014,0,0,10,1134,0,0,136.426054,0.01566400000001522,579162,0
"172.16.133.67",56071,"172.16.139.250",5440,10,1186,12015,0,0,10,1186,0,0,136.44213,60.597995,156,0
"172.16.133.68",60832,"172.16.139.250",5440,10,1022,12016,0,0,10,1022,0,0,136.458909,0.005581000000006497,1464970,0
"172.16.133.12",59853,"172.16.139.250",5440,10,1022,12017,0,0,10,1022,0,0,136.471115,0.008063999999990301,1013888,0
"172.16.133.40",50231,"216.219.120.244",443,6,366,12018,0,0,4,246,2,120,136.47531,0.171323000000001,11487,5603
"172.16.133.63",53961,"172.16.139.250",5440,10,1022,12019,0,0,10,1022,0,0,136.481764,0.01472400000000107,555283,0
"172.16.133.66",53981,"172.16.139.250",5440,10,1022,12020,0,0,10,1022,0,0,136.495283,0.005509999999986803,1483847,0
"172.16.133.82",61469,"172.16.139.250",5440,10,1022,12021,0,0,10,1022,0,0,136.510097,0.005616000000003396,1455840,0
"172.16.133.37",60699,"172.16.139.250",5440,10,1022,12022,0,0,10,1022,0,0,136.523527,0.00665300000000002,1228919,0
"172.16.125.220",22294,"172.16.133.233",80,7,420,12023,0,0,4,240,3,180,136.589676,0.19182599999999184,10009,7506
"172.16.133.67",56072,"96.43.146.48",443,12,1111,12024,0,0,7,682,5,429,136.618006,135.230038,40,25
"172.16.133.25",54817,"172.16.139.250",5500,24,11264,12025,0,0,24,11264,0,0,136.646919,46.753702000000004,1927,0
"172.16.133.78",59296,"172.16.139.250",5440,12,1142,12026,0,0,12,1142,0,0,136.680043,0.02932399999997415,311553,0
"172.16.133.67",56073,"172.16.139.250",5440,12,1142,12027,0,0,12,1142,0,0,136.73445,0.005961999999982481,1532371,0
"172.16.133.121",56627,"72.233.61.125",443,26,9022,12028,0,0,13,1963,13,7059,136.755531,30.51835200000002,514,1850
"172.16.133.56",61508,"172.16.139.250",5440,12,1142,12029,0,0,12,1142,0,0,136.755789,0.009028000000000702,1011962,0
"172.16.133.121",56628,"75.126.58.194",443,16,5341,12030,0,0,8,1630,8,3711,136.776739,0.45171200000001477,28867,65723
"172.16.133.41",53221,"172.16.139.250",5440,10,1022,12031,0,0,10,1022,0,0,136.812223,0.01478500000001759,552992,0
"172.16.133.121",56629,"50.18.252.109",443,23,6437,12032,0,0,12,4428,11,2009,136.82264,66.363046,533,242
"172.16.133.42",57201,"172.16.139.250",5440,12,1142,12033,0,0,12,1142,0,0,136.840254,0.0443740000000048,205886,0
"172.16.133.41",53222,"216.115.219.126",443,6,366,12034,0,0,4,246,2,120,136.848906,0.4951020000000028,3974,1938
"172.16.133.30",62702,"23.21.214.217",80,27,22255,12035,0,0,9,921,18,21334,136.848975,58.67184499999999,125,2908
"172.16.133.45",61344,"78.108.119.250",443,6,366,12036,0,0,4,246,2,120,136.850507,0.3522870000000182,5586,2725
"172.16.133.45",61345,"216.115.209.254",443,6,366,12037,0,0,4,246,2,120,136.851155,0.24433500000000663,8054,3929
"172.16.133.45",61346,"68.64.5.249",443,6,366,12038,0,0,4,246,2,120,136.852761,0.20930100000001062,9402,4586
"172.16.133.45",61347,"68.64.25.250",443,6,366,12039,0,0,4,246,2,120,136.852935,0.2100900000000081,9367,4569
"172.16.133.85",52350,"172.16.139.250",5440,12,1142,12040,0,0,12,1142,0,0,136.879218,0.0060579999999959,1508088,0
"172.16.133.43",57857,"172.16.139.250",5440,10,1022,12041,0,0,10,1022,0,0,136.882403,0.006249999999994316,1308160,0
"172.16.133.13",53113,"172.16.139.250",5440,12,1142,12042,0,0,12,1142,0,0,136.901884,0.006023999999996477,1516600,0
"172.16.133.20",62487,"172.16.139.250",5440,12,1142,12043,0,0,12,1142,0,0,136.951985,0.004831999999993286,"",""
"172.16.133.75",51053,"172.16.139.250",5440,10,1022,12044,0,0,10,1022,0,0,136.967047,0.00538899999997966,1517164,0
"172.16.133.40",50232,"216.115.220.254",443,6,366,12045,0,0,4,246,2,120,136.97736,0.4741689999999892,4150,2024
"172.16.133.121",56630,"174.129.10.56",443,20,2509,12046,0,0,10,1503,10,1006,136.97767,135.237776,88,59
"172.16.133.121",56631,"74.125.226.30",443,14,3683,12047,0,0,8,967,6,2716,136.977845,6.1230270000000075,1263,3548
"172.16.133.121",56632,"74.125.226.30",443,29,6346,12048,0,0,15,2743,14,3603,136.978005,135.368129,162,212
"172.16.133.121",56633,"204.246.169.222",443,75,58728,12049,0,0,28,3390,47,55338,136.978218,126.21787600000002,214,3507
"172.16.133.121",56634,"204.246.169.222",443,38,21744,12050,0,0,16,1759,22,19985,136.9784,126.21746399999998,111,1266
"172.16.133.121",56635,"204.246.169.222",443,69,56649,12051,0,0,24,2249,45,54400,136.978576,126.21859299999997,142,3447
"172.16.133.28",49173,"172.16.139.250",5440,10,1022,12052,0,0,10,1022,0,0,136.981189,0.015268999999989319,535464,0
"172.16.133.121",56636,"50.18.252.109",443,77,53439,12053,0,0,32,15744,45,37695,136.981629,96.203159,1309,3134
"172.16.133.121",56637,"50.18.252.109",443,18,1751,12054,0,0,9,998,9,753,136.981891,66.20278200000001,120,90
"172.16.133.121",56638,"204.246.169.222",443,106,95775,12055,0,0,36,2960,70,92815,136.983214,126.21276099999997,187,5883
"172.16.133.121",56639,"72.233.61.125",443,20,6883,12056,0,0,10,946,10,5937,136.983641,36.167226,209,1313
"172.16.133.99",56124,"172.16.139.250",5440,12,1142,12057,0,0,12,1142,0,0,137.008261,0.014274999999997817,640000,0
"172.16.133.121",56640,"174.129.10.56",443,6,372,12058,0,0,4,246,2,126,137.027344,16.938165999999995,116,59
"172.16.133.87",60310,"172.16.139.250",5440,10,1022,12059,0,0,10,1022,0,0,137.031235,0.005571000000003323,1467600,0
"172.16.133.35",50049,"172.16.139.250",5440,12,1142,12060,0,0,12,1142,0,0,137.042159,0.02961500000000683,308492,0
"172.16.133.121",56641,"204.246.169.222",443,6,372,12061,0,0,4,246,2,126,137.045535,16.913556,116,59
"172.16.133.116",53598,"172.16.139.250",5440,12,1142,12062,0,0,12,1142,0,0,137.046477,0.01249799999999368,730996,0
"172.16.133.116",53599,"172.16.139.250",5440,12,1142,12063,0,0,12,1142,0,0,137.05997,0.006696000000005142,1364396,0
"172.16.133.116",53600,"172.16.139.250",5440,10,1022,12064,0,0,10,1022,0,0,137.06769,0.005878999999993084,1390712,0
"172.16.133.84",58875,"172.16.139.250",5440,12,1142,12065,0,0,12,1142,0,0,137.067874,0.015420000000005984,592477,0
"172.16.133.30",62703,"23.21.214.217",80,88,74683,12066,0,0,33,4166,55,70517,137.080363,10.167884999999984,3277,55482
"172.16.133.116",53601,"23.0.49.244",80,24,10153,12067,0,0,12,2464,12,7689,137.106849,128.857028,152,477
"172.16.133.49",55871,"172.16.139.250",5440,12,1142,12068,0,0,12,1142,0,0,137.144367,0.01645000000002028,555379,0
"172.16.133.95",57044,"172.16.139.250",5440,12,1142,12069,0,0,12,1142,0,0,137.182998,0.006859999999988986,1331778,0
"172.16.133.26",53087,"216.219.115.250",443,6,366,12070,0,0,4,246,2,120,137.20438,0.04972800000001598,39575,19305
"172.16.133.92",57758,"172.16.139.250",5440,10,1022,12071,0,0,10,1022,0,0,137.210093,0.0054879999999855045,1489795,0
"172.16.133.29",61030,"172.16.139.250",5440,10,1022,12072,0,0,10,1022,0,0,137.227957,0.015393999999986363,531116,0
"172.16.133.26",53088,"67.217.66.244",443,6,366,12073,0,0,4,246,2,120,137.233221,0.06205300000002012,31714,15470
"172.16.133.44",64911,"172.16.139.250",5440,10,1022,12074,0,0,10,1022,0,0,137.234304,0.015533000000004904,526363,0
"172.16.133.30",62704,"23.21.214.217",80,87,53854,12075,0,0,43,6059,44,47795,137.257027,9.991137000000009,4851,38269
"172.16.133.207",56008,"172.16.139.250",5440,12,1142,12076,0,0,12,1142,0,0,137.26007,0.01845599999998626,495015,0
"172.16.133.26",53089,"68.64.13.250",443,6,366,12077,0,0,4,246,2,120,137.265459,0.11429499999999848,17218,8399
"172.16.133.26",53090,"68.64.30.250",443,6,366,12078,0,0,4,246,2,120,137.267508,0.08734000000001174,22532,10991
"172.16.133.83",57166,"172.16.139.250",5440,12,1142,12079,0,0,12,1142,0,0,137.269713,0.004897999999997182,"",""
"172.16.133.93",60795,"172.16.139.250",5440,12,1142,12080,0,0,12,1142,0,0,137.286366,0.014385000000004311,635106,0
"172.16.133.16",59339,"173.194.75.147",443,36,8499,12081,0,0,18,5773,18,2726,137.294235,135.57089500000004,340,160
"172.16.133.11",55217,"172.16.139.250",5440,10,1022,12082,0,0,10,1022,0,0,137.301877,0.005398000000013781,1514635,0
"172.16.133.55",57707,"172.16.139.250",5440,10,1022,12083,0,0,10,1022,0,0,137.307147,0.014708000000013044,555887,0
"172.16.133.73",60764,"96.43.146.22",443,19,4165,12084,0,0,11,3268,8,897,137.320595,135.250775,193,53
"172.16.133.73",60765,"172.16.139.250",5440,12,1142,12085,0,0,12,1142,0,0,137.330099,0.020710000000008222,441139,0
"172.16.133.53",54194,"172.16.139.250",5440,10,1022,12086,0,0,10,1022,0,0,137.331909,0.005428999999992357,1505986,0
"172.16.133.21",53269,"172.16.139.250",5440,10,1022,12087,0,0,10,1022,0,0,137.336265,0.005448999999998705,1500458,0
"172.16.133.30",62705,"172.16.139.250",5440,10,1022,12088,0,0,10,1022,0,0,137.339602,0.006160999999991645,1327057,0
"172.16.133.25",63564,"172.16.139.250",5440,12,1142,12089,0,0,12,1142,0,0,137.347404,0.01656899999997563,551391,0
"172.16.133.34",50514,"172.16.139.250",5440,10,1022,12090,0,0,10,1022,0,0,137.354961,0.005124999999992497,1595317,0
"172.16.133.97",59469,"172.16.139.250",5440,10,1022,12091,0,0,10,1022,0,0,137.365839,0.005343000000010534,1530226,0
"172.16.133.33",57978,"172.16.139.250",5440,10,1022,12092,0,0,10,1022,0,0,137.439021,0.005606999999997697,1458177,0
"172.16.133.46",64584,"192.147.107.14",8883,8,521,12093,0,0,5,335,3,186,137.470238,0.1098700000000008,24392,13543
"172.16.133.68",60833,"172.16.139.250",5440,10,1022,12094,0,0,10,1022,0,0,137.471596,0.014530000000007703,562697,0
"172.16.133.12",59854,"172.16.139.250",5440,12,1142,12095,0,0,12,1142,0,0,137.48515,0.016086000000001377,567947,0
"172.16.133.63",53962,"172.16.139.250",5440,12,1142,12096,0,0,12,1142,0,0,137.496076,0.008841000000018084,1033367,0
"172.16.133.66",53982,"172.16.139.250",5440,10,1022,12097,0,0,10,1022,0,0,137.509245,0.005516999999997552,1481964,0
"172.16.133.82",61470,"172.16.139.250",5440,12,1142,12098,0,0,12,1142,0,0,137.52409,0.006412000000011631,1424828,0
"172.16.133.37",60701,"172.16.139.250",5440,12,1142,12099,0,0,12,1142,0,0,137.53832,0.0064289999999971315,1421060,0
"172.16.133.184",46338,"173.194.43.60",443,6,412,12100,0,0,4,272,2,140,137.63989,0.04347199999997997,50055,25763
"172.16.133.184",37039,"173.194.43.59",443,6,412,12101,0,0,4,272,2,140,137.685186,0.04070700000002603,53455,27513
"172.16.133.78",59297,"172.16.139.250",5440,12,1142,12102,0,0,12,1142,0,0,137.693282,0.0065439999999910015,1396088,0
"172.16.133.67",56074,"172.16.139.250",5440,10,1022,12103,0,0,10,1022,0,0,137.747448,0.005391000000003032,1516601,0
"172.16.133.184",54783,"98.139.225.42",443,6,412,12104,0,0,4,272,2,140,137.760933,0.0787559999999985,27629,14221
"172.16.133.56",61509,"172.16.139.250",5440,12,1142,12105,0,0,12,1142,0,0,137.770707,0.004777000000018461,"",""
"172.16.133.41",53223,"172.16.139.250",5440,8,902,12106,0,0,8,902,0,0,137.826402,0.005635000000012269,1280567,0
"172.16.133.184",34432,"173.194.43.57",443,6,412,12107,0,0,4,272,2,140,137.843549,0.04523399999999356,48105,24760
"172.16.133.42",57202,"172.16.139.250",5440,12,1142,12108,0,0,12,1142,0,0,137.86128,0.03709600000001956,246279,0
"172.16.133.85",52351,"172.16.139.250",5440,10,1022,12109,0,0,10,1022,0,0,137.889604,0.005455000000011978,1498808,0
"172.16.133.184",43068,"76.13.234.33",443,6,374,12110,0,0,4,254,2,120,137.889677,0.05811399999998912,34965,16519
"172.16.133.43",57858,"172.16.139.250",5440,10,1022,12111,0,0,10,1022,0,0,137.897106,0.005616000000003396,1455840,0
"172.16.133.13",53114,"172.16.139.250",5440,10,1022,12112,0,0,10,1022,0,0,137.914913,0.005566999999985001,1468654,0
"172.16.133.184",58178,"65.54.81.135",443,8,544,12113,0,0,4,272,4,272,137.949262,0.053404999999997926,40745,40745
"172.16.133.20",62488,"172.16.139.250",5440,12,1142,12114,0,0,12,1142,0,0,137.96377,0.014848000000000638,615301,0
"172.16.133.75",51054,"172.16.139.250",5440,12,1142,12115,0,0,12,1142,0,0,137.981269,0.006003999999990128,1521652,0
"172.16.133.28",49174,"172.16.139.250",5440,10,1022,12116,0,0,10,1022,0,0,137.994462,0.015330000000005839,533333,0
"172.16.133.184",46344,"173.194.43.60",443,6,412,12117,0,0,4,272,2,140,138.004351,0.09045199999999909,24056,12382
"172.16.133.99",56125,"172.16.139.250",5440,10,1022,12118,0,0,10,1022,0,0,138.02179,0.0146220000000028,559157,0
"172.16.133.87",60311,"172.16.139.250",5440,10,1022,12119,0,0,10,1022,0,0,138.044759,0.02035799999998744,401611,0
"172.16.133.35",50050,"172.16.139.250",5440,12,1142,12120,0,0,12,1142,0,0,138.053897,0.025707999999980302,355375,0
"172.16.133.116",53602,"172.16.139.250",5440,10,1022,12121,0,0,10,1022,0,0,138.060168,0.012569999999982429,650437,0
"172.16.133.116",53603,"172.16.139.250",5440,10,1022,12122,0,0,10,1022,0,0,138.074069,0.005077999999997473,1610082,0
"172.16.133.116",53604,"172.16.139.250",5440,10,1022,12123,0,0,10,1022,0,0,138.080199,0.005854999999996835,1396413,0
"172.16.133.84",58876,"172.16.139.250",5440,10,1022,12124,0,0,10,1022,0,0,138.081247,0.008631000000008271,947283,0
"172.16.133.184",40742,"173.194.43.58",443,6,412,12125,0,0,4,272,2,140,138.094597,0.04819499999999266,45149,23238
"172.16.133.49",55872,"172.16.139.250",5440,12,1142,12126,0,0,12,1142,0,0,138.158507,0.015578000000004977,586468,0
"172.16.133.184",46632,"205.210.187.119",443,6,374,12127,0,0,4,254,2,120,138.190762,0.10029499999998848,20260,9571
"172.16.133.95",57045,"172.16.139.250",5440,12,1142,12128,0,0,12,1142,0,0,138.19755,0.006090999999997848,1499917,0
"172.16.133.30",62707,"208.68.110.119",80,8,863,12129,0,0,5,536,3,327,138.206675,0.2946760000000097,14551,8877
"172.16.133.54",64707,"72.21.91.196",80,6,372,12130,0,0,4,246,2,126,138.219405,6.011006000000009,327,167
"172.16.133.92",57759,"172.16.139.250",5440,10,1022,12131,0,0,10,1022,0,0,138.223747,0.00575399999999604,1420924,0
"172.16.133.29",61031,"172.16.139.250",5440,12,1142,12132,0,0,12,1142,0,0,138.241985,0.006311000000010836,1447631,0
"172.16.133.44",64912,"172.16.139.250",5440,12,1142,12133,0,0,12,1142,0,0,138.254501,0.006250999999991791,1461526,0
"172.16.133.207",56009,"172.16.139.250",5440,12,1142,12134,0,0,12,1142,0,0,138.27389,0.005004000000013775,1825739,0
"172.16.133.83",57167,"172.16.139.250",5440,10,1022,12135,0,0,10,1022,0,0,138.28364,0.004754000000019687,"",""
"172.16.133.39",64271,"174.129.24.9",443,2015,2048780,12136,0,0,677,48106,1338,2000674,138.288876,12.231484000000023,31463,1308540
"172.16.133.184",36271,"64.208.138.117",443,6,412,12137,0,0,4,272,2,140,138.292913,0.045802000000009,47508,24453
"172.16.133.93",60796,"172.16.139.250",5440,12,1142,12138,0,0,12,1142,0,0,138.299417,0.014583999999985053,626439,0
"172.16.133.11",55218,"172.16.139.250",5440,12,1142,12139,0,0,12,1142,0,0,138.315746,0.015492000000023154,589723,0
"172.16.133.55",57708,"172.16.139.250",5440,10,1022,12140,0,0,10,1022,0,0,138.32143,0.01529300000001399,534623,0
"172.16.133.40",50233,"216.115.217.254",443,6,366,12141,0,0,4,246,2,120,138.326453,0.06421700000001351,30646,14949
"172.16.133.113",55648,"96.43.146.48",443,15,3254,12142,0,0,9,2457,6,797,138.335748,81.75836900000002,240,77
"172.16.133.113",55649,"96.43.146.48",443,12,1066,12143,0,0,6,560,6,506,138.343372,81.79239700000002,54,49
"172.16.133.73",60766,"172.16.139.250",5440,10,1022,12144,0,0,10,1022,0,0,138.34383,0.02162000000001285,378168,0
"172.16.133.53",54195,"172.16.139.250",5440,12,1142,12145,0,0,12,1142,0,0,138.346829,0.008293999999978041,1101519,0
"172.16.133.21",53270,"172.16.139.250",5440,12,1142,12146,0,0,12,1142,0,0,138.349939,0.020017999999993208,456389,0
"172.16.133.30",62708,"172.16.139.250",5440,10,1022,12147,0,0,10,1022,0,0,138.353497,0.007892999999995709,1035854,0
"172.16.133.25",63565,"172.16.139.250",5440,12,1142,12148,0,0,12,1142,0,0,138.360134,0.013457000000016706,678903,0
"172.16.133.34",50515,"172.16.139.250",5440,10,1022,12149,0,0,10,1022,0,0,138.370253,0.014957000000009657,546633,0
"172.16.133.184",45013,"64.215.255.95",443,5,314,12150,0,0,3,194,2,120,138.37307,0.06080599999998526,25523,15787
"172.16.133.97",59470,"172.16.139.250",5440,10,1022,12151,0,0,10,1022,0,0,138.380268,0.008729999999985694,936540,0
"172.16.133.30",62709,"208.68.110.117",80,72,55519,12152,0,0,28,3992,44,51527,138.433538,8.880987000000005,3595,46415
"172.16.133.184",58503,"50.22.198.102",443,7,478,12153,0,0,4,272,3,206,138.435855,0.061001000000004524,35671,27015
"172.16.133.54",64708,"176.32.96.6",80,23,14857,12154,0,0,9,1515,14,13342,138.440848,122.78428299999999,98,869
"172.16.133.54",64709,"176.32.96.6",80,6,368,12155,0,0,4,246,2,122,138.441056,5.792755999999997,339,168
"172.16.133.33",57979,"172.16.139.250",5440,12,1142,12156,0,0,12,1142,0,0,138.453778,0.0065820000000087475,1388027,0
"172.16.133.68",60834,"172.16.139.250",5440,10,1022,12157,0,0,10,1022,0,0,138.48614800000001,0.015034999999983256,543797,0
"172.16.133.184",34441,"173.194.43.57",443,6,412,12158,0,0,4,272,2,140,138.497475,0.05394699999999375,40335,20761
"172.16.133.12",59855,"172.16.139.250",5440,12,1142,12159,0,0,12,1142,0,0,138.499069,0.007272000000000389,1256325,0
"172.16.133.63",53964,"172.16.139.250",5440,10,1022,12160,0,0,10,1022,0,0,138.510151,0.005337999999994736,1531659,0
"172.16.133.66",53983,"172.16.139.250",5440,10,1022,12161,0,0,10,1022,0,0,138.526523,0.005504000000001952,1485465,0
"172.16.133.82",61471,"172.16.139.250",5440,10,1022,12162,0,0,10,1022,0,0,138.537252,0.015420000000005984,530220,0
"172.16.133.37",60702,"172.16.139.250",5440,12,1142,12163,0,0,12,1142,0,0,138.552028,0.0062399999999911415,1464102,0
"172.16.133.40",50234,"216.219.120.244",443,6,366,12164,0,0,4,246,2,120,138.558216,0.18300899999999842,10753,5245
"172.16.133.54",64710,"199.27.74.193",80,6,372,12165,0,0,4,246,2,126,138.575236,5.703009000000009,345,176
"172.16.133.54",64711,"199.27.74.193",80,6,372,12166,0,0,4,246,2,126,138.628756,5.648659999999978,348,178
"172.16.133.30",62710,"208.68.110.119",80,8,863,12167,0,0,5,536,3,327,138.636974,0.3130740000000003,13696,8355
"172.16.133.54",64712,"173.204.219.5",80,8,2103,12168,0,0,5,1091,3,1012,138.662477,0.08321699999999055,104882,97287
"172.16.133.54",64713,"216.52.121.177",80,9,1389,12169,0,0,5,778,4,611,138.663046,0.08365799999998558,74398,58428
"172.16.133.54",64714,"204.13.194.137",80,39,19175,12170,0,0,18,9176,21,9999,138.671033,24.884342000000004,2949,3214
"172.16.133.54",64715,"204.13.194.137",80,6,372,12171,0,0,4,246,2,126,138.692117,5.537351000000001,355,182
"172.16.133.54",64716,"216.52.121.177",80,7,432,12172,0,0,4,246,3,186,138.692384,5.544173000000001,354,268
"172.16.133.78",59298,"172.16.139.250",5440,12,1142,12173,0,0,12,1142,0,0,138.70843,0.006675999999998794,1368484,0
"172.16.133.67",56075,"172.16.139.250",5440,12,1142,12174,0,0,12,1142,0,0,138.761854,0.12174100000001431,75044,0
"172.16.133.56",61510,"172.16.139.250",5440,10,1022,12175,0,0,10,1022,0,0,138.784106,0.10220200000000546,79998,0
"172.16.133.54",64717,"108.170.193.53",80,11,3824,12176,0,0,6,2281,5,1543,138.795273,0.24115000000000464,75670,51188
"172.16.133.54",64718,"108.170.193.53",80,11,3824,12177,0,0,6,2281,5,1543,138.796494,0.23930799999999408,76253,51582
"172.16.133.54",64719,"108.170.193.53",80,11,3820,12178,0,0,6,2281,5,1539,138.797667,0.23796200000001022,76684,51739
"172.16.133.54",64720,"108.170.193.53",80,12,3885,12179,0,0,6,2282,6,1603,138.80086,0.24081100000000788,75810,53253
"172.16.133.54",64721,"108.170.193.53",80,11,3820,12180,0,0,6,2281,5,1539,138.801859,0.24170499999999606,75496,50938
"172.16.133.54",64722,"108.170.193.53",80,11,3812,12181,0,0,6,2281,5,1531,138.802303,0.24058899999999994,75847,50908
"172.16.133.41",53224,"172.16.139.250",5440,10,1022,12182,0,0,10,1022,0,0,138.839296,0.05764700000000289,141828,0
"172.16.133.42",57203,"172.16.139.250",5440,12,1142,12183,0,0,12,1142,0,0,138.87339,0.03760600000001091,242939,0
"172.16.133.85",52352,"172.16.139.250",5440,12,1142,12184,0,0,12,1142,0,0,138.908448,0.007287000000019361,1253739,0
"172.16.133.43",57859,"172.16.139.250",5440,10,1022,12185,0,0,10,1022,0,0,138.911394,0.008277999999990016,987678,0
"172.16.133.13",53115,"172.16.139.250",5440,12,1142,12186,0,0,12,1142,0,0,138.929638,0.006253999999984217,1460825,0
"172.16.133.30",62711,"208.68.110.119",80,8,861,12187,0,0,5,535,3,326,138.955609,0.33178899999998634,12899,7860
"172.16.133.45",61348,"68.64.5.249",443,6,366,12188,0,0,4,246,2,120,138.971709,0.12416199999998412,15850,7731
"172.16.133.45",61349,"68.64.25.250",443,6,366,12189,0,0,4,246,2,120,138.973613,0.12128899999999021,16225,7914
"172.16.133.20",62489,"172.16.139.250",5440,10,1022,12190,0,0,10,1022,0,0,138.980739,0.005808999999999287,1407471,0
"172.16.133.54",64723,"108.170.193.53",80,11,3820,12191,0,0,6,2281,5,1539,138.983549,0.19506799999999203,93546,63116
"172.16.133.45",61350,"216.115.209.254",443,6,366,12192,0,0,4,246,2,120,138.985533,0.20770600000000172,9474,4621
"172.16.133.54",64724,"108.170.193.53",80,12,3884,12193,0,0,6,2281,6,1603,138.987687,0.2473410000000058,73776,51847
"172.16.133.54",64725,"108.170.193.53",80,11,3824,12194,0,0,6,2281,5,1543,138.988116,0.2470220000000154,73871,49971
"172.16.133.54",64726,"98.138.49.43",80,34,16204,12195,0,0,17,8381,17,7823,138.989628,28.47564699999998,2354,2197
"172.16.133.54",64727,"98.138.49.43",80,55,28968,12196,0,0,28,15027,27,13941,138.98984,28.545158000000015,4211,3907
"172.16.133.54",64728,"98.138.49.43",80,45,22822,12197,0,0,23,11799,22,11023,138.990065,28.468328000000014,3315,3097
"172.16.133.54",64729,"108.170.193.53",80,11,3820,12198,0,0,6,2281,5,1539,138.990284,0.7606560000000115,23989,16186
"172.16.133.54",64730,"108.170.193.53",80,11,3820,12199,0,0,6,2281,5,1539,138.990459,0.24437500000001933,74672,50381
"172.16.133.54",64731,"108.170.193.53",80,12,3880,12200,0,0,6,2281,6,1599,138.990897,0.25992500000000973,70204,49214
"172.16.133.45",61351,"78.108.119.250",443,6,366,12201,0,0,4,246,2,120,138.992577,0.3166569999999922,6214,3031
"172.16.133.75",51055,"172.16.139.250",5440,12,1142,12202,0,0,12,1142,0,0,138.995509,0.01750300000000493,521967,0
"172.16.133.54",64732,"98.138.49.43",80,39,18664,12203,0,0,20,10090,19,8574,139.002015,28.459630000000004,2836,2410
"172.16.133.54",64733,"98.138.49.43",80,39,19392,12204,0,0,20,10090,19,9302,139.002964,28.45558700000001,2836,2615
"172.16.133.54",64734,"98.138.49.43",80,39,19418,12205,0,0,20,10090,19,9328,139.003215,28.45544799999999,2836,2622
"172.16.133.28",49175,"172.16.139.250",5440,12,1142,12206,0,0,12,1142,0,0,139.009539,0.016832000000022163,542775,0
"172.16.133.99",56126,"172.16.139.250",5440,12,1142,12207,0,0,12,1142,0,0,139.036628,0.005103999999988673,1789968,0
"172.16.133.87",60312,"172.16.139.250",5440,10,1022,12208,0,0,10,1022,0,0,139.060202,0.005901999999991858,1385293,0
"172.16.133.35",50051,"172.16.139.250",5440,12,1142,12209,0,0,12,1142,0,0,139.067628,0.008036999999973204,1136742,0
"172.16.133.116",53605,"172.16.139.250",5440,12,1142,12210,0,0,12,1142,0,0,139.073069,0.006618000000003121,1380477,0
"172.16.133.116",53606,"172.16.139.250",5440,12,1142,12211,0,0,12,1142,0,0,139.080595,0.006885000000011132,1326942,0
"172.16.133.116",53607,"172.16.139.250",5440,10,1022,12212,0,0,10,1022,0,0,139.088155,0.015088999999989028,541851,0
"172.16.133.54",64735,"108.170.193.53",80,12,3859,12213,0,0,6,2268,6,1591,139.096273,0.21209300000001008,85547,60011
"172.16.133.84",58877,"172.16.139.250",5440,10,1022,12214,0,0,10,1022,0,0,139.096274,0.015095000000002301,541636,0
"172.16.133.20",52446,"172.16.139.250",5500,22,10364,12215,0,0,22,10364,0,0,139.137365,2.8724160000000154,28864,0
"172.16.133.49",55873,"172.16.139.250",5440,12,1142,12216,0,0,12,1142,0,0,139.172765,0.006797000000005937,1344122,0
"172.16.133.95",57046,"172.16.139.250",5440,10,1022,12217,0,0,10,1022,0,0,139.210948,0.005865000000000009,1394032,0
"172.16.133.40",50235,"216.115.220.254",443,6,366,12218,0,0,4,246,2,120,139.225579,0.47791200000000345,4117,2008
"172.16.133.26",53091,"216.219.115.250",443,6,366,12219,0,0,4,246,2,120,139.228461,0.06092799999998988,32300,15756
"172.16.133.92",57760,"172.16.139.250",5440,12,1142,12220,0,0,12,1142,0,0,139.237892,0.006355000000013433,1437608,0
"172.16.133.29",61032,"172.16.139.250",5440,10,1022,12221,0,0,10,1022,0,0,139.256607,0.01647199999999316,496357,0
"172.16.133.44",64913,"172.16.139.250",5440,10,1022,12222,0,0,10,1022,0,0,139.262628,0.005478999999979806,1492243,0
"172.16.133.26",53092,"67.217.66.244",443,6,366,12223,0,0,4,246,2,120,139.27163,0.07374599999999987,26686,13017
"172.16.133.207",56010,"172.16.139.250",5440,10,1022,12224,0,0,10,1022,0,0,139.287885,0.004921000000024378,"",""
"172.16.133.30",62712,"208.68.110.119",80,8,873,12225,0,0,5,541,3,332,139.289644,0.3264329999999802,13258,8136
"172.16.133.83",57168,"172.16.139.250",5440,12,1142,12226,0,0,12,1142,0,0,139.297696,0.01370099999999752,666812,0
"172.16.133.26",53093,"68.64.30.250",443,6,366,12227,0,0,4,246,2,120,139.308465,0.14577699999998117,13500,6585
"172.16.133.93",60797,"172.16.139.250",5440,12,1142,12228,0,0,12,1142,0,0,139.314264,0.014747999999997319,619473,0
"172.16.133.26",53094,"68.64.13.250",443,6,366,12229,0,0,4,246,2,120,139.327544,0.12944900000002235,15202,7416
"172.16.133.11",55219,"172.16.139.250",5440,12,1142,12230,0,0,12,1142,0,0,139.32972,0.0054649999999867305,1671729,0
"172.16.133.23",55046,"64.90.204.229",443,20,4645,12231,0,0,9,2867,11,1778,139.331362,5.083530999999994,4511,2798
"172.16.133.55",57709,"172.16.139.250",5440,12,1142,12232,0,0,12,1142,0,0,139.337687,0.00595599999999763,1533915,0
"172.16.133.73",60767,"172.16.139.250",5440,12,1142,12233,0,0,12,1142,0,0,139.358151,0.02008700000001795,454821,0
"172.16.133.6",1692,"172.16.128.203",135,4,240,12234,0,0,2,120,2,120,139.360335,0.1157970000000148,8290,8290
"172.16.133.53",54196,"172.16.139.250",5440,12,1142,12235,0,0,12,1142,0,0,139.360416,0.021185000000002674,431248,0
"172.16.133.21",53271,"172.16.139.250",5440,10,1022,12236,0,0,10,1022,0,0,139.363966,0.006320999999985588,1293466,0
"172.16.133.30",62713,"172.16.139.250",5440,10,1022,12237,0,0,10,1022,0,0,139.366749,0.007116999999993823,1148798,0
"172.16.133.25",63566,"172.16.139.250",5440,12,1142,12238,0,0,12,1142,0,0,139.3756,0.0463500000000181,197108,0
"172.16.133.54",64736,"74.121.139.112",80,18,7781,12239,0,0,10,3676,8,4105,139.381156,10.845841000000007,2711,3027
"172.16.133.34",50516,"172.16.139.250",5440,10,1022,12240,0,0,10,1022,0,0,139.383888,0.05097699999998895,160386,0
"172.16.133.54",64737,"74.121.139.112",80,6,372,12241,0,0,4,246,2,126,139.386113,5.922264000000013,332,170
"172.16.133.97",59471,"172.16.139.250",5440,10,1022,12242,0,0,10,1022,0,0,139.394065,0.03368999999997868,242683,0
"172.16.133.12",59856,"172.16.139.250",5440,12,1142,12243,0,0,12,1142,0,0,139.405696,0.02639500000000794,346126,0
"172.16.133.16",59340,"31.13.77.58",443,221,204684,12244,0,0,71,5676,150,199008,139.452431,126.950175,357,12540
"172.16.133.33",57980,"172.16.139.250",5440,12,1142,12245,0,0,12,1142,0,0,139.467054,0.01044000000001688,875095,0
"172.16.133.16",59341,"208.47.254.27",443,32,17939,12246,0,0,15,2458,17,15481,139.477441,135.828688,144,911
"172.16.133.20",62490,"96.43.146.176",443,20,4042,12247,0,0,11,2475,9,1567,139.498771,75.06664899999998,263,166
"172.16.133.68",60835,"172.16.139.250",5440,10,1022,12248,0,0,10,1022,0,0,139.499814,0.005643000000020493,1448874,0
"172.16.133.12",59857,"172.16.139.250",5440,12,1142,12249,0,0,12,1142,0,0,139.514723,0.009111999999987574,1002633,0
"172.16.133.63",53965,"172.16.139.250",5440,12,1142,12250,0,0,12,1142,0,0,139.525222,0.005908999999974185,1546116,0
"172.16.133.66",53984,"172.16.139.250",5440,12,1142,12251,0,0,12,1142,0,0,139.53745,0.00628799999998364,1452926,0
"172.16.133.82",61472,"172.16.139.250",5440,10,1022,12252,0,0,10,1022,0,0,139.551949,0.016142999999999574,506473,0
"172.16.133.37",60703,"172.16.139.250",5440,12,1142,12253,0,0,12,1142,0,0,139.564023,0.008975000000020827,1017938,0
"172.16.133.54",64738,"69.89.93.5",80,6,372,12254,0,0,4,246,2,126,139.577174,5.7716359999999725,340,174
"172.16.133.54",64739,"69.89.93.5",80,14,2500,12255,0,0,8,1424,6,1076,139.577442,28.71874600000001,396,299
"172.16.133.16",59342,"208.47.254.27",443,34,11676,12256,0,0,17,4436,17,7240,139.581025,140.21135299999997,253,413
"172.16.133.16",59343,"31.13.77.58",443,23,2130,12257,0,0,12,1218,11,912,139.582606,130.192592,74,56
"172.16.133.16",59344,"23.67.243.42",443,19,5865,12258,0,0,9,1398,10,4467,139.618881,50.07275900000002,223,713
"172.16.133.16",59345,"23.67.243.42",443,21,6353,12259,0,0,10,1480,11,4873,139.619298,50.073406000000006,236,778
"172.16.133.30",62714,"208.68.110.119",80,8,865,12260,0,0,5,537,3,328,139.61948,0.2882239999999854,14905,9104
"172.16.133.16",59346,"23.67.243.42",443,19,5929,12261,0,0,9,1398,10,4531,139.619557,50.073328000000004,223,723
"172.16.133.16",59347,"23.67.243.42",443,30,14320,12262,0,0,13,2548,17,11772,139.619786,50.07320099999998,407,1880
"172.16.133.16",59348,"23.67.243.42",443,26,10861,12263,0,0,12,2520,14,8341,139.619973,60.08973900000001,335,1110
"172.16.133.78",59299,"172.16.139.250",5440,10,1022,12264,0,0,10,1022,0,0,139.721122,0.014735999999999194,554831,0
"172.16.133.67",56076,"172.16.139.250",5440,10,1022,12265,0,0,10,1022,0,0,139.775667,0.005665999999990845,1442993,0
"172.16.133.56",61511,"172.16.139.250",5440,10,1022,12266,0,0,10,1022,0,0,139.798146,0.004764999999991915,"",""
"172.16.133.41",53225,"172.16.139.250",5440,10,1022,12267,0,0,10,1022,0,0,139.85426,0.016470999999995684,496387,0
"172.16.133.54",64740,"157.56.134.97",80,13,6194,12268,0,0,7,2564,6,3630,139.876718,0.13192799999998783,155478,220120
"172.16.133.42",57204,"172.16.139.250",5440,12,1142,12269,0,0,12,1142,0,0,139.884567,0.018966000000006034,481704,0
"172.16.133.30",62715,"208.68.110.119",80,8,861,12270,0,0,5,535,3,326,139.911795,0.3296959999999842,12981,7910
"172.16.133.85",52353,"172.16.139.250",5440,10,1022,12271,0,0,10,1022,0,0,139.918693,0.005575000000021646,1466547,0
"172.16.133.43",57860,"172.16.139.250",5440,10,1022,12272,0,0,10,1022,0,0,139.924989,0.005219999999980018,1566283,0
"172.16.133.16",59349,"23.67.242.73",443,49,34945,12273,0,0,20,2538,29,32407,139.92539,139.71867000000003,145,1855
"172.16.133.16",59350,"23.67.242.73",443,52,38264,12274,0,0,20,2538,32,35726,139.92577,139.71829200000002,145,2045
"172.16.133.16",59351,"23.67.242.73",443,38,26065,12275,0,0,15,1775,23,24290,139.927677,135.271715,104,1436
"172.16.133.16",59352,"23.67.242.73",443,27,14851,12276,0,0,12,1595,15,13256,139.928218,135.233438,94,784
"172.16.133.13",53116,"172.16.139.250",5440,12,1142,12277,0,0,12,1142,0,0,139.942608,0.005922999999995682,1542461,0
"172.16.133.113",55650,"172.16.139.250",135,8,492,12278,0,0,8,492,0,0,139.954722,0.013073999999988928,301055,0
"172.16.133.113",55651,"172.16.139.250",5462,12,816,12279,0,0,12,816,0,0,139.978617,0.5076579999999922,12859,0
"172.16.133.34",50517,"173.194.75.105",443,217,133968,12280,0,0,87,19311,130,114657,139.992054,129.039083,1197,7108
"172.16.133.20",62491,"172.16.139.250",5440,12,1142,12281,0,0,12,1142,0,0,139.992246,0.007520999999997002,1214732,0
"172.16.133.54",64741,"204.154.111.33",80,11,2502,12282,0,0,6,1976,5,526,139.994948,0.09012100000001055,175408,46692
"172.16.133.23",55047,"64.90.204.229",443,17,2655,12283,0,0,8,1580,9,1075,140.004602,4.409316999999987,2866,1950
"172.16.133.54",64742,"208.47.254.57",80,6,372,12284,0,0,4,246,2,126,140.005085,5.282724000000002,372,190
"172.16.133.75",51056,"172.16.139.250",5440,12,1142,12285,0,0,12,1142,0,0,140.009271,0.005733999999989692,1593303,0
"172.16.133.54",64743,"204.154.111.33",80,5,306,12286,0,0,3,186,2,120,140.01333,5.27428900000001,282,182
"172.16.133.28",49176,"172.16.139.250",5440,12,1142,12287,0,0,12,1142,0,0,140.022288,0.006099000000006072,1497950,0
"172.16.133.16",59353,"31.13.74.10",443,64,39247,12288,0,0,26,2542,38,36705,140.033989,120.25701699999999,169,2441
"172.16.133.99",56127,"172.16.139.250",5440,12,1142,12289,0,0,12,1142,0,0,140.049755,0.01130200000000059,808352,0
"172.16.133.87",60313,"172.16.139.250",5440,10,1022,12290,0,0,10,1022,0,0,140.073997,0.007025999999996202,1163677,0
"172.16.133.116",53608,"172.16.139.250",5440,10,1022,12291,0,0,10,1022,0,0,140.087966,0.005570000000005848,1467863,0
"172.16.133.35",50052,"172.16.139.250",5440,12,1142,12292,0,0,12,1142,0,0,140.093693,0.09913499999998976,92157,0
"172.16.133.116",53609,"172.16.139.250",5440,10,1022,12293,0,0,10,1022,0,0,140.094513,0.005047999999987951,1619651,0
"172.16.133.40",50236,"202.173.27.250",443,6,366,12294,0,0,4,246,2,120,140.095376,0.5553629999999998,3543,1728
"172.16.133.116",53610,"172.16.139.250",5440,10,1022,12295,0,0,10,1022,0,0,140.100376,0.005761999999975842,1418951,0
"172.16.133.84",58878,"172.16.139.250",5440,10,1022,12296,0,0,10,1022,0,0,140.110025,0.015627999999992426,523163,0
"172.16.133.235",2700,"172.16.131.10",8080,20,3933,12297,0,0,10,2319,10,1614,140.110376,18.610696999999988,996,693
"173.194.43.7",80,"172.16.133.27",60918,4,264,12298,0,0,2,132,2,132,140.111062,0.1118799999999851,9438,9438
"172.16.133.49",55874,"172.16.139.250",5440,10,1022,12299,0,0,10,1022,0,0,140.186697,0.005632999999988897,1451446,0
"172.16.133.54",64744,"65.54.81.133",80,9,558,12300,0,0,5,312,4,246,140.192948,9.063642999999985,275,217
"172.16.133.48",60523,"199.47.216.177",443,23,10754,12301,0,0,6,1956,17,8798,140.22169,60.64309800000001,258,1160
"172.16.133.95",57047,"172.16.139.250",5440,12,1142,12302,0,0,12,1142,0,0,140.225475,0.006092000000023745,1499671,0
"172.16.133.84",58879,"64.90.204.229",443,20,4662,12303,0,0,9,2865,11,1797,140.246661,5.097814999999997,4496,2820
"172.16.133.30",62716,"208.68.110.119",80,8,863,12304,0,0,5,536,3,327,140.247363,0.3174769999999967,13506,8239
"172.16.133.92",57761,"172.16.139.250",5440,10,1022,12305,0,0,10,1022,0,0,140.252206,0.015288999999995667,534763,0
"172.16.133.29",61033,"172.16.139.250",5440,10,1022,12306,0,0,10,1022,0,0,140.270925,0.005340999999987162,1530799,0
"172.16.133.44",64914,"172.16.139.250",5440,10,1022,12307,0,0,10,1022,0,0,140.276955,0.014812000000006265,551984,0
"172.16.133.207",56011,"172.16.139.250",5440,12,1142,12308,0,0,12,1142,0,0,140.302284,0.014310000000023138,638434,0
"172.16.133.83",57169,"172.16.139.250",5440,12,1142,12309,0,0,12,1142,0,0,140.31178,0.013701999999994996,666763,0
"172.16.133.93",60802,"172.16.139.250",5440,10,1022,12310,0,0,10,1022,0,0,140.327231,0.00482900000000086,"",""
"172.16.133.11",55220,"172.16.139.250",5440,10,1022,12311,0,0,10,1022,0,0,140.343986,0.015250000000008868,536131,0
"172.16.133.55",57710,"172.16.139.250",5440,10,1022,12312,0,0,10,1022,0,0,140.349481,0.0055240000000083,1480086,0
"172.16.133.73",60768,"172.16.139.250",5440,10,1022,12313,0,0,10,1022,0,0,140.370941,0.0054110000000093805,1510996,0
"172.16.133.53",54197,"172.16.139.250",5440,10,1022,12314,0,0,10,1022,0,0,140.374957,0.00566499999999337,1443248,0
"172.16.133.21",53272,"172.16.139.250",5440,10,1022,12315,0,0,10,1022,0,0,140.378147,0.006484000000000378,1260950,0
"172.16.133.30",62717,"172.16.139.250",5440,10,1022,12316,0,0,10,1022,0,0,140.380895,0.007578999999992675,1078770,0
"172.16.133.25",63567,"172.16.139.250",5440,12,1142,12317,0,0,12,1142,0,0,140.388101,0.005982999999986305,1526993,0
"172.16.133.34",50518,"172.16.139.250",5440,10,1022,12318,0,0,10,1022,0,0,140.397135,0.005043000000000575,1621257,0
"172.16.133.63",53966,"174.129.29.218",80,10,1341,12319,0,0,5,856,5,485,140.397197,0.09531999999998675,71842,40704
"172.16.133.97",59472,"172.16.139.250",5440,10,1022,12320,0,0,10,1022,0,0,140.407931,0.005636000000009744,1450674,0
"172.16.133.54",64745,"65.54.81.133",80,50,42191,12321,0,0,20,4185,30,38006,140.421108,3.9314880000000016,8515,77336
"172.16.133.33",57981,"172.16.139.250",5440,10,1022,12322,0,0,10,1022,0,0,140.481155,0.005572999999998274,1467073,0
"172.16.133.68",60836,"172.16.139.250",5440,10,1022,12323,0,0,10,1022,0,0,140.513754,0.007701999999994769,1061542,0
"172.16.133.63",53967,"172.16.139.250",5440,10,1022,12324,0,0,10,1022,0,0,140.537527,0.006987999999978456,1170005,0
"172.16.133.12",59860,"172.16.139.250",5440,10,1022,12325,0,0,10,1022,0,0,140.548432,0.0058260000000132095,1403364,0
"172.16.133.66",53985,"172.16.139.250",5440,12,1142,12326,0,0,12,1142,0,0,140.551333,0.007279000000011138,1255117,0
"172.16.133.82",61473,"172.16.139.250",5440,10,1022,12327,0,0,10,1022,0,0,140.565112,0.005745999999987816,1422902,0
"172.16.133.54",64746,"67.69.196.139",80,87,79736,12328,0,0,32,9168,55,70568,140.566347,129.679529,565,4353
"172.16.133.37",60704,"172.16.139.250",5440,10,1022,12329,0,0,10,1022,0,0,140.579223,0.014809999999982892,552059,0
"172.16.133.16",59354,"173.194.43.60",443,40,13139,12330,0,0,21,11435,19,1704,140.589368,139.465072,655,97
"172.16.133.16",59355,"74.217.34.33",443,24,12063,12331,0,0,12,5925,12,6138,140.618987,0.28469100000000935,166496,172481
"172.16.133.54",64747,"176.32.96.31",80,177,168303,12332,0,0,63,5560,114,162743,140.641627,31.54321200000001,1410,41274
"172.16.133.54",64748,"176.32.96.31",80,22,15290,12333,0,0,10,1692,12,13598,140.64188,31.544044000000014,429,3448
"172.16.133.30",62718,"208.68.110.119",80,8,859,12334,0,0,5,534,3,325,140.66986,0.3142880000000048,13592,8272
"172.16.133.78",59300,"172.16.139.250",5440,12,1142,12335,0,0,12,1142,0,0,140.735228,0.006103999999993448,1496723,0
"172.16.133.84",58880,"64.90.204.229",443,17,2654,12336,0,0,8,1579,9,1075,140.754495,4.592337000000015,2750,1872
"172.16.133.54",64749,"50.57.17.148",80,13,3045,12337,0,0,7,1682,6,1363,140.77722,30.41554099999999,442,358
"172.16.133.54",64750,"50.57.17.148",80,7,432,12338,0,0,4,246,3,186,140.777842,5.492862000000002,358,270
"172.16.133.67",56077,"172.16.139.250",5440,10,1022,12339,0,0,10,1022,0,0,140.789637,0.005662999999998419,1443757,0
"172.16.133.56",61512,"172.16.139.250",5440,12,1142,12340,0,0,12,1142,0,0,140.812093,0.014477999999996882,631026,0
"172.16.133.132",40042,"96.43.146.22",443,7,482,12341,0,0,4,272,3,210,140.835726,0.08847900000000664,24593,18987
"172.16.133.41",53226,"172.16.139.250",5440,12,1142,12342,0,0,12,1142,0,0,140.868629,0.016109999999997626,567101,0
"172.16.133.42",57205,"172.16.139.250",5440,12,1142,12343,0,0,12,1142,0,0,140.899989,0.0141179999999963,647117,0
"172.16.133.132",47700,"96.43.146.50",443,7,482,12344,0,0,4,272,3,210,140.928329,0.10410100000001421,20902,16138
"172.16.133.85",52354,"172.16.139.250",5440,10,1022,12345,0,0,10,1022,0,0,140.93184,0.019231000000019094,425146,0
"172.16.133.43",57861,"172.16.139.250",5440,10,1022,12346,0,0,10,1022,0,0,140.939404,0.00682700000001546,1197597,0
"172.16.133.184",43347,"205.216.16.228",80,129,102330,12347,0,0,56,3466,73,98864,140.943737,0.750187000000011,36961,1054286
"172.16.133.67",56078,"172.16.139.250",5440,10,1020,12348,0,0,10,1020,0,0,140.95311,56.437275,144,0
"172.16.133.13",53117,"172.16.139.250",5440,10,1022,12349,0,0,10,1022,0,0,140.957754,0.005443000000013853,1502112,0
"172.16.133.30",62719,"208.68.110.119",80,8,873,12350,0,0,5,541,3,332,140.986495,0.3526209999999992,12273,7532
"172.16.133.20",62492,"172.16.139.250",5440,12,1142,12351,0,0,12,1142,0,0,141.00692,0.014604999999988877,625539,0
"172.16.133.75",51057,"172.16.139.250",5440,10,1022,12352,0,0,10,1022,0,0,141.023642,0.01544699999999466,529293,0
"172.16.133.28",49177,"172.16.139.250",5440,10,1022,12353,0,0,10,1022,0,0,141.036506,0.006169999999997344,1325121,0
"172.16.133.132",36691,"96.43.146.48",443,7,482,12354,0,0,4,272,3,210,141.03772,0.08078599999998914,26935,20795
"172.16.133.45",61352,"68.64.25.250",443,6,366,12355,0,0,4,246,2,120,141.038729,0.11458799999999769,17174,8377
"172.16.133.45",61353,"68.64.5.249",443,6,366,12356,0,0,4,246,2,120,141.045606,0.11770500000000084,16719,8155
"172.16.133.99",56128,"172.16.139.250",5440,10,1022,12357,0,0,10,1022,0,0,141.063546,0.01374899999999002,594661,0
"172.16.133.87",60314,"172.16.139.250",5440,10,1022,12358,0,0,10,1022,0,0,141.087983,0.018372999999996864,445000,0
"172.16.133.45",61354,"216.115.209.254",443,6,366,12359,0,0,4,246,2,120,141.095726,0.2717349999999783,7242,3532
"172.16.133.35",50053,"172.16.139.250",5440,12,1142,12360,0,0,12,1142,0,0,141.096744,0.009459999999990032,965750,0
"172.16.133.54",64751,"50.57.17.148",80,10,2610,12361,0,0,6,1688,4,922,141.099572,31.102925,434,237
"172.16.133.54",64752,"50.57.17.148",80,7,432,12362,0,0,4,246,3,186,141.100201,5.1701730000000055,380,287
"172.16.133.116",53612,"172.16.139.250",5440,12,1142,12363,0,0,12,1142,0,0,141.101001,0.010222999999996318,893671,0
"172.16.133.116",53613,"172.16.139.250",5440,12,1142,12364,0,0,12,1142,0,0,141.112235,0.00514400000000137,1776049,0
"172.16.133.116",53614,"172.16.139.250",5440,10,1022,12365,0,0,10,1022,0,0,141.11821,0.00879799999998454,929302,0
"172.16.133.84",58881,"172.16.139.250",5440,12,1142,12366,0,0,12,1142,0,0,141.124031,0.015345999999993865,595334,0
"172.16.133.132",42259,"66.235.146.171",443,7,482,12367,0,0,4,272,3,210,141.125994,0.050781999999998106,42849,33082
"172.16.133.45",61355,"78.108.119.250",443,6,366,12368,0,0,4,246,2,120,141.178839,0.30579499999998916,6435,3139
"172.16.133.132",48509,"70.42.13.100",443,6,374,12369,0,0,4,254,2,120,141.188179,0.1577180000000169,12883,6086
"172.16.133.93",60806,"199.48.204.30",80,14,6611,12370,0,0,6,1058,8,5553,141.19831,4.457656000000014,1898,9965
"172.16.133.49",55875,"172.16.139.250",5440,10,1022,12371,0,0,10,1022,0,0,141.199747,0.0062360000000012406,1311096,0
"172.16.133.93",60807,"199.48.204.30",80,8,504,12372,0,0,5,312,3,192,141.206173,16.36289499999998,152,93
"172.16.133.93",60808,"199.48.204.30",80,20,12117,12373,0,0,8,1878,12,10239,141.206454,16.363718000000006,918,5005
"172.16.133.93",60809,"199.48.204.30",80,8,504,12374,0,0,5,312,3,192,141.2067,16.378479999999996,152,93
"172.16.133.93",60810,"199.48.204.30",80,8,504,12375,0,0,5,312,3,192,141.206937,16.366269999999986,152,93
"172.16.133.93",60811,"199.48.204.30",80,8,504,12376,0,0,5,312,3,192,141.207231,16.363000999999997,152,93
"172.16.133.93",60812,"173.194.74.95",80,6,372,12377,0,0,4,246,2,126,141.209295,16.326791000000014,120,61
"172.16.133.93",60813,"173.194.74.95",80,6,372,12378,0,0,4,246,2,126,141.209514,16.325579999999974,120,61
"172.16.133.93",60814,"168.215.63.101",80,6,372,12379,0,0,3,186,3,186,141.213954,16.334261999999995,91,91
"172.16.133.93",60815,"168.215.63.101",80,6,372,12380,0,0,3,186,3,186,141.21417,16.335324000000014,91,91
"172.16.133.93",60816,"168.215.63.101",80,6,372,12381,0,0,3,186,3,186,141.214377,16.333743,91,91
"172.16.133.93",60817,"168.215.63.101",80,6,372,12382,0,0,3,186,3,186,141.214579,16.335181000000006,91,91
"172.16.133.93",60818,"74.125.226.4",80,7,432,12383,0,0,4,246,3,186,141.214833,16.32753600000001,120,91
"172.16.133.93",60819,"74.125.226.4",80,6,372,12384,0,0,4,246,2,126,141.215028,16.327067,120,61
"172.16.133.54",64753,"176.32.96.31",80,22,14206,12385,0,0,11,1752,11,12454,141.222799,30.96301699999998,452,3217
"172.16.133.95",57048,"172.16.139.250",5440,12,1142,12386,0,0,12,1142,0,0,141.239322,0.015413000000023658,592746,0
"172.16.133.26",53095,"216.219.115.250",443,6,366,12387,0,0,4,246,2,120,141.261691,0.12215899999998214,16110,7858
"172.16.133.92",57762,"172.16.139.250",5440,12,1142,12388,0,0,12,1142,0,0,141.266073,0.016103999999984353,567312,0
"172.16.133.29",61034,"172.16.139.250",5440,12,1142,12389,0,0,12,1142,0,0,141.28511,0.0061709999999948195,1480473,0
"172.16.133.44",64915,"172.16.139.250",5440,12,1142,12390,0,0,12,1142,0,0,141.291702,0.00620800000001509,1471649,0
"172.16.133.26",53096,"67.217.66.244",443,6,366,12391,0,0,4,246,2,120,141.312595,0.14460500000001275,13609,6638
"172.16.133.207",56012,"172.16.139.250",5440,10,1022,12392,0,0,10,1022,0,0,141.316108,0.01829599999999232,446873,0
"172.16.133.83",57170,"172.16.139.250",5440,10,1022,12393,0,0,10,1022,0,0,141.325686,0.004630000000020118,"",""
"172.16.133.93",60820,"172.16.139.250",5440,10,1022,12394,0,0,10,1022,0,0,141.341534,0.005107000000009521,1600939,0
"172.16.133.30",62720,"208.68.110.119",80,8,861,12395,0,0,5,535,3,326,141.341975,0.3207580000000121,13343,8130
"172.16.133.93",60821,"141.101.123.8",80,7,432,12396,0,0,4,246,3,186,141.343645,16.178922999999998,121,91
"172.16.133.93",60822,"141.101.123.8",80,7,432,12397,0,0,4,246,3,186,141.343927,16.178849999999983,121,91
"172.16.133.132",37349,"23.33.47.60",443,6,412,12398,0,0,4,272,2,140,141.349454,0.07421700000000442,29319,15090
"172.16.133.93",60823,"23.67.242.66",80,6,372,12399,0,0,4,246,2,126,141.352391,16.171629999999993,121,62
"172.16.133.93",60824,"23.67.242.66",80,6,372,12400,0,0,4,246,2,126,141.352651,16.171065,121,62
"172.16.133.11",55221,"172.16.139.250",5440,10,1022,12401,0,0,10,1022,0,0,141.357775,0.005603000000007796,1459218,0
"172.16.133.55",57711,"172.16.139.250",5440,12,1142,12402,0,0,12,1142,0,0,141.363424,0.015823999999980742,577350,0
"172.16.133.26",53097,"68.64.30.250",443,6,366,12403,0,0,4,246,2,120,141.373594,0.10074399999999173,19534,9529
"172.16.133.73",60769,"172.16.139.250",5440,12,1142,12404,0,0,12,1142,0,0,141.385252,0.015813999999977568,577715,0
"172.16.133.26",53098,"68.64.13.250",443,6,366,12405,0,0,4,246,2,120,141.386758,0.1431570000000022,13747,6705
"172.16.133.53",54198,"172.16.139.250",5440,10,1022,12406,0,0,10,1022,0,0,141.388223,0.006264999999984866,1305027,0
"172.16.133.21",53273,"172.16.139.250",5440,12,1142,12407,0,0,12,1142,0,0,141.392322,0.01562300000000505,584778,0
"172.16.133.30",62721,"172.16.139.250",5440,12,1142,12408,0,0,12,1142,0,0,141.395789,0.020461999999980662,446486,0
"172.16.133.25",63568,"172.16.139.250",5440,12,1142,12409,0,0,12,1142,0,0,141.403224,0.007853000000011434,1163377,0
"172.16.133.34",50519,"172.16.139.250",5440,8,902,12410,0,0,8,902,0,0,141.411979,0.0073189999999954125,985927,0
"172.16.133.97",59473,"172.16.139.250",5440,10,1022,12411,0,0,10,1022,0,0,141.421958,0.0063520000000210075,1287153,0
"172.16.133.93",60825,"173.194.74.95",443,14,3547,12412,0,0,8,962,6,2585,141.443304,9.471469999999982,812,2183
"172.16.133.93",60826,"199.48.206.210",443,14,1496,12413,0,0,7,918,7,578,141.443761,135.66011300000002,54,34
"172.16.133.93",60827,"199.48.206.78",443,14,1282,12414,0,0,7,699,7,583,141.444825,135.65656399999997,41,34
"172.16.133.93",60828,"199.48.206.68",443,14,1282,12415,0,0,7,699,7,583,141.445019,135.65846299999998,41,34
"172.16.133.93",60829,"199.48.206.68",443,31,10667,12416,0,0,16,5541,15,5126,141.44516,29.568622000000005,1499,1386
"172.16.133.132",40048,"96.43.146.22",443,7,482,12417,0,0,4,272,3,210,141.455803,0.09343400000000202,23289,17980
"172.16.133.33",57982,"172.16.139.250",5440,10,1022,12418,0,0,10,1022,0,0,141.495434,0.015352000000007138,532569,0
"172.16.133.68",60837,"172.16.139.250",5440,10,1022,12419,0,0,10,1022,0,0,141.528907,0.006204999999994243,1317647,0
"172.16.133.12",59861,"172.16.139.250",5440,12,1142,12420,0,0,12,1142,0,0,141.541078,0.01620700000000852,563707,0
"172.16.133.93",60830,"23.6.17.224",80,25,8531,12421,0,0,14,5858,11,2673,141.545269,143.696565,326,148
"172.16.133.93",60831,"199.59.150.43",443,27,7935,12422,0,0,13,2770,14,5165,141.546877,34.365567999999996,644,1202
"172.16.133.63",53968,"172.16.139.250",5440,10,1022,12423,0,0,10,1022,0,0,141.55114,0.009163999999998396,892186,0
"172.16.133.132",52389,"96.43.149.26",443,7,482,12424,0,0,4,272,3,210,141.558564,0.05828100000002223,37336,28825
"172.16.133.66",53986,"172.16.139.250",5440,10,1022,12425,0,0,10,1022,0,0,141.566704,0.01547100000001933,528472,0
"172.16.133.93",60832,"199.48.206.108",443,16,2765,12426,0,0,8,1522,8,1243,141.572254,0.4390940000000114,27729,22646
"172.16.133.82",61474,"172.16.139.250",5440,10,1022,12427,0,0,10,1022,0,0,141.579065,0.015549999999990405,525787,0
"172.16.133.37",60705,"172.16.139.250",5440,10,1022,12428,0,0,10,1022,0,0,141.593377,0.006028999999983853,1356112,0
"172.16.133.184",58800,"204.14.232.101",443,31,13386,12429,0,0,16,1681,15,11705,141.616756,0.18589299999999298,72342,503730
"172.16.133.78",59301,"172.16.139.250",5440,12,1142,12430,0,0,12,1142,0,0,141.749367,0.008689000000003944,1051444,0
"172.16.133.67",56079,"172.16.139.250",5440,12,1142,12431,0,0,12,1142,0,0,141.804077,0.007604999999983875,1201314,0
"172.16.133.56",61513,"172.16.139.250",5440,12,1142,12432,0,0,12,1142,0,0,141.825988,0.006068999999996549,1505355,0
"172.16.133.41",53227,"172.16.139.250",5440,12,1142,12433,0,0,12,1142,0,0,141.882067,0.006500999999985879,1405322,0
"172.16.133.42",57206,"172.16.139.250",5440,12,1142,12434,0,0,12,1142,0,0,141.917102,0.021004000000004908,434964,0
"172.16.133.30",62722,"172.16.139.250",5440,10,1020,12435,0,0,10,1020,0,0,141.926458,1.9136320000000069,4264,0
"172.16.133.30",62723,"172.16.139.250",5440,10,1026,12436,0,0,10,1026,0,0,141.926577,0.03562299999998686,230412,0
"172.16.133.85",52355,"172.16.139.250",5440,12,1142,12437,0,0,12,1142,0,0,141.946772,0.08792599999998174,103905,0
"172.16.133.43",57862,"172.16.139.250",5440,10,1022,12438,0,0,10,1022,0,0,141.953296,0.08449300000000903,96765,0
"172.16.133.13",53118,"172.16.139.250",5440,10,1022,12440,0,0,10,1022,0,0,141.971738,0.07592900000000213,107679,0
"172.16.133.30",62724,"157.166.226.108",80,65,60111,12441,0,0,21,2029,44,58082,141.971968,53.564317999999986,303,8674
"172.16.133.20",62493,"172.16.139.250",5440,12,1142,12442,0,0,12,1142,0,0,142.030193,0.020938999999998487,436315,0
"172.16.133.75",51058,"172.16.139.250",5440,10,1022,12443,0,0,10,1022,0,0,142.038157,0.017446999999975787,468619,0
"172.16.133.54",64754,"63.146.126.10",80,16,8551,12444,0,0,8,2014,8,6537,142.038434,0.9359310000000107,17214,55875
"172.16.133.28",49178,"172.16.139.250",5440,10,1022,12445,0,0,10,1022,0,0,142.050298,0.0171280000000138,477347,0
"172.16.133.99",56129,"172.16.139.250",5440,10,1022,12446,0,0,10,1022,0,0,142.078125,0.014677000000006046,557062,0
"172.16.133.41",53228,"172.16.139.250",5440,10,1020,12447,0,0,10,1020,0,0,142.094633,120.00958600000001,67,0
"172.16.133.87",60315,"172.16.139.250",5440,10,1022,12448,0,0,10,1022,0,0,142.101608,0.015420000000005984,530220,0
"172.16.133.35",50054,"172.16.139.250",5440,12,1142,12449,0,0,12,1142,0,0,142.108958,0.020419000000003962,447426,0
"172.16.133.116",53615,"172.16.139.250",5440,12,1142,12450,0,0,12,1142,0,0,142.115295,0.006717000000008966,1360131,0
"172.16.133.116",53616,"172.16.139.250",5440,10,1022,12451,0,0,10,1022,0,0,142.122965,0.0065170000000023265,1254564,0
"172.16.133.116",53617,"172.16.139.250",5440,12,1142,12452,0,0,12,1142,0,0,142.130295,0.006182000000023891,1477838,0
"172.16.133.84",58882,"172.16.139.250",5440,12,1142,12453,0,0,12,1142,0,0,142.137432,0.01597900000001573,571750,0
"172.16.133.49",55876,"172.16.139.250",5440,12,1142,12454,0,0,12,1142,0,0,142.214744,0.05168000000000461,176780,0
"172.16.133.95",57049,"172.16.139.250",5440,12,1142,12455,0,0,12,1142,0,0,142.253501,0.016871000000008962,541520,0
"172.16.133.30",62725,"173.194.74.121",80,15,6774,12456,0,0,8,881,7,5893,142.278395,53.25031900000002,132,885
"172.16.133.92",57763,"172.16.139.250",5440,10,1022,12457,0,0,10,1022,0,0,142.280185,0.005693000000007942,1436149,0
"172.16.133.29",61035,"172.16.139.250",5440,12,1142,12458,0,0,12,1142,0,0,142.298311,0.007799999999974716,1171282,0
"172.16.133.44",64916,"172.16.139.250",5440,12,1142,12459,0,0,12,1142,0,0,142.305107,0.006277000000011412,1455472,0
"172.16.133.207",56013,"172.16.139.250",5440,12,1142,12460,0,0,12,1142,0,0,142.330181,0.005066999999996824,1803039,0
"172.16.133.83",57171,"172.16.139.250",5440,12,1142,12461,0,0,12,1142,0,0,142.339829,0.004712999999981093,"",""
"172.16.133.93",60833,"172.16.139.250",5440,12,1142,12462,0,0,12,1142,0,0,142.35572,0.01440900000000056,634048,0
"172.16.133.11",55222,"172.16.139.250",5440,10,1022,12463,0,0,10,1022,0,0,142.37177,0.0056000000000153705,1459999,0
"172.16.133.40",50237,"202.173.27.250",443,6,366,12464,0,0,4,246,2,120,142.375545,0.5914429999999982,3327,1623
"172.16.133.55",57712,"172.16.139.250",5440,12,1142,12465,0,0,12,1142,0,0,142.377239,0.005837999999982912,1564919,0
"172.16.133.73",60770,"172.16.139.250",5440,12,1142,12466,0,0,12,1142,0,0,142.400575,0.005542999999988751,1648204,0
"172.16.133.53",54199,"172.16.139.250",5440,10,1022,12467,0,0,10,1022,0,0,142.402211,0.00785799999999881,1040468,0
"172.16.133.21",53274,"172.16.139.250",5440,12,1142,12468,0,0,12,1142,0,0,142.405429,0.00949099999999703,962596,0
"172.16.133.30",62726,"172.16.139.250",5440,10,1022,12469,0,0,10,1022,0,0,142.408789,0.009171999999978198,891408,0
"172.16.133.25",63569,"172.16.139.250",5440,12,1142,12470,0,0,12,1142,0,0,142.417765,0.005274999999983265,1731943,0
"172.16.133.71",57384,"132.245.2.22",443,2,120,12471,0,0,1,60,1,60,142.423099,9.399999999004649e-05,"",""
"172.16.133.71",57573,"132.245.2.22",443,142,63814,12472,0,0,71,29306,71,34508,142.423966,133.05141500000002,1762,2074
"172.16.133.34",50520,"172.16.139.250",5440,10,1022,12473,0,0,10,1022,0,0,142.424735,0.017105000000015025,477988,0
"172.16.133.97",59474,"172.16.139.250",5440,10,1022,12474,0,0,10,1022,0,0,142.435893,0.009236000000015565,885231,0
"172.16.133.33",57983,"172.16.139.250",5440,10,1022,12475,0,0,10,1022,0,0,142.50812,0.014980000000008431,545794,0
"172.16.133.68",60838,"172.16.139.250",5440,10,1022,12476,0,0,10,1022,0,0,142.542046,0.016567000000009102,493511,0
"172.16.133.12",59862,"172.16.139.250",5440,10,1022,12477,0,0,10,1022,0,0,142.555248,0.00715900000000147,1142058,0
"172.16.133.63",53969,"172.16.139.250",5440,10,1022,12478,0,0,10,1022,0,0,142.565391,0.005324000000001661,1535687,0
"172.16.133.66",53987,"172.16.139.250",5440,12,1142,12479,0,0,12,1142,0,0,142.579287,0.006378000000012207,1432423,0
"172.16.133.82",61475,"172.16.139.250",5440,12,1142,12480,0,0,12,1142,0,0,142.594131,0.016628999999994676,549401,0
"172.16.133.37",60706,"172.16.139.250",5440,10,1022,12481,0,0,10,1022,0,0,142.606552,0.007385999999996784,1106959,0
"172.16.133.54",64755,"107.21.255.53",80,97,76368,12482,0,0,39,21164,58,55204,142.63878,71.131888,2380,6208
"172.16.133.54",64756,"23.21.204.69",80,8,1687,12483,0,0,5,910,3,777,142.718279,0.08101400000001036,89861,76727
"172.16.133.78",59302,"172.16.139.250",5440,12,1142,12484,0,0,12,1142,0,0,142.762529,0.016281999999989694,561110,0
"172.16.133.28",49179,"172.16.139.250",5440,12,1142,12485,0,0,12,1142,0,0,142.802498,0.008612999999996873,1060722,0
"172.16.133.67",56080,"172.16.139.250",5440,12,1142,12486,0,0,12,1142,0,0,142.818212,0.007710000000002992,1184954,0
"172.16.133.56",61514,"172.16.139.250",5440,12,1142,12487,0,0,12,1142,0,0,142.840884,0.005043000000000575,1811620,0
"172.16.128.233",55264,"172.16.133.233",22,174,22884,12488,0,0,51,4240,123,18644,142.85379,12.164478000000003,2788,12261
"172.16.133.41",53229,"172.16.139.250",5440,10,1022,12489,0,0,10,1022,0,0,142.895836,0.015152999999997974,539563,0
"172.16.133.42",57207,"172.16.139.250",5440,12,1142,12490,0,0,12,1142,0,0,142.927962,0.03413699999998698,267627,0
"172.16.133.85",52356,"172.16.139.250",5440,10,1022,12491,0,0,10,1022,0,0,142.959657,0.016925000000014734,483072,0
"172.16.133.43",57863,"172.16.139.250",5440,10,1022,12492,0,0,10,1022,0,0,142.967241,0.005650000000002819,1447079,0
"172.16.133.13",53119,"172.16.139.250",5440,10,1022,12493,0,0,10,1022,0,0,142.984652,0.0051649999999767715,1582962,0
"172.16.133.20",62494,"172.16.139.250",5440,12,1142,12494,0,0,12,1142,0,0,143.035254,0.04377900000000068,208684,0
"172.16.133.75",51059,"172.16.139.250",5440,10,1022,12495,0,0,10,1022,0,0,143.051271,0.03117399999999293,262269,0
"172.16.133.28",49180,"172.16.139.250",5440,12,1142,12496,0,0,12,1142,0,0,143.064239,0.022082000000011703,413730,0
"172.16.133.54",64757,"54.240.160.30",80,152,135350,12497,0,0,59,11414,93,123936,143.065529,126.16584700000001,723,7858
"172.16.133.54",64758,"54.240.160.30",80,31,17234,12498,0,0,16,3382,15,13852,143.065992,122.20331399999998,221,906
"172.16.133.34",50521,"173.194.43.40",80,22,9883,12499,0,0,10,3008,12,6875,143.078244,145.84377499999997,164,377
"172.16.133.99",56130,"172.16.139.250",5440,10,1022,12500,0,0,10,1022,0,0,143.091817,0.06415400000000204,127443,0
"172.16.133.45",61356,"68.64.25.250",443,6,366,12501,0,0,4,246,2,120,143.095935,0.15525700000000597,12675,6183
"172.16.133.45",61357,"68.64.5.249",443,6,366,12502,0,0,4,246,2,120,143.103782,0.1398810000000026,14069,6862
"172.16.133.30",62727,"157.55.211.160",80,96,103328,12503,0,0,25,2153,71,101175,143.107469,52.43207099999998,328,15437
"172.16.133.87",60316,"172.16.139.250",5440,10,1022,12504,0,0,10,1022,0,0,143.11485,0.04439700000000357,184156,0
"172.16.133.35",50055,"172.16.139.250",5440,12,1142,12505,0,0,12,1142,0,0,143.123334,0.05661299999999869,161376,0
"172.16.133.116",53618,"172.16.139.250",5440,10,1022,12506,0,0,10,1022,0,0,143.130078,0.03303900000000226,247465,0
"172.16.133.84",58883,"172.16.139.250",5440,10,1022,12507,0,0,10,1022,0,0,143.151106,0.01837199999999939,445025,0
"172.16.133.116",53619,"172.16.139.250",5440,12,1142,12508,0,0,12,1142,0,0,143.164169,0.017350000000021737,526570,0
"172.16.133.116",53620,"172.16.139.250",5440,10,1022,12509,0,0,10,1022,0,0,143.182445,0.008315000000010286,983283,0
"172.16.133.45",61358,"216.115.209.254",443,6,366,12510,0,0,4,246,2,120,143.202775,0.2657910000000072,7404,3611
"172.16.133.49",55877,"172.16.139.250",5440,12,1142,12511,0,0,12,1142,0,0,143.227773,0.00649199999998018,1407270,0
"172.16.133.95",57050,"172.16.139.250",5440,12,1142,12512,0,0,12,1142,0,0,143.267394,0.00620800000001509,1471649,0
"172.16.133.132",49118,"216.185.152.144",80,44,26408,12513,0,0,23,1496,21,24912,143.282418,0.9528159999999843,12560,209165
"172.16.133.34",50522,"173.194.41.111",80,16,2200,12514,0,0,9,1338,7,862,143.288709,145.958625,73,47
"172.16.133.92",57764,"172.16.139.250",5440,10,1022,12515,0,0,10,1022,0,0,143.294462,0.015096999999997252,541564,0
"172.16.133.29",61036,"172.16.139.250",5440,12,1142,12516,0,0,12,1142,0,0,143.312011,0.006332999999983713,1442602,0
"172.16.133.44",64918,"172.16.139.250",5440,12,1142,12517,0,0,12,1142,0,0,143.318508,0.006192999999996118,1475213,0
"172.16.133.207",56014,"172.16.139.250",5440,12,1142,12518,0,0,12,1142,0,0,143.34428,0.07932700000000636,115168,0
"172.16.133.83",57172,"172.16.139.250",5440,10,1022,12519,0,0,10,1022,0,0,143.352911,0.07413999999999987,110277,0
"172.16.133.45",61359,"78.108.119.250",443,6,366,12520,0,0,4,246,2,120,143.356774,0.26240699999999606,7499,3658
"172.16.133.93",60834,"172.16.139.250",5440,10,1022,12521,0,0,10,1022,0,0,143.369195,0.04614300000000071,177188,0
"172.16.133.11",55223,"172.16.139.250",5440,12,1142,12522,0,0,12,1142,0,0,143.386291,0.03343599999999469,273238,0
"172.16.133.54",64759,"208.47.254.67",80,18,5882,12523,0,0,10,1494,8,4388,143.390912,116.81853300000003,102,300
"172.16.133.55",57713,"172.16.139.250",5440,12,1142,12524,0,0,12,1142,0,0,143.393024,0.03774500000000103,242045,0
"172.16.133.73",60771,"172.16.139.250",5440,12,1142,12525,0,0,12,1142,0,0,143.414602,0.02241699999999014,407547,0
"172.16.133.53",54200,"172.16.139.250",5440,10,1022,12526,0,0,10,1022,0,0,143.417037,0.026814999999999145,304903,0
"172.16.133.21",53275,"172.16.139.250",5440,12,1142,12527,0,0,12,1142,0,0,143.420387,0.020469999999988886,446311,0
"172.16.133.30",62728,"172.16.139.250",5440,12,1142,12528,0,0,12,1142,0,0,143.423901,0.03193099999998594,286116,0
"172.16.133.25",63570,"172.16.139.250",5440,10,1022,12529,0,0,10,1022,0,0,143.431256,0.0165980000000161,492589,0
"172.16.133.34",50523,"172.16.139.250",5440,12,1142,12530,0,0,12,1142,0,0,143.440165,0.012092999999993026,755478,0
"172.16.133.97",59475,"172.16.139.250",5440,10,1022,12531,0,0,10,1022,0,0,143.450166,0.009424999999993133,867480,0
"172.16.133.54",64760,"54.240.160.30",80,6,372,12532,0,0,4,246,2,126,143.473298,5.783412999999996,340,174
"172.16.133.73",60772,"96.43.146.13",443,14,2164,12533,0,0,8,1390,6,774,143.496636,0.4819300000000055,23073,12848
"172.16.133.73",60773,"96.43.146.13",443,14,2164,12534,0,0,8,1390,6,774,143.496932,50.596303000000006,219,122
"172.16.133.54",64761,"23.21.84.31",80,12,2347,12535,0,0,7,1542,5,805,143.519921,5.415390000000002,2277,1189
"172.16.133.33",57984,"172.16.139.250",5440,12,1142,12536,0,0,12,1142,0,0,143.522051,0.006778999999994539,1347691,0
"172.16.133.54",64762,"23.21.84.31",80,6,372,12537,0,0,4,246,2,126,143.530361,5.730508000000015,343,175
"172.16.133.68",60840,"172.16.139.250",5440,12,1142,12538,0,0,12,1142,0,0,143.555797,0.015846999999979516,576512,0
"172.16.133.63",53970,"172.16.139.250",5440,12,1142,12539,0,0,12,1142,0,0,143.579397,0.006398999999987609,1427723,0
"172.16.133.12",59863,"172.16.139.250",5440,12,1142,12540,0,0,12,1142,0,0,143.58919,0.01603299999999308,569824,0
"172.16.133.66",53988,"172.16.139.250",5440,12,1142,12541,0,0,12,1142,0,0,143.593346,0.007703999999989719,1185877,0
"172.16.133.82",61476,"172.16.139.250",5440,12,1142,12542,0,0,12,1142,0,0,143.60795,0.01662200000001235,549633,0
"172.16.133.37",60707,"172.16.139.250",5440,12,1142,12543,0,0,12,1142,0,0,143.621085,0.020571000000018103,444120,0
"172.16.133.99",56131,"78.108.118.250",443,6,366,12544,0,0,4,246,2,120,143.658231,0.21089699999998857,9331,4551
"172.16.133.99",56132,"216.219.118.244",443,6,366,12545,0,0,4,246,2,120,143.658592,0.21151399999999398,9304,4538
"172.16.133.99",56133,"68.64.24.250",443,6,366,12546,0,0,4,246,2,120,143.660329,0.10822000000001708,18185,8870
"172.16.133.99",56134,"216.115.219.126",443,6,366,12547,0,0,4,246,2,120,143.660915,0.49650300000001835,3963,1933
"172.16.133.45",61360,"64.90.204.229",443,17,3149,12548,0,0,8,2066,9,1083,143.669735,2.5045959999999923,6599,3459
"172.16.133.45",61361,"64.90.204.229",443,17,2829,12549,0,0,8,1754,9,1075,143.696353,2.4780780000000107,5662,3470
"172.16.133.45",61362,"64.90.204.229",443,41,20647,12550,0,0,17,9984,24,10663,143.717328,10.62935299999998,7514,8025
"172.16.133.54",64763,"205.210.187.119",80,28,16950,12551,0,0,13,6614,15,10336,143.775715,5.718547999999998,9252,14459
"172.16.133.16",59356,"69.171.246.16",443,32,16401,12552,0,0,13,8475,19,7926,143.77596,152.45910600000002,444,415
"172.16.133.78",59303,"172.16.139.250",5440,12,1142,12553,0,0,12,1142,0,0,143.77616,0.015692999999998847,582170,0
"172.16.133.67",56081,"172.16.139.250",5440,10,1022,12554,0,0,10,1022,0,0,143.832454,0.015000999999983833,545030,0
"172.16.133.30",62729,"172.16.139.250",5440,10,1020,12555,0,0,10,1020,0,0,143.840619,120.01373699999999,67,0
"172.16.133.30",62730,"172.16.139.250",5440,10,1026,12556,0,0,10,1026,0,0,143.840824,0.010571999999996251,776390,0
"172.16.133.56",61515,"172.16.139.250",5440,12,1142,12557,0,0,12,1142,0,0,143.854042,0.004937000000012404,"",""
"172.16.133.41",53230,"172.16.139.250",5440,10,1022,12558,0,0,10,1022,0,0,143.909719,0.006244000000009464,1309417,0
"172.16.133.54",64764,"205.210.187.135",80,10,1471,12559,0,0,5,984,5,487,143.922689,0.7067030000000045,11139,5512
"172.16.133.54",64765,"205.210.187.135",80,11,696,12560,0,0,6,378,5,318,143.922983,5.344652000000025,565,475
"172.16.133.85",52357,"172.16.139.250",5440,10,1022,12561,0,0,10,1022,0,0,143.974897,0.005557000000010248,1471297,0
"172.16.133.43",57864,"172.16.139.250",5440,12,1142,12562,0,0,12,1142,0,0,143.980714,0.0062439999999810425,1463164,0
"172.16.133.42",57208,"172.16.139.250",5440,12,1142,12563,0,0,12,1142,0,0,143.983222,0.09411599999998543,97071,0
"172.16.133.13",53120,"172.16.139.250",5440,12,1142,12564,0,0,12,1142,0,0,143.999949,0.006257000000005064,1460124,0
"172.16.133.20",62495,"172.16.139.250",5440,12,1142,12565,0,0,12,1142,0,0,144.047828,0.01662999999999215,549368,0
"172.16.133.75",51060,"172.16.139.250",5440,10,1022,12566,0,0,10,1022,0,0,144.065466,0.0055030000000044765,1485735,0
"172.16.133.53",54201,"172.16.139.250",5440,10,1020,12567,0,0,10,1020,0,0,144.078025,120.01469699999998,67,0
"172.16.133.28",49181,"172.16.139.250",5440,12,1142,12568,0,0,12,1142,0,0,144.078351,0.006682000000012067,1367255,0
"172.16.133.29",61037,"172.16.139.250",5440,10,1020,12569,0,0,10,1020,0,0,144.078607,120.01357599999997,67,0
"172.16.133.44",64919,"172.16.139.250",5440,10,1020,12570,0,0,10,1020,0,0,144.079095,120.013351,67,0
"172.16.133.46",64585,"172.16.139.250",5440,10,1020,12571,0,0,10,1020,0,0,144.079652,120.01292000000001,67,0
"172.16.133.43",57865,"172.16.139.250",5440,10,1020,12572,0,0,10,1020,0,0,144.093706,120.01431300000002,67,0
"172.16.133.33",57985,"172.16.139.250",5440,10,1020,12573,0,0,10,1020,0,0,144.094593,120.012258,67,0
"172.16.133.99",56135,"172.16.139.250",5440,12,1142,12574,0,0,12,1142,0,0,144.105018,0.014799000000010665,617339,0
"172.16.133.35",50056,"172.16.139.250",5440,12,1142,12575,0,0,12,1142,0,0,144.140355,0.013251999999994268,689405,0
"172.16.133.116",53621,"172.16.139.250",5440,12,1142,12576,0,0,12,1142,0,0,144.143056,0.008678000000003294,1052777,0
"172.16.133.87",60317,"172.16.139.250",5440,10,1022,12577,0,0,10,1022,0,0,144.147323,0.00836400000000026,977522,0
"172.16.133.116",53622,"172.16.139.250",5440,10,1022,12578,0,0,10,1022,0,0,144.152662,0.00788000000000011,1037563,0
"172.16.133.45",61363,"172.16.139.250",5440,10,1020,12579,0,0,10,1020,0,0,144.157155,120.00965500000001,67,0
"172.16.133.34",50524,"172.16.139.250",5440,10,1020,12580,0,0,10,1020,0,0,144.157221,120.00989400000003,67,0
"172.16.133.116",53623,"172.16.139.250",5440,10,1022,12581,0,0,10,1022,0,0,144.161314,0.006456999999983282,1266222,0
"172.16.133.132",33260,"96.43.146.48",443,29,13271,12582,0,0,15,1614,14,11657,144.162254,0.4142060000000072,31172,225144
"172.16.133.84",58884,"172.16.139.250",5440,12,1142,12583,0,0,12,1142,0,0,144.166216,0.016081000000014,568123,0
"172.16.133.207",56015,"172.16.139.250",5440,12,1140,12584,0,0,12,1140,0,0,144.171652,121.01104200000003,75,0
"172.16.133.63",53971,"172.16.139.250",5440,12,1140,12585,0,0,12,1140,0,0,144.172,121.01335800000001,75,0
"172.16.133.75",51061,"172.16.139.250",5440,10,1020,12586,0,0,10,1020,0,0,144.173277,121.01045200000002,67,0
"172.16.133.12",59864,"172.16.139.250",5440,12,1140,12587,0,0,12,1140,0,0,144.173387,121.012291,75,0
"172.16.133.78",59304,"172.16.139.250",5440,12,1140,12588,0,0,12,1140,0,0,144.173475,121.01295499999998,75,0
"172.16.133.88",51242,"172.16.139.250",5440,12,1140,12589,0,0,12,1140,0,0,144.173736,121.01109900000003,75,0
"172.16.133.35",50057,"172.16.139.250",5440,12,1140,12590,0,0,12,1140,0,0,144.174604,121.01612800000004,75,0
"172.16.133.60",62135,"172.16.139.250",5440,10,1020,12591,0,0,10,1020,0,0,144.175582,121.00711099999998,67,0
"172.16.133.128",65052,"172.16.139.250",5440,10,1020,12592,0,0,10,1020,0,0,144.1763,121.00718500000002,67,0
"172.16.133.54",64766,"209.190.70.254",80,17,7373,12593,0,0,8,3467,9,3906,144.1807,0.46762300000000323,59312,66823
"173.194.43.47",80,"172.16.133.27",60919,4,258,12594,0,0,2,126,2,132,144.190507,5.972779000000003,168,176
"172.16.133.37",60708,"172.16.139.250",5440,10,1020,12595,0,0,10,1020,0,0,144.219464,120.96750399999999,67,0
"172.16.133.103",63443,"172.16.139.250",5440,10,1020,12596,0,0,10,1020,0,0,144.219982,120.96659100000002,67,0
"172.16.133.49",55878,"172.16.139.250",5440,10,1022,12597,0,0,10,1022,0,0,144.242837,0.006002999999992653,1361985,0
"172.16.133.54",64767,"69.172.216.156",80,39,34717,12598,0,0,14,3313,25,31404,144.264616,0.35863400000002343,73902,700524
"172.16.133.95",57051,"172.16.139.250",5440,12,1142,12599,0,0,12,1142,0,0,144.2814,0.01672400000001062,546280,0
"172.16.133.132",41038,"199.27.208.20",80,800,673118,12600,0,0,279,39061,521,634057,144.281401,20.802607000000023,15021,243837
"172.16.133.92",57765,"172.16.139.250",5440,10,1022,12601,0,0,10,1022,0,0,144.308146,0.005681000000009817,1439183,0
"172.16.133.29",61038,"172.16.139.250",5440,12,1142,12602,0,0,12,1142,0,0,144.327112,0.006418999999993957,1423274,0
"172.16.133.44",64920,"172.16.139.250",5440,10,1022,12603,0,0,10,1022,0,0,144.332926,0.005539000000027272,1476078,0
"172.16.133.23",55048,"64.90.204.229",443,17,3095,12604,0,0,8,1780,9,1315,144.334338,11.238878999999997,1267,936
"172.16.133.207",56016,"172.16.139.250",5440,12,1142,12605,0,0,12,1142,0,0,144.358404,0.004936999999983982,"",""
"172.16.133.83",57173,"172.16.139.250",5440,12,1142,12606,0,0,12,1142,0,0,144.367752,0.014055000000013251,650017,0
"172.16.133.55",57714,"72.32.20.63",80,9,1614,12607,0,0,5,1082,4,532,144.383133,0.2843210000000056,30444,14968
"172.16.133.93",60835,"172.16.139.250",5440,12,1142,12608,0,0,12,1142,0,0,144.383358,0.005045000000023947,1810901,0
"172.16.133.54",64768,"64.215.255.57",80,8,1369,12609,0,0,5,1048,3,321,144.398532,0.16580200000001355,50566,15488
"172.16.133.11",55224,"172.16.139.250",5440,12,1142,12610,0,0,12,1142,0,0,144.399789,0.006498999999990929,1405754,0
"172.16.133.55",57715,"172.16.139.250",5440,12,1142,12611,0,0,12,1142,0,0,144.403994,0.006251999999989266,1461292,0
"172.16.133.54",64769,"208.118.234.120",80,6,553,12612,0,0,4,246,2,307,144.416992,5.815450999999996,338,422
"172.16.133.54",64770,"208.118.234.120",80,11,1611,12613,0,0,6,762,5,849,144.417334,30.490364999999997,199,222
"172.16.133.73",60774,"172.16.139.250",5440,10,1022,12614,0,0,10,1022,0,0,144.428011,0.0057150000000092405,1430621,0
"172.16.133.53",54202,"172.16.139.250",5440,12,1142,12615,0,0,12,1142,0,0,144.430151,0.019218999999992548,475362,0
"172.16.133.21",53276,"172.16.139.250",5440,10,1022,12616,0,0,10,1022,0,0,144.434182,0.00641000000001668,1275507,0
"172.16.133.30",62732,"172.16.139.250",5440,10,1022,12617,0,0,10,1022,0,0,144.436914,0.007541000000003351,1084206,0
"172.16.133.25",63571,"172.16.139.250",5440,12,1142,12618,0,0,12,1142,0,0,144.444314,0.008513000000021975,1073182,0
"172.16.133.34",50525,"172.16.139.250",5440,12,1142,12619,0,0,12,1142,0,0,144.45325,0.006682000000012067,1367255,0
"172.16.133.97",59476,"172.16.139.250",5440,10,1022,12620,0,0,10,1022,0,0,144.464455,0.014799000000010665,552469,0
"172.16.133.113",55652,"172.16.139.250",135,8,492,12621,0,0,8,492,0,0,144.493975,0.008735999999998967,450549,0
"172.16.133.113",55653,"172.16.139.250",5462,10,696,12622,0,0,10,696,0,0,144.504597,0.5230200000000025,10645,0
"172.16.133.132",35441,"38.70.64.178",80,35,21315,12623,0,0,19,1447,16,19868,144.525799,0.3931419999999832,29444,404291
"172.16.133.33",57986,"172.16.139.250",5440,10,1022,12624,0,0,10,1022,0,0,144.536119,0.005419999999986658,1508487,0
"172.16.133.68",60841,"172.16.139.250",5440,10,1022,12625,0,0,10,1022,0,0,144.569975,0.005662000000000944,1444012,0
"172.16.133.54",64771,"69.172.216.156",80,12,4592,12626,0,0,6,3056,6,1536,144.570205,0.31529300000002536,77540,38973
"172.16.133.54",64772,"54.240.160.238",80,41,30567,12627,0,0,17,2882,24,27685,144.576006,120.69320499999998,191,1835
"172.16.133.54",64773,"54.240.160.238",80,6,372,12628,0,0,4,246,2,126,144.576348,5.656947000000002,347,178
"172.16.133.12",59865,"172.16.139.250",5440,10,1022,12629,0,0,10,1022,0,0,144.583309,0.005623999999983198,1453769,0
"172.16.133.54",64774,"54.240.160.238",80,125,122501,12630,0,0,43,4428,82,118073,144.590583,120.679471,293,7827
"172.16.133.54",64775,"54.240.160.238",80,42,35634,12631,0,0,16,1416,26,34218,144.590983,115.624234,97,2367
"172.16.133.54",64776,"54.240.160.238",80,6,372,12632,0,0,4,246,2,126,144.5915,5.641911999999991,348,178
"172.16.133.54",64777,"54.240.160.238",80,21,12333,12633,0,0,10,1449,11,10884,144.591914,115.62322600000002,100,753
"172.16.133.63",53972,"172.16.139.250",5440,12,1142,12634,0,0,12,1142,0,0,144.593551,0.01646999999999821,554705,0
"172.16.133.54",64778,"69.172.216.156",80,11,2450,12635,0,0,6,1966,5,484,144.60508,0.28241800000000694,55690,13710
"172.16.133.66",53989,"172.16.139.250",5440,10,1022,12636,0,0,10,1022,0,0,144.606645,0.011301000000003114,723475,0
"172.16.133.54",64779,"69.172.216.156",80,6,372,12637,0,0,4,246,2,126,144.616361,5.681147999999979,346,177
"172.16.133.82",61477,"172.16.139.250",5440,12,1142,12638,0,0,12,1142,0,0,144.62099,0.006054000000005999,1509084,0
"172.16.133.54",64780,"204.246.169.43",80,67,58307,12639,0,0,27,3358,40,54949,144.625906,120.63612599999999,222,3643
"172.16.133.54",64781,"204.246.169.43",80,6,372,12640,0,0,4,246,2,126,144.626153,5.605108999999999,351,179
"172.16.133.54",64782,"69.172.216.156",80,6,372,12641,0,0,4,246,2,126,144.629214,5.670252000000005,347,177
"172.16.133.37",60709,"172.16.139.250",5440,12,1142,12642,0,0,12,1142,0,0,144.635353,0.017017999999978883,536843,0
"172.16.133.54",64783,"96.43.148.26",80,13,3827,12643,0,0,7,3065,6,762,144.641453,115.573575,212,52
"172.16.133.54",64784,"209.190.70.254",80,14,4256,12644,0,0,7,3515,7,741,144.642296,0.3562730000000158,78928,16638
"172.16.133.54",64785,"96.43.148.26",80,7,432,12645,0,0,4,246,3,186,144.698856,5.533687999999984,355,268
"172.16.133.54",64786,"209.190.70.254",80,18,9996,12646,0,0,9,6451,9,3545,144.699093,1.0817559999999844,47707,26216
"172.16.133.153",47988,"209.112.253.15",80,183,151814,12647,0,0,77,5191,106,146623,144.779421,1.0529389999999808,39440,1114009
"172.16.133.78",59305,"172.16.139.250",5440,10,1022,12648,0,0,10,1022,0,0,144.790369,0.034278000000000475,238520,0
"172.16.133.87",60318,"74.125.226.24",443,31,7697,12649,0,0,16,3058,15,4639,144.808196,144.726425,169,256
"172.16.133.67",56082,"172.16.139.250",5440,12,1142,12650,0,0,12,1142,0,0,144.845668,0.007859000000024707,1162488,0
"172.16.133.132",46646,"38.70.64.178",80,71,50517,12651,0,0,35,2472,36,48045,144.845746,1.184106000000014,16701,324599
"172.16.133.56",61516,"172.16.139.250",5440,10,1022,12652,0,0,10,1022,0,0,144.867615,0.014780000000001792,553179,0
"172.16.133.54",64787,"72.21.91.196",80,6,372,12653,0,0,4,246,2,126,144.916418,5.311814999999996,370,189
"172.16.133.41",53231,"172.16.139.250",5440,10,1022,12654,0,0,10,1022,0,0,144.924467,0.005857000000020207,1395936,0
"172.16.133.42",57209,"172.16.139.250",5440,12,1142,12655,0,0,12,1142,0,0,144.959849,0.0458629999999971,199201,0
"172.16.133.54",64788,"157.56.134.97",80,6,378,12656,0,0,4,252,2,126,144.982961,8.245925,244,122
"172.16.133.85",52358,"172.16.139.250",5440,12,1142,12657,0,0,12,1142,0,0,144.987061,0.017430999999987762,524123,0
"172.16.133.43",57866,"172.16.139.250",5440,10,1022,12658,0,0,10,1022,0,0,144.995418,0.005389000000008082,1517164,0
"172.16.133.132",41039,"199.27.208.20",80,134,89192,12659,0,0,61,8099,73,81093,145.010729,20.065338999999994,3229,32331
"172.16.133.13",53121,"172.16.139.250",5440,10,1022,12660,0,0,10,1022,0,0,145.013975,0.06705400000001305,121931,0
"172.16.133.132",41040,"199.27.208.20",80,84,63040,12661,0,0,33,4363,51,58677,145.01531,20.06086099999999,1739,23399
"172.16.133.132",41041,"199.27.208.20",80,95,68052,12662,0,0,38,5739,57,62313,145.019428,20.071093999999988,2287,24836
"172.16.133.132",41042,"199.27.208.20",80,199,146557,12663,0,0,88,8148,111,138409,145.031506,20.060226999999998,3249,55197
"172.16.133.132",41043,"199.27.208.20",80,193,164990,12664,0,0,71,6505,122,158485,145.038097,20.062587000000008,2593,63196
"172.16.133.56",61517,"96.43.146.48",443,19,4004,12665,0,0,11,2497,8,1507,145.04121,42.81293499999998,466,281
"172.16.133.20",62496,"172.16.139.250",5440,10,1022,12666,0,0,10,1022,0,0,145.063145,0.02424100000001772,337279,0
"172.16.133.75",51062,"172.16.139.250",5440,10,1022,12667,0,0,10,1022,0,0,145.079253,0.02263200000001575,361258,0
"172.16.133.132",41190,"199.27.208.19",443,22,6268,12668,0,0,13,1541,9,4727,145.091138,20.010896000000002,616,1889
"172.16.133.28",49184,"172.16.139.250",5440,10,1022,12669,0,0,10,1022,0,0,145.094486,0.012261000000023614,666829,0
"172.16.133.99",56136,"172.16.139.250",5440,10,1022,12670,0,0,10,1022,0,0,145.119149,0.014695000000017444,556379,0
"172.16.133.132",60612,"173.194.43.45",80,19,5944,12671,0,0,12,1701,7,4243,145.131369,19.951999,682,1701
"172.16.133.87",60319,"172.16.139.250",5440,10,1022,12672,0,0,10,1022,0,0,145.143447,0.005507999999991853,1484386,0
"172.16.133.132",33781,"193.149.47.76",443,22,8155,12673,0,0,12,1455,10,6700,145.146985,19.619651000000005,593,2731
"172.16.133.54",64789,"157.56.134.97",80,13,6813,12674,0,0,7,2861,6,3952,145.147865,0.21933899999999085,104349,144142
"172.16.133.35",50058,"172.16.139.250",5440,12,1142,12675,0,0,12,1142,0,0,145.152052,0.04453000000000884,205165,0
"172.16.133.132",59010,"23.45.65.65",80,14,3525,12676,0,0,9,916,5,2609,145.155156,19.95778899999999,367,1045
"172.16.133.116",53624,"172.16.139.250",5440,10,1022,12677,0,0,10,1022,0,0,145.155656,0.0070430000000101245,1160868,0
"172.16.133.116",53625,"172.16.139.250",5440,10,1022,12678,0,0,10,1022,0,0,145.16353,0.006148999999993521,1329647,0
"172.16.133.116",53626,"172.16.139.250",5440,10,1022,12679,0,0,10,1022,0,0,145.170495,0.0051109999999994216,1599686,0
"172.16.133.45",61364,"68.64.5.249",443,6,366,12680,0,0,4,246,2,120,145.171893,0.16384299999998575,12011,5859
"172.16.133.45",61365,"68.64.25.250",443,6,366,12681,0,0,4,246,2,120,145.172706,0.17053200000000857,11540,5629
"172.16.133.84",58885,"172.16.139.250",5440,10,1022,12682,0,0,10,1022,0,0,145.180277,0.0055030000000044765,1485735,0
"172.16.133.78",59306,"108.13.7.222",61312,585,454029,12683,0,0,222,15776,363,438253,145.187971,152.76780100000002,826,22950
"172.16.133.78",59307,"209.193.97.196",59836,6,374,12684,0,0,3,194,3,180,145.188029,1.4511039999999866,1069,992
"172.16.133.78",59308,"71.189.11.25",18063,3,194,12685,0,0,3,194,0,0,145.188147,8.997404000000017,172,0
"172.16.133.78",59309,"35.40.143.166",41514,3,194,12686,0,0,3,194,0,0,145.188231,8.999299000000008,172,0
"172.16.133.78",59310,"71.62.158.222",24727,1236,1312624,12687,0,0,333,25088,903,1287536,145.18836,154.39144300000004,1299,66715
"172.16.133.35",50059,"72.32.20.63",80,9,1527,12688,0,0,5,1083,4,444,145.198854,0.2679149999999879,32338,13257
"172.16.133.78",59311,"31.13.74.7",443,18,4475,12689,0,0,9,1492,9,2983,145.208068,85.22530700000002,140,280
"172.16.133.11",55225,"172.16.139.250",5440,10,1020,12690,0,0,10,1020,0,0,145.234308,120.02659899999998,67,0
"172.16.133.95",57052,"172.16.139.250",5440,10,1020,12691,0,0,10,1020,0,0,145.234425,120.010493,67,0
"172.16.133.67",56083,"173.194.43.33",80,9,2779,12692,0,0,5,1659,4,1120,145.234767,0.2658089999999902,49930,33708
"172.16.133.66",53990,"172.16.139.250",5440,10,1020,12693,0,0,10,1020,0,0,145.234771,120.01063400000001,67,0
"172.16.133.13",53122,"172.16.139.250",5440,10,1020,12694,0,0,10,1020,0,0,145.234849,120.01028300000002,67,0
"172.16.133.25",63572,"172.16.139.250",5440,12,1140,12695,0,0,12,1140,0,0,145.235156,120.01102,75,0
"172.16.133.40",50238,"172.16.139.250",5440,12,1140,12696,0,0,12,1140,0,0,145.23628,120.01089700000003,75,0
"172.16.133.84",58886,"64.90.204.229",443,17,3101,12697,0,0,8,1773,9,1328,145.248105,5.9258649999999875,2393,1792
"172.16.133.83",57174,"172.16.139.250",5440,12,1140,12698,0,0,12,1140,0,0,145.249944,120.01383000000001,75,0
"172.16.133.28",49185,"172.16.139.250",5440,12,1140,12699,0,0,12,1140,0,0,145.250705,120.0144,75,0
"172.16.133.116",53627,"172.16.139.250",5440,12,1140,12700,0,0,12,1140,0,0,145.251031,120.01401799999996,75,0
"172.16.133.21",53277,"172.16.139.250",5440,10,1020,12701,0,0,10,1020,0,0,145.251227,120.01483399999998,67,0
"172.16.133.73",60775,"172.16.139.250",5440,10,1020,12702,0,0,10,1020,0,0,145.251677,120.01052200000001,67,0
"172.16.133.55",57716,"172.16.139.250",5440,10,1020,12703,0,0,10,1020,0,0,145.251678,120.01017499999998,67,0
"172.16.133.84",58887,"172.16.139.250",5440,10,1020,12704,0,0,10,1020,0,0,145.252021,120.008467,67,0
"172.16.133.20",62497,"172.16.139.250",5440,10,1020,12705,0,0,10,1020,0,0,145.252705,120.013171,67,0
"172.16.133.68",60842,"172.16.139.250",5440,12,1140,12706,0,0,12,1140,0,0,145.253179,120.00960500000002,75,0
"172.16.133.85",52359,"172.16.139.250",5440,10,1020,12707,0,0,10,1020,0,0,145.253817,120.02237900000003,67,0
"172.16.133.97",59477,"172.16.139.250",5440,10,1020,12708,0,0,10,1020,0,0,145.254388,120.00795699999998,67,0
"172.16.133.56",61518,"172.16.139.250",5440,12,1140,12709,0,0,12,1140,0,0,145.254776,120.02193199999999,75,0
"172.16.133.23",55049,"172.16.139.250",5440,12,1140,12710,0,0,12,1140,0,0,145.254833,120.00848800000003,75,0
"172.16.133.92",57766,"172.16.139.250",5440,12,1140,12711,0,0,12,1140,0,0,145.255646,120.02099599999997,75,0
"172.16.133.49",55879,"172.16.139.250",5440,12,1142,12712,0,0,12,1142,0,0,145.255705,0.0070570000000032,1294601,0
"172.16.133.54",64790,"12.130.48.51",80,9,1803,12713,0,0,5,1338,4,465,145.259663,0.1403190000000052,76283,26511
"172.16.133.95",57053,"172.16.139.250",5440,12,1142,12714,0,0,12,1142,0,0,145.295536,0.053754999999995334,169956,0
"172.16.133.92",57767,"172.16.139.250",5440,10,1022,12715,0,0,10,1022,0,0,145.322216,0.03099600000001601,263775,0
"172.16.133.54",64791,"208.47.254.57",80,6,372,12716,0,0,4,246,2,126,145.335931,5.893144000000007,333,171
"172.16.133.29",61039,"172.16.139.250",5440,10,1022,12717,0,0,10,1022,0,0,145.340569,0.020420999999998912,400372,0
"172.16.133.44",64921,"172.16.139.250",5440,10,1022,12718,0,0,10,1022,0,0,145.34668,0.010525000000001228,776817,0
"172.16.133.30",62734,"204.232.250.59",80,23,12724,12719,0,0,9,1094,14,11630,145.351305,3.1772750000000087,2754,29282
"172.16.133.54",64792,"207.46.193.179",80,5,308,12720,0,0,3,186,2,122,145.35573,5.895163999999994,252,165
"172.16.133.54",64793,"12.130.48.51",80,7,432,12721,0,0,4,246,3,186,145.369057,5.506156000000004,357,270
"172.16.133.207",56017,"172.16.139.250",5440,12,1142,12722,0,0,12,1142,0,0,145.371342,0.004692000000005692,"",""
"172.16.133.45",61366,"216.115.209.254",443,6,366,12723,0,0,4,246,2,120,145.372026,0.20807700000000295,9458,4613
"172.16.133.78",59312,"173.252.71.6",54083,3,194,12724,0,0,3,194,0,0,145.375896,9.004657999999978,172,0
"172.16.133.78",59313,"161.130.158.160",37541,3,194,12725,0,0,3,194,0,0,145.380635,8.994916999999987,172,0
"172.16.133.83",57175,"172.16.139.250",5440,10,1022,12726,0,0,10,1022,0,0,145.380758,0.014035000000006903,582543,0
"172.16.133.93",60836,"172.16.139.250",5440,10,1022,12727,0,0,10,1022,0,0,145.39773,0.004969000000016877,"",""
"172.16.133.11",55226,"172.16.139.250",5440,12,1142,12728,0,0,12,1142,0,0,145.413795,0.042718000000007805,213867,0
"172.16.133.55",57717,"172.16.139.250",5440,12,1142,12729,0,0,12,1142,0,0,145.419268,0.04021099999999933,227201,0
"172.16.133.73",60776,"172.16.139.250",5440,12,1142,12730,0,0,12,1142,0,0,145.441377,0.027656000000007452,330344,0
"172.16.133.53",54203,"172.16.139.250",5440,10,1022,12731,0,0,10,1022,0,0,145.44464,0.020093000000002803,406907,0
"172.16.133.21",53278,"172.16.139.250",5440,10,1022,12732,0,0,10,1022,0,0,145.447116,0.028858000000013817,283318,0
"172.16.133.30",62735,"172.16.139.250",5440,10,1022,12733,0,0,10,1022,0,0,145.451665,0.02069500000001767,395071,0
"172.16.133.25",63573,"172.16.139.250",5440,12,1142,12734,0,0,12,1142,0,0,145.459715,0.020631000000008726,442828,0
"172.16.133.34",50526,"172.16.139.250",5440,12,1142,12735,0,0,12,1142,0,0,145.468201,0.015948000000008733,572861,0
"172.16.133.45",61367,"78.108.119.250",443,6,366,12736,0,0,4,246,2,120,145.476774,0.2945169999999848,6682,3259
"172.16.133.97",59478,"172.16.139.250",5440,10,1022,12737,0,0,10,1022,0,0,145.47801,0.014852999999988015,550461,0
"172.16.133.33",57987,"172.16.139.250",5440,12,1142,12738,0,0,12,1142,0,0,145.550524,0.006258000000002539,1459891,0
"172.16.133.68",60843,"172.16.139.250",5440,10,1022,12739,0,0,10,1022,0,0,145.585079,0.005522999999982403,1480354,0
"172.16.133.12",59866,"172.16.139.250",5440,10,1022,12740,0,0,10,1022,0,0,145.597216,0.015973000000002457,511863,0
"172.16.133.63",53973,"172.16.139.250",5440,10,1022,12741,0,0,10,1022,0,0,145.608204,0.008649999999988722,945202,0
"172.16.133.66",53991,"172.16.139.250",5440,10,1022,12742,0,0,10,1022,0,0,145.620298,0.005367000000006783,1523383,0
"172.16.133.82",61478,"172.16.139.250",5440,10,1022,12743,0,0,10,1022,0,0,145.635143,0.01590899999999351,513922,0
"172.16.133.37",60710,"172.16.139.250",5440,12,1142,12744,0,0,12,1142,0,0,145.648651,0.007426000000009481,1230272,0
"172.16.133.99",56137,"68.64.24.250",443,6,366,12745,0,0,4,246,2,120,145.720687,0.1275139999999908,15433,7528
"172.16.133.93",60837,"199.48.206.210",443,14,1496,12746,0,0,7,918,7,578,145.722929,135.67461899999998,54,34
"172.16.133.153",42053,"141.101.113.194",80,100,83012,12747,0,0,43,2946,57,80066,145.726703,0.24044000000000665,98020,2663982
"172.16.133.99",56138,"78.108.118.250",443,6,366,12748,0,0,4,246,2,120,145.774618,0.21616800000001035,9104,4440
"172.16.133.99",56139,"216.219.118.244",443,6,366,12749,0,0,4,246,2,120,145.775468,0.20438800000002288,9628,4696
"172.16.133.30",62736,"208.93.140.140",80,61,53973,12750,0,0,18,3485,43,50488,145.787507,64.770353,430,6235
"172.16.133.78",59314,"172.16.139.250",5440,8,902,12751,0,0,8,902,0,0,145.804212,0.006204999999994243,1162933,0
"172.16.133.93",60839,"199.48.206.108",443,16,2774,12752,0,0,8,1531,8,1243,145.849163,0.4297339999999963,28501,23139
"172.16.133.67",56084,"172.16.139.250",5440,12,1142,12753,0,0,12,1142,0,0,145.85888,0.006267000000008238,1457794,0
"172.16.133.56",61519,"172.16.139.250",5440,12,1142,12754,0,0,12,1142,0,0,145.883837,0.005122999999997546,1783330,0
"172.16.133.99",56140,"216.115.219.126",443,6,366,12755,0,0,4,246,2,120,145.917594,0.4808079999999961,4093,1996
"172.16.133.93",60840,"172.16.139.250",5440,10,1020,12756,0,0,10,1020,0,0,145.921557,120.042102,67,0
"172.16.133.54",64794,"176.32.100.5",80,13,3308,12757,0,0,8,1603,5,1705,145.924551,116.29174,110,117
"172.16.133.54",64795,"176.32.100.5",80,6,368,12758,0,0,4,246,2,122,145.925779,5.309160999999989,370,183
"172.16.133.54",64796,"176.32.98.118",80,6,368,12759,0,0,4,246,2,122,145.927773,5.30724699999999,370,183
"172.16.133.54",64797,"176.32.98.118",80,10,1138,12760,0,0,6,743,4,395,145.927998,115.29830499999997,51,27
"172.16.133.41",53232,"172.16.139.250",5440,10,1022,12761,0,0,10,1022,0,0,145.93746,0.03296100000000024,248050,0
"172.16.133.153",40576,"64.17.236.31",80,69,43010,12762,0,0,36,2726,33,40284,145.947835,2.0281339999999943,10752,158900
"172.16.133.42",57210,"172.16.139.250",5440,12,1142,12763,0,0,12,1142,0,0,145.986786,0.028087999999996782,325263,0
"172.16.133.85",52360,"172.16.139.250",5440,12,1142,12764,0,0,12,1142,0,0,146.000959,0.006326999999998861,1443970,0
"172.16.133.43",57867,"172.16.139.250",5440,10,1022,12765,0,0,10,1022,0,0,146.009199,0.0056730000000015934,1441212,0
"172.16.133.13",53123,"172.16.139.250",5440,10,1022,12766,0,0,10,1022,0,0,146.026763,0.005244000000004689,1559115,0
"172.16.133.20",62498,"172.16.139.250",5440,12,1142,12767,0,0,12,1142,0,0,146.077374,0.004930000000001655,"",""
"172.16.133.75",51063,"172.16.139.250",5440,10,1022,12768,0,0,10,1022,0,0,146.092495,0.0054369999999721585,1503770,0
"172.16.133.28",49186,"172.16.139.250",5440,10,1022,12769,0,0,10,1022,0,0,146.106713,0.005542999999988751,1475013,0
"172.16.133.99",56141,"172.16.139.250",5440,12,1142,12770,0,0,12,1142,0,0,146.132988,0.015037999999975682,607527,0
"172.16.133.87",60320,"172.16.139.250",5440,10,1022,12771,0,0,10,1022,0,0,146.156772,0.014758999999997968,553967,0
"172.16.133.35",50060,"172.16.139.250",5440,12,1142,12772,0,0,12,1142,0,0,146.168107,0.04071300000001088,224400,0
"172.16.133.116",53628,"172.16.139.250",5440,10,1022,12773,0,0,10,1022,0,0,146.171134,0.004958000000016227,"",""
"172.16.133.116",53629,"172.16.139.250",5440,12,1142,12774,0,0,12,1142,0,0,146.177046,0.01653100000001473,552658,0
"172.16.133.84",58888,"172.16.139.250",5440,10,1022,12775,0,0,10,1022,0,0,146.193321,0.006963000000013153,1174206,0
"172.16.133.116",53630,"172.16.139.250",5440,10,1022,12776,0,0,10,1022,0,0,146.19446,0.009786000000019612,835479,0
"172.16.133.49",55880,"172.16.139.250",5440,12,1142,12777,0,0,12,1142,0,0,146.269891,0.00553899999999885,1649395,0
"172.16.133.54",64798,"176.32.96.31",80,6,368,12778,0,0,4,246,2,122,146.274471,5.972006999999991,329,163
"172.16.133.54",64799,"176.32.96.31",80,6,368,12779,0,0,4,246,2,122,146.274679,5.971930000000015,329,163
"172.16.133.54",64800,"176.32.96.31",80,6,368,12780,0,0,4,246,2,122,146.274885,5.97165099999998,329,163
"172.16.133.93",60841,"199.48.206.108",443,13,1416,12781,0,0,6,835,7,581,146.300419,24.71745999999999,270,188
"172.16.133.93",60842,"199.48.206.108",443,18,4203,12782,0,0,9,2082,9,2121,146.300605,24.71829600000001,673,686
"172.16.133.95",57054,"172.16.139.250",5440,10,1022,12783,0,0,10,1022,0,0,146.309887,0.0052809999999965385,1548191,0
"172.16.133.54",64801,"199.27.74.193",80,6,372,12784,0,0,4,246,2,126,146.322688,5.9662600000000054,329,168
"172.16.133.92",57768,"172.16.139.250",5440,10,1022,12785,0,0,10,1022,0,0,146.336156,0.016002000000014505,510936,0
"172.16.133.29",61040,"172.16.139.250",5440,10,1022,12786,0,0,10,1022,0,0,146.357098,0.005419999999986658,1508487,0
"172.16.133.44",64922,"172.16.139.250",5440,12,1142,12787,0,0,12,1142,0,0,146.360844,0.01922500000000582,475214,0
"172.16.133.207",56018,"172.16.139.250",5440,12,1142,12788,0,0,12,1142,0,0,146.385269,0.018646000000018148,489971,0
"172.16.133.83",57176,"172.16.139.250",5440,12,1142,12789,0,0,12,1142,0,0,146.394939,0.004930000000001655,"",""
"172.16.133.54",64802,"204.246.169.70",80,15,6888,12790,0,0,8,1252,7,5636,146.409588,115.80375000000001,86,389
"172.16.133.54",64803,"204.246.169.70",80,15,6576,12791,0,0,8,1252,7,5324,146.409896,115.803788,86,367
"172.16.133.54",64804,"204.246.169.70",80,15,6098,12792,0,0,8,1252,7,4846,146.410103,115.80311899999998,86,334
"172.16.133.54",64805,"204.246.169.70",80,11,3279,12793,0,0,6,749,5,2530,146.410327,115.80328500000002,51,174
"172.16.133.54",64806,"204.246.169.70",80,11,2983,12794,0,0,6,749,5,2234,146.410536,115.802967,51,154
"172.16.133.54",64807,"204.246.169.70",80,15,6276,12795,0,0,8,1252,7,5024,146.410738,115.80151700000002,86,347
"172.16.133.93",60843,"172.16.139.250",5440,12,1142,12796,0,0,12,1142,0,0,146.411276,0.014742000000012467,619725,0
"172.16.133.11",55227,"172.16.139.250",5440,10,1022,12797,0,0,10,1022,0,0,146.42805,0.01597899999998731,511671,0
"172.16.133.55",57718,"172.16.139.250",5440,10,1022,12798,0,0,10,1022,0,0,146.432545,0.0055529999999919255,1472357,0
"172.16.133.54",64808,"173.204.219.5",80,8,2145,12799,0,0,5,1133,3,1012,146.45486,0.08820800000000872,102757,91783
"172.16.133.73",60777,"172.16.139.250",5440,12,1142,12800,0,0,12,1142,0,0,146.456325,0.01673500000001127,545921,0
"172.16.133.54",64809,"216.52.121.177",80,9,1431,12801,0,0,5,820,4,611,146.456397,0.08272999999999797,79294,59083
"172.16.133.53",54204,"172.16.139.250",5440,10,1022,12802,0,0,10,1022,0,0,146.458308,0.005633000000017319,1451446,0
"172.16.133.21",53279,"172.16.139.250",5440,10,1022,12803,0,0,10,1022,0,0,146.460336,0.007830999999981714,1044055,0
"172.16.133.30",62737,"172.16.139.250",5440,10,1022,12804,0,0,10,1022,0,0,146.46597,0.017271999999991294,473367,0
"172.16.133.25",63574,"172.16.139.250",5440,12,1142,12805,0,0,12,1142,0,0,146.473575,0.0049619999999777065,"",""
"172.16.133.34",50527,"172.16.139.250",5440,12,1142,12806,0,0,12,1142,0,0,146.481397,0.005413000000004331,1687788,0
"172.16.133.54",64810,"216.52.121.177",80,9,1354,12807,0,0,5,743,4,611,146.48398,5.04192900000001,1178,969
"172.16.133.97",59479,"172.16.139.250",5440,12,1142,12808,0,0,12,1142,0,0,146.492399,0.006123999999999796,1491835,0
"172.16.133.33",57988,"172.16.139.250",5440,10,1022,12809,0,0,10,1022,0,0,146.563841,0.01472400000000107,555283,0
"172.16.133.68",60844,"172.16.139.250",5440,10,1022,12810,0,0,10,1022,0,0,146.59797,0.00598399999998378,1366310,0
"172.16.133.12",59867,"172.16.139.250",5440,12,1142,12811,0,0,12,1142,0,0,146.610911,0.005790000000018836,1577892,0
"172.16.133.63",53974,"172.16.139.250",5440,10,1022,12812,0,0,10,1022,0,0,146.621819,0.00581500000001256,1406018,0
"172.16.133.66",53992,"172.16.139.250",5440,12,1142,12813,0,0,12,1142,0,0,146.634442,0.006641999999999371,1375489,0
"172.16.133.82",61479,"172.16.139.250",5440,12,1142,12814,0,0,12,1142,0,0,146.649375,0.006342000000017833,1440555,0
"172.16.133.37",60711,"172.16.139.250",5440,10,1022,12815,0,0,10,1022,0,0,146.663143,0.01742500000000291,469210,0
"172.16.133.78",59315,"172.16.139.250",5440,12,1142,12816,0,0,12,1142,0,0,146.818438,0.005719000000027563,1597482,0
"172.16.133.67",56085,"172.16.139.250",5440,10,1022,12817,0,0,10,1022,0,0,146.873038,0.005251999999984491,1556740,0
"172.16.133.56",61520,"172.16.139.250",5440,10,1022,12818,0,0,10,1022,0,0,146.896948,0.005046999999990476,1619972,0
"172.16.133.41",53233,"172.16.139.250",5440,10,1022,12819,0,0,10,1022,0,0,146.951449,0.005439999999993006,1502941,0
"172.16.133.42",57211,"172.16.139.250",5440,12,1142,12820,0,0,12,1142,0,0,146.989709,0.03309300000000803,276070,0
"172.16.133.85",52361,"172.16.139.250",5440,10,1022,12821,0,0,10,1022,0,0,147.01543,0.006592999999980975,1240103,0
"172.16.133.43",57868,"172.16.139.250",5440,10,1022,12822,0,0,10,1022,0,0,147.022278,0.0057380000000080145,1424886,0
"172.16.133.13",53124,"172.16.139.250",5440,12,1142,12823,0,0,12,1142,0,0,147.04109,0.006116999999989048,1493542,0
"172.16.133.20",62499,"172.16.139.250",5440,12,1142,12824,0,0,12,1142,0,0,147.090366,0.005459000000001879,1673566,0
"172.16.133.75",51064,"172.16.139.250",5440,10,1022,12825,0,0,10,1022,0,0,147.107561,0.015323999999992566,533542,0
"172.16.133.28",49187,"172.16.139.250",5440,10,1022,12826,0,0,10,1022,0,0,147.121465,0.005863000000005059,1394507,0
"172.16.133.99",56142,"172.16.139.250",5440,10,1022,12827,0,0,10,1022,0,0,147.147414,0.005181999999990694,1577769,0
"172.16.133.54",64811,"108.170.193.53",80,11,3894,12828,0,0,6,2351,5,1543,147.1506,0.18044000000000437,104234,68410
"172.16.133.54",64812,"108.170.193.53",80,12,3954,12829,0,0,6,2351,6,1603,147.151296,0.17856499999999187,105328,71816
"172.16.133.54",64813,"108.170.193.53",80,11,3898,12830,0,0,6,2351,5,1547,147.152006,0.18097499999998945,103925,68385
"172.16.133.54",64814,"108.170.193.53",80,11,3903,12831,0,0,6,2352,5,1551,147.153603,0.1782479999999964,105560,69610
"172.16.133.54",64815,"108.170.193.53",80,12,3958,12832,0,0,6,2351,6,1607,147.154174,0.2707589999999982,69463,47481
"172.16.133.54",64816,"108.170.193.53",80,12,3950,12833,0,0,6,2351,6,1599,147.154382,0.17882900000000745,105173,71532
"172.16.133.87",60321,"172.16.139.250",5440,10,1022,12834,0,0,10,1022,0,0,147.17114,0.0053079999999852134,1540316,0
"172.16.133.35",50061,"172.16.139.250",5440,12,1142,12835,0,0,12,1142,0,0,147.179326,0.01423499999998512,641798,0
"172.16.133.116",53631,"172.16.139.250",5440,10,1022,12836,0,0,10,1022,0,0,147.185178,0.008150999999998021,1003067,0
"172.16.133.116",53632,"172.16.139.250",5440,10,1022,12837,0,0,10,1022,0,0,147.19443,0.006118999999983998,1336166,0
"172.16.133.116",53633,"172.16.139.250",5440,10,1022,12838,0,0,10,1022,0,0,147.201307,0.00490699999997446,"",""
"172.16.133.84",58889,"172.16.139.250",5440,12,1142,12839,0,0,12,1142,0,0,147.207268,0.016130000000003974,566398,0
"172.16.133.82",61480,"64.56.203.22",443,31,19390,12840,0,0,14,5900,17,13490,147.257528,18.583864000000005,2539,5807
"172.16.133.54",64817,"108.170.193.53",80,11,3898,12841,0,0,6,2351,5,1547,147.2786,0.2180049999999767,86273,56769
"172.16.133.54",64818,"108.170.193.53",80,11,3898,12842,0,0,6,2351,5,1547,147.284835,0.21166900000000055,88855,58468
"172.16.133.49",55881,"172.16.139.250",5440,10,1022,12843,0,0,10,1022,0,0,147.284916,0.005678999999986445,1439690,0
"172.16.133.54",64819,"108.170.193.53",80,11,3898,12844,0,0,6,2351,5,1547,147.287705,0.20895600000000059,90009,59227
"172.16.133.54",64820,"108.170.193.53",80,12,3950,12845,0,0,6,2351,6,1599,147.288284,0.20863699999998175,90147,61312
"172.16.133.54",64821,"108.170.193.53",80,11,3898,12846,0,0,6,2351,5,1547,147.28893,0.2083770000000129,90259,59392
"172.16.133.30",62738,"198.61.152.151",80,14,4069,12847,0,0,8,1615,6,2454,147.29214,134.891924,95,145
"172.16.133.95",57055,"172.16.139.250",5440,10,1022,12848,0,0,10,1022,0,0,147.323747,0.016208000000005995,504442,0
"172.16.133.45",61368,"64.90.204.229",443,27,7908,12849,0,0,12,4860,15,3048,147.342041,11.930840000000018,3258,2043
"172.16.133.45",61369,"64.90.204.229",443,17,3031,12850,0,0,8,1747,9,1284,147.342231,7.004322000000002,1995,1466
"172.16.133.45",61370,"64.90.204.229",443,19,5342,12851,0,0,9,1815,10,3527,147.342427,7.004382000000021,2072,4028
"172.16.133.45",61371,"64.90.204.229",443,17,3005,12852,0,0,8,1781,9,1224,147.342882,6.922705000000008,2058,1414
"172.16.133.45",61372,"64.90.204.229",443,17,3820,12853,0,0,8,1749,9,2071,147.343134,7.003778000000011,1997,2365
"172.16.133.78",59316,"153.90.68.50",53458,3,194,12854,0,0,3,194,0,0,147.349047,8.998514999999998,172,0
"172.16.133.92",57769,"172.16.139.250",5440,10,1022,12855,0,0,10,1022,0,0,147.350134,0.005561000000000149,1470239,0
"172.16.133.29",61041,"172.16.139.250",5440,10,1022,12856,0,0,10,1022,0,0,147.369047,0.0055540000000178225,1472092,0
"172.16.133.44",64923,"172.16.139.250",5440,10,1022,12857,0,0,10,1022,0,0,147.37475,0.015302999999988742,534274,0
"172.16.133.54",64822,"108.170.193.53",80,11,3902,12858,0,0,6,2351,5,1551,147.379478,0.2353430000000003,79917,52723
"172.16.133.207",56019,"172.16.139.250",5440,10,1022,12859,0,0,10,1022,0,0,147.400107,0.00825100000000134,990910,0
"172.16.133.54",64823,"108.170.193.53",80,11,3877,12860,0,0,6,2338,5,1539,147.407321,0.2078170000000057,90002,59244
"172.16.133.83",57177,"172.16.139.250",5440,10,1022,12861,0,0,10,1022,0,0,147.409102,0.004906000000005406,"",""
"172.16.133.93",60844,"172.16.139.250",5440,10,1022,12862,0,0,10,1022,0,0,147.424389,0.04916099999999801,166310,0
"172.16.133.11",55236,"172.16.139.250",5440,12,1142,12863,0,0,12,1142,0,0,147.443073,0.1520529999999951,60084,0
"172.16.133.55",57719,"172.16.139.250",5440,12,1142,12864,0,0,12,1142,0,0,147.446649,0.15158800000000383,60268,0
"172.16.133.73",60778,"172.16.139.250",5440,10,1022,12865,0,0,10,1022,0,0,147.471772,0.0796890000000019,102598,0
"172.16.133.53",54205,"172.16.139.250",5440,10,1022,12866,0,0,10,1022,0,0,147.473248,0.1285919999999976,63580,0
"172.16.133.21",53280,"172.16.139.250",5440,12,1142,12867,0,0,12,1142,0,0,147.474503,0.08274099999999862,110416,0
"172.16.133.30",62739,"172.16.139.250",5440,12,1142,12868,0,0,12,1142,0,0,147.47854,0.0830919999999935,109950,0
"172.16.133.82",61482,"204.93.223.146",443,15,3435,12869,0,0,7,2751,8,684,147.486531,35.03301499999998,628,156
"172.16.133.25",63575,"172.16.139.250",5440,12,1142,12870,0,0,12,1142,0,0,147.486532,0.08111699999997768,112627,0
"172.16.133.82",61483,"216.137.33.109",443,12,1314,12871,0,0,6,825,6,489,147.486869,38.29251199999999,172,102
"172.16.133.82",61484,"23.20.26.196",443,16,5734,12872,0,0,8,899,8,4835,147.48694,8.300274000000002,866,4660
"172.16.133.82",61485,"23.20.26.196",443,18,5913,12873,0,0,9,965,9,4948,147.487078,8.300040999999993,930,4769
"172.16.133.82",61486,"72.44.52.222",443,18,5854,12874,0,0,9,959,9,4895,147.487313,8.299622,924,4718
"172.16.133.82",61487,"72.44.52.222",443,18,5854,12875,0,0,9,959,9,4895,147.487367,8.299476999999996,924,4718
"172.16.133.82",61488,"72.44.52.222",443,19,5914,12876,0,0,9,959,10,4955,147.487472,8.299555999999995,924,4776
"172.16.133.82",61489,"72.44.52.222",443,28,9963,12877,0,0,14,3583,14,6380,147.487591,18.30397099999999,1565,2788
"172.16.133.82",61490,"216.137.33.1",443,26,9090,12878,0,0,12,1953,14,7137,147.487845,128.289179,121,445
"172.16.133.82",61491,"107.21.93.12",443,21,6086,12879,0,0,10,1150,11,4936,147.487905,68.29547399999998,134,578
"172.16.133.82",61492,"72.21.215.132",443,19,4550,12880,0,0,8,883,11,3667,147.488148,28.335024000000004,249,1035
"172.16.133.82",61493,"72.21.215.132",443,19,4550,12881,0,0,8,883,11,3667,147.48815,28.33492000000001,249,1035
"172.16.133.82",61494,"72.21.215.132",443,19,4550,12882,0,0,8,883,11,3667,147.488271,28.334696000000008,249,1035
"172.16.133.82",61495,"64.208.138.113",443,19,4041,12883,0,0,10,1149,9,2892,147.488484,68.287005,134,338
"172.16.133.82",61496,"64.208.138.113",443,29,14089,12884,0,0,14,6047,15,8042,147.488543,18.284806000000003,2645,3518
"172.16.133.82",61497,"204.232.201.76",443,19,6366,12885,0,0,9,967,10,5399,147.488778,8.33377999999999,928,5182
"172.16.133.82",61498,"204.232.201.76",443,22,7722,12886,0,0,11,2093,11,5629,147.488779,8.335341999999997,2008,5402
"172.16.133.82",61499,"204.232.201.76",443,19,6366,12887,0,0,9,967,10,5399,147.48891,8.332786999999996,928,5183
"172.16.133.34",50528,"172.16.139.250",5440,12,1142,12888,0,0,12,1142,0,0,147.496713,0.07660999999998808,119253,0
"172.16.133.97",59480,"172.16.139.250",5440,10,1022,12889,0,0,10,1022,0,0,147.505069,0.09787300000002119,83536,0
"172.16.133.126",61906,"173.194.43.54",443,51,16975,12890,0,0,26,13495,25,3480,147.556422,135.742438,795,205
"172.16.133.54",64824,"173.194.43.45",80,10,1791,12891,0,0,6,924,4,867,147.563438,120.65760400000002,61,57
"172.16.133.33",57989,"172.16.139.250",5440,12,1142,12892,0,0,12,1142,0,0,147.578764,0.0352929999999958,258861,0
"172.16.133.153",47843,"64.17.236.31",80,131,103094,12893,0,0,64,4694,67,98400,147.581677,1.503183999999976,24981,523688
"172.16.133.68",60846,"172.16.139.250",5440,12,1142,12894,0,0,12,1142,0,0,147.612018,0.006760999999983142,1351279,0
"172.16.133.12",59868,"172.16.139.250",5440,12,1142,12895,0,0,12,1142,0,0,147.625206,0.0061440000000061445,1486979,0
"172.16.133.63",53975,"172.16.139.250",5440,12,1142,12896,0,0,12,1142,0,0,147.635725,0.006523999999984653,1400367,0
"172.16.133.66",53993,"172.16.139.250",5440,12,1142,12897,0,0,12,1142,0,0,147.648469,0.006168999999999869,1480953,0
"172.16.133.82",61500,"172.16.139.250",5440,12,1142,12898,0,0,12,1142,0,0,147.662716,0.006217000000020789,1469519,0
"172.16.133.37",60712,"172.16.139.250",5440,12,1142,12899,0,0,12,1142,0,0,147.676499,0.00656399999999735,1391834,0
"172.16.133.82",61501,"23.22.135.102",443,23,8598,12900,0,0,11,2391,12,6207,147.737076,8.049660999999986,2376,6168
"172.16.133.99",56143,"68.64.24.250",443,6,366,12901,0,0,4,246,2,120,147.78773,0.10895999999999617,18061,8810
"172.16.133.78",59317,"172.16.139.250",5440,12,1142,12902,0,0,12,1142,0,0,147.832423,0.020780999999999494,439632,0
"172.16.133.99",56144,"216.219.118.244",443,6,366,12903,0,0,4,246,2,120,147.878601,0.21471700000000737,9165,4471
"172.16.133.67",56086,"172.16.139.250",5440,12,1142,12904,0,0,12,1142,0,0,147.887642,0.006191999999998643,1475452,0
"172.16.133.99",56145,"78.108.118.250",443,6,366,12905,0,0,4,246,2,120,147.88862,0.21428299999999467,9184,4480
"172.16.133.56",61521,"172.16.139.250",5440,10,1022,12906,0,0,10,1022,0,0,147.910598,0.015011000000015429,544667,0
"172.16.133.39",64274,"173.194.43.46",80,12,3550,12907,0,0,7,1394,5,2156,147.91713,118.11618500000003,94,146
"172.16.133.30",62740,"198.61.152.151",443,39,25053,12908,0,0,16,3744,23,21309,147.947426,134.236736,223,1269
"172.16.133.54",64825,"67.69.174.136",80,11,2580,12909,0,0,6,732,5,1848,147.956455,115.289358,50,128
"172.16.133.54",64826,"67.69.174.136",80,6,372,12910,0,0,4,246,2,126,147.956868,5.2929340000000025,371,190
"172.16.133.41",53234,"172.16.139.250",5440,10,1022,12911,0,0,10,1022,0,0,147.965711,0.005953000000005204,1373425,0
"172.16.133.28",49188,"216.52.242.80",80,251,219026,12912,0,0,86,38807,165,180219,147.967342,113.43087799999998,2736,12710
"172.16.133.39",64276,"173.194.43.2",80,24,13912,12913,0,0,12,3567,12,10345,147.995821,118.03733600000001,241,701
"172.16.133.42",57212,"172.16.139.250",5440,12,1142,12914,0,0,12,1142,0,0,148.008478,0.012776999999999816,715034,0
"172.16.133.85",52362,"172.16.139.250",5440,12,1142,12915,0,0,12,1142,0,0,148.029077,0.006378000000012207,1432423,0
"172.16.133.43",57869,"172.16.139.250",5440,12,1142,12916,0,0,12,1142,0,0,148.037754,0.0064710000000047785,1411837,0
"172.16.133.13",53126,"172.16.139.250",5440,10,1022,12917,0,0,10,1022,0,0,148.056631,0.015050000000002228,543255,0
"172.16.133.28",49189,"23.62.193.244",80,7,432,12918,0,0,4,246,3,186,148.091342,11.595003999999989,169,128
"172.16.133.28",49190,"23.62.193.244",80,6,372,12919,0,0,4,246,2,126,148.091684,11.626483000000007,169,86
"172.16.133.28",49191,"208.111.160.6",80,8,492,12920,0,0,4,246,4,246,148.09378,11.591723000000002,169,169
"172.16.133.28",49192,"208.111.160.6",80,8,492,12921,0,0,4,246,4,246,148.093876,11.591633000000002,169,169
"172.16.133.28",49193,"208.111.160.6",80,8,492,12922,0,0,4,246,4,246,148.094033,11.590608000000003,169,169
"172.16.133.28",49194,"208.111.160.6",80,8,492,12923,0,0,4,246,4,246,148.094138,11.591372000000007,169,169
"172.16.133.20",62500,"172.16.139.250",5440,12,1142,12924,0,0,12,1142,0,0,148.104235,0.014707000000015569,621200,0
"172.16.133.54",64827,"208.47.254.49",80,24,9696,12925,0,0,13,4013,11,5683,148.107928,117.15503100000004,274,388
"172.16.133.75",51065,"172.16.139.250",5440,10,1022,12926,0,0,10,1022,0,0,148.120449,0.005515000000002601,1482502,0
"172.16.133.28",49195,"208.111.160.6",80,17,6169,12927,0,0,7,1906,10,4263,148.126764,41.514297,367,821
"172.16.133.28",49196,"208.111.160.6",80,13,4334,12928,0,0,6,1112,7,3222,148.127112,41.51547199999999,214,620
"172.16.133.28",49197,"208.111.160.6",80,19,7469,12929,0,0,8,1972,11,5497,148.127317,41.51513,380,1059
"172.16.133.28",49198,"208.111.160.6",80,21,7432,12930,0,0,9,2032,12,5400,148.127523,41.515169000000014,391,1040
"172.16.133.28",49199,"208.111.160.6",80,13,2969,12931,0,0,6,1106,7,1863,148.127737,41.514410999999996,213,359
"172.16.133.28",49200,"208.111.160.6",80,20,5965,12932,0,0,8,1966,12,3999,148.127928,41.51442900000001,378,770
"172.16.133.28",49201,"172.16.139.250",5440,12,1142,12933,0,0,12,1142,0,0,148.134879,0.005588999999986299,1634639,0
"172.16.133.99",56146,"216.115.219.126",443,7,432,12934,0,0,5,312,2,120,148.159674,3.4908570000000054,715,275
"172.16.133.99",56147,"172.16.139.250",5440,10,1022,12935,0,0,10,1022,0,0,148.16152,0.014362000000005537,569280,0
"172.16.133.30",62741,"172.16.139.250",5440,10,1022,12936,0,0,10,1022,0,0,148.166003,0.00528100000002496,1548191,0
"172.16.133.93",60845,"199.48.206.68",443,15,1348,12937,0,0,8,765,7,583,148.17618,138.660482,44,33
"172.16.133.93",60846,"199.48.206.210",443,15,1562,12938,0,0,8,984,7,578,148.176564,138.674949,56,33
"172.16.133.87",60322,"172.16.139.250",5440,12,1142,12939,0,0,12,1142,0,0,148.185736,0.018434000000013384,495605,0
"172.16.133.35",50062,"172.16.139.250",5440,12,1142,12940,0,0,12,1142,0,0,148.192997,0.01198800000000233,762095,0
"172.16.133.116",53634,"172.16.139.250",5440,10,1022,12941,0,0,10,1022,0,0,148.199105,0.008131999999989148,1005410,0
"172.16.133.116",53635,"172.16.139.250",5440,10,1022,12942,0,0,10,1022,0,0,148.207801,0.005558000000007723,1471032,0
"172.16.133.116",53636,"172.16.139.250",5440,10,1022,12943,0,0,10,1022,0,0,148.214154,0.005147999999991271,1588189,0
"172.16.133.84",58890,"172.16.139.250",5440,10,1022,12944,0,0,10,1022,0,0,148.220223,0.005583999999998923,1464183,0
"172.16.133.49",55882,"172.16.139.250",5440,12,1142,12945,0,0,12,1142,0,0,148.297995,0.01649800000001278,553764,0
"172.16.133.95",57056,"172.16.139.250",5440,10,1022,12947,0,0,10,1022,0,0,148.337607,0.005977999999998929,1367681,0
"172.16.133.92",57770,"172.16.139.250",5440,12,1142,12948,0,0,12,1142,0,0,148.363221,0.01594799999998031,572861,0
"172.16.133.29",61042,"172.16.139.250",5440,10,1022,12949,0,0,10,1022,0,0,148.382411,0.01647400000001653,496297,0
"172.16.133.44",64924,"172.16.139.250",5440,10,1022,12950,0,0,10,1022,0,0,148.389683,0.0054149999999992815,1509879,0
"172.16.133.207",56020,"172.16.139.250",5440,12,1142,12951,0,0,12,1142,0,0,148.414198,0.0051379999999880965,1778123,0
"172.16.133.54",64828,"67.69.174.11",80,12,3958,12952,0,0,7,1530,5,2428,148.416005,115.83080499999997,105,167
"172.16.133.83",57178,"172.16.139.250",5440,12,1142,12953,0,0,12,1142,0,0,148.422919,0.004914999999982683,"",""
"172.16.133.93",60847,"172.16.139.250",5440,10,1022,12954,0,0,10,1022,0,0,148.439775,0.005088999999998123,1606602,0
"172.16.133.11",55237,"172.16.139.250",5440,10,1022,12955,0,0,10,1022,0,0,148.455771,0.005819999999999936,1404810,0
"172.16.133.55",57720,"172.16.139.250",5440,12,1142,12956,0,0,12,1142,0,0,148.460373,0.01723799999999187,529991,0
"172.16.133.73",60779,"172.16.139.250",5440,10,1022,12957,0,0,10,1022,0,0,148.484397,0.005648000000007869,1447592,0
"172.16.133.53",54206,"172.16.139.250",5440,10,1022,12958,0,0,10,1022,0,0,148.487461,0.006320000000016535,1293670,0
"172.16.133.21",53281,"172.16.139.250",5440,12,1142,12959,0,0,12,1142,0,0,148.489473,0.01552699999999163,588394,0
"172.16.133.30",62742,"172.16.139.250",5440,10,1022,12960,0,0,10,1022,0,0,148.492594,0.020309999999994943,402560,0
"172.16.133.25",63576,"172.16.139.250",5440,12,1142,12961,0,0,12,1142,0,0,148.499764,0.008679999999998245,1052534,0
"172.16.133.34",50529,"172.16.139.250",5440,10,1022,12962,0,0,10,1022,0,0,148.510448,0.006776000000002114,1206611,0
"172.16.133.97",59481,"172.16.139.250",5440,10,1022,12963,0,0,10,1022,0,0,148.519059,0.005471999999997479,1494152,0
"172.16.133.33",57990,"172.16.139.250",5440,12,1142,12964,0,0,12,1142,0,0,148.593623,0.006548999999978378,1395022,0
"172.16.133.68",60847,"172.16.139.250",5440,10,1022,12965,0,0,10,1022,0,0,148.626865,0.015011999999984482,544630,0
"172.16.133.12",59869,"172.16.139.250",5440,10,1022,12966,0,0,10,1022,0,0,148.639457,0.006240000000019563,1310256,0
"172.16.133.63",53976,"172.16.139.250",5440,10,1022,12967,0,0,10,1022,0,0,148.649637,0.015634999999974752,522929,0
"172.16.133.28",49202,"138.108.7.20",80,11,4072,12968,0,0,6,2942,5,1130,148.656269,15.323852999999986,1535,589
"172.16.133.66",53994,"172.16.139.250",5440,10,1022,12969,0,0,10,1022,0,0,148.66234,0.006820000000004711,1198826,0
"172.16.133.28",49203,"64.94.107.62",80,8,2056,12970,0,0,5,1593,3,463,148.667006,0.07127200000002176,178807,51969
"172.16.133.82",61502,"172.16.139.250",5440,12,1142,12971,0,0,12,1142,0,0,148.677063,0.0058709999999848606,1556123,0
"172.16.133.37",60713,"172.16.139.250",5440,10,1022,12972,0,0,10,1022,0,0,148.691628,0.0058339999999930114,1401439,0
"172.16.133.78",59318,"172.16.139.250",5440,10,1022,12973,0,0,10,1022,0,0,148.846439,0.006383999999997059,1280701,0
"172.16.133.67",56087,"172.16.139.250",5440,10,1022,12974,0,0,10,1022,0,0,148.901849,0.005682000000007292,1438929,0
"172.16.133.56",61522,"172.16.139.250",5440,12,1142,12975,0,0,12,1142,0,0,148.924247,0.01544899999998961,591365,0
"172.16.133.41",53235,"172.16.139.250",5440,10,1022,12976,0,0,10,1022,0,0,148.980587,0.04808899999997607,170018,0
"172.16.133.54",64830,"108.170.196.147",80,11,3809,12977,0,0,6,2263,5,1546,149.017694,0.18281500000000506,99029,67653
"172.16.133.42",57213,"172.16.139.250",5440,12,1142,12978,0,0,12,1142,0,0,149.018361,0.0724570000000142,126088,0
"172.16.133.113",55654,"172.16.139.250",135,8,492,12979,0,0,8,492,0,0,149.032946,0.010942000000000007,359714,0
"172.16.133.85",52363,"172.16.139.250",5440,10,1022,12980,0,0,10,1022,0,0,149.043055,0.045865999999989526,178258,0
"172.16.133.113",55655,"172.16.139.250",5462,10,696,12981,0,0,10,696,0,0,149.044136,0.5163309999999797,10783,0
"172.16.133.153",55643,"23.33.83.78",80,63,44917,12982,0,0,31,2152,32,42765,149.044979,0.1591359999999895,108184,2149859
"172.16.133.43",57870,"172.16.139.250",5440,10,1022,12983,0,0,10,1022,0,0,149.050306,0.043594999999982065,187544,0
"172.16.133.54",64831,"204.11.109.61",80,12,1781,12984,0,0,6,899,6,882,149.067779,116.26265500000002,61,60
"172.16.133.54",64832,"50.116.194.21",80,12,2135,12985,0,0,6,1008,6,1127,149.068067,5.180076999999983,1556,1740
"172.16.133.13",53127,"172.16.139.250",5440,10,1022,12986,0,0,10,1022,0,0,149.069357,0.027784999999994398,294259,0
"172.16.133.54",64833,"204.11.109.61",80,7,432,12987,0,0,4,246,3,186,149.082725,6.221963999999986,316,239
"172.16.133.54",64834,"50.116.194.21",80,6,366,12988,0,0,4,246,2,120,149.083025,5.249240000000015,374,182
"172.16.133.20",62501,"172.16.139.250",5440,12,1142,12989,0,0,12,1142,0,0,149.118238,0.004765000000020336,"",""
"172.16.133.75",51066,"172.16.139.250",5440,10,1022,12990,0,0,10,1022,0,0,149.134459,0.0161329999999964,506787,0
"172.16.133.28",49204,"172.16.139.250",5440,12,1142,12991,0,0,12,1142,0,0,149.148357,0.0069090000000073815,1322333,0
"172.16.133.153",60629,"23.33.83.78",80,119,102830,12992,0,0,50,3441,69,99389,149.162678,0.2918430000000001,94324,2724451
"172.16.133.99",56148,"172.16.139.250",5440,10,1022,12993,0,0,10,1022,0,0,149.175367,0.004909999999995307,"",""
"172.16.133.11",55238,"184.73.225.104",443,24,8153,12994,0,0,12,2160,12,5993,149.187692,5.408746000000008,3194,8864
"172.16.133.87",60323,"172.16.139.250",5440,12,1142,12995,0,0,12,1142,0,0,149.199304,0.0061939999999935935,1474975,0
"172.16.133.116",53637,"172.16.139.250",5440,10,1022,12996,0,0,10,1022,0,0,149.21321,0.005631999999991422,1451704,0
"172.16.133.35",50063,"172.16.139.250",5440,12,1142,12997,0,0,12,1142,0,0,149.215333,0.015561000000019476,587108,0
"172.16.133.116",53638,"172.16.139.250",5440,10,1022,12998,0,0,10,1022,0,0,149.219773,0.008524999999991678,959061,0
"172.16.133.116",53639,"172.16.139.250",5440,10,1022,12999,0,0,10,1022,0,0,149.229692,0.005410000000011905,1511275,0
"172.16.133.84",58891,"172.16.139.250",5440,12,1142,13000,0,0,12,1142,0,0,149.235291,0.006303000000002612,1449468,0
"172.16.133.49",55883,"172.16.139.250",5440,10,1022,13001,0,0,10,1022,0,0,149.311817,0.005901000000022805,1385527,0
"172.16.133.95",57057,"172.16.139.250",5440,10,1022,13002,0,0,10,1022,0,0,149.351771,0.014645999999999049,558241,0
"172.16.133.54",64835,"107.21.255.53",80,13,3867,13003,0,0,7,2291,6,1576,149.354686,59.418301000000014,308,212
"172.16.133.92",57771,"172.16.139.250",5440,12,1142,13004,0,0,12,1142,0,0,149.379675,0.01572500000000332,580985,0
"172.16.133.29",61043,"172.16.139.250",5440,10,1022,13005,0,0,10,1022,0,0,149.395143,0.005355000000008658,1526797,0
"172.16.133.44",64925,"172.16.139.250",5440,10,1022,13006,0,0,10,1022,0,0,149.403838,0.015223999999989246,537046,0
"172.16.133.153",58322,"205.153.84.114",80,8,771,13007,0,0,4,403,4,368,149.422334,0.09786499999998455,32943,30082
"172.16.133.207",56021,"172.16.139.250",5440,12,1142,13008,0,0,12,1142,0,0,149.427413,0.014657999999997173,623277,0
"172.16.133.83",57179,"172.16.139.250",5440,12,1142,13009,0,0,12,1142,0,0,149.438135,0.01488700000001586,613689,0
"172.16.133.93",60848,"172.16.139.250",5440,10,1022,13010,0,0,10,1022,0,0,149.45334,0.004799999999988813,"",""
"172.16.133.11",55239,"172.16.139.250",5440,10,1022,13011,0,0,10,1022,0,0,149.470134,0.030548000000010234,267644,0
"172.16.133.55",57721,"172.16.139.250",5440,12,1142,13012,0,0,12,1142,0,0,149.475482,0.021358999999989692,427735,0
"172.16.133.153",58259,"184.84.3.78",80,247,216787,13013,0,0,103,6914,144,209873,149.488087,0.614342999999991,90034,2732974
"172.16.133.54",64836,"54.240.160.30",80,6,372,13014,0,0,4,246,2,126,149.495725,5.74582700000002,342,175
"172.16.133.54",64837,"54.240.160.30",80,6,372,13015,0,0,4,246,2,126,149.496309,5.7442120000000045,342,175
"172.16.133.73",60780,"172.16.139.250",5440,10,1022,13016,0,0,10,1022,0,0,149.498319,0.0071659999999837964,1140943,0
"172.16.133.53",54207,"172.16.139.250",5440,12,1142,13017,0,0,12,1142,0,0,149.500245,0.009550999999987653,956549,0
"172.16.133.21",53282,"172.16.139.250",5440,12,1142,13018,0,0,12,1142,0,0,149.502465,0.01101299999999128,829565,0
"172.16.133.30",62743,"172.16.139.250",5440,12,1142,13019,0,0,12,1142,0,0,149.507022,0.01557499999998413,586581,0
"172.16.133.25",63577,"172.16.139.250",5440,12,1142,13020,0,0,12,1142,0,0,149.514446,0.018552999999997155,492427,0
"172.16.133.34",50530,"172.16.139.250",5440,12,1142,13021,0,0,12,1142,0,0,149.524056,0.005192999999991343,1759291,0
"172.16.133.97",59482,"172.16.139.250",5440,10,1022,13022,0,0,10,1022,0,0,149.533637,0.005465000000015152,1496065,0
"172.16.133.54",64838,"67.69.174.25",80,6,372,13023,0,0,4,246,2,126,149.543069,5.700288999999998,345,176
"172.16.133.54",64839,"67.69.174.25",80,14,6046,13024,0,0,7,1066,7,4980,149.543851,115.743232,73,344
"172.16.133.11",55240,"157.56.244.217",443,6,374,13025,0,0,3,194,3,180,149.54721,1.2026229999999885,1290,1197
"172.16.133.33",57991,"172.16.139.250",5440,12,1142,13027,0,0,12,1142,0,0,149.606125,0.005839000000008809,1564651,0
"172.16.133.95",57058,"199.59.148.247",80,12,2378,13028,0,0,7,1620,5,758,149.613395,36.20929000000001,357,167
"172.16.133.68",60848,"172.16.139.250",5440,10,1022,13029,0,0,10,1022,0,0,149.639792,0.015305000000012114,534204,0
"172.16.133.12",59870,"172.16.139.250",5440,12,1142,13030,0,0,12,1142,0,0,149.653016,0.006372999999996409,1433547,0
"172.16.133.63",53977,"172.16.139.250",5440,12,1142,13031,0,0,12,1142,0,0,149.663599,0.01655199999999013,551957,0
"172.16.133.66",53995,"172.16.139.250",5440,10,1022,13032,0,0,10,1022,0,0,149.676918,0.006937999999991007,1178437,0
"172.16.133.82",61503,"172.16.139.250",5440,12,1142,13033,0,0,12,1142,0,0,149.691392,0.006315999999998212,1446485,0
"172.16.133.37",60714,"172.16.139.250",5440,10,1022,13034,0,0,10,1022,0,0,149.703411,0.014616000000017948,559386,0
"172.16.133.128",65053,"216.115.222.200",443,6,366,13035,0,0,4,246,2,120,149.814106,0.21124699999998597,9316,4544
"172.16.133.128",65054,"202.173.24.200",443,6,366,13036,0,0,4,246,2,120,149.814845,0.4953260000000057,3973,1938
"172.16.133.128",65055,"216.219.112.250",443,6,366,13037,0,0,4,246,2,120,149.81534,0.2530020000000093,7778,3794
"172.16.133.128",65056,"66.151.158.187",443,6,366,13038,0,0,4,246,2,120,149.815664,0.23408399999999574,8407,4101
"172.16.133.99",56149,"68.64.24.250",443,6,366,13039,0,0,4,246,2,120,149.854725,0.1703200000000038,11554,5636
"172.16.133.78",59319,"172.16.139.250",5440,10,1022,13040,0,0,10,1022,0,0,149.860372,0.005380999999999858,1519420,0
"172.16.133.67",56088,"172.16.139.250",5440,10,1022,13041,0,0,10,1022,0,0,149.915065,0.005304999999992788,1541187,0
"172.16.133.30",62744,"216.221.224.26",80,139,118205,13042,0,0,42,3816,97,114389,149.931402,34.113044,894,26825
"172.16.133.56",61523,"172.16.139.250",5440,12,1142,13043,0,0,12,1142,0,0,149.938854,0.014888000000013335,613648,0
"172.16.133.99",56150,"216.219.118.244",443,6,366,13044,0,0,4,246,2,120,149.992701,0.23808299999998894,8266,4032
"172.16.133.41",53236,"172.16.139.250",5440,10,1022,13045,0,0,10,1022,0,0,149.993424,0.031094999999993433,262936,0
"172.16.133.99",56151,"78.108.118.250",443,6,366,13046,0,0,4,246,2,120,149.995617,0.23580899999998906,8345,4071
"172.16.133.42",57214,"172.16.139.250",5440,12,1142,13047,0,0,12,1142,0,0,150.03531,0.012598999999994476,725136,0
"172.16.133.85",52364,"172.16.139.250",5440,10,1022,13048,0,0,10,1022,0,0,150.056817,0.014704999999992197,556001,0
"172.16.133.43",57871,"172.16.139.250",5440,10,1022,13049,0,0,10,1022,0,0,150.064268,0.015581999999994878,524707,0
"172.16.133.13",53128,"172.16.139.250",5440,10,1022,13050,0,0,10,1022,0,0,150.083195,0.015453000000007933,529088,0
"172.16.133.20",62502,"172.16.139.250",5440,12,1142,13051,0,0,12,1142,0,0,150.132431,0.014637999999990825,624128,0
"172.16.133.75",51067,"172.16.139.250",5440,8,902,13052,0,0,8,902,0,0,150.149559,0.005569999999977426,1295511,0
"172.16.133.28",49205,"172.16.139.250",5440,12,1142,13053,0,0,12,1142,0,0,150.163601,0.0063370000000020354,1441691,0
"172.16.133.99",56152,"172.16.139.250",5440,12,1142,13054,0,0,12,1142,0,0,150.189104,0.01501300000001038,608539,0
"172.16.133.132",58037,"23.61.31.139",80,83,65304,13055,0,0,38,2828,45,62476,150.198011,14.884845999999982,1519,33578
"172.16.133.87",60324,"172.16.139.250",5440,10,1022,13056,0,0,10,1022,0,0,150.21314,0.015091999999981454,541743,0
"172.16.133.35",50064,"172.16.139.250",5440,12,1142,13057,0,0,12,1142,0,0,150.22119,0.013628999999980351,670335,0
"172.16.133.116",53640,"172.16.139.250",5440,10,1022,13058,0,0,10,1022,0,0,150.229055,0.006427999999999656,1271935,0
"172.16.133.116",53641,"172.16.139.250",5440,10,1022,13059,0,0,10,1022,0,0,150.23624,0.005319999999983338,1536842,0
"172.16.133.116",53642,"172.16.139.250",5440,10,1022,13060,0,0,10,1022,0,0,150.242092,0.005358999999998559,1525657,0
"172.16.133.84",58892,"172.16.139.250",5440,10,1022,13061,0,0,10,1022,0,0,150.24927,0.005924999999990632,1379915,0
"172.16.133.116",53643,"23.0.49.244",80,7,432,13062,0,0,4,246,3,186,150.274079,11.87931900000001,165,125
"172.16.133.116",53644,"216.52.242.80",80,6,372,13063,0,0,4,246,2,126,150.274305,11.94961699999999,164,84
"172.16.133.49",55884,"172.16.139.250",5440,12,1142,13064,0,0,12,1142,0,0,150.32684,0.016190999999992073,564264,0
"172.16.133.54",64840,"63.146.126.10",80,16,9828,13065,0,0,8,2180,8,7648,150.333334,1.3772479999999803,12662,44424
"172.16.133.29",61044,"208.47.254.81",80,6,372,13066,0,0,4,246,2,126,150.344122,10.748897999999997,183,93
"172.16.133.29",61045,"208.111.161.254",80,8,492,13067,0,0,4,246,4,246,150.344589,10.752192999999977,183,183
"172.16.133.29",61046,"208.111.161.254",80,8,492,13068,0,0,4,246,4,246,150.344863,10.751919999999984,183,183
"172.16.133.29",61047,"208.111.161.254",80,8,492,13069,0,0,4,246,4,246,150.345125,10.751593000000014,183,183
"172.16.133.29",61048,"208.111.161.254",80,8,492,13070,0,0,4,246,4,246,150.345393,10.751387999999992,183,183
"172.16.133.29",61049,"208.111.161.254",80,8,492,13071,0,0,4,246,4,246,150.346197,10.751421000000022,183,183
"172.16.133.29",61050,"216.52.242.80",80,6,372,13072,0,0,4,246,2,126,150.346893,10.818959000000007,181,93
"172.16.133.29",61051,"23.0.49.244",80,7,432,13073,0,0,4,246,3,186,150.349594,10.750608999999997,183,138
"172.16.133.29",61052,"23.0.49.244",80,7,432,13074,0,0,4,246,3,186,150.350127,10.772592000000003,182,138
"172.16.133.95",57059,"172.16.139.250",5440,10,1022,13075,0,0,10,1022,0,0,150.365913,0.0053230000000041855,1535975,0
"172.16.133.54",64841,"69.172.216.156",80,40,35035,13076,0,0,16,3566,24,31469,150.379282,3.486298000000005,8182,72211
"172.16.133.92",57772,"172.16.139.250",5440,10,1022,13077,0,0,10,1022,0,0,150.392164,0.00544800000000123,1500734,0
"172.16.133.29",61053,"172.16.139.250",5440,10,1022,13078,0,0,10,1022,0,0,150.409418,0.005268999999998414,1551717,0
"172.16.133.44",64926,"172.16.139.250",5440,10,1022,13079,0,0,10,1022,0,0,150.418528,0.014594999999985703,560191,0
"172.16.133.207",56022,"172.16.139.250",5440,12,1142,13080,0,0,12,1142,0,0,150.442458,0.014423000000022057,633432,0
"172.16.133.83",57180,"172.16.139.250",5440,12,1142,13081,0,0,12,1142,0,0,150.450996,0.013924000000002934,656133,0
"172.16.133.93",60849,"172.16.139.250",5440,12,1142,13082,0,0,12,1142,0,0,150.466523,0.014764000000013766,618802,0
"172.16.133.11",55241,"172.16.139.250",5440,10,1022,13083,0,0,10,1022,0,0,150.48428,0.01545999999999026,528848,0
"172.16.133.55",57722,"172.16.139.250",5440,12,1142,13084,0,0,12,1142,0,0,150.489779,0.016150000000010323,565696,0
"172.16.133.73",60781,"172.16.139.250",5440,10,1022,13085,0,0,10,1022,0,0,150.511386,0.017943000000002485,455665,0
"172.16.133.53",54208,"172.16.139.250",5440,10,1022,13086,0,0,10,1022,0,0,150.515305,0.005719999999996617,1429370,0
"172.16.133.21",53283,"172.16.139.250",5440,12,1142,13087,0,0,12,1142,0,0,150.517633,0.008138999999999896,1122496,0
"172.16.133.30",62745,"172.16.139.250",5440,10,1022,13088,0,0,10,1022,0,0,150.522168,0.010847000000012486,753756,0
"172.16.133.25",63578,"172.16.139.250",5440,10,1022,13089,0,0,10,1022,0,0,150.527503,0.01543599999999401,529670,0
"172.16.133.34",50531,"172.16.139.250",5440,10,1022,13090,0,0,10,1022,0,0,150.538782,0.008135000000009995,1005039,0
"172.16.133.29",61054,"23.62.193.244",80,41,23139,13091,0,0,17,4436,24,18703,150.541475,119.405552,297,1253
"172.16.133.29",61055,"23.62.193.244",80,34,18075,13092,0,0,15,3837,19,14238,150.5417,119.40537499999999,257,953
"172.16.133.97",59483,"172.16.139.250",5440,10,1022,13093,0,0,10,1022,0,0,150.54723,0.005588999999986299,1462873,0
"172.16.133.28",49206,"216.52.242.80",80,6,372,13094,0,0,4,246,2,126,150.575448,19.139591999999993,102,52
"172.16.133.33",57992,"172.16.139.250",5440,12,1142,13095,0,0,12,1142,0,0,150.620312,0.006161999999989121,1482635,0
"172.16.133.68",60849,"172.16.139.250",5440,12,1142,13096,0,0,12,1142,0,0,150.653811,0.01567300000002092,582913,0
"172.16.133.28",49207,"173.194.43.59",80,6,372,13097,0,0,4,246,2,126,150.66821,18.973337000000015,103,53
"172.16.133.28",49208,"208.111.160.6",80,8,492,13098,0,0,4,246,4,246,150.668832,18.980912999999987,103,103
"172.16.133.28",49209,"208.111.160.6",80,8,492,13099,0,0,4,246,4,246,150.669069,18.97819099999998,103,103
"172.16.133.28",49210,"216.52.242.80",80,6,372,13100,0,0,4,246,2,126,150.669399,19.049282000000005,103,52
"172.16.133.63",53978,"172.16.139.250",5440,10,1022,13101,0,0,10,1022,0,0,150.677982,0.005252000000012913,1556740,0
"172.16.133.66",53996,"172.16.139.250",5440,10,1022,13102,0,0,10,1022,0,0,150.690621,0.005324999999999136,1535399,0
"172.16.133.82",61504,"172.16.139.250",5440,10,1022,13103,0,0,10,1022,0,0,150.70427,0.015619999999984202,523431,0
"172.16.133.37",60715,"172.16.139.250",5440,10,1022,13104,0,0,10,1022,0,0,150.71763,0.00698499999998603,1170508,0
"172.16.133.12",59871,"172.16.139.250",5440,12,1142,13105,0,0,12,1142,0,0,150.730541,0.006544000000019423,1396088,0
"172.16.133.11",55242,"157.56.234.137",443,6,374,13106,0,0,3,194,3,180,150.750446,1.2199369999999874,1272,1180
"172.16.133.54",64842,"72.21.91.196",80,6,372,13107,0,0,4,246,2,126,150.760535,5.455825000000004,360,184
"172.16.133.54",64843,"12.130.48.51",80,17,8356,13108,0,0,8,2298,9,6058,150.840362,89.098884,206,543
"172.16.133.54",64844,"12.130.48.51",80,9,2106,13109,0,0,5,1209,4,897,150.840816,89.09856500000001,108,80
"172.16.133.54",64845,"12.130.48.51",80,9,2127,13110,0,0,5,1218,4,909,150.841021,89.09850599999999,109,81
"172.16.133.29",61056,"138.108.6.20",80,8,1747,13111,0,0,4,1089,4,658,150.852486,10.812249000000008,805,486
"172.16.133.29",61057,"64.94.107.11",80,8,1736,13112,0,0,5,1273,3,463,150.860901,0.07715799999999717,131988,48005
"172.16.133.78",59320,"172.16.139.250",5440,12,1142,13113,0,0,12,1142,0,0,150.874631,0.006255000000010114,1460591,0
"172.16.133.54",64846,"173.194.75.104",80,12,3255,13114,0,0,7,2052,5,1203,150.908469,115.32605400000003,142,83
"172.16.133.67",56089,"172.16.139.250",5440,12,1142,13115,0,0,12,1142,0,0,150.929505,0.005938999999983707,1538306,0
"172.16.133.54",64847,"173.194.43.45",80,10,1748,13116,0,0,6,800,4,948,150.945358,115.274,55,65
"172.16.133.54",64848,"173.194.43.45",80,10,2446,13117,0,0,6,798,4,1648,150.945575,115.27363499999998,55,114
"172.16.133.54",64849,"173.194.43.45",80,10,1608,13118,0,0,6,794,4,814,150.94578,115.27371099999999,55,56
"172.16.133.54",64850,"173.194.43.45",80,10,1612,13119,0,0,6,799,4,813,150.945986,115.27362099999999,55,56
"172.16.133.54",64851,"173.194.43.45",80,10,1846,13120,0,0,6,797,4,1049,150.946172,115.27318500000001,55,72
"172.16.133.56",61524,"172.16.139.250",5440,12,1142,13121,0,0,12,1142,0,0,150.950944,0.004995000000008076,"",""
"172.16.133.28",49211,"64.94.107.62",80,10,2412,13122,0,0,6,1889,4,523,150.953744,0.1373000000000104,110065,30473
"172.16.133.41",53237,"172.16.139.250",5440,10,1022,13123,0,0,10,1022,0,0,151.007449,0.005393999999995458,1515758,0
"172.16.133.42",57215,"172.16.139.250",5440,12,1142,13124,0,0,12,1142,0,0,151.05086,0.020597000000009302,443559,0
"172.16.133.85",52365,"172.16.139.250",5440,10,1022,13125,0,0,10,1022,0,0,151.074525,0.006096000000013646,1341207,0
"172.16.133.43",57872,"172.16.139.250",5440,12,1142,13126,0,0,12,1142,0,0,151.077382,0.007327000000003636,1246895,0
"172.16.133.13",53129,"172.16.139.250",5440,10,1022,13127,0,0,10,1022,0,0,151.097107,0.00539600000001883,1515196,0
"172.16.133.20",62503,"172.16.139.250",5440,12,1142,13128,0,0,12,1142,0,0,151.146548,0.004877999999990834,"",""
"172.16.133.75",51068,"172.16.139.250",5440,10,1022,13129,0,0,10,1022,0,0,151.162575,0.01580300000000534,517370,0
"172.16.133.28",49212,"172.16.139.250",5440,12,1142,13130,0,0,12,1142,0,0,151.176775,0.005973000000011552,1529549,0
"172.16.133.99",56153,"172.16.139.250",5440,10,1022,13131,0,0,10,1022,0,0,151.203521,0.014241999999995869,574076,0
"172.16.133.87",60325,"172.16.139.250",5440,10,1022,13132,0,0,10,1022,0,0,151.228747,0.014871999999996888,549757,0
"172.16.133.35",50065,"172.16.139.250",5440,12,1142,13133,0,0,12,1142,0,0,151.236323,0.015351000000009662,595140,0
"172.16.133.116",53645,"172.16.139.250",5440,10,1022,13134,0,0,10,1022,0,0,151.242532,0.008989999999982956,909454,0
"172.16.133.116",53646,"172.16.139.250",5440,10,1022,13135,0,0,10,1022,0,0,151.252388,0.005073000000010097,1611669,0
"172.16.133.116",53647,"172.16.139.250",5440,10,1022,13136,0,0,10,1022,0,0,151.259163,0.005318999999985863,1537131,0
"172.16.133.84",58893,"172.16.139.250",5440,12,1142,13137,0,0,12,1142,0,0,151.263239,0.015243999999995594,599317,0
"172.16.133.116",53648,"208.111.161.254",80,21,15375,13138,0,0,7,1725,14,13650,151.280047,30.87031300000001,447,3537
"172.16.133.57",60628,"157.166.240.13",80,17,5466,13139,0,0,9,3490,8,1976,151.313119,17.632805999999988,1583,896
"172.16.133.49",55885,"172.16.139.250",5440,10,1022,13140,0,0,10,1022,0,0,151.340107,0.015314000000017813,533890,0
"172.16.133.95",57060,"172.16.139.250",5440,10,1022,13141,0,0,10,1022,0,0,151.378865,0.014855000000011387,550387,0
"172.16.133.92",57773,"172.16.139.250",5440,10,1022,13142,0,0,10,1022,0,0,151.407755,0.005576999999988175,1466021,0
"172.16.133.54",64852,"173.204.219.5",80,8,2068,13143,0,0,5,1056,3,1012,151.412426,0.11118799999999851,75979,72813
"172.16.133.29",61058,"172.16.139.250",5440,10,1022,13144,0,0,10,1022,0,0,151.424282,0.005864000000002534,1394270,0
"172.16.133.44",64927,"172.16.139.250",5440,10,1022,13145,0,0,10,1022,0,0,151.431624,0.014723000000003594,555321,0
"172.16.133.207",56023,"172.16.139.250",5440,10,1022,13146,0,0,10,1022,0,0,151.455317,0.01454799999999068,562001,0
"172.16.133.83",57181,"172.16.139.250",5440,12,1142,13147,0,0,12,1142,0,0,151.465029,0.013928000000021257,655944,0
"172.16.133.93",60850,"172.16.139.250",5440,12,1142,13148,0,0,12,1142,0,0,151.480849,0.014403999999984762,634268,0
"172.16.133.11",55243,"172.16.139.250",5440,10,1022,13149,0,0,10,1022,0,0,151.497899,0.014791999999999916,552731,0
"172.16.133.55",57723,"172.16.139.250",5440,10,1022,13150,0,0,10,1022,0,0,151.502459,0.014679000000000997,556986,0
"172.16.133.116",53649,"138.108.7.20",80,8,1694,13151,0,0,4,1036,4,658,151.515433,10.129134999999991,818,519
"172.16.133.116",53650,"64.94.107.62",80,8,1680,13152,0,0,5,1217,3,463,151.521382,0.06487700000002405,150068,57092
"172.16.133.57",60571,"157.166.255.246",80,4,4732,13153,0,0,2,2366,2,2366,151.523455,0.0006529999999997926,"",""
"172.16.133.73",60782,"172.16.139.250",5440,10,1022,13154,0,0,10,1022,0,0,151.52761,0.005977999999998929,1367681,0
"172.16.133.53",54209,"172.16.139.250",5440,10,1022,13155,0,0,10,1022,0,0,151.529565,0.008452000000005455,967345,0
"172.16.133.21",53284,"172.16.139.250",5440,10,1022,13156,0,0,10,1022,0,0,151.531337,0.010192999999986796,802119,0
"172.16.133.30",62746,"172.16.139.250",5440,12,1142,13157,0,0,12,1142,0,0,151.53602,0.010379999999997835,880154,0
"172.16.133.25",63579,"172.16.139.250",5440,12,1142,13158,0,0,12,1142,0,0,151.541802,0.008180000000010068,1116870,0
"172.16.133.34",50532,"172.16.139.250",5440,12,1142,13159,0,0,12,1142,0,0,151.552295,0.005072000000012622,1801261,0
"172.16.133.97",59484,"172.16.139.250",5440,12,1142,13160,0,0,12,1142,0,0,151.561025,0.01577699999998572,579070,0
"172.16.133.57",60629,"157.166.255.245",80,9,3932,13161,0,0,5,2576,4,1356,151.567233,0.09946500000000924,207188,109063
"172.16.133.126",61916,"204.14.233.101",443,38,14763,13162,0,0,19,6746,19,8017,151.619864,135.92093599999998,397,471
"172.16.133.33",57993,"172.16.139.250",5440,10,1022,13163,0,0,10,1022,0,0,151.634193,0.00575399999999604,1420924,0
"172.16.133.132",46271,"23.13.210.227",80,10,2085,13164,0,0,5,710,5,1375,151.663474,0.12314399999999637,46124,89326
"172.16.133.68",60850,"172.16.139.250",5440,12,1142,13165,0,0,12,1142,0,0,151.668151,0.0063370000000020354,1441691,0
"172.16.133.132",48932,"157.56.134.97",80,8,1506,13166,0,0,5,731,3,775,151.681022,1.781248999999974,3283,3480
"172.16.133.132",48933,"157.56.134.97",80,8,1445,13167,0,0,5,657,3,788,151.681384,0.12233999999997991,42962,51528
"172.16.133.132",48934,"157.56.134.97",80,8,1455,13168,0,0,5,667,3,788,151.681677,0.13251999999999953,40265,47570
"172.16.133.12",59872,"172.16.139.250",5440,12,1142,13169,0,0,12,1142,0,0,151.682728,0.019902999999999338,459026,0
"172.16.133.132",39665,"216.38.163.167",80,13,1822,13170,0,0,6,813,7,1009,151.685155,2.5637940000000015,2536,3148
"172.16.133.132",34650,"74.122.143.24",80,10,1519,13171,0,0,5,694,5,825,151.688068,0.1245670000000132,44570,52983
"172.16.133.63",53979,"172.16.139.250",5440,12,1142,13172,0,0,12,1142,0,0,151.692014,0.0062450000000069394,1462930,0
"172.16.133.132",50110,"67.202.66.161",80,8,1178,13173,0,0,4,601,4,577,151.694909,0.15463900000000308,31091,29850
"172.16.133.57",60630,"8.27.253.125",80,57,39695,13174,0,0,23,1945,34,37750,151.699642,17.233659999999986,902,17523
"172.16.133.66",53997,"172.16.139.250",5440,10,1022,13175,0,0,10,1022,0,0,151.704827,0.005874000000005708,1391896,0
"172.16.133.82",61505,"172.16.139.250",5440,10,1022,13176,0,0,10,1022,0,0,151.719343,0.00820099999998547,996951,0
"172.16.133.37",60716,"172.16.139.250",5440,10,1022,13177,0,0,10,1022,0,0,151.73253,0.00632300000000896,1293057,0
"172.16.133.132",47040,"173.194.43.57",80,25,7637,13178,0,0,16,3409,9,4228,151.771927,13.311230999999992,2048,2541
"172.16.133.132",47012,"74.122.143.12",80,13,1975,13179,0,0,8,886,5,1089,151.856569,13.219251999999983,536,659
"172.16.133.78",59321,"172.16.139.250",5440,12,1142,13180,0,0,12,1142,0,0,151.888423,0.006344000000012784,1440100,0
"172.16.133.132",46280,"23.13.210.227",80,10,1932,13181,0,0,5,767,5,1165,151.925172,0.08335600000000909,73611,111809
"172.16.133.132",51034,"70.42.13.100",80,18,5275,13182,0,0,12,3420,6,1855,151.926118,13.141531999999984,2081,1129
"172.16.133.128",65057,"216.115.222.200",443,6,366,13183,0,0,4,246,2,120,151.938894,0.08339499999999589,23598,11511
"172.16.133.128",65058,"66.151.158.187",443,6,366,13184,0,0,4,246,2,120,151.941767,0.19577799999999002,10052,4903
"172.16.133.67",56090,"172.16.139.250",5440,12,1142,13185,0,0,12,1142,0,0,151.942756,0.0060709999999915,1504859,0
"172.16.133.128",65059,"216.219.112.250",443,6,366,13186,0,0,4,246,2,120,151.942757,0.20145400000001246,9768,4765
"172.16.133.99",56154,"68.64.24.250",443,6,366,13187,0,0,4,246,2,120,151.956864,0.09439499999999157,20848,10170
"172.16.133.132",51731,"74.122.143.73",80,13,1885,13188,0,0,8,908,5,977,151.963977,13.078517000000005,555,597
"172.16.133.56",61525,"172.16.139.250",5440,10,1022,13189,0,0,10,1022,0,0,151.965042,0.014268999999984544,572990,0
"172.16.133.11",55244,"157.56.236.89",443,5,314,13190,0,0,3,194,2,120,151.971002,6.733711999999997,230,142
"172.16.133.54",64853,"108.170.193.53",80,11,3801,13191,0,0,6,2258,5,1543,151.998755,0.19321899999999914,93489,63886
"172.16.133.54",64854,"108.170.193.53",80,11,3801,13192,0,0,6,2258,5,1543,152.005468,0.19239799999999718,93888,64158
"172.16.133.54",64855,"108.170.193.53",80,12,3869,13193,0,0,6,2258,6,1611,152.007797,0.19062399999998547,94762,67609
"172.16.133.54",64856,"108.170.193.53",80,11,3805,13194,0,0,6,2258,5,1547,152.010899,0.18739600000000678,96394,66041
"172.16.133.54",64857,"108.170.193.53",80,10,3754,13195,0,0,6,2259,4,1495,152.011194,0.18732800000000793,96472,63845
"172.16.133.54",64858,"108.170.193.53",80,11,3797,13196,0,0,6,2258,5,1539,152.011477,0.18766299999998637,96257,65606
"172.16.133.132",47979,"98.138.49.43",80,73,21978,13197,0,0,44,11187,29,10791,152.017364,12.64232800000002,7079,6828
"172.16.133.41",53238,"172.16.139.250",5440,10,1022,13198,0,0,10,1022,0,0,152.021454,0.006127999999989697,1334203,0
"172.16.133.42",57216,"172.16.139.250",5440,12,1142,13199,0,0,12,1142,0,0,152.063945,0.03436200000001577,265875,0
"172.16.133.128",65060,"202.173.24.200",443,6,366,13200,0,0,4,246,2,120,152.065996,0.4793689999999913,4105,2002
"172.16.133.85",52366,"172.16.139.250",5440,10,1022,13201,0,0,10,1022,0,0,152.085115,0.017012999999991507,480573,0
"172.16.133.43",57873,"172.16.139.250",5440,10,1022,13202,0,0,10,1022,0,0,152.092156,0.005519000000020924,1481427,0
"172.16.133.13",53130,"172.16.139.250",5440,12,1142,13203,0,0,12,1142,0,0,152.110001,0.015467999999998483,590638,0
"172.16.133.99",56155,"78.108.118.250",443,6,366,13204,0,0,4,246,2,120,152.12582,0.2199899999999957,8945,4363
"172.16.133.99",56156,"216.219.118.244",443,6,366,13205,0,0,4,246,2,120,152.12668,0.20766900000000987,9476,4622
"172.16.133.54",64859,"108.170.193.53",80,11,3809,13206,0,0,6,2258,5,1551,152.13845,0.19201100000000793,94077,64621
"172.16.133.54",64860,"108.170.193.53",80,11,3809,13207,0,0,6,2258,5,1551,152.141525,0.190291000000002,94928,65205
"172.16.133.54",64861,"108.170.193.53",80,11,3805,13208,0,0,6,2258,5,1547,152.142319,0.18930400000002123,95423,65376
"172.16.133.54",64862,"108.170.193.53",80,11,3797,13209,0,0,6,2258,5,1539,152.143111,0.1894839999999931,95332,64976
"172.16.133.54",64863,"108.170.193.53",80,12,3869,13210,0,0,6,2258,6,1611,152.143366,0.19752800000000548,91450,65246
"172.16.133.54",64864,"108.170.193.53",80,11,3809,13211,0,0,6,2258,5,1551,152.143701,0.18915100000000962,95500,65598
"172.16.133.54",64865,"108.161.187.32",80,12,2457,13212,0,0,6,774,6,1683,152.144006,4.07304000000002,1520,3305
"172.16.133.54",64866,"108.161.187.32",80,6,372,13213,0,0,4,246,2,126,152.144209,5.072474,387,198
"172.16.133.54",64867,"108.161.187.32",80,12,2416,13214,0,0,6,774,6,1642,152.144503,4.072733000000028,1520,3225
"172.16.133.54",64868,"108.161.187.32",80,6,372,13215,0,0,4,246,2,126,152.144806,5.071749000000011,388,198
"173.194.43.56",443,"172.16.133.36",65008,9,696,13216,0,0,4,366,5,330,152.148668,0.025508000000002085,114787,103496
"172.16.133.20",62504,"172.16.139.250",5440,12,1142,13217,0,0,12,1142,0,0,152.160572,0.004960000000011178,"",""
"172.16.133.75",51069,"172.16.139.250",5440,10,1022,13218,0,0,10,1022,0,0,152.176499,0.005581000000006497,1464970,0
"172.16.133.54",64869,"209.190.70.254",80,16,7408,13219,0,0,7,3346,9,4062,152.177808,0.5781169999999918,46302,56210
"172.16.133.28",49213,"172.16.139.250",5440,10,1022,13220,0,0,10,1022,0,0,152.190466,0.005415000000027703,1509879,0
"172.16.133.54",64870,"209.190.70.254",80,14,4508,13221,0,0,7,3636,7,872,152.19402,0.7358450000000119,39530,9480
"172.16.133.99",56157,"172.16.139.250",5440,12,1142,13222,0,0,12,1142,0,0,152.217316,0.014856999999977916,614928,0
"172.16.133.87",60326,"172.16.139.250",5440,12,1142,13223,0,0,12,1142,0,0,152.241407,0.006165999999979022,1481673,0
"172.16.133.35",50066,"172.16.139.250",5440,12,1142,13224,0,0,12,1142,0,0,152.251562,0.014504999999985557,629851,0
"172.16.133.116",53651,"172.16.139.250",5440,10,1022,13225,0,0,10,1022,0,0,152.254852,0.00563700000000722,1450416,0
"172.16.133.116",53652,"172.16.139.250",5440,10,1022,13226,0,0,10,1022,0,0,152.261567,0.006836999999990212,1195846,0
"172.16.133.116",53653,"172.16.139.250",5440,10,1022,13227,0,0,10,1022,0,0,152.269561,0.0048469999999838365,"",""
"172.16.133.54",64871,"64.215.255.57",80,8,1322,13228,0,0,5,1001,3,321,152.269784,0.09745300000000157,82172,26351
"172.16.133.54",64872,"108.170.193.53",80,11,3784,13229,0,0,6,2245,5,1539,152.277647,0.1784849999999949,100624,68980
"172.16.133.84",58894,"172.16.139.250",5440,12,1142,13230,0,0,12,1142,0,0,152.280019,0.005958999999990056,1533143,0
"172.16.133.132",57514,"54.243.66.79",80,15,3175,13231,0,0,10,1447,5,1728,152.280555,12.78973400000001,905,1080
"172.16.133.54",64873,"64.215.255.57",80,8,1425,13232,0,0,5,1104,3,321,152.281605,1.2099609999999927,7299,2122
"172.16.133.82",61506,"64.56.203.22",443,20,8129,13233,0,0,11,3480,9,4649,152.29947,13.542916999999989,2055,2746
"172.16.133.82",61507,"64.56.203.22",443,16,4109,13234,0,0,9,3087,7,1022,152.299472,13.543194999999997,1823,603
"172.16.133.82",61508,"64.56.203.22",443,22,9943,13235,0,0,12,3610,10,6333,152.29974,13.542925999999994,2132,3740
"172.16.133.54",64874,"63.146.126.10",80,17,8612,13236,0,0,8,2219,9,6393,152.352518,1.2757699999999943,13914,40088
"172.16.133.49",55886,"172.16.139.250",5440,10,1022,13237,0,0,10,1022,0,0,152.354804,0.0146259999999927,559004,0
"172.16.133.54",64875,"63.146.126.10",80,7,638,13238,0,0,4,246,3,392,152.366973,5.905864000000008,333,530
"172.16.133.126",61917,"66.235.146.171",443,19,6139,13239,0,0,10,1144,9,4995,152.380376,135.270891,67,295
"172.16.133.126",61918,"66.235.146.171",443,25,10900,13240,0,0,14,5059,11,5841,152.380378,136.329227,296,342
"172.16.133.126",61919,"66.235.146.171",443,19,6139,13241,0,0,10,1144,9,4995,152.380379,135.275954,67,295
"172.16.133.126",61920,"96.43.149.26",443,35,18106,13242,0,0,18,8703,17,9403,152.382436,136.925036,508,549
"172.16.133.126",61921,"96.43.149.26",443,32,17466,13243,0,0,17,8409,15,9057,152.383827,136.10594300000002,494,532
"172.16.133.126",61922,"96.43.149.26",443,20,6423,13244,0,0,11,1493,9,4930,152.38619,135.778052,87,290
"172.16.133.95",57061,"172.16.139.250",5440,10,1022,13245,0,0,10,1022,0,0,152.393052,0.015662999999989324,521994,0
"172.16.133.126",61923,"70.42.13.101",443,18,5149,13246,0,0,9,1050,9,4099,152.41414,14.268797000000006,588,2298
"172.16.133.126",61924,"70.42.13.101",443,23,8661,13247,0,0,12,3019,11,5642,152.414796,14.273507999999993,1692,3162
"172.16.133.126",61925,"70.42.13.101",443,17,5356,13248,0,0,9,1358,8,3998,152.414798,14.272491000000002,761,2240
"172.16.133.126",61926,"23.33.47.60",443,23,5591,13249,0,0,12,2360,11,3231,152.415356,54.257519,347,476
"172.16.133.126",61927,"23.33.47.60",443,22,4592,13250,0,0,12,1721,10,2871,152.415358,135.94356100000002,101,168
"172.16.133.126",61928,"23.33.47.60",443,22,4576,13251,0,0,12,1737,10,2839,152.415359,135.86458100000002,102,167
"172.16.133.92",57774,"172.16.139.250",5440,12,1142,13252,0,0,12,1142,0,0,152.419971,0.006135000000000446,1489160,0
"172.16.133.29",61059,"172.16.139.250",5440,12,1142,13253,0,0,12,1142,0,0,152.438237,0.01780100000001994,513229,0
"172.16.133.44",64928,"172.16.139.250",5440,10,1022,13254,0,0,10,1022,0,0,152.445903,0.005773000000004913,1416248,0
"172.16.133.207",56024,"172.16.139.250",5440,12,1142,13255,0,0,12,1142,0,0,152.470433,0.13219299999997247,69111,0
"172.16.133.83",57182,"172.16.139.250",5440,12,1142,13256,0,0,12,1142,0,0,152.479373,0.09463399999998501,96540,0
"172.16.133.93",60851,"172.16.139.250",5440,12,1142,13257,0,0,12,1142,0,0,152.4946,0.08756200000001968,104337,0
"172.16.133.11",55245,"172.16.139.250",5440,10,1022,13258,0,0,10,1022,0,0,152.512522,0.0973250000000121,84007,0
"172.16.133.55",57724,"172.16.139.250",5440,12,1142,13259,0,0,12,1142,0,0,152.516634,0.09013399999997773,101360,0
"172.16.133.73",60783,"172.16.139.250",5440,12,1142,13260,0,0,12,1142,0,0,152.540567,0.04396099999999592,207820,0
"172.16.133.53",54210,"172.16.139.250",5440,12,1142,13261,0,0,12,1142,0,0,152.542347,0.07105400000000373,128578,0
"172.16.133.132",38365,"23.32.181.109",80,51,22944,13262,0,0,32,7788,19,15156,152.54249,12.558942000000002,4960,9654
"172.16.133.132",38366,"23.32.181.109",80,21,7352,13263,0,0,13,2040,8,5312,152.542827,12.05646200000001,1353,3524
"172.16.133.132",38367,"23.32.181.109",80,11,1798,13264,0,0,7,831,4,967,152.543123,12.062535999999994,551,641
"172.16.133.132",59407,"76.13.234.33",80,12,2657,13265,0,0,7,1482,5,1175,152.544283,3.1642249999999876,3746,2970
"172.16.133.21",53285,"172.16.139.250",5440,10,1022,13266,0,0,10,1022,0,0,152.54482,0.07196400000000835,113612,0
"172.16.133.30",62747,"172.16.139.250",5440,12,1142,13267,0,0,12,1142,0,0,152.549017,0.07437799999999584,122832,0
"172.16.133.25",63580,"172.16.139.250",5440,12,1142,13268,0,0,12,1142,0,0,152.5566,0.10156299999999874,89954,0
"172.16.133.34",50533,"172.16.139.250",5440,12,1142,13269,0,0,12,1142,0,0,152.565254,0.09829999999999472,92939,0
"172.16.133.97",59485,"172.16.139.250",5440,12,1142,13270,0,0,12,1142,0,0,152.575291,0.09244000000001051,98831,0
"172.16.133.33",57994,"172.16.139.250",5440,10,1022,13271,0,0,10,1022,0,0,152.648142,0.031132999999982758,262615,0
"172.16.133.68",60851,"172.16.139.250",5440,10,1022,13272,0,0,10,1022,0,0,152.681831,0.00561100000001602,1457137,0
"172.16.133.12",59873,"172.16.139.250",5440,12,1142,13273,0,0,12,1142,0,0,152.695085,0.008170000000006894,1118237,0
"172.16.133.63",53980,"172.16.139.250",5440,12,1142,13274,0,0,12,1142,0,0,152.705994,0.008370999999982587,1091386,0
"172.16.133.66",53998,"172.16.139.250",5440,10,1022,13275,0,0,10,1022,0,0,152.718531,0.006545999999985952,1249007,0
"172.16.133.82",61509,"172.16.139.250",5440,10,1022,13276,0,0,10,1022,0,0,152.732637,0.005589999999983775,1462611,0
"172.16.133.37",60717,"172.16.139.250",5440,12,1142,13277,0,0,12,1142,0,0,152.746305,0.00646399999999403,1413366,0
"172.16.133.132",54945,"193.149.47.98",80,22,5816,13278,0,0,14,2545,8,3271,152.776108,11.970371,1700,2186
"172.16.133.54",64876,"54.241.15.61",80,15,4072,13279,0,0,8,2492,7,1580,152.798329,59.827308000000016,333,211
"172.16.133.132",58239,"208.47.254.25",80,15,3583,13280,0,0,10,1797,5,1786,152.840793,12.116368000000023,1186,1179
"172.16.133.78",59322,"172.16.139.250",5440,10,1022,13281,0,0,10,1022,0,0,152.902414,0.006895000000014306,1185786,0
"172.16.133.33",57995,"157.56.245.198",443,22,9457,13282,0,0,10,2082,12,7375,152.934928,0.3327059999999733,50062,177333
"172.16.133.82",61510,"204.232.250.57",443,17,4774,13283,0,0,10,3794,7,980,152.953525,12.82363699999999,2366,611
"172.16.133.67",56091,"172.16.139.250",5440,12,1142,13284,0,0,12,1142,0,0,152.957371,0.005336999999997261,1711823,0
"172.16.133.56",61526,"172.16.139.250",5440,10,1022,13285,0,0,10,1022,0,0,152.978947,0.0146519999999839,558012,0
"172.16.133.41",53239,"172.16.139.250",5440,10,1022,13286,0,0,10,1022,0,0,153.035635,0.005461999999994305,1496887,0
"172.16.133.132",37013,"173.252.110.27",80,34,8692,13287,0,0,18,2080,16,6612,153.070962,12.012802999999991,1385,4403
"172.16.133.42",57217,"172.16.139.250",5440,12,1142,13288,0,0,12,1142,0,0,153.077581,0.03360399999999686,271872,0
"172.16.133.132",47290,"204.13.194.191",80,10,1418,13289,0,0,5,650,5,768,153.083051,10.08131899999998,515,609
"172.16.133.85",52367,"172.16.139.250",5440,12,1142,13290,0,0,12,1142,0,0,153.099456,0.016747000000009393,545530,0
"172.16.133.132",37015,"173.252.110.27",80,18,2000,13291,0,0,10,1032,8,968,153.101996,11.508020999999985,717,672
"172.16.133.43",57874,"172.16.139.250",5440,10,1022,13292,0,0,10,1022,0,0,153.105249,0.005888000000027205,1388586,0
"172.16.133.13",53131,"172.16.139.250",5440,10,1022,13293,0,0,10,1022,0,0,153.125589,0.005286000000012336,1546727,0
"172.16.133.20",62505,"172.16.139.250",5440,12,1142,13294,0,0,12,1142,0,0,153.175411,0.0050740000000075725,1800551,0
"172.16.133.132",47292,"204.13.194.191",80,10,1664,13295,0,0,5,648,5,1016,153.183067,0.07154700000000958,72455,113603
"172.16.133.75",51070,"172.16.139.250",5440,10,1022,13296,0,0,10,1022,0,0,153.191542,0.014500999999995656,563823,0
"172.16.133.28",49215,"172.16.139.250",5440,10,1022,13297,0,0,10,1022,0,0,153.204829,0.005583000000001448,1464445,0
"172.16.133.99",56158,"172.16.139.250",5440,10,1022,13298,0,0,10,1022,0,0,153.232476,0.014550000000014052,561924,0
"172.16.133.207",56025,"199.16.156.8",80,11,2129,13299,0,0,6,1236,5,893,153.236735,31.759694999999994,311,224
"172.16.133.25",63581,"172.16.139.250",5440,12,1142,13300,0,0,12,1142,0,0,153.244322,0.006714999999985594,1360536,0
"172.16.133.87",60327,"172.16.139.250",5440,10,1022,13301,0,0,10,1022,0,0,153.255336,0.005338999999992211,1531372,0
"172.16.133.132",47293,"204.13.194.191",80,10,1865,13302,0,0,5,709,5,1156,153.264852,0.07586700000001656,74762,121897
"172.16.133.116",53654,"172.16.139.250",5440,10,1022,13303,0,0,10,1022,0,0,153.268918,0.005417999999991707,1509043,0
"172.16.133.116",53655,"172.16.139.250",5440,10,1022,13304,0,0,10,1022,0,0,153.274804,0.004666000000014492,"",""
"172.16.133.116",53656,"172.16.139.250",5440,10,1022,13305,0,0,10,1022,0,0,153.280025,0.005909000000002607,1383652,0
"172.16.133.35",50067,"172.16.139.250",5440,12,1142,13306,0,0,12,1142,0,0,153.28515,0.030415000000004966,300378,0
"172.16.133.84",58895,"172.16.139.250",5440,12,1142,13307,0,0,12,1142,0,0,153.291393,0.016275000000007367,561351,0
"172.16.133.54",64877,"209.190.70.254",80,17,7084,13308,0,0,8,3507,9,3577,153.306066,0.42325300000001675,66286,67609
"172.16.133.54",64878,"199.27.74.193",80,6,372,13309,0,0,4,246,2,126,153.307001,5.93400699999998,331,169
"172.16.133.54",64879,"205.210.187.119",80,27,17556,13310,0,0,12,6993,15,10563,153.359522,5.314402000000001,10526,15900
"172.16.133.49",55887,"172.16.139.250",5440,12,1142,13311,0,0,12,1142,0,0,153.367751,0.006255000000010114,1460591,0
"172.16.133.132",59415,"76.13.234.33",80,11,1765,13312,0,0,6,744,5,1021,153.404377,0.08839799999998377,67331,92400
"172.16.133.99",56159,"216.115.219.126",443,6,366,13313,0,0,4,246,2,120,153.407886,0.48444800000001464,4062,1981
"172.16.133.95",57062,"172.16.139.250",5440,12,1142,13314,0,0,12,1142,0,0,153.408077,0.0996290000000215,91700,0
"172.16.128.233",55267,"172.16.133.233",22,203,29858,13315,0,0,69,5320,134,24538,153.411957,8.014202000000012,5310,24494
"172.16.133.92",57775,"172.16.139.250",5440,10,1022,13316,0,0,10,1022,0,0,153.434244,0.07749200000000656,105507,0
"172.16.133.29",61060,"172.16.139.250",5440,10,1022,13317,0,0,10,1022,0,0,153.452687,0.06302900000000022,129718,0
"172.16.133.30",62748,"216.221.224.26",80,9,984,13318,0,0,5,485,4,499,153.456167,0.2871059999999943,13514,13904
"172.16.133.44",64929,"172.16.139.250",5440,10,1022,13319,0,0,10,1022,0,0,153.460371,0.05864799999997672,139407,0
"172.16.133.132",35101,"64.94.107.58",80,9,3573,13320,0,0,5,615,4,2958,153.474457,0.05966200000000299,82464,396634
"172.16.133.132",34677,"63.135.90.138",80,13,1992,13321,0,0,9,892,4,1100,153.481568,11.593878999999987,615,759
"172.16.133.207",56026,"172.16.139.250",5440,12,1142,13322,0,0,12,1142,0,0,153.484254,0.04253199999999424,214802,0
"172.16.133.83",57183,"172.16.139.250",5440,12,1142,13323,0,0,12,1142,0,0,153.493257,0.029607999999996082,308565,0
"172.16.133.93",60852,"172.16.139.250",5440,12,1142,13324,0,0,12,1142,0,0,153.508948,0.022033999999990783,414631,0
"172.16.133.11",55246,"172.16.139.250",5440,12,1142,13325,0,0,12,1142,0,0,153.526239,0.009541999999981954,957451,0
"172.16.133.55",57725,"172.16.139.250",5440,12,1142,13326,0,0,12,1142,0,0,153.530857,0.009335999999990463,978577,0
"172.16.133.132",50372,"184.172.28.153",80,12,2502,13327,0,0,6,832,6,1670,153.54019,0.21997400000000766,30258,60734
"172.16.133.54",64880,"205.210.187.216",80,9,564,13328,0,0,5,312,4,252,153.542478,11.393293999999997,219,176
"172.16.133.54",64881,"205.210.187.216",80,10,1519,13329,0,0,5,1032,5,487,153.542826,9.03967400000002,913,430
"172.16.133.73",60784,"172.16.139.250",5440,12,1142,13330,0,0,12,1142,0,0,153.553493,0.020411999999993213,447579,0
"172.16.133.53",54211,"172.16.139.250",5440,12,1142,13331,0,0,12,1142,0,0,153.555353,0.006339999999994461,1441009,0
"172.16.133.21",53286,"172.16.139.250",5440,10,1022,13332,0,0,10,1022,0,0,153.558473,0.018812999999994418,434593,0
"172.16.133.113",55656,"172.16.139.250",135,8,492,13333,0,0,8,492,0,0,153.562146,0.006480999999979531,607313,0
"172.16.133.30",62749,"172.16.139.250",5440,12,1142,13334,0,0,12,1142,0,0,153.562572,0.007241000000021813,1261704,0
"172.16.133.25",63582,"172.16.139.250",5440,10,1022,13335,0,0,10,1022,0,0,153.56974,0.012178000000005795,671374,0
"172.16.133.113",55657,"172.16.139.250",5462,10,696,13336,0,0,10,696,0,0,153.573154,0.5120290000000125,10874,0
"172.16.133.34",50534,"172.16.139.250",5440,12,1142,13337,0,0,12,1142,0,0,153.57978,0.006279000000006363,1455008,0
"172.16.133.54",64882,"205.210.187.119",80,9,552,13338,0,0,4,246,5,306,153.586973,5.146885999999995,382,475
"172.16.133.97",59486,"172.16.139.250",5440,12,1142,13339,0,0,12,1142,0,0,153.589352,0.006040000000012924,1512582,0
"172.16.133.97",59487,"96.43.146.22",443,19,4155,13340,0,0,11,3258,8,897,153.608526,135.324377,192,53
"172.16.133.54",64883,"205.210.187.119",80,9,552,13341,0,0,4,246,5,306,153.611054,5.157498000000004,381,474
"172.16.133.30",62750,"216.221.224.26",80,56,41247,13342,0,0,19,1929,37,39318,153.65125,34.299227,449,9170
"172.16.133.33",57996,"172.16.139.250",5440,12,1142,13343,0,0,12,1142,0,0,153.662384,0.006562000000002399,1392258,0
"172.16.133.68",60852,"172.16.139.250",5440,10,1022,13344,0,0,10,1022,0,0,153.694909,0.005752999999998565,1421171,0
"172.16.133.12",59874,"172.16.139.250",5440,12,1142,13345,0,0,12,1142,0,0,153.709622,0.006279000000006363,1455008,0
"172.16.133.118",58219,"202.173.27.250",443,6,366,13346,0,0,4,246,2,120,153.713792,0.6182989999999791,3182,1552
"172.16.133.118",58220,"216.115.217.254",443,6,366,13347,0,0,4,246,2,120,153.71565,0.0780149999999935,25225,12305
"172.16.133.118",58221,"216.115.220.254",443,6,366,13348,0,0,4,246,2,120,153.718005,0.5303049999999985,3711,1810
"172.16.133.63",53981,"172.16.139.250",5440,12,1142,13349,0,0,12,1142,0,0,153.719758,0.006076999999976351,1503373,0
"172.16.133.118",58222,"216.219.120.244",443,6,366,13350,0,0,4,246,2,120,153.720559,0.17874799999998459,11009,5370
"172.16.133.66",53999,"172.16.139.250",5440,10,1022,13351,0,0,10,1022,0,0,153.732799,0.005357000000003609,1526227,0
"172.16.133.82",61511,"172.16.139.250",5440,12,1142,13352,0,0,12,1142,0,0,153.746158,0.0064199999999914326,1423052,0
"172.16.133.37",60718,"172.16.139.250",5440,10,1022,13353,0,0,10,1022,0,0,153.760443,0.018101000000001477,451687,0
"172.16.133.54",64884,"209.190.70.254",80,16,7004,13354,0,0,7,3455,9,3549,153.765849,0.3989949999999851,69274,71158
"172.16.133.54",64885,"209.190.70.254",80,6,368,13355,0,0,4,246,2,122,153.778086,5.437110999999987,361,179
"172.16.133.56",61527,"208.111.135.60",80,14,2972,13356,0,0,7,2388,7,584,153.820969,7.988334000000009,2391,584
"172.16.133.56",61528,"208.111.135.60",80,14,2972,13357,0,0,7,2388,7,584,153.821276,7.987511999999981,2391,584
"172.16.133.56",61529,"208.111.135.60",80,20,5452,13358,0,0,10,4530,10,922,153.821506,8.244192999999996,4395,894
"172.16.133.56",61530,"208.111.135.60",80,14,2972,13359,0,0,7,2388,7,584,153.821736,7.987268,2391,584
"172.16.133.56",61531,"208.111.135.60",80,14,2972,13360,0,0,7,2388,7,584,153.82196,7.987146000000024,2391,584
"172.16.133.56",61532,"208.111.135.60",80,15,3032,13361,0,0,8,2448,7,584,153.822225,8.242450999999988,2375,566
"172.16.133.54",64886,"69.172.216.156",80,12,4713,13362,0,0,6,3137,6,1576,153.867593,0.31231500000001233,80354,40369
"172.16.133.54",64887,"69.172.216.156",80,11,2492,13363,0,0,6,2008,5,484,153.903231,0.34379200000000765,46725,11262
"172.16.133.132",50713,"23.21.65.96",80,14,1990,13364,0,0,9,942,5,1048,153.903924,11.051645000000008,681,758
"172.16.133.78",59323,"172.16.139.250",5440,10,1022,13365,0,0,10,1022,0,0,153.918158,0.00543700000000058,1503770,0
"172.16.133.33",57997,"157.56.245.198",443,24,12165,13366,0,0,10,2592,14,9573,153.949229,0.9190669999999841,22562,83327
"172.16.133.54",64888,"69.172.216.156",80,11,2467,13367,0,0,6,1983,5,484,153.968979,3.518755999999996,4508,1100
"172.16.133.67",56092,"172.16.139.250",5440,10,1022,13368,0,0,10,1022,0,0,153.970932,0.014624999999995225,559042,0
"172.16.133.128",65061,"216.115.222.200",443,6,366,13369,0,0,4,246,2,120,153.986112,0.09855400000000714,19968,9740
"172.16.133.56",61533,"172.16.139.250",5440,10,1022,13370,0,0,10,1022,0,0,153.99554,0.0046999999999854936,"",""
"172.16.133.128",65062,"66.151.158.187",443,6,366,13371,0,0,4,246,2,120,154.032081,0.2169319999999857,9071,4425
"172.16.133.128",65063,"216.219.112.250",443,6,366,13372,0,0,4,246,2,120,154.042055,0.22216000000000236,8858,4321
"172.16.133.41",53240,"172.16.139.250",5440,10,1022,13373,0,0,10,1022,0,0,154.049723,0.011000999999993155,743205,0
"172.16.133.132",47299,"204.13.194.191",80,10,1946,13374,0,0,5,867,5,1079,154.055121,0.06733799999997814,103002,128189
"172.16.133.42",57218,"172.16.139.250",5440,12,1142,13375,0,0,12,1142,0,0,154.089148,0.022117000000008602,413075,0
"172.16.133.132",33091,"64.94.107.47",80,8,1586,13376,0,0,5,822,3,764,154.09804,0.05868900000001531,112048,104142
"172.16.133.85",52368,"172.16.139.250",5440,10,1022,13377,0,0,10,1022,0,0,154.113538,0.005447000000003754,1501009,0
"172.16.133.13",53132,"172.16.139.250",5440,10,1022,13378,0,0,10,1022,0,0,154.138176,0.015652000000017097,522361,0
"172.16.133.132",42703,"108.168.136.156",443,18,6257,13379,0,0,10,1412,8,4845,154.142102,0.48817900000000236,23139,79397
"172.16.133.43",57875,"172.16.139.250",5440,10,1022,13380,0,0,10,1022,0,0,154.144163,0.005903000000017755,1385058,0
"172.16.133.132",59648,"23.23.139.110",80,11,2380,13381,0,0,7,948,4,1432,154.162987,10.437202000000013,726,1097
"172.16.133.20",62506,"172.16.139.250",5440,10,1022,13382,0,0,10,1022,0,0,154.188636,0.014353999999997313,569597,0
"172.16.133.75",51071,"172.16.139.250",5440,10,1022,13383,0,0,10,1022,0,0,154.205844,0.008420000000000982,971021,0
"172.16.133.28",49216,"172.16.139.250",5440,10,1022,13384,0,0,10,1022,0,0,154.218728,0.005344000000008009,1529940,0
"172.16.133.99",56160,"172.16.139.250",5440,10,1022,13385,0,0,10,1022,0,0,154.245683,0.014189999999985048,576180,0
"172.16.133.87",60328,"172.16.139.250",5440,10,1022,13386,0,0,10,1022,0,0,154.270347,0.005487000000016451,1490067,0
"172.16.133.35",50068,"172.16.139.250",5440,12,1142,13387,0,0,12,1142,0,0,154.275775,0.017977999999999383,508176,0
"172.16.133.116",53657,"172.16.139.250",5440,10,1022,13388,0,0,10,1022,0,0,154.287886,0.006157000000001744,1327919,0
"172.16.133.116",53658,"172.16.139.250",5440,10,1022,13389,0,0,10,1022,0,0,154.294939,0.016419000000013284,497959,0
"172.16.133.54",64889,"157.56.134.97",80,13,6926,13390,0,0,7,2941,6,3985,154.302538,0.17505500000001462,134403,182114
"172.16.133.84",58896,"172.16.139.250",5440,10,1022,13391,0,0,10,1022,0,0,154.305485,0.015226999999981672,536940,0
"172.16.133.128",65064,"202.173.24.200",443,6,366,13392,0,0,4,246,2,120,154.308054,0.5281720000000121,3726,1817
"172.16.133.116",53659,"172.16.139.250",5440,10,1022,13393,0,0,10,1022,0,0,154.312156,0.014206000000001495,575531,0
"172.16.133.49",55888,"172.16.139.250",5440,12,1142,13394,0,0,12,1142,0,0,154.381692,0.007318000000026359,1248428,0
"172.16.133.95",57063,"172.16.139.250",5440,10,1022,13395,0,0,10,1022,0,0,154.420922,0.014918000000022857,548062,0
"172.16.133.54",64890,"208.47.254.57",80,6,372,13396,0,0,4,246,2,126,154.446925,5.732394999999997,343,175
"172.16.133.92",57776,"172.16.139.250",5440,12,1142,13397,0,0,12,1142,0,0,154.448984,0.006316999999995687,1446256,0
"172.16.133.132",47722,"54.243.108.184",80,12,1796,13398,0,0,8,973,4,823,154.44944,10.507121999999981,740,626
"172.16.133.29",61061,"172.16.139.250",5440,10,1022,13399,0,0,10,1022,0,0,154.466837,0.005294999999989614,1544098,0
"172.16.133.44",64930,"172.16.139.250",5440,10,1022,13400,0,0,10,1022,0,0,154.473658,0.00632300000000896,1293057,0
"172.16.133.207",56027,"172.16.139.250",5440,12,1142,13401,0,0,12,1142,0,0,154.498352,0.0176529999999957,517532,0
"172.16.133.83",57184,"172.16.139.250",5440,12,1142,13402,0,0,12,1142,0,0,154.507475,0.004746000000011463,"",""
"172.16.133.132",46890,"23.33.44.79",80,17,4570,13403,0,0,11,1489,6,3081,154.515802,10.52973,1131,2340
"172.16.133.93",60853,"172.16.139.250",5440,10,1022,13404,0,0,10,1022,0,0,154.523971,0.004912000000018679,"",""
"172.16.133.11",55247,"172.16.139.250",5440,10,1022,13405,0,0,10,1022,0,0,154.539961,0.00565399999999272,1446055,0
"172.16.133.55",57726,"172.16.139.250",5440,10,1022,13406,0,0,10,1022,0,0,154.544519,0.0059219999999982065,1380614,0
"172.16.133.73",60785,"172.16.139.250",5440,10,1022,13407,0,0,10,1022,0,0,154.568933,0.005352000000016233,1527653,0
"172.16.133.53",54212,"172.16.139.250",5440,10,1022,13408,0,0,10,1022,0,0,154.570771,0.007326000000006161,1116025,0
"172.16.133.21",53287,"172.16.139.250",5440,12,1142,13409,0,0,12,1142,0,0,154.572667,0.010953000000000657,834109,0
"172.16.133.30",62751,"172.16.139.250",5440,10,1022,13410,0,0,10,1022,0,0,154.57733,0.010213000000021566,800548,0
"172.16.133.25",63583,"172.16.139.250",5440,12,1142,13411,0,0,12,1142,0,0,154.585103,0.006788000000000238,1345904,0
"172.16.133.34",50535,"172.16.139.250",5440,10,1022,13412,0,0,10,1022,0,0,154.593161,0.004877999999990834,"",""
"172.16.133.97",59488,"172.16.139.250",5440,10,1022,13413,0,0,10,1022,0,0,154.6037,0.005517999999995027,1481696,0
"172.16.133.33",57998,"172.16.139.250",5440,12,1142,13414,0,0,12,1142,0,0,154.676241,0.006641000000001895,1375696,0
"172.16.133.132",45928,"23.67.242.73",80,8,544,13415,0,0,6,404,2,140,154.683289,10.400276999999988,310,107
"172.16.133.132",45929,"23.67.242.73",80,12,2244,13416,0,0,8,1027,4,1217,154.683654,10.385648000000003,791,937
"172.16.133.132",45930,"23.67.242.73",80,60,41923,13417,0,0,31,2577,29,39346,154.683959,10.385260000000017,1985,30309
"172.16.133.45",61373,"64.90.204.229",443,17,3105,13418,0,0,8,1780,9,1325,154.690638,11.476287999999983,1240,923
"172.16.133.68",60853,"172.16.139.250",5440,10,1022,13419,0,0,10,1022,0,0,154.709265,0.005735000000015589,1425632,0
"172.16.133.63",53986,"172.16.139.250",5440,10,1022,13420,0,0,10,1022,0,0,154.734032,0.01575099999999452,519078,0
"172.16.133.66",54000,"172.16.139.250",5440,10,1022,13421,0,0,10,1022,0,0,154.746832,0.015599999999977854,524102,0
"172.16.133.82",61512,"172.16.139.250",5440,10,1022,13422,0,0,10,1022,0,0,154.761267,0.005634999999983847,1450931,0
"172.16.133.12",59875,"172.16.139.250",5440,12,1142,13423,0,0,12,1142,0,0,154.764607,0.006853999999975713,1332944,0
"172.16.133.37",60719,"172.16.139.250",5440,10,1022,13424,0,0,10,1022,0,0,154.776265,0.005408000000016955,1511834,0
"172.16.133.78",59324,"172.16.139.250",5440,12,1142,13425,0,0,12,1142,0,0,154.930542,0.006527000000005501,1399724,0
"172.16.133.132",40243,"69.25.24.24",80,23,7189,13426,0,0,16,3372,7,3817,154.974825,10.100560000000002,2670,3023
"172.16.133.67",56093,"172.16.139.250",5440,10,1022,13427,0,0,10,1022,0,0,154.984961,0.005316999999990912,1537709,0
"172.16.133.132",50384,"184.172.28.153",80,10,2705,13428,0,0,6,946,4,1759,155.006328,0.24140199999999368,31350,58292
"172.16.133.56",61534,"172.16.139.250",5440,10,1022,13429,0,0,10,1022,0,0,155.008097,0.005186000000009017,1576552,0
"172.16.133.24",57700,"180.153.31.250",443,6,366,13430,0,0,4,246,2,120,155.01096,0.47260699999998224,4164,2031
"172.16.133.41",53241,"172.16.139.250",5440,10,1022,13431,0,0,10,1022,0,0,155.062671,0.0055949999999995725,1461304,0
"172.16.133.132",53576,"74.121.142.248",80,25,9723,13432,0,0,15,4990,10,4733,155.124831,9.218637000000001,4330,4107
"172.16.133.85",52369,"172.16.139.250",5440,10,1022,13433,0,0,10,1022,0,0,155.127201,0.0156729999999925,521661,0
"172.16.133.43",57876,"172.16.139.250",5440,12,1142,13434,0,0,12,1142,0,0,155.133558,0.0063560000000109085,1437382,0
"172.16.133.13",53133,"172.16.139.250",5440,10,1022,13435,0,0,10,1022,0,0,155.153341,0.00807100000000105,1013009,0
"172.16.133.20",62507,"172.16.139.250",5440,12,1142,13436,0,0,12,1142,0,0,155.203575,0.005259999999992715,1736882,0
"172.16.133.42",57219,"172.16.139.250",5440,12,1142,13437,0,0,12,1142,0,0,155.215293,0.020486000000005333,445963,0
"172.16.133.75",51072,"172.16.139.250",5440,12,1142,13438,0,0,12,1142,0,0,155.219591,0.006168999999999869,1480953,0
"172.16.133.132",40711,"184.173.189.190",80,34,5876,13439,0,0,21,2981,13,2895,155.229285,9.843704000000002,2422,2352
"172.16.133.28",49217,"172.16.139.250",5440,10,1022,13440,0,0,10,1022,0,0,155.232789,0.005553999999989401,1472092,0
"172.16.133.99",56161,"172.16.139.250",5440,10,1022,13441,0,0,10,1022,0,0,155.259421,0.014468999999991183,565070,0
"172.16.133.87",60330,"172.16.139.250",5440,10,1022,13442,0,0,10,1022,0,0,155.282751,0.00543700000000058,1503770,0
"172.16.133.35",50069,"172.16.139.250",5440,12,1142,13443,0,0,12,1142,0,0,155.291532,0.016796999999996842,543906,0
"172.16.133.116",53660,"172.16.139.250",5440,10,1022,13444,0,0,10,1022,0,0,155.296599,0.005253000000010388,1556443,0
"172.16.133.132",51897,"50.116.194.21",80,10,1274,13445,0,0,5,615,5,659,155.299524,5.175523999999996,950,1018
"172.16.133.116",53661,"172.16.139.250",5440,10,1022,13446,0,0,10,1022,0,0,155.302857,0.015832000000017388,516422,0
"172.16.133.132",46131,"184.172.28.156",80,10,1519,13447,0,0,5,808,5,711,155.308488,0.24461999999999762,26424,23252
"172.16.133.71",57574,"132.245.2.22",443,30,12325,13448,0,0,16,3867,14,8458,155.308953,1.0199509999999918,30330,66340
"172.16.133.84",58897,"172.16.139.250",5440,10,1022,13449,0,0,10,1022,0,0,155.317975,0.014679000000000997,556986,0
"172.16.133.116",53662,"172.16.139.250",5440,10,1022,13450,0,0,10,1022,0,0,155.319279,0.0171799999999962,475902,0
"172.16.133.78",59325,"128.208.92.167",59071,3,194,13451,0,0,3,194,0,0,155.376852,8.998968999999988,172,0
"172.16.133.78",59326,"98.113.186.78",60198,150,16479,13452,0,0,69,8519,81,7960,155.377073,84.3717,807,754
"172.16.133.49",55889,"172.16.139.250",5440,10,1022,13453,0,0,10,1022,0,0,155.395272,0.005522999999982403,1480354,0
"172.16.133.95",57064,"172.16.139.250",5440,12,1142,13454,0,0,12,1142,0,0,155.435038,0.015546999999997979,587637,0
"172.16.133.92",57777,"172.16.139.250",5440,10,1022,13455,0,0,10,1022,0,0,155.461556,0.005616000000003396,1455840,0
"172.16.133.29",61062,"172.16.139.250",5440,10,1022,13456,0,0,10,1022,0,0,155.480489,0.005417999999991707,1509043,0
"172.16.133.44",64931,"172.16.139.250",5440,10,1022,13457,0,0,10,1022,0,0,155.486725,0.005368000000004258,1523099,0
"172.16.133.207",56028,"172.16.139.250",5440,12,1142,13458,0,0,12,1142,0,0,155.512898,0.017078999999995403,534925,0
"172.16.133.83",57185,"172.16.139.250",5440,12,1142,13459,0,0,12,1142,0,0,155.521282,0.004701999999980444,"",""
"172.16.133.93",60854,"172.16.139.250",5440,12,1142,13460,0,0,12,1142,0,0,155.536619,0.014655000000004748,623404,0
"172.16.133.11",55248,"172.16.139.250",5440,10,1022,13461,0,0,10,1022,0,0,155.55483,0.005613999999980024,1456359,0
"172.16.133.55",57727,"172.16.139.250",5440,10,1022,13462,0,0,10,1022,0,0,155.558882,0.005848999999983562,1397845,0
"172.16.133.73",60786,"172.16.139.250",5440,10,1022,13463,0,0,10,1022,0,0,155.582556,0.015620999999981677,523397,0
"172.16.133.53",54213,"172.16.139.250",5440,12,1142,13464,0,0,12,1142,0,0,155.58433,0.006371999999998934,1433772,0
"172.16.133.21",53288,"172.16.139.250",5440,12,1142,13465,0,0,12,1142,0,0,155.587952,0.018331999999986692,498363,0
"172.16.133.30",62752,"172.16.139.250",5440,12,1142,13466,0,0,12,1142,0,0,155.590428,0.022928000000007387,398464,0
"172.16.133.25",63584,"172.16.139.250",5440,10,1022,13467,0,0,10,1022,0,0,155.598585,0.011631999999991649,702888,0
"172.16.133.34",50536,"172.16.139.250",5440,10,1022,13468,0,0,10,1022,0,0,155.606597,0.015086999999994077,541923,0
"172.16.133.97",59489,"172.16.139.250",5440,10,1022,13469,0,0,10,1022,0,0,155.617252,0.008206000000001268,996344,0
"172.16.133.99",56162,"216.115.219.126",443,6,366,13470,0,0,4,246,2,120,155.650966,0.48756599999998684,4036,1968
"172.16.133.33",57999,"172.16.139.250",5440,10,1022,13471,0,0,10,1022,0,0,155.69021,0.007413999999982934,1102778,0
"172.16.133.68",60854,"172.16.139.250",5440,12,1142,13472,0,0,12,1142,0,0,155.724033,0.006357000000008384,1437155,0
"172.16.133.12",59876,"172.16.139.250",5440,12,1142,13473,0,0,12,1142,0,0,155.736415,0.0176270000000045,518295,0
"172.16.133.63",53994,"172.16.139.250",5440,12,1142,13474,0,0,12,1142,0,0,155.748523,0.009423999999995658,969439,0
"172.16.133.118",58224,"216.115.217.254",443,7,426,13475,0,0,4,246,3,180,155.755752,0.07448700000000485,26420,19332
"172.16.133.66",54001,"172.16.139.250",5440,10,1022,13476,0,0,10,1022,0,0,155.760594,0.005310000000008586,1539736,0
"172.16.133.34",50537,"68.64.24.250",443,6,366,13477,0,0,4,246,2,120,155.772845,0.11567200000001776,17013,8299
"172.16.133.34",50538,"78.108.118.250",443,6,366,13478,0,0,4,246,2,120,155.772846,0.20072800000002644,9804,4782
"172.16.133.34",50539,"216.219.118.244",443,6,366,13479,0,0,4,246,2,120,155.774007,0.22154199999999946,8883,4333
"172.16.133.82",61513,"172.16.139.250",5440,8,902,13480,0,0,8,902,0,0,155.774385,0.01077000000000794,670009,0
"172.16.133.34",50540,"216.115.219.126",443,6,366,13481,0,0,4,246,2,120,155.774387,0.5195420000000013,3787,1847
"172.16.133.37",60720,"172.16.139.250",5440,12,1142,13482,0,0,12,1142,0,0,155.788384,0.015490999999997257,589761,0
"172.16.133.118",58225,"216.219.120.244",443,6,366,13483,0,0,4,246,2,120,155.81572,0.2681929999999966,7337,3579
"172.16.133.43",57877,"157.56.236.102",443,22,9476,13484,0,0,10,2088,12,7388,155.892522,0.5634349999999984,29646,104899
"172.16.133.78",59327,"172.16.139.250",5440,12,1142,13485,0,0,12,1142,0,0,155.944475,0.006659999999982347,1371771,0
"172.16.133.118",58226,"216.115.220.254",443,6,366,13486,0,0,4,246,2,120,155.978018,0.5186970000000031,3794,1850
"172.16.133.67",56094,"172.16.139.250",5440,10,1022,13487,0,0,10,1022,0,0,155.999171,0.006050000000016098,1351404,0
"172.16.133.56",61535,"172.16.139.250",5440,12,1142,13488,0,0,12,1142,0,0,156.021154,0.005000999999992928,1826834,0
"172.16.133.128",65065,"216.115.222.200",443,6,366,13489,0,0,4,246,2,120,156.049069,0.09173300000000495,21453,10465
"172.16.133.41",53242,"172.16.139.250",5440,12,1142,13490,0,0,12,1142,0,0,156.076662,0.006375999999988835,1432873,0
"172.16.133.118",58227,"202.173.27.250",443,6,366,13491,0,0,4,246,2,120,156.081526,0.6425160000000005,3062,1494
"172.16.133.128",65066,"66.151.158.187",443,6,366,13492,0,0,4,246,2,120,156.129032,0.21215399999999818,9276,4525
"172.16.133.42",57220,"172.16.139.250",5440,12,1142,13493,0,0,12,1142,0,0,156.134484,0.015965000000022656,572251,0
"172.16.133.85",52370,"172.16.139.250",5440,12,1142,13494,0,0,12,1142,0,0,156.141521,0.015983999999974685,571571,0
"172.16.133.43",57878,"172.16.139.250",5440,12,1142,13495,0,0,12,1142,0,0,156.147527,0.016412000000002536,556665,0
"172.16.133.128",65067,"216.219.112.250",443,6,366,13496,0,0,4,246,2,120,156.151935,0.2864259999999774,6870,3351
"172.16.133.13",53134,"172.16.139.250",5440,10,1022,13497,0,0,10,1022,0,0,156.166438,0.005504000000001952,1485465,0
"172.16.133.43",57879,"172.16.139.250",5440,12,1136,13498,0,0,12,1136,0,0,156.181285,0.05612099999999032,161935,0
"172.16.133.20",62508,"172.16.139.250",5440,12,1142,13499,0,0,12,1142,0,0,156.216711,0.024642000000000053,370749,0
"172.16.133.75",51073,"172.16.139.250",5440,10,1022,13500,0,0,10,1022,0,0,156.232919,0.015861000000001013,515478,0
"172.16.133.132",57126,"66.235.138.44",80,14,4926,13501,0,0,9,2761,5,2165,156.23496,8.446235999999999,2615,2050
"172.16.133.28",49218,"172.16.139.250",5440,12,1142,13502,0,0,12,1142,0,0,156.245493,0.007821999999976015,1167987,0
"172.16.133.99",56163,"172.16.139.250",5440,12,1142,13503,0,0,12,1142,0,0,156.273247,0.016443000000009533,555616,0
"172.16.133.87",60331,"172.16.139.250",5440,10,1022,13504,0,0,10,1022,0,0,156.296735,0.018104999999991378,451587,0
"172.16.133.116",53663,"172.16.139.250",5440,12,1142,13505,0,0,12,1142,0,0,156.310948,0.00937600000000316,974402,0
"172.16.133.116",53664,"172.16.139.250",5440,10,1022,13506,0,0,10,1022,0,0,156.320018,0.008169000000009419,1000856,0
"172.16.133.35",50070,"172.16.139.250",5440,12,1142,13507,0,0,12,1142,0,0,156.322642,0.01884499999999889,484797,0
"172.16.133.116",53665,"172.16.139.250",5440,10,1022,13508,0,0,10,1022,0,0,156.328993,0.006413000000009106,1274910,0
"172.16.133.84",58898,"172.16.139.250",5440,10,1022,13509,0,0,10,1022,0,0,156.332338,0.014694000000019969,556417,0
"172.16.133.132",46317,"23.13.210.227",80,10,2145,13510,0,0,5,794,5,1351,156.345224,0.1843759999999861,34451,58619
"172.16.133.132",47316,"204.13.194.191",80,12,1959,13511,0,0,6,861,6,1098,156.358284,0.16670700000000238,41318,52691
"172.16.133.49",55890,"172.16.139.250",5440,10,1022,13512,0,0,10,1022,0,0,156.409815,0.005559000000005199,1470768,0
"172.16.133.132",49800,"173.241.242.7",80,7,1324,13513,0,0,4,634,3,690,156.448341,0.12074200000000701,42006,45717
"172.16.133.95",57065,"172.16.139.250",5440,12,1142,13514,0,0,12,1142,0,0,156.448968,0.015530999999981532,588242,0
"172.16.133.92",57778,"172.16.139.250",5440,10,1022,13515,0,0,10,1022,0,0,156.475344,0.015716999999995096,520201,0
"172.16.133.132",46330,"23.67.243.65",80,24,5967,13516,0,0,16,3528,8,2439,156.47912,8.545039000000003,3302,2283
"172.16.133.132",59951,"209.190.70.254",80,10,1569,13517,0,0,5,671,5,898,156.479654,0.16217799999998306,33099,44297
"172.16.133.132",45946,"206.188.4.2",80,11,1760,13518,0,0,6,786,5,974,156.480158,0.07508700000002477,83742,103772
"172.16.133.132",44704,"23.33.47.196",80,18,5062,13519,0,0,12,2359,6,2703,156.480634,8.543210999999985,2209,2531
"172.16.133.132",40722,"184.173.189.190",80,7,434,13520,0,0,5,314,2,120,156.484832,10.820411999999976,232,88
"172.16.133.71",57575,"132.245.2.22",443,33,15594,13521,0,0,18,7042,15,8552,156.488077,1.4731809999999825,38241,46441
"172.16.133.132",47017,"216.52.121.177",80,9,1329,13522,0,0,5,680,4,649,156.493063,0.12170199999999909,44699,42661
"172.16.133.29",61063,"172.16.139.250",5440,10,1022,13523,0,0,10,1022,0,0,156.494512,0.005627000000004045,1452994,0
"172.16.133.132",35323,"74.119.118.94",80,33,8898,13524,0,0,18,5919,15,2979,156.496382,8.549442999999997,5538,2787
"172.16.133.44",64932,"172.16.139.250",5440,10,1022,13525,0,0,10,1022,0,0,156.499969,0.005408000000016955,1511834,0
"172.16.133.132",52673,"50.112.165.97",80,11,1378,13526,0,0,7,895,4,483,156.505683,8.167556999999988,876,473
"172.16.133.132",46910,"67.217.177.93",80,9,1523,13527,0,0,5,686,4,837,156.507731,0.11350699999999847,48349,58991
"172.16.133.132",40192,"23.0.51.167",80,18,5172,13528,0,0,12,2169,6,3003,156.513226,8.55686399999999,2027,2807
"172.16.133.132",35754,"107.20.232.172",80,18,4377,13529,0,0,12,2199,6,2178,156.51359,8.569455000000005,2052,2033
"172.16.133.207",56029,"172.16.139.250",5440,10,1022,13530,0,0,10,1022,0,0,156.526518,0.040602999999975964,201364,0
"172.16.133.83",57186,"172.16.139.250",5440,12,1142,13531,0,0,12,1142,0,0,156.535255,0.03657099999998081,249815,0
"172.16.133.132",57515,"23.0.50.77",80,18,3998,13532,0,0,12,2136,6,1862,156.537241,8.538318000000004,2001,1744
"172.16.133.132",59326,"85.90.254.45",80,14,3264,13533,0,0,9,1608,5,1656,156.537643,8.189256999999998,1570,1617
"172.16.133.41",53243,"96.43.146.176",443,110,89468,13534,0,0,52,45037,58,44431,156.541366,112.186993,3211,3168
"172.16.133.41",53244,"96.43.146.176",443,90,66508,13535,0,0,43,34204,47,32304,156.541626,112.386395,2434,2299
"172.16.133.41",53245,"96.43.146.176",443,78,57869,13536,0,0,37,28751,41,29118,156.542004,140.37558400000003,1638,1659
"172.16.133.132",57460,"149.174.149.39",80,21,3180,13537,0,0,14,2006,7,1174,156.545386,8.524592999999982,1882,1101
"172.16.133.132",58493,"54.242.202.249",80,10,1572,13538,0,0,5,670,5,902,156.545805,0.10964999999998781,48882,65809
"172.16.133.132",39549,"23.32.178.116",80,16,3278,13539,0,0,10,1663,6,1615,156.546117,8.412001000000004,1581,1535
"172.16.133.132",35485,"63.135.90.139",80,20,3026,13540,0,0,12,1361,8,1665,156.546494,8.554654999999997,1272,1557
"172.16.133.93",60855,"172.16.139.250",5440,10,1022,13541,0,0,10,1022,0,0,156.550898,0.025846000000001368,316335,0
"172.16.133.132",54269,"138.108.6.20",80,10,1710,13542,0,0,5,727,5,983,156.564257,0.41438600000000747,14035,18977
"172.16.133.11",55249,"172.16.139.250",5440,10,1022,13543,0,0,10,1022,0,0,156.567324,0.013426999999978761,608922,0
"172.16.133.55",57728,"172.16.139.250",5440,12,1142,13544,0,0,12,1142,0,0,156.572957,0.011602000000010548,787450,0
"172.16.133.128",65068,"202.173.24.200",443,7,426,13545,0,0,5,306,2,120,156.584084,1.245141000000018,1966,770
"172.16.133.73",60787,"172.16.139.250",5440,12,1142,13546,0,0,12,1142,0,0,156.597288,0.0064519999999959055,1415995,0
"172.16.133.53",54214,"172.16.139.250",5440,12,1142,13547,0,0,12,1142,0,0,156.598661,0.017277000000007092,528795,0
"172.16.133.21",53289,"172.16.139.250",5440,12,1142,13548,0,0,12,1142,0,0,156.600855,0.006973000000016327,1310196,0
"172.16.133.30",62753,"172.16.139.250",5440,10,1022,13549,0,0,10,1022,0,0,156.60519,0.006180999999997994,1322763,0
"172.16.133.25",63585,"172.16.139.250",5440,10,1022,13550,0,0,10,1022,0,0,156.61275,0.006378999999981261,1281705,0
"172.16.133.34",50541,"172.16.139.250",5440,12,1142,13551,0,0,12,1142,0,0,156.62041,0.0050229999999942265,1818833,0
"172.16.133.97",59490,"172.16.139.250",5440,10,1022,13552,0,0,10,1022,0,0,156.6314,0.00665300000000002,1228919,0
"172.16.133.132",47336,"204.13.194.191",80,10,2100,13553,0,0,5,918,5,1182,156.651585,0.08982199999999807,81761,105274
"172.16.133.41",53246,"96.43.146.176",443,167,133246,13554,0,0,82,71375,85,61871,156.657774,112.60842600000004,5070,4395
"172.16.133.41",53247,"96.43.146.176",443,212,172869,13555,0,0,95,74651,117,98218,156.659033,112.85604900000001,5291,6962
"172.16.133.33",58000,"172.16.139.250",5440,12,1142,13556,0,0,12,1142,0,0,156.704239,0.020521999999999707,445180,0
"172.16.133.132",49820,"173.241.242.7",80,7,1304,13557,0,0,4,687,3,617,156.738284,0.21778800000001297,25235,22664
"172.16.133.68",60856,"172.16.139.250",5440,10,1022,13558,0,0,10,1022,0,0,156.738336,0.005641999999994596,1449131,0
"172.16.133.12",59877,"172.16.139.250",5440,12,1142,13559,0,0,12,1142,0,0,156.754156,0.005606000000000222,1629682,0
"172.16.133.63",53995,"172.16.139.250",5440,12,1142,13560,0,0,12,1142,0,0,156.761871,0.006485999999995329,1408572,0
"172.16.133.71",57576,"132.245.2.22",443,35,15166,13561,0,0,19,5133,16,10033,156.765125,1.3029459999999915,31516,61601
"172.16.133.66",54002,"172.16.139.250",5440,10,1022,13562,0,0,10,1022,0,0,156.774679,0.00625999999999749,1306070,0
"172.16.133.82",61514,"172.16.139.250",5440,12,1142,13563,0,0,12,1142,0,0,156.787955,0.007196999999990794,1269417,0
"172.16.133.37",60721,"172.16.139.250",5440,12,1142,13564,0,0,12,1142,0,0,156.801566,0.007204999999999018,1268008,0
"172.16.133.132",59970,"209.190.70.254",80,11,2586,13565,0,0,6,878,5,1708,156.828969,3.376560000000012,2080,4046
"172.16.133.113",55658,"63.147.189.115",80,17,6418,13566,0,0,8,1418,9,5000,156.935304,25.30310399999999,448,1580
"172.16.133.113",55659,"63.147.189.115",80,15,6286,13567,0,0,7,1352,8,4934,156.937288,0.38843199999999456,27845,101618
"172.16.133.78",59328,"172.16.139.250",5440,10,1022,13568,0,0,10,1022,0,0,156.958811,0.005547000000007074,1473949,0
"172.16.133.128",65069,"208.111.161.254",80,16,5025,13569,0,0,7,1286,9,3739,156.969476,38.703543000000025,265,772
"172.16.133.128",65070,"208.111.161.254",80,14,3745,13570,0,0,6,1220,8,2525,156.969658,38.70436099999998,252,521
"172.16.133.128",65071,"208.111.161.254",80,19,5397,13571,0,0,7,1280,12,4117,156.969761,38.703148,264,850
"172.16.133.128",65072,"208.111.160.6",80,22,14483,13572,0,0,8,2146,14,12337,156.971705,38.70220500000002,443,2550
"172.16.133.128",65073,"208.111.160.6",80,8,492,13573,0,0,4,246,4,246,156.971869,18.72045700000001,105,105
"172.16.133.128",65074,"208.111.160.6",80,8,492,13574,0,0,4,246,4,246,156.971989,18.721294999999998,105,105
"172.16.133.128",65075,"208.111.160.6",80,8,492,13575,0,0,4,246,4,246,156.97212,18.721165000000013,105,105
"172.16.133.128",65076,"208.111.160.6",80,8,492,13576,0,0,4,246,4,246,156.972215,18.721018999999984,105,105
"172.16.133.128",65077,"208.111.160.6",80,8,492,13577,0,0,4,246,4,246,156.972333,18.720954000000006,105,105
"172.16.133.128",65078,"23.0.49.244",80,6,372,13578,0,0,4,246,2,126,157.007221,18.68612200000001,105,53
"172.16.133.128",65079,"23.0.49.244",80,6,372,13579,0,0,4,246,2,126,157.007337,18.68499,105,53
"172.16.133.67",56095,"172.16.139.250",5440,10,1022,13580,0,0,10,1022,0,0,157.012775,0.005397999999985359,1514635,0
"172.16.133.132",53605,"74.121.142.248",80,10,2232,13581,0,0,5,1265,5,967,157.028186,5.076679999999982,1993,1523
"172.16.133.56",61536,"172.16.139.250",5440,12,1142,13582,0,0,12,1142,0,0,157.036438,0.0049960000000055516,"",""
"172.16.133.132",49260,"107.6.106.10",80,10,1686,13583,0,0,5,789,5,897,157.083026,0.1719410000000039,36710,41735
"172.16.133.41",53248,"172.16.139.250",5440,10,1022,13584,0,0,10,1022,0,0,157.090632,0.00532000000001176,1536842,0
"172.16.133.42",57221,"172.16.139.250",5440,12,1142,13585,0,0,12,1142,0,0,157.136541,0.021728999999993448,420451,0
"172.16.133.85",52371,"172.16.139.250",5440,10,1022,13586,0,0,10,1022,0,0,157.155358,0.005886000000003833,1389058,0
"172.16.133.43",57880,"172.16.139.250",5440,10,1022,13587,0,0,10,1022,0,0,157.1615,0.005831999999998061,1401920,0
"172.16.133.13",53135,"172.16.139.250",5440,12,1142,13588,0,0,12,1142,0,0,157.18148,0.016264000000006718,561731,0
"172.16.133.20",62509,"172.16.139.250",5440,12,1142,13589,0,0,12,1142,0,0,157.230627,0.0050970000000063465,1792426,0
"172.16.133.75",51074,"172.16.139.250",5440,12,1142,13590,0,0,12,1142,0,0,157.246734,0.01633100000000809,559426,0
"172.16.133.24",57701,"180.153.31.250",443,6,366,13591,0,0,4,246,2,120,157.256815,0.48229299999999853,4080,1990
"172.16.133.28",49219,"172.16.139.250",5440,10,1022,13592,0,0,10,1022,0,0,157.260782,0.015276000000000067,535218,0
"172.16.133.132",49261,"107.6.106.10",80,1,74,13593,0,0,1,74,0,0,157.287902,0,"",""
"172.16.133.99",56164,"172.16.139.250",5440,10,1022,13594,0,0,10,1022,0,0,157.288065,0.014949000000001433,546926,0
"172.16.133.132",49262,"107.6.106.10",80,10,1686,13595,0,0,5,789,5,897,157.309145,0.2723709999999926,23174,26346
"172.16.133.87",60332,"172.16.139.250",5440,10,1022,13596,0,0,10,1022,0,0,157.31182,0.005665999999990845,1442993,0
"172.16.133.132",47037,"216.52.121.177",80,9,1250,13597,0,0,5,728,4,522,157.31669,0.16949900000000184,34360,24637
"172.16.133.35",50071,"172.16.139.250",5440,12,1142,13598,0,0,12,1142,0,0,157.318784,0.010560999999995602,865069,0
"172.16.133.116",53666,"172.16.139.250",5440,10,1022,13599,0,0,10,1022,0,0,157.325435,0.005112999999994372,1599061,0
"172.16.133.116",53667,"172.16.139.250",5440,10,1022,13600,0,0,10,1022,0,0,157.331596,0.00530700000001616,1540606,0
"172.16.133.132",52667,"173.194.43.32",80,35,19145,13601,0,0,20,2407,15,16738,157.334594,7.689324999999997,2504,17414
"172.16.133.116",53668,"172.16.139.250",5440,10,1022,13602,0,0,10,1022,0,0,157.337862,0.0231860000000097,352626,0
"172.16.133.84",58899,"172.16.139.250",5440,10,1022,13603,0,0,10,1022,0,0,157.346625,0.011068000000022948,738706,0
"172.16.133.132",49828,"173.241.242.7",80,7,1299,13604,0,0,4,682,3,617,157.365866,0.1619269999999915,33694,30482
"172.16.133.49",55891,"172.16.139.250",5440,10,1022,13605,0,0,10,1022,0,0,157.423713,0.014925000000005184,547805,0
"172.16.133.95",57066,"172.16.139.250",5440,12,1142,13606,0,0,12,1142,0,0,157.463247,0.01611800000000585,566819,0
"172.16.133.132",38351,"207.171.163.14",80,20,3512,13607,0,0,12,1655,8,1857,157.486452,7.588711999999987,1744,1957
"172.16.133.92",57779,"172.16.139.250",5440,10,1022,13608,0,0,10,1022,0,0,157.489689,0.015140999999999849,539990,0
"172.16.133.29",61064,"172.16.139.250",5440,10,1022,13609,0,0,10,1022,0,0,157.507715,0.0161250000000166,507038,0
"172.16.133.44",64933,"172.16.139.250",5440,10,1022,13610,0,0,10,1022,0,0,157.513758,0.014639000000016722,558508,0
"172.16.133.207",56030,"172.16.139.250",5440,10,1022,13611,0,0,10,1022,0,0,157.540818,0.0047470000000089385,"",""
"172.16.133.83",57187,"172.16.139.250",5440,12,1142,13612,0,0,12,1142,0,0,157.549411,0.01381000000000654,661549,0
"172.16.133.93",60856,"172.16.139.250",5440,10,1022,13613,0,0,10,1022,0,0,157.564688,0.005119000000007645,1597186,0
"172.16.133.11",55250,"172.16.139.250",5440,10,1022,13614,0,0,10,1022,0,0,157.581386,0.005656999999985146,1445289,0
"172.16.133.55",57729,"172.16.139.250",5440,10,1022,13615,0,0,10,1022,0,0,157.586743,0.005377999999979011,1520267,0
"172.16.133.73",60788,"172.16.139.250",5440,12,1142,13616,0,0,12,1142,0,0,157.61003,0.006044000000002825,1511581,0
"172.16.133.53",54215,"172.16.139.250",5440,12,1142,13617,0,0,12,1142,0,0,157.611849,0.0791629999999941,115407,0
"172.16.133.21",53290,"172.16.139.250",5440,10,1022,13618,0,0,10,1022,0,0,157.615174,0.08339800000001674,98035,0
"172.16.133.30",62754,"172.16.139.250",5440,12,1142,13619,0,0,12,1142,0,0,157.619569,0.005657999999982621,1614704,0
"172.16.133.25",63586,"172.16.139.250",5440,10,1022,13620,0,0,10,1022,0,0,157.626695,0.0762279999999862,107257,0
"172.16.133.34",50542,"172.16.139.250",5440,12,1142,13621,0,0,12,1142,0,0,157.634345,0.07237200000000144,126236,0
"172.16.133.97",59491,"172.16.139.250",5440,10,1022,13622,0,0,10,1022,0,0,157.645269,0.04971499999999196,164457,0
"172.16.133.96",53354,"173.194.43.53",443,43,7894,13623,0,0,23,3945,20,3949,157.717381,88.27767800000001,357,357
"172.16.133.33",58001,"172.16.139.250",5440,10,1022,13624,0,0,10,1022,0,0,157.718241,0.012731999999999744,642161,0
"172.16.133.68",60857,"172.16.139.250",5440,12,1142,13625,0,0,12,1142,0,0,157.752579,0.016117000000008375,566854,0
"172.16.133.63",53996,"172.16.139.250",5440,12,1142,13626,0,0,12,1142,0,0,157.776217,0.015971000000007507,572036,0
"172.16.133.66",54003,"172.16.139.250",5440,10,1022,13627,0,0,10,1022,0,0,157.788653,0.006585000000001173,1241609,0
"172.16.133.118",58228,"216.115.217.254",443,6,366,13628,0,0,4,246,2,120,157.790911,0.08805900000001543,22348,10901
"172.16.133.12",59878,"172.16.139.250",5440,12,1142,13629,0,0,12,1142,0,0,157.797881,0.015627000000023372,584629,0
"172.16.133.82",61515,"172.16.139.250",5440,12,1142,13630,0,0,12,1142,0,0,157.802522,0.005636999999978798,1620720,0
"172.16.133.37",60723,"172.16.139.250",5440,10,1022,13631,0,0,10,1022,0,0,157.815325,0.0063600000000008095,1285534,0
"172.16.133.34",50543,"68.64.24.250",443,6,366,13632,0,0,4,246,2,120,157.826598,0.09315800000001673,21125,10305
"172.16.133.34",50544,"78.108.118.250",443,6,366,13633,0,0,4,246,2,120,157.877542,0.22235200000000077,8850,4317
"172.16.133.34",50545,"216.219.118.244",443,6,366,13634,0,0,4,246,2,120,157.90249,0.20144500000000676,9769,4765
"172.16.133.118",58229,"216.219.120.244",443,6,366,13635,0,0,4,246,2,120,157.913703,0.18492800000001353,10641,5191
"172.16.133.78",59329,"172.16.139.250",5440,10,1022,13636,0,0,10,1022,0,0,157.97272,0.005610999999987598,1457137,0
"172.16.133.67",56096,"172.16.139.250",5440,10,1022,13637,0,0,10,1022,0,0,158.027657,0.005241999999981317,1559710,0
"172.16.133.34",50546,"216.115.219.126",443,6,366,13638,0,0,4,246,2,120,158.047511,0.5045340000000067,3900,1902
"172.16.133.56",61537,"172.16.139.250",5440,10,1022,13639,0,0,10,1022,0,0,158.054851,0.009625999999997248,849366,0
"172.16.133.37",60724,"96.43.146.22",443,19,4184,13640,0,0,11,3287,8,897,158.068304,135.25806899999998,194,53
"172.16.133.132",47111,"173.194.43.57",80,12,2051,13641,0,0,8,1175,4,876,158.070753,6.953231000000017,1351,1007
"172.16.133.113",55660,"172.16.139.250",135,8,492,13642,0,0,8,492,0,0,158.088336,0.02317500000000905,169838,0
"172.16.133.41",53249,"172.16.139.250",5440,12,1142,13643,0,0,12,1142,0,0,158.104388,0.006009000000005926,1520386,0
"172.16.133.128",65080,"216.115.222.200",443,6,366,13644,0,0,4,246,2,120,158.10611,0.09051400000001308,21742,10606
"172.16.133.113",55661,"172.16.139.250",5462,12,816,13645,0,0,12,816,0,0,158.112288,0.515420000000006,12665,0
"172.16.133.30",62755,"216.221.224.26",80,16,8096,13646,0,0,9,730,7,7366,158.120941,0.28537100000002624,20464,206496
"172.16.133.42",57222,"172.16.139.250",5440,12,1142,13647,0,0,12,1142,0,0,158.15221,0.05804399999999532,157397,0
"172.16.133.85",52372,"172.16.139.250",5440,12,1142,13648,0,0,12,1142,0,0,158.169159,0.005652999999995245,1616133,0
"172.16.133.43",57881,"172.16.139.250",5440,12,1142,13649,0,0,12,1142,0,0,158.176959,0.015453999999976986,591173,0
"172.16.133.13",53136,"172.16.139.250",5440,12,1142,13650,0,0,12,1142,0,0,158.195289,0.006189000000006217,1476167,0
"172.16.133.118",58230,"216.115.220.254",443,6,366,13651,0,0,4,246,2,120,158.225685,0.48349999999999227,4070,1985
"172.16.133.128",65081,"66.151.158.187",443,6,366,13652,0,0,4,246,2,120,158.238953,0.18443899999999758,10670,5204
"172.16.133.20",62510,"172.16.139.250",5440,10,1022,13653,0,0,10,1022,0,0,158.243726,0.014381999999983464,568488,0
"172.16.133.75",51075,"172.16.139.250",5440,10,1022,13654,0,0,10,1022,0,0,158.260781,0.01557499999998413,524943,0
"172.16.133.128",65082,"216.219.112.250",443,6,366,13655,0,0,4,246,2,120,158.268103,0.20727700000000482,9494,4631
"172.16.133.28",49220,"172.16.139.250",5440,10,1022,13656,0,0,10,1022,0,0,158.274552,0.00572800000000484,1427374,0
"172.16.133.99",56165,"172.16.139.250",5440,10,1022,13657,0,0,10,1022,0,0,158.301341,0.015063999999995303,542750,0
"172.16.133.87",60333,"172.16.139.250",5440,10,1022,13658,0,0,10,1022,0,0,158.324595,0.0161250000000166,507038,0
"172.16.133.35",50072,"172.16.139.250",5440,12,1142,13659,0,0,12,1142,0,0,158.331367,0.011383999999992511,802529,0
"172.16.133.116",53669,"172.16.139.250",5440,10,1022,13660,0,0,10,1022,0,0,158.341603,0.005516000000000076,1482233,0
"172.16.133.116",53670,"172.16.139.250",5440,10,1022,13661,0,0,10,1022,0,0,158.348244,0.005369999999999209,1522532,0
"172.16.133.116",53671,"172.16.139.250",5440,10,1022,13662,0,0,10,1022,0,0,158.354534,0.005214999999992642,1567785,0
"172.16.133.84",58900,"172.16.139.250",5440,10,1022,13663,0,0,10,1022,0,0,158.360085,0.01504299999999148,543508,0
"172.16.133.118",58231,"202.173.27.250",443,6,366,13664,0,0,4,246,2,120,158.376671,0.616987000000023,3189,1555
"172.16.133.49",55892,"172.16.139.250",5440,12,1142,13665,0,0,12,1142,0,0,158.438062,0.0161420000000021,565976,0
"172.16.133.128",65083,"208.47.254.88",80,6,372,13666,0,0,4,246,2,126,158.441583,17.241428999999982,114,58
"172.16.133.128",65084,"208.47.254.88",80,6,372,13667,0,0,4,246,2,126,158.441816,17.242097,114,58
"172.16.133.128",65085,"63.241.108.124",80,4,246,13668,0,0,2,126,2,120,158.44481,10.307646000000005,97,93
"172.16.133.128",65086,"63.241.108.124",80,4,246,13669,0,0,2,126,2,120,158.444933,11.239076000000011,89,85
"172.16.133.95",57067,"172.16.139.250",5440,12,1142,13670,0,0,12,1142,0,0,158.477149,0.015140999999999849,603394,0
"172.16.133.92",57780,"172.16.139.250",5440,10,1022,13671,0,0,10,1022,0,0,158.503985,0.005670000000009168,1441975,0
"172.16.133.29",61065,"172.16.139.250",5440,10,1022,13672,0,0,10,1022,0,0,158.526103,0.005379000000004908,1519985,0
"172.16.133.128",65087,"173.194.43.59",80,6,372,13673,0,0,4,246,2,126,158.526863,17.156090000000006,114,58
"172.16.133.128",65088,"216.52.242.80",80,6,372,13674,0,0,4,246,2,126,158.527326,17.235280000000017,114,58
"172.16.133.44",64934,"172.16.139.250",5440,12,1142,13675,0,0,12,1142,0,0,158.52943,0.006650000000007594,1373834,0
"172.16.133.207",56031,"172.16.139.250",5440,12,1142,13676,0,0,12,1142,0,0,158.553628,0.014513999999991256,629461,0
"172.16.133.83",57188,"172.16.139.250",5440,12,1142,13677,0,0,12,1142,0,0,158.563456,0.01483899999999494,615674,0
"172.16.133.93",60857,"172.16.139.250",5440,12,1142,13678,0,0,12,1142,0,0,158.579745,0.014487000000002581,630634,0
"172.16.133.11",55251,"172.16.139.250",5440,10,1022,13679,0,0,10,1022,0,0,158.595401,0.015479999999996608,528165,0
"172.16.133.55",57730,"172.16.139.250",5440,10,1022,13680,0,0,10,1022,0,0,158.600645,0.00562400000001162,1453769,0
"172.16.133.73",60789,"172.16.139.250",5440,12,1142,13681,0,0,12,1142,0,0,158.623449,0.005650000000002819,1616991,0
"172.16.133.53",54216,"172.16.139.250",5440,10,1022,13682,0,0,10,1022,0,0,158.626426,0.01073699999997757,761478,0
"172.16.133.21",53291,"172.16.139.250",5440,10,1022,13683,0,0,10,1022,0,0,158.629736,0.01490400000000136,548577,0
"172.16.133.30",62756,"172.16.139.250",5440,10,1022,13684,0,0,10,1022,0,0,158.633485,0.018061999999986256,452663,0
"173.194.75.103",443,"172.16.133.36",64969,8,570,13685,0,0,4,330,4,240,158.638567,0.04693299999999567,56250,40909
"172.16.133.25",63587,"172.16.139.250",5440,12,1142,13686,0,0,12,1142,0,0,158.639932,0.015835000000009813,576949,0
"172.16.133.34",50547,"172.16.139.250",5440,10,1022,13687,0,0,10,1022,0,0,158.649468,0.009675999999984697,844977,0
"172.16.133.97",59492,"172.16.139.250",5440,10,1022,13688,0,0,10,1022,0,0,158.659677,0.016356000000001814,499877,0
"172.16.133.11",55252,"157.56.240.137",443,6,374,13689,0,0,3,194,3,180,158.705301,1.0828930000000128,1433,1329
"172.16.133.33",58002,"172.16.139.250",5440,10,1022,13690,0,0,10,1022,0,0,158.732214,0.005544000000014648,1474747,0
"172.16.133.132",49831,"173.241.242.7",80,7,1298,13691,0,0,4,681,3,617,158.742901,0.08838600000001406,61638,55845
"172.16.133.132",45975,"206.188.4.2",80,11,1715,13692,0,0,6,882,5,833,158.75101,0.0825580000000059,85467,80719
"172.16.133.132",47044,"216.52.121.177",80,9,1253,13693,0,0,5,731,4,522,158.762836,0.0972940000000051,60106,42921
"172.16.133.68",60858,"172.16.139.250",5440,10,1022,13694,0,0,10,1022,0,0,158.765199,0.015635000000003174,522929,0
"172.16.133.12",59879,"172.16.139.250",5440,10,1022,13695,0,0,10,1022,0,0,158.779663,0.005489000000011401,1489524,0
"172.16.133.132",46935,"67.217.177.93",80,8,1549,13696,0,0,5,778,3,771,158.779911,0.09433500000000095,65977,65384
"172.16.133.63",53997,"172.16.139.250",5440,12,1142,13697,0,0,12,1142,0,0,158.788644,0.015314999999986867,596539,0
"172.16.133.132",58513,"54.242.202.249",80,10,1542,13698,0,0,5,814,5,728,158.797581,0.09012599999999793,72254,64620
"172.16.133.66",54004,"172.16.139.250",5440,10,1022,13699,0,0,10,1022,0,0,158.802617,0.0054990000000145756,1486815,0
"172.16.133.82",61516,"172.16.139.250",5440,12,1142,13700,0,0,12,1142,0,0,158.81669,0.007398999999992384,1234761,0
"172.16.133.37",60725,"172.16.139.250",5440,10,1022,13701,0,0,10,1022,0,0,158.830278,0.005564000000020997,1469446,0
"172.16.133.132",54287,"138.108.6.20",80,10,1533,13702,0,0,5,806,5,727,158.832122,0.3090139999999906,20866,18821
"172.16.133.128",65089,"202.173.24.200",443,6,366,13703,0,0,4,246,2,120,158.835141,0.4889029999999934,4025,1963
"172.16.133.126",61938,"66.114.52.21",80,36,23381,13704,0,0,15,1296,21,22085,158.925634,7.7901410000000055,1330,22679
"172.16.133.41",49797,"96.43.146.176",443,2,120,13705,0,0,1,60,1,60,158.931321,7.700000000454565e-05,"",""
"172.16.133.41",53250,"96.43.146.176",443,30,10290,13706,0,0,16,3901,14,6389,158.931899,110.049488,283,464
"172.16.133.126",61939,"66.175.214.5",3333,17,2200,13707,0,0,9,1442,8,758,158.940239,127.82281900000001,90,47
"172.16.133.126",61940,"93.184.216.229",80,17,6641,13708,0,0,8,1445,9,5196,158.950778,7.7528879999999845,1491,5361
"172.16.133.78",59330,"172.16.139.250",5440,10,1022,13709,0,0,10,1022,0,0,158.986589,0.0055370000000039,1476611,0
"172.16.133.126",61941,"64.94.107.14",80,8,1493,13710,0,0,5,1030,3,463,158.995402,0.09687900000000127,85054,38233
"172.16.133.126",61942,"174.35.22.43",80,17,3707,13711,0,0,9,2051,8,1656,159.025137,17.67113599999999,928,749
"172.16.133.67",56097,"172.16.139.250",5440,10,1022,13712,0,0,10,1022,0,0,159.041637,0.02198500000000081,371889,0
"172.16.133.128",65090,"138.108.6.20",80,10,2547,13713,0,0,5,1829,5,718,159.04847,13.399299999999982,1091,428
"172.16.133.128",65091,"64.94.107.14",80,10,2523,13714,0,0,6,2000,4,523,159.060927,0.06804700000000707,235131,61486
"172.16.133.56",61538,"172.16.139.250",5440,12,1142,13715,0,0,12,1142,0,0,159.063094,0.005381999999997333,1697510,0
"172.16.133.126",61943,"173.194.43.41",80,15,3641,13716,0,0,8,2457,7,1184,159.107243,135.27890399999998,145,70
"172.16.133.41",53251,"172.16.139.250",5440,10,1022,13717,0,0,10,1022,0,0,159.118907,0.01551200000000108,527075,0
"172.16.133.42",57223,"172.16.139.250",5440,12,1142,13718,0,0,12,1142,0,0,159.166354,0.020947999999975764,436127,0
"172.16.133.126",61944,"64.94.107.14",80,8,1304,13719,0,0,5,841,3,463,159.167177,0.07523899999998207,89421,49229
"172.16.133.85",52373,"172.16.139.250",5440,10,1022,13720,0,0,10,1022,0,0,159.183288,0.005724999999983993,1428122,0
"172.16.133.43",57882,"172.16.139.250",5440,10,1022,13721,0,0,10,1022,0,0,159.190404,0.00563700000000722,1450416,0
"172.16.133.13",53137,"172.16.139.250",5440,10,1022,13722,0,0,10,1022,0,0,159.208485,0.005445000000008804,1501561,0
"172.16.133.20",62511,"172.16.139.250",5440,10,1022,13723,0,0,10,1022,0,0,159.257453,0.014630000000011023,558851,0
"172.16.133.126",61945,"174.35.22.43",80,9,556,13724,0,0,6,374,3,182,159.263752,27.45850299999998,108,53
"172.16.133.75",51076,"172.16.139.250",5440,10,1022,13725,0,0,10,1022,0,0,159.274917,0.015501000000000431,527449,0
"172.16.133.28",49221,"172.16.139.250",5440,10,1022,13726,0,0,10,1022,0,0,159.287511,0.006713000000019065,1217935,0
"172.16.133.126",61946,"54.235.137.123",80,13,2128,13727,0,0,7,1218,6,910,159.307425,67.388756,144,108
"172.16.133.99",56166,"172.16.139.250",5440,10,1022,13728,0,0,10,1022,0,0,159.315402,0.014801000000005615,552395,0
"172.16.133.87",60334,"172.16.139.250",5440,12,1142,13729,0,0,12,1142,0,0,159.33985,0.006263999999987391,1458492,0
"172.16.133.35",50073,"172.16.139.250",5440,12,1142,13730,0,0,12,1142,0,0,159.34667,0.03856100000001561,236923,0
"172.16.133.116",53672,"23.0.49.244",80,7,432,13731,0,0,4,246,3,186,159.350121,12.802211,153,116
"172.16.133.116",53673,"172.16.139.250",5440,10,1022,13732,0,0,10,1022,0,0,159.354657,0.006786000000005288,1204833,0
"172.16.133.116",53674,"172.16.139.250",5440,10,1022,13733,0,0,10,1022,0,0,159.362231,0.015782999999998992,518025,0
"172.16.133.84",58901,"172.16.139.250",5440,12,1142,13734,0,0,12,1142,0,0,159.374644,0.015904000000006135,574446,0
"172.16.133.116",53675,"172.16.139.250",5440,10,1022,13735,0,0,10,1022,0,0,159.378762,0.005723000000017464,1428621,0
"172.16.133.235",2701,"172.16.131.10",8080,19,3213,13736,0,0,10,1627,9,1586,159.416417,18.48760200000001,704,686
"172.16.133.49",55893,"172.16.139.250",5440,12,1142,13737,0,0,12,1142,0,0,159.451746,0.015573999999986654,586618,0
"172.16.133.95",57068,"172.16.139.250",5440,10,1022,13738,0,0,10,1022,0,0,159.490865,0.00518699999997807,1576248,0
"172.16.133.24",57702,"180.153.31.250",443,6,366,13739,0,0,4,246,2,120,159.509758,0.4662390000000016,4221,2059
"172.16.133.92",57781,"172.16.139.250",5440,10,1022,13740,0,0,10,1022,0,0,159.517767,0.0054980000000171,1487086,0
"172.16.133.29",61066,"172.16.139.250",5440,10,1022,13741,0,0,10,1022,0,0,159.535987,0.005205999999986943,1570495,0
"172.16.133.44",64935,"172.16.139.250",5440,10,1022,13742,0,0,10,1022,0,0,159.542216,0.015260000000012042,535779,0
"172.16.133.207",56032,"172.16.139.250",5440,10,1022,13743,0,0,10,1022,0,0,159.567383,0.004704000000003816,"",""
"172.16.133.83",57189,"172.16.139.250",5440,12,1142,13744,0,0,12,1142,0,0,159.577343,0.004904999999979509,"",""
"172.16.133.93",60858,"172.16.139.250",5440,12,1142,13745,0,0,12,1142,0,0,159.592728,0.005259999999992715,1736882,0
"172.16.133.11",55253,"172.16.139.250",5440,10,1022,13746,0,0,10,1022,0,0,159.609476,0.0056179999999983465,1455322,0
"172.16.133.55",57731,"172.16.139.250",5440,12,1142,13747,0,0,12,1142,0,0,159.614827,0.006370000000003984,1434222,0
"172.16.133.73",60790,"172.16.139.250",5440,12,1142,13748,0,0,12,1142,0,0,159.638438,0.006439000000000306,1418853,0
"172.16.133.53",54217,"172.16.139.250",5440,12,1142,13749,0,0,12,1142,0,0,159.640517,0.00817299999999932,1117826,0
"172.16.133.21",53292,"172.16.139.250",5440,10,1022,13750,0,0,10,1022,0,0,159.64269,0.016749000000004344,488148,0
"172.16.133.30",62757,"172.16.139.250",5440,10,1022,13751,0,0,10,1022,0,0,159.647396,0.005492000000003827,1488710,0
"172.16.133.25",63588,"172.16.139.250",5440,10,1022,13752,0,0,10,1022,0,0,159.65484,0.007778000000001839,1051169,0
"172.16.133.34",50548,"172.16.139.250",5440,10,1022,13753,0,0,10,1022,0,0,159.663642,0.005115999999986798,1598123,0
"172.16.133.97",59493,"172.16.139.250",5440,12,1142,13754,0,0,12,1142,0,0,159.673777,0.006091999999995323,1499671,0
"172.16.133.36",65080,"54.243.254.190",443,33,12284,13755,0,0,18,7426,15,4858,159.683835,74.60659100000001,796,520
"172.16.133.36",65081,"54.243.254.190",443,39,14135,13756,0,0,20,8992,19,5143,159.684254,74.60556699999998,964,551
"172.16.133.36",65082,"54.243.254.190",443,33,13596,13757,0,0,18,7426,15,6170,159.684255,74.60491399999998,796,661
"172.16.133.36",65083,"54.243.254.190",443,27,7857,13758,0,0,14,3856,13,4001,159.684257,74.60706400000001,413,429
"172.16.133.36",65084,"54.243.254.190",443,42,17186,13759,0,0,22,10004,20,7182,159.684258,74.606169,1072,770
"172.16.133.36",65085,"54.243.254.190",443,57,30649,13760,0,0,29,11772,28,18877,159.743145,74.541122,1263,2025
"172.16.133.33",58003,"172.16.139.250",5440,12,1142,13761,0,0,12,1142,0,0,159.746443,0.016108000000002676,567171,0
"172.16.133.68",60859,"172.16.139.250",5440,10,1022,13762,0,0,10,1022,0,0,159.77927,0.015568000000001803,525179,0
"172.16.133.12",59880,"172.16.139.250",5440,10,1022,13763,0,0,10,1022,0,0,159.793619,0.0055799999999806005,1465232,0
"172.16.133.63",53998,"172.16.139.250",5440,10,1022,13764,0,0,10,1022,0,0,159.802777,0.005459999999999354,1497435,0
"172.16.133.66",54005,"172.16.139.250",5440,10,1022,13765,0,0,10,1022,0,0,159.816949,0.005340000000018108,1531086,0
"172.16.133.11",55254,"65.55.171.159",443,6,374,13766,0,0,3,194,3,180,159.820598,1.0790780000000098,1438,1334
"172.16.133.132",47048,"216.52.121.177",80,9,1249,13767,0,0,5,727,4,522,159.828063,0.1154780000000244,50364,36162
"172.16.133.82",61517,"172.16.139.250",5440,12,1142,13768,0,0,12,1142,0,0,159.8304,0.015375000000005912,594211,0
"172.16.133.118",58232,"216.115.217.254",443,6,366,13769,0,0,4,246,2,120,159.837736,0.06290400000000318,31285,15261
"172.16.133.37",60726,"172.16.139.250",5440,12,1142,13770,0,0,12,1142,0,0,159.844666,0.006191000000001168,1475690,0
"172.16.133.34",50549,"68.64.24.250",443,6,366,13771,0,0,4,246,2,120,159.877658,0.11631099999999606,16920,8253
"172.16.133.34",50550,"78.108.118.250",443,6,366,13772,0,0,4,246,2,120,159.983615,0.2691960000000222,7310,3566
"172.16.133.78",59331,"172.16.139.250",5440,12,1142,13773,0,0,12,1142,0,0,160.001029,0.005758000000014363,1586662,0
"172.16.133.34",50551,"216.219.118.244",443,6,366,13774,0,0,4,246,2,120,160.007642,0.24833599999999478,7924,3865
"172.16.133.118",58233,"216.219.120.244",443,6,366,13775,0,0,4,246,2,120,160.015237,0.22208099999997444,8861,4322
"172.16.133.67",56098,"172.16.139.250",5440,10,1022,13776,0,0,10,1022,0,0,160.055279,0.01240899999999101,658876,0
"172.16.133.56",61539,"172.16.139.250",5440,10,1022,13777,0,0,10,1022,0,0,160.077314,0.004739000000000715,"",""
"172.16.133.132",56578,"74.119.118.84",80,17,5256,13778,0,0,10,1267,7,3989,160.092666,4.980520999999982,2035,6407
"172.16.133.41",53252,"172.16.139.250",5440,12,1142,13779,0,0,12,1142,0,0,160.133048,0.005472999999994954,1669285,0
"172.16.133.42",57224,"172.16.139.250",5440,12,1142,13780,0,0,12,1142,0,0,160.18318,0.02057400000001053,444055,0
"172.16.133.85",52374,"172.16.139.250",5440,10,1022,13781,0,0,10,1022,0,0,160.197344,0.005684999999999718,1438170,0
"172.16.133.43",57883,"172.16.139.250",5440,10,1022,13782,0,0,10,1022,0,0,160.205249,0.014503999999988082,563706,0
"172.16.133.13",53138,"172.16.139.250",5440,12,1142,13783,0,0,12,1142,0,0,160.22253,0.016168999999990774,565031,0
"172.16.133.20",62512,"172.16.139.250",5440,12,1142,13784,0,0,12,1142,0,0,160.271737,0.005044999999995525,1810901,0
"172.16.133.132",47356,"204.13.194.191",80,10,2218,13785,0,0,5,998,5,1220,160.275428,0.08582400000000234,93027,113721
"172.16.133.75",51077,"172.16.139.250",5440,10,1022,13786,0,0,10,1022,0,0,160.289734,0.015052999999994654,543147,0
"172.16.133.132",36534,"67.217.177.126",80,9,2111,13787,0,0,5,967,4,1144,160.292087,0.10514599999999064,73573,87040
"172.16.133.28",49222,"172.16.139.250",5440,10,1022,13788,0,0,10,1022,0,0,160.302287,0.015088999999989028,541851,0
"172.16.133.132",45984,"206.188.4.2",80,11,1983,13789,0,0,6,993,5,990,160.302288,0.07910899999998833,100418,100115
"172.16.133.34",50552,"216.115.219.126",443,6,366,13790,0,0,4,246,2,120,160.305673,0.48569599999999014,4051,1976
"172.16.133.132",49842,"173.241.242.7",80,7,1402,13791,0,0,4,785,3,617,160.31338,0.09050100000001748,69391,54540
"172.16.133.99",56167,"172.16.139.250",5440,10,1022,13792,0,0,10,1022,0,0,160.329699,0.01483899999999494,550980,0
"172.16.133.132",55172,"74.117.199.102",80,8,1745,13793,0,0,5,825,3,920,160.345649,0.1768459999999834,37320,41618
"172.16.133.87",60335,"172.16.139.250",5440,12,1142,13794,0,0,12,1142,0,0,160.35309,0.006202000000001817,1473073,0
"172.16.133.35",50074,"172.16.139.250",5440,12,1142,13795,0,0,12,1142,0,0,160.359435,0.013199000000014394,692173,0
"172.16.133.132",50685,"173.241.242.187",80,7,1355,13796,0,0,4,720,3,635,160.36308,0.10074800000001005,57172,50422
"172.16.133.116",53676,"172.16.139.250",5440,10,1022,13797,0,0,10,1022,0,0,160.366535,0.005343000000010534,1530226,0
"172.16.133.116",53677,"172.16.139.250",5440,10,1022,13798,0,0,10,1022,0,0,160.372772,0.015186999999997397,538355,0
"172.16.133.132",53778,"23.67.242.24",80,14,2104,13799,0,0,9,1054,5,1050,160.377736,4.579530000000005,1841,1834
"172.16.133.132",48758,"184.73.220.229",80,12,1834,13800,0,0,8,985,4,849,160.384253,4.685910000000007,1681,1449
"172.16.133.132",57967,"67.203.19.35",80,10,1682,13801,0,0,5,771,5,911,160.384769,0.33839899999998124,18227,21536
"172.16.133.84",58902,"172.16.139.250",5440,10,1022,13802,0,0,10,1022,0,0,160.388671,0.01530600000000959,534169,0
"172.16.133.116",53678,"172.16.139.250",5440,10,1022,13803,0,0,10,1022,0,0,160.389395,0.005392999999997983,1516039,0
"172.16.133.132",33586,"68.71.249.121",80,10,1543,13804,0,0,7,862,3,681,160.406227,4.276023000000009,1612,1274
"172.16.133.132",55244,"64.12.96.244",80,13,1494,13805,0,0,9,1026,4,468,160.409248,4.6667030000000125,1758,802
"172.16.133.132",44912,"8.9.23.204",80,9,1455,13806,0,0,5,773,4,682,160.437663,0.1546470000000113,39987,35280
"172.16.133.49",55894,"172.16.139.250",5440,12,1142,13807,0,0,12,1142,0,0,160.466047,0.00626199999999244,1458958,0
"172.16.133.118",58234,"216.115.220.254",443,6,366,13808,0,0,4,246,2,120,160.470682,0.5100649999999973,3858,1882
"172.16.133.95",57069,"172.16.139.250",5440,10,1022,13809,0,0,10,1022,0,0,160.505132,0.005249999999989541,1557333,0
"172.16.133.92",57782,"172.16.139.250",5440,10,1022,13810,0,0,10,1022,0,0,160.531714,0.01532299999999509,533576,0
"172.16.133.29",61067,"172.16.139.250",5440,10,1022,13811,0,0,10,1022,0,0,160.550528,0.005185999999980595,1576552,0
"172.16.133.132",47368,"204.13.194.191",80,10,1982,13812,0,0,5,938,5,1044,160.551106,0.0867590000000007,86492,96266
"172.16.133.44",64936,"172.16.139.250",5440,10,1022,13813,0,0,10,1022,0,0,160.557061,0.005536000000006425,1476878,0
"172.16.133.207",56033,"172.16.139.250",5440,10,1022,13814,0,0,10,1022,0,0,160.581613,0.005335999999999785,1532233,0
"172.16.133.83",57190,"172.16.139.250",5440,12,1142,13815,0,0,12,1142,0,0,160.591418,0.004644999999982247,"",""
"172.16.133.93",60859,"172.16.139.250",5440,10,1022,13816,0,0,10,1022,0,0,160.607871,0.027846000000010918,293614,0
"172.16.133.11",55255,"172.16.139.250",5440,10,1022,13817,0,0,10,1022,0,0,160.623221,0.13005599999999617,62865,0
"172.16.133.55",57732,"172.16.139.250",5440,10,1022,13818,0,0,10,1022,0,0,160.627731,0.1219859999999926,67024,0
"172.16.133.73",60791,"172.16.139.250",5440,10,1022,13819,0,0,10,1022,0,0,160.650478,0.10618400000001316,76998,0
"172.16.133.53",54218,"172.16.139.250",5440,10,1022,13820,0,0,10,1022,0,0,160.654004,0.10589200000001142,77210,0
"172.16.133.21",53293,"172.16.139.250",5440,12,1142,13821,0,0,12,1142,0,0,160.656836,0.10799199999999587,84598,0
"172.16.133.118",58235,"202.173.27.250",443,6,366,13822,0,0,4,246,2,120,160.66096,0.6281409999999994,3133,1528
"172.16.133.30",62758,"172.16.139.250",5440,12,1142,13823,0,0,12,1142,0,0,160.661602,0.11427100000000223,79950,0
"172.16.133.25",63589,"172.16.139.250",5440,12,1142,13824,0,0,12,1142,0,0,160.667916,0.10089000000002102,90554,0
"172.16.133.34",50553,"172.16.139.250",5440,12,1142,13825,0,0,12,1142,0,0,160.677633,0.12981500000000779,70377,0
"172.16.133.97",59494,"172.16.139.250",5440,10,1022,13826,0,0,10,1022,0,0,160.687515,0.017078999999995403,478716,0
"172.16.128.233",55269,"172.16.133.233",22,203,22516,13827,0,0,55,4558,148,17958,160.747975,8.141706,4478,17645
"172.16.133.33",58004,"172.16.139.250",5440,12,1142,13828,0,0,12,1142,0,0,160.760222,0.06778099999999654,134787,0
"172.16.133.68",60860,"172.16.139.250",5440,10,1022,13829,0,0,10,1022,0,0,160.794456,0.037448000000011916,218329,0
"172.16.133.12",59881,"172.16.139.250",5440,12,1142,13830,0,0,12,1142,0,0,160.807974,0.02863600000000588,319038,0
"172.16.133.63",53999,"172.16.139.250",5440,12,1142,13831,0,0,12,1142,0,0,160.817194,0.02299500000000876,397303,0
"172.16.133.66",54006,"172.16.139.250",5440,12,1142,13832,0,0,12,1142,0,0,160.830636,0.013987000000014405,653177,0
"172.16.133.82",61518,"172.16.139.250",5440,12,1142,13833,0,0,12,1142,0,0,160.848308,0.015077999999988378,605915,0
"172.16.133.37",60729,"172.16.139.250",5440,12,1142,13834,0,0,12,1142,0,0,160.858291,0.009655999999978349,946147,0
"172.16.133.132",50693,"173.241.242.187",80,7,1478,13835,0,0,4,789,3,689,160.861618,0.12539100000000758,50338,43958
"172.16.133.11",55256,"157.56.244.217",80,8,884,13836,0,0,5,532,3,352,160.903686,0.22100900000000934,19257,12741
"172.16.133.78",59332,"172.16.139.250",5440,10,1022,13837,0,0,10,1022,0,0,161.014996,0.007086000000015247,1153824,0
"172.16.133.132",57973,"67.203.19.35",80,10,1733,13838,0,0,5,790,5,943,161.065531,0.2958550000000173,21361,25498
"172.16.133.67",56099,"172.16.139.250",5440,10,1022,13839,0,0,10,1022,0,0,161.06922,0.01553799999999228,526193,0
"172.16.133.56",61540,"172.16.139.250",5440,10,1022,13840,0,0,10,1022,0,0,161.092154,0.014348000000012462,569835,0
"172.16.133.41",53253,"172.16.139.250",5440,12,1142,13841,0,0,12,1142,0,0,161.146779,0.014596999999980653,625882,0
"172.16.133.132",35370,"74.119.118.94",80,13,2148,13842,0,0,8,1477,5,671,161.147742,3.806947000000008,3103,1410
"172.16.133.42",57225,"172.16.139.250",5440,12,1142,13843,0,0,12,1142,0,0,161.19703,0.03367099999999823,271331,0
"172.16.133.85",52375,"172.16.139.250",5440,10,1022,13844,0,0,10,1022,0,0,161.211591,0.0161109999999951,507479,0
"172.16.133.43",57884,"172.16.139.250",5440,10,1022,13845,0,0,10,1022,0,0,161.218458,0.005531999999988102,1477946,0
"172.16.133.13",53139,"172.16.139.250",5440,10,1022,13846,0,0,10,1022,0,0,161.237589,0.005358999999998559,1525657,0
"172.16.133.132",57380,"173.241.242.153",80,7,1515,13847,0,0,4,827,3,688,161.274287,0.10425800000001573,63457,52792
"172.16.133.20",62513,"172.16.139.250",5440,12,1142,13848,0,0,12,1142,0,0,161.287008,0.005423000000007505,1684676,0
"172.16.133.75",51078,"172.16.139.250",5440,10,1022,13849,0,0,10,1022,0,0,161.302913,0.005636000000009744,1450674,0
"172.16.133.28",49223,"172.16.139.250",5440,10,1022,13850,0,0,10,1022,0,0,161.315642,0.01459800000000655,560076,0
"172.16.133.99",56168,"172.16.139.250",5440,12,1142,13851,0,0,12,1142,0,0,161.34347,0.015046000000012327,607204,0
"172.16.133.87",60336,"172.16.139.250",5440,12,1142,13852,0,0,12,1142,0,0,161.368542,0.006346000000007734,1439647,0
"172.16.133.35",50075,"172.16.139.250",5440,12,1142,13853,0,0,12,1142,0,0,161.378907,0.054606000000006816,167307,0
"172.16.133.116",53679,"172.16.139.250",5440,10,1022,13854,0,0,10,1022,0,0,161.380574,0.004832999999990761,"",""
"172.16.133.116",53680,"172.16.139.250",5440,10,1022,13855,0,0,10,1022,0,0,161.386309,0.014386000000001786,568330,0
"172.16.133.116",53681,"172.16.139.250",5440,10,1022,13856,0,0,10,1022,0,0,161.401554,0.00548899999998298,1489524,0
"172.16.133.84",58903,"172.16.139.250",5440,10,1022,13857,0,0,10,1022,0,0,161.402404,0.014752000000015641,554229,0
"172.16.133.132",50697,"173.241.242.187",80,7,1527,13858,0,0,4,839,3,688,161.431552,0.08417099999999778,79742,65390
"172.16.133.49",55895,"172.16.139.250",5440,10,1022,13859,0,0,10,1022,0,0,161.479291,0.007902000000001408,1034674,0
"172.16.133.95",57070,"172.16.139.250",5440,10,1022,13860,0,0,10,1022,0,0,161.519345,0.005289000000004762,1545849,0
"172.16.133.92",57783,"172.16.139.250",5440,10,1022,13861,0,0,10,1022,0,0,161.545547,0.01574199999998882,519374,0
"172.16.133.29",61068,"172.16.139.250",5440,10,1022,13862,0,0,10,1022,0,0,161.564534,0.00542400000000498,1507374,0
"172.16.133.44",64937,"172.16.139.250",5440,10,1022,13863,0,0,10,1022,0,0,161.571878,0.004875999999995884,"",""
"172.16.133.207",56034,"172.16.139.250",5440,12,1142,13864,0,0,12,1142,0,0,161.595969,0.01611400000001595,566960,0
"172.16.133.83",57191,"172.16.139.250",5440,12,1142,13865,0,0,12,1142,0,0,161.605511,0.01699299999998516,537633,0
"172.16.133.93",60860,"172.16.139.250",5440,12,1142,13866,0,0,12,1142,0,0,161.619885,0.014375000000001137,635547,0
"172.16.133.11",55257,"172.16.139.250",5440,10,1022,13867,0,0,10,1022,0,0,161.637297,0.006487000000021226,1260366,0
"172.16.133.55",57733,"172.16.139.250",5440,10,1022,13868,0,0,10,1022,0,0,161.641753,0.0057610000000067885,1419198,0
"172.16.133.73",60792,"172.16.139.250",5440,10,1022,13869,0,0,10,1022,0,0,161.664634,0.01884699999999384,433809,0
"172.16.133.53",54219,"172.16.139.250",5440,12,1142,13870,0,0,12,1142,0,0,161.667672,0.005654999999990196,1615561,0
"172.16.133.21",53294,"172.16.139.250",5440,10,1022,13871,0,0,10,1022,0,0,161.670755,0.016704999999973325,489434,0
"172.16.133.30",62759,"172.16.139.250",5440,10,1022,13872,0,0,10,1022,0,0,161.674346,0.0053679999999758365,1523099,0
"172.16.133.25",63590,"172.16.139.250",5440,10,1022,13873,0,0,10,1022,0,0,161.682884,0.008543000000003076,957040,0
"172.16.133.34",50554,"172.16.139.250",5440,10,1022,13874,0,0,10,1022,0,0,161.691553,0.005882000000013932,1390003,0
"172.16.133.97",59495,"172.16.139.250",5440,10,1022,13875,0,0,10,1022,0,0,161.701582,0.0151429999999948,539919,0
"172.16.133.24",57703,"180.153.31.250",443,6,366,13876,0,0,4,246,2,120,161.738835,0.5125409999999988,3839,1873
"172.16.133.33",58005,"172.16.139.250",5440,10,1022,13877,0,0,10,1022,0,0,161.774235,0.005699999999990268,1434385,0
"172.16.133.68",60861,"172.16.139.250",5440,10,1022,13878,0,0,10,1022,0,0,161.807417,0.006254000000012638,1307323,0
"172.16.133.12",59882,"172.16.139.250",5440,12,1142,13879,0,0,12,1142,0,0,161.821712,0.019215000000002647,475461,0
"172.16.133.63",54000,"172.16.139.250",5440,10,1022,13880,0,0,10,1022,0,0,161.830977,0.005804000000011911,1408683,0
"172.16.133.66",54007,"172.16.139.250",5440,10,1022,13881,0,0,10,1022,0,0,161.84473500000001,0.005398999999982834,1514354,0
"172.16.133.82",61519,"172.16.139.250",5440,12,1142,13882,0,0,12,1142,0,0,161.859452,0.00615999999999417,1483116,0
"172.16.133.37",60730,"172.16.139.250",5440,12,1142,13883,0,0,12,1142,0,0,161.871481,0.00634700000000521,1439420,0
"172.16.133.118",58236,"216.115.217.254",443,6,366,13884,0,0,4,246,2,120,161.883365,0.055949999999995725,35174,17158
"172.16.133.34",50555,"68.64.24.250",443,6,366,13885,0,0,4,246,2,120,161.928777,0.09795099999999479,20091,9800
"172.16.133.132",59870,"216.52.121.178",80,9,1229,13886,0,0,5,700,4,529,161.969483,0.08893399999999474,62968,47585
"172.16.133.132",59871,"216.52.121.178",80,10,1295,13887,0,0,6,766,4,529,161.970387,0.08450100000001726,72519,50082
"172.16.133.132",59872,"216.52.121.178",80,9,1228,13888,0,0,5,699,4,529,161.97131,0.0973340000000178,57451,43479
"172.16.133.132",59873,"216.52.121.178",80,9,1228,13889,0,0,5,699,4,529,161.972183,0.09635299999999347,58036,43921
"172.16.133.132",59874,"216.52.121.178",80,9,614,13890,0,0,6,404,3,210,161.973021,3.0997640000000217,1042,541
"172.16.133.132",59875,"216.52.121.178",80,9,614,13891,0,0,6,404,3,210,161.973868,3.096724999999992,1043,542
"172.16.133.78",59333,"172.16.139.250",5440,10,1022,13892,0,0,10,1022,0,0,162.027865,0.005691000000012991,1436654,0
"172.16.133.67",56100,"172.16.139.250",5440,10,1022,13893,0,0,10,1022,0,0,162.083353,0.005290999999999713,1545265,0
"172.16.133.56",61541,"172.16.139.250",5440,12,1142,13894,0,0,12,1142,0,0,162.106429,0.00521800000001349,1750862,0
"172.16.133.118",58237,"216.219.120.244",443,6,366,13895,0,0,4,246,2,120,162.151848,0.18159299999999234,10837,5286
"172.16.133.34",50556,"78.108.118.250",443,6,366,13896,0,0,4,246,2,120,162.15786,0.21574200000000587,9122,4449
"172.16.133.34",50557,"216.219.118.244",443,6,366,13897,0,0,4,246,2,120,162.158631,0.20454699999999093,9621,4693
"172.16.133.41",53254,"172.16.139.250",5440,12,1142,13898,0,0,12,1142,0,0,162.161105,0.006292000000001963,1452002,0
"172.16.133.132",36693,"206.188.4.9",443,19,5833,13899,0,0,10,1723,9,4110,162.167288,0.22028399999999237,62573,149261
"172.16.133.42",57226,"172.16.139.250",5440,12,1142,13900,0,0,12,1142,0,0,162.209416,0.0064979999999934535,1405971,0
"172.16.133.85",52376,"172.16.139.250",5440,12,1142,13901,0,0,12,1142,0,0,162.225604,0.016300999999998567,560456,0
"172.16.133.43",57885,"172.16.139.250",5440,10,1022,13902,0,0,10,1022,0,0,162.23142,0.005548999999973603,1473418,0
"172.16.133.13",53140,"172.16.139.250",5440,10,1022,13903,0,0,10,1022,0,0,162.25038,0.014522999999996955,562969,0
"172.16.133.20",62514,"172.16.139.250",5440,12,1142,13904,0,0,12,1142,0,0,162.301969,0.014603999999991402,625582,0
"172.16.133.75",51079,"172.16.139.250",5440,10,1022,13905,0,0,10,1022,0,0,162.317049,0.005358000000001084,1525942,0
"172.16.133.28",49224,"172.16.139.250",5440,12,1142,13906,0,0,12,1142,0,0,162.329758,0.006114999999994097,1494031,0
"172.16.133.99",56169,"172.16.139.250",5440,12,1142,13907,0,0,12,1142,0,0,162.357813,0.014681999999993423,622258,0
"172.16.133.87",60337,"172.16.139.250",5440,10,1022,13908,0,0,10,1022,0,0,162.381953,0.005619999999993297,1454804,0
"172.16.133.35",50076,"172.16.139.250",5440,12,1142,13909,0,0,12,1142,0,0,162.388202,0.015782999999998992,578850,0
"172.16.133.116",53682,"172.16.139.250",5440,10,1022,13910,0,0,10,1022,0,0,162.402341,0.005651000000000295,1446823,0
"172.16.133.116",53683,"172.16.139.250",5440,12,1142,13911,0,0,12,1142,0,0,162.409542,0.006076000000007298,1503620,0
"172.16.133.116",53684,"172.16.139.250",5440,12,1142,13912,0,0,12,1142,0,0,162.416178,0.015160000000008722,602638,0
"172.16.133.84",58904,"172.16.139.250",5440,10,1022,13913,0,0,10,1022,0,0,162.416459,0.01788299999998344,457193,0
"172.16.133.163",3569,"66.235.139.153",80,9,3676,13914,0,0,5,2736,4,940,162.492863,8.208460000000002,2666,916
"172.16.133.49",55896,"172.16.139.250",5440,10,1022,13915,0,0,10,1022,0,0,162.492864,0.01621299999999337,504286,0
"172.16.133.163",3570,"15.201.8.73",443,238,198921,13916,0,0,84,10091,154,188830,162.507823,132.750257,608,11379
"172.16.133.95",57071,"172.16.139.250",5440,10,1022,13917,0,0,10,1022,0,0,162.533525,0.005811999999991713,1406744,0
"172.16.133.34",50558,"216.115.219.126",443,6,366,13918,0,0,4,246,2,120,162.555786,0.5269779999999855,3734,1821
"172.16.133.92",57784,"172.16.139.250",5440,12,1142,13919,0,0,12,1142,0,0,162.559934,0.015090000000014925,605434,0
"172.16.133.29",61069,"172.16.139.250",5440,10,1022,13920,0,0,10,1022,0,0,162.577617,0.005238999999988891,1560603,0
"172.16.133.44",64938,"172.16.139.250",5440,10,1022,13921,0,0,10,1022,0,0,162.584411,0.015598000000011325,524169,0
"172.16.133.207",56035,"172.16.139.250",5440,10,1022,13922,0,0,10,1022,0,0,162.61055,0.0061760000000106174,1323834,0
"172.16.133.83",57192,"172.16.139.250",5440,12,1142,13923,0,0,12,1142,0,0,162.619569,0.009478999999998905,963814,0
"172.16.133.93",60861,"172.16.139.250",5440,12,1142,13924,0,0,12,1142,0,0,162.63427,0.005017000000009375,1821008,0
"172.16.133.113",55662,"172.16.139.250",135,8,492,13925,0,0,8,492,0,0,162.64407,0.009090000000014697,433003,0
"172.16.133.11",55258,"172.16.139.250",5440,10,1022,13926,0,0,10,1022,0,0,162.651504,0.0058989999999994325,1385997,0
"172.16.133.55",57734,"172.16.139.250",5440,10,1022,13927,0,0,10,1022,0,0,162.656134,0.015560999999991054,525416,0
"172.16.133.113",55663,"172.16.139.250",5462,12,816,13928,0,0,12,816,0,0,162.661745,0.5082580000000121,12843,0
"172.16.133.73",60793,"172.16.139.250",5440,10,1022,13929,0,0,10,1022,0,0,162.678367,0.0053460000000029595,1529367,0
"172.16.133.53",54220,"172.16.139.250",5440,10,1022,13930,0,0,10,1022,0,0,162.681541,0.011464999999986958,713126,0
"172.16.133.21",53295,"172.16.139.250",5440,10,1022,13931,0,0,10,1022,0,0,162.685297,0.010823000000016236,755428,0
"172.16.133.30",62762,"172.16.139.250",5440,12,1142,13932,0,0,12,1142,0,0,162.68958,0.010890999999986661,838857,0
"172.16.133.18",50300,"174.129.20.55",443,26,9590,13933,0,0,13,2336,13,7254,162.694617,10.396998999999994,1797,5581
"172.16.133.25",63591,"172.16.139.250",5440,12,1142,13934,0,0,12,1142,0,0,162.695746,0.008598999999975376,1062449,0
"172.16.133.34",50559,"172.16.139.250",5440,12,1142,13935,0,0,12,1142,0,0,162.705706,0.0050160000000119,1821371,0
"172.16.133.97",59496,"172.16.139.250",5440,12,1142,13936,0,0,12,1142,0,0,162.715738,0.005557000000010248,1644052,0
"172.16.133.16",59357,"174.129.250.132",80,9,1638,13937,0,0,5,985,4,653,162.717248,0.15623699999997598,50436,33436
"172.16.133.118",58238,"216.115.220.254",443,6,366,13938,0,0,4,246,2,120,162.738841,0.47526600000000485,4140,2019
"172.16.133.16",59358,"208.92.52.90",80,10,1775,13939,0,0,5,965,5,810,162.75009,0.17506800000001022,44097,37014
"172.16.133.33",58006,"172.16.139.250",5440,12,1142,13940,0,0,12,1142,0,0,162.787513,0.0062819999999987886,1454313,0
"172.16.133.68",60862,"172.16.139.250",5440,12,1142,13941,0,0,12,1142,0,0,162.822222,0.006466999999986456,1412710,0
"172.16.133.12",59883,"172.16.139.250",5440,12,1142,13942,0,0,12,1142,0,0,162.835877,0.006295999999991864,1451080,0
"172.16.133.63",54001,"172.16.139.250",5440,10,1022,13943,0,0,10,1022,0,0,162.845022,0.00657699999999295,1243119,0
"172.16.133.66",54008,"172.16.139.250",5440,10,1022,13944,0,0,10,1022,0,0,162.858785,0.005509999999986803,1483847,0
"172.16.133.82",61520,"172.16.139.250",5440,10,1022,13945,0,0,10,1022,0,0,162.87359,0.005691999999982045,1436401,0
"172.16.133.37",60731,"172.16.139.250",5440,12,1142,13946,0,0,12,1142,0,0,162.885543,0.015670000000000073,583024,0
"172.16.133.118",58239,"202.173.27.250",443,6,366,13947,0,0,4,246,2,120,163.015123,0.6082120000000089,3235,1578
"172.16.133.78",59334,"172.16.139.250",5440,10,1022,13948,0,0,10,1022,0,0,163.041891,0.005859000000015158,1395459,0
"172.16.133.67",56101,"172.16.139.250",5440,10,1022,13949,0,0,10,1022,0,0,163.097119,0.005883000000011407,1389767,0
"172.16.133.56",61542,"172.16.139.250",5440,10,1022,13950,0,0,10,1022,0,0,163.119688,0.005128000000013344,1594383,0
"172.16.133.41",53255,"172.16.139.250",5440,10,1022,13951,0,0,10,1022,0,0,163.174865,0.014681999999993423,556872,0
"172.16.133.93",60862,"199.48.204.30",80,15,7083,13952,0,0,7,1106,8,5977,163.217549,4.336327000000011,2040,11026
"172.16.133.42",57227,"172.16.139.250",5440,12,1142,13953,0,0,12,1142,0,0,163.225018,0.010739999999998417,850651,0
"172.16.133.85",52377,"172.16.139.250",5440,10,1022,13954,0,0,10,1022,0,0,163.239405,0.0053039999999953125,1541478,0
"172.16.133.43",57886,"172.16.139.250",5440,10,1022,13955,0,0,10,1022,0,0,163.246548,0.005558000000007723,1471032,0
"172.16.133.13",53141,"172.16.139.250",5440,12,1142,13956,0,0,12,1142,0,0,163.264334,0.006987000000009402,1307571,0
"172.16.133.20",62515,"172.16.139.250",5440,12,1142,13957,0,0,12,1142,0,0,163.313623,0.0052069999999844185,1754561,0
"172.16.133.163",3571,"15.201.8.73",443,133,105975,13958,0,0,49,6212,84,99763,163.31925,131.938382,376,6049
"172.16.133.163",3572,"15.201.8.73",443,19,5668,13959,0,0,10,2396,9,3272,163.319946,131.938003,145,198
"172.16.133.75",51080,"172.16.139.250",5440,10,1022,13960,0,0,10,1022,0,0,163.329865,0.005237999999991416,1560901,0
"172.16.133.11",55259,"157.56.240.246",443,24,9683,13961,0,0,11,2947,13,6736,163.341104,1.816205999999994,12980,29670
"172.16.133.28",49225,"172.16.139.250",5440,10,1022,13962,0,0,10,1022,0,0,163.344853,0.005958999999990056,1372042,0
"172.16.133.99",56170,"172.16.139.250",5440,12,1142,13963,0,0,12,1142,0,0,163.370792,0.014560000000017226,627472,0
"172.16.133.163",3573,"15.201.8.73",443,186,150549,13964,0,0,69,9128,117,141421,163.371936,115.549439,631,9791
"172.16.133.163",3574,"15.201.8.73",443,17,4482,13965,0,0,9,2336,8,2146,163.373684,131.883838,141,130
"172.16.133.163",3575,"15.201.8.73",443,25,11476,13966,0,0,12,2500,13,8976,163.374446,131.88328099999998,151,544
"172.16.133.163",3576,"8.27.247.119",443,32,11061,13967,0,0,16,2798,16,8263,163.379806,70.16919999999999,319,942
"172.16.133.163",3577,"8.27.247.119",443,72,47859,13968,0,0,29,4106,43,43753,163.380185,70.168928,468,4988
"172.16.133.163",3578,"8.27.247.119",443,33,12517,13969,0,0,16,3263,17,9254,163.380415,70.168915,372,1055
"172.16.133.163",3579,"8.27.247.119",443,36,15546,13970,0,0,17,2899,19,12647,163.38298,70.16572099999999,330,1441
"172.16.133.87",60338,"172.16.139.250",5440,10,1022,13971,0,0,10,1022,0,0,163.395852,0.00522000000000844,1566283,0
"172.16.133.35",50077,"172.16.139.250",5440,12,1142,13972,0,0,12,1142,0,0,163.406258,0.017935999999991736,509366,0
"172.16.133.116",53685,"172.16.139.250",5440,12,1142,13973,0,0,12,1142,0,0,163.408534,0.015240000000005693,599475,0
"172.16.133.116",53686,"172.16.139.250",5440,12,1142,13974,0,0,12,1142,0,0,163.424779,0.005985000000009677,1526482,0
"172.16.133.84",58905,"172.16.139.250",5440,10,1022,13975,0,0,10,1022,0,0,163.430648,0.005530000000021573,1478481,0
"172.16.133.116",53687,"172.16.139.250",5440,12,1142,13976,0,0,12,1142,0,0,163.431616,0.00903500000001145,1011178,0
"172.16.133.49",55897,"172.16.139.250",5440,10,1022,13977,0,0,10,1022,0,0,163.506861,0.024022999999999683,340340,0
"172.16.133.93",60863,"168.215.63.101",80,9,1186,13978,0,0,5,771,4,415,163.540331,0.1429499999999848,43147,23224
"172.16.133.95",57072,"172.16.139.250",5440,12,1142,13979,0,0,12,1142,0,0,163.547365,0.015303999999986218,596968,0
"172.16.133.92",57785,"172.16.139.250",5440,10,1022,13980,0,0,10,1022,0,0,163.574505,0.01818300000002182,449650,0
"172.16.133.29",61070,"172.16.139.250",5440,10,1022,13981,0,0,10,1022,0,0,163.591955,0.005540999999993801,1475545,0
"172.16.133.44",64940,"172.16.139.250",5440,12,1142,13982,0,0,12,1142,0,0,163.601298,0.006228999999990492,1466688,0
"172.16.133.207",56036,"172.16.139.250",5440,12,1142,13983,0,0,12,1142,0,0,163.623588,0.005033999999994876,1814858,0
"172.16.133.83",57193,"172.16.139.250",5440,10,1022,13984,0,0,10,1022,0,0,163.63349,0.004648000000003094,"",""
"172.16.133.63",54002,"74.125.226.233",443,33,5531,13985,0,0,18,2787,15,2744,163.637993,136.198916,163,161
"172.16.133.93",60864,"172.16.139.250",5440,12,1142,13986,0,0,12,1142,0,0,163.648346,0.005100999999996247,1791021,0
"172.16.133.11",55260,"172.16.139.250",5440,10,1022,13987,0,0,10,1022,0,0,163.665209,0.005514000000005126,1482771,0
"172.16.133.55",57735,"172.16.139.250",5440,12,1142,13988,0,0,12,1142,0,0,163.670536,0.006718000000006441,1359928,0
"172.16.133.73",60794,"172.16.139.250",5440,12,1142,13989,0,0,12,1142,0,0,163.692143,0.005903000000017755,1547687,0
"172.16.133.53",54221,"172.16.139.250",5440,10,1022,13990,0,0,10,1022,0,0,163.696037,0.01753200000001698,466347,0
"172.16.133.21",53296,"172.16.139.250",5440,12,1142,13991,0,0,12,1142,0,0,163.699375,0.0060330000000021755,1514337,0
"172.16.133.30",62763,"172.16.139.250",5440,10,1022,13992,0,0,10,1022,0,0,163.703622,0.005939000000012129,1376662,0
"172.16.133.25",63592,"172.16.139.250",5440,10,1022,13993,0,0,10,1022,0,0,163.710039,0.007301000000012436,1119846,0
"172.16.133.34",50560,"172.16.139.250",5440,12,1142,13994,0,0,12,1142,0,0,163.719469,0.005161999999984346,1769856,0
"172.16.133.97",59497,"172.16.139.250",5440,10,1022,13995,0,0,10,1022,0,0,163.729513,0.01772500000001287,461269,0
"172.16.133.63",54003,"173.194.43.35",443,91,55853,13996,0,0,36,4305,55,51548,163.730793,135.536902,254,3042
"172.16.133.33",58007,"172.16.139.250",5440,10,1022,13997,0,0,10,1022,0,0,163.801228,0.019829999999984693,412304,0
"172.16.133.68",60863,"172.16.139.250",5440,12,1142,13998,0,0,12,1142,0,0,163.835505,0.015588999999977204,586054,0
"172.16.133.12",59884,"172.16.139.250",5440,12,1142,13999,0,0,12,1142,0,0,163.849786,0.006346000000007734,1439647,0
"172.16.133.63",54004,"172.16.139.250",5440,10,1022,14000,0,0,10,1022,0,0,163.859077,0.01571999999998752,520101,0
"172.16.133.66",54009,"172.16.139.250",5440,12,1142,14001,0,0,12,1142,0,0,163.871398,0.009470999999990681,964628,0
"172.16.133.82",61521,"172.16.139.250",5440,12,1142,14002,0,0,12,1142,0,0,163.885438,0.005495999999993728,1662299,0
"172.16.133.37",60732,"172.16.139.250",5440,10,1022,14003,0,0,10,1022,0,0,163.900958,0.0052299999999831925,1563288,0
"172.16.133.34",50561,"68.64.24.250",443,6,366,14004,0,0,4,246,2,120,163.987798,0.12987599999999588,15152,7391
"172.16.133.24",57704,"180.153.31.250",443,7,426,14005,0,0,5,306,2,120,164.01991,1.3210239999999942,1853,726
"172.16.133.78",59335,"172.16.139.250",5440,10,1022,14006,0,0,10,1022,0,0,164.055628,0.005559999999974252,1470503,0
"172.16.133.63",54005,"199.59.150.39",443,26,9188,14007,0,0,12,3785,14,5403,164.063912,30.863395000000025,981,1400
"172.16.133.163",3580,"23.33.87.130",443,49,31422,14008,0,0,20,2967,29,28455,164.071391,135.32682599999998,175,1682
"172.16.133.67",56102,"172.16.139.250",5440,10,1022,14009,0,0,10,1022,0,0,164.111435,0.005472999999994954,1493879,0
"172.16.133.56",61543,"172.16.139.250",5440,12,1142,14010,0,0,12,1142,0,0,164.134138,0.004806999999999562,"",""
"172.16.133.78",59336,"172.16.128.169",8014,15,5870,14011,0,0,8,3050,7,2820,164.162471,37.670293999999984,647,598
"172.16.133.163",3581,"8.27.247.119",443,25,8411,14012,0,0,12,1771,13,6640,164.168482,69.380414,204,765
"172.16.133.163",3582,"8.27.247.119",443,18,2431,14013,0,0,9,1423,9,1008,164.169008,69.37980000000002,164,116
"172.16.133.41",53256,"172.16.139.250",5440,10,1022,14014,0,0,10,1022,0,0,164.189039,0.01882100000000264,434408,0
"172.16.133.42",57228,"172.16.139.250",5440,12,1142,14015,0,0,12,1142,0,0,164.239741,0.011261999999987893,811223,0
"172.16.133.85",52378,"172.16.139.250",5440,10,1022,14016,0,0,10,1022,0,0,164.252094,0.020306000000005042,402639,0
"172.16.133.43",57887,"172.16.139.250",5440,10,1022,14017,0,0,10,1022,0,0,164.26022,0.0054609999999968295,1497161,0
"172.16.133.34",50562,"216.219.118.244",443,7,432,14018,0,0,5,312,2,120,164.265748,3.2193739999999877,775,298
"172.16.133.34",50563,"78.108.118.250",443,7,432,14019,0,0,5,312,2,120,164.274686,3.2036139999999875,779,299
"172.16.133.13",53142,"172.16.139.250",5440,12,1142,14020,0,0,12,1142,0,0,164.279505,0.009501999999997679,961481,0
"172.16.133.20",62516,"172.16.139.250",5440,12,1142,14021,0,0,12,1142,0,0,164.328306,0.004986000000002377,"",""
"172.16.133.75",51081,"172.16.139.250",5440,10,1022,14022,0,0,10,1022,0,0,164.344897,0.006205999999991718,1317434,0
"172.16.133.28",49226,"172.16.139.250",5440,10,1022,14023,0,0,10,1022,0,0,164.357608,0.0054340000000081545,1504600,0
"172.16.133.99",56171,"172.16.139.250",5440,12,1142,14024,0,0,12,1142,0,0,164.384711,0.006207999999986669,1471649,0
"172.16.133.87",60339,"172.16.139.250",5440,10,1022,14025,0,0,10,1022,0,0,164.409087,0.006003999999990128,1361758,0
"172.16.133.35",50078,"172.16.139.250",5440,12,1142,14026,0,0,12,1142,0,0,164.417674,0.027012999999982412,338207,0
"172.16.133.116",53688,"172.16.139.250",5440,10,1022,14027,0,0,10,1022,0,0,164.421497,0.004937000000012404,"",""
"172.16.133.116",53689,"172.16.139.250",5440,10,1022,14028,0,0,10,1022,0,0,164.427183,0.005450999999993655,1499908,0
"172.16.133.116",53690,"172.16.139.250",5440,10,1022,14029,0,0,10,1022,0,0,164.433404,0.015883999999999787,514731,0
"172.16.133.84",58906,"172.16.139.250",5440,10,1022,14030,0,0,10,1022,0,0,164.444685,0.008406000000007907,972638,0
"172.16.133.163",3583,"15.240.238.52",443,32,19919,14031,0,0,15,2930,17,16989,164.458127,0.962506000000019,24353,141206
"172.16.133.163",3584,"173.194.43.35",443,34,6874,14032,0,0,18,2725,16,4149,164.464209,114.44219100000001,190,290
"172.16.133.49",55898,"172.16.139.250",5440,10,1022,14033,0,0,10,1022,0,0,164.522069,0.005639999999999645,1449645,0
"172.16.133.95",57073,"172.16.139.250",5440,12,1142,14034,0,0,12,1142,0,0,164.56148,0.016178000000024895,564717,0
"172.16.133.92",57786,"172.16.139.250",5440,12,1142,14035,0,0,12,1142,0,0,164.587902,0.008931999999987283,1022839,0
"172.16.133.29",61071,"172.16.139.250",5440,10,1022,14036,0,0,10,1022,0,0,164.606717,0.005656999999985146,1445289,0
"172.16.133.44",64941,"172.16.139.250",5440,12,1142,14037,0,0,12,1142,0,0,164.612304,0.016124000000019123,566608,0
"172.16.133.207",56037,"172.16.139.250",5440,10,1022,14038,0,0,10,1022,0,0,164.637826,0.014697000000012395,556304,0
"172.16.133.83",57194,"172.16.139.250",5440,10,1022,14039,0,0,10,1022,0,0,164.646702,0.013630000000006248,599853,0
"172.16.133.93",60865,"172.16.139.250",5440,12,1142,14040,0,0,12,1142,0,0,164.661897,0.015696999999988748,582022,0
"172.16.133.233",51595,"184.73.225.104",80,76,19962,14041,0,0,43,2592,33,17370,164.662294,0.19295399999998608,107466,720171
"172.16.133.233",42283,"172.16.125.220",80,7,420,14042,0,0,4,240,3,180,164.665084,0.19323599999998464,9936,7452
"172.16.133.11",55261,"172.16.139.250",5440,10,1022,14043,0,0,10,1022,0,0,164.679743,0.005461999999994305,1496887,0
"172.16.133.55",57736,"172.16.139.250",5440,10,1022,14044,0,0,10,1022,0,0,164.683668,0.006251999999989266,1307741,0
"172.16.133.73",60795,"172.16.139.250",5440,12,1142,14045,0,0,12,1142,0,0,164.70665,0.01607899999999063,568194,0
"172.16.133.53",54222,"172.16.139.250",5440,10,1022,14046,0,0,10,1022,0,0,164.709686,0.005638000000004695,1450159,0
"172.16.133.21",53297,"172.16.139.250",5440,10,1022,14047,0,0,10,1022,0,0,164.712909,0.01703599999999028,479924,0
"172.16.133.30",62764,"172.16.139.250",5440,10,1022,14048,0,0,10,1022,0,0,164.717433,0.0085550000000012,955698,0
"172.16.133.25",63593,"172.16.139.250",5440,10,1022,14049,0,0,10,1022,0,0,164.724249,0.009408000000007632,869047,0
"172.16.133.34",50564,"172.16.139.250",5440,10,1022,14050,0,0,10,1022,0,0,164.73358,0.0049550000000238015,"",""
"172.16.133.97",59498,"172.16.139.250",5440,10,1022,14051,0,0,10,1022,0,0,164.74389,0.015388999999998987,531288,0
"172.16.133.33",58008,"172.16.139.250",5440,12,1142,14052,0,0,12,1142,0,0,164.815654,0.015949000000006208,572825,0
"172.16.133.34",50565,"216.115.219.126",443,6,366,14053,0,0,4,246,2,120,164.838836,0.5082230000000152,3872,1888
"172.16.133.68",60864,"172.16.139.250",5440,10,1022,14054,0,0,10,1022,0,0,164.850407,0.015652000000017097,522361,0
"172.16.133.12",59885,"172.16.139.250",5440,12,1142,14055,0,0,12,1142,0,0,164.863264,0.008672000000018443,1053505,0
"172.16.133.63",54006,"172.16.139.250",5440,10,1022,14056,0,0,10,1022,0,0,164.873489,0.0053539999999827614,1527082,0
"172.16.133.66",54010,"172.16.139.250",5440,10,1022,14057,0,0,10,1022,0,0,164.88609,0.005361999999990985,1524804,0
"172.16.133.82",61522,"172.16.139.250",5440,10,1022,14058,0,0,10,1022,0,0,164.900644,0.0156639999999868,521961,0
"172.16.133.37",60736,"172.16.139.250",5440,10,1022,14059,0,0,10,1022,0,0,164.914842,0.005871000000013282,1392607,0
"172.16.133.132",47116,"74.122.143.12",80,7,482,14060,0,0,4,272,3,210,165.029422,0.10239899999999125,21250,16406
"172.16.133.78",59337,"172.16.139.250",5440,12,1142,14061,0,0,12,1142,0,0,165.069665,0.006284000000022161,1453851,0
"172.16.133.67",56103,"172.16.139.250",5440,10,1022,14062,0,0,10,1022,0,0,165.125308,0.005594000000002097,1461565,0
"172.16.133.132",35808,"107.20.232.172",80,6,412,14063,0,0,4,272,2,140,165.135936,0.06557800000001635,33181,17078
"172.16.133.56",61544,"172.16.139.250",5440,10,1022,14064,0,0,10,1022,0,0,165.147378,0.005681000000009817,1439183,0
"172.16.133.11",55262,"157.56.238.6",443,18,8453,14065,0,0,8,1874,10,6579,165.195615,0.44826900000001046,33444,117411
"172.16.133.41",53257,"172.16.139.250",5440,10,1022,14066,0,0,10,1022,0,0,165.202831,0.005696999999997843,1435141,0
"172.16.133.30",62765,"157.56.237.150",443,22,11148,14067,0,0,9,2375,13,8773,165.206856,1.85745,10229,37785
"172.16.133.132",55041,"193.149.47.98",80,6,374,14068,0,0,4,254,2,120,165.207759,0.22835399999999595,8898,4203
"172.16.133.42",57229,"172.16.139.250",5440,12,1142,14069,0,0,12,1142,0,0,165.252406,0.026481999999987238,344989,0
"172.16.133.85",52379,"172.16.139.250",5440,10,1022,14070,0,0,10,1022,0,0,165.266345,0.018810000000001992,434662,0
"172.16.133.43",57888,"172.16.139.250",5440,10,1022,14071,0,0,10,1022,0,0,165.273623,0.007469000000014603,1094657,0
"172.16.133.13",53143,"172.16.139.250",5440,10,1022,14072,0,0,10,1022,0,0,165.293694,0.0053880000000106065,1517446,0
"172.16.133.54",64891,"96.43.146.176",443,18,3563,14073,0,0,10,2623,8,940,165.303881,115.94373999999999,180,64
"172.16.133.20",62517,"172.16.139.250",5440,12,1142,14074,0,0,12,1142,0,0,165.342644,0.00506999999998925,1801972,0
"172.16.133.75",51082,"172.16.139.250",5440,10,1022,14075,0,0,10,1022,0,0,165.35886,0.015061000000002878,542859,0
"172.16.133.28",49227,"172.16.139.250",5440,12,1142,14076,0,0,12,1142,0,0,165.371997,0.006369000000006508,1434448,0
"172.16.133.99",56172,"172.16.139.250",5440,10,1022,14077,0,0,10,1022,0,0,165.398618,0.014600999999998976,559961,0
"172.16.133.87",60340,"172.16.139.250",5440,12,1142,14078,0,0,12,1142,0,0,165.422675,0.020545999999995956,444660,0
"172.16.133.35",50079,"172.16.139.250",5440,12,1142,14079,0,0,12,1142,0,0,165.429691,0.05120300000001521,178427,0
"172.16.133.116",53691,"172.16.139.250",5440,10,1022,14080,0,0,10,1022,0,0,165.436467,0.010830999999996038,754870,0
"172.16.133.132",44767,"23.33.47.196",80,6,412,14081,0,0,4,272,2,140,165.446077,0.050218000000000984,43331,22302
"172.16.133.116",53692,"172.16.139.250",5440,12,1142,14082,0,0,12,1142,0,0,165.447771,0.008090000000009923,1129295,0
"172.16.133.116",53693,"172.16.139.250",5440,10,1022,14083,0,0,10,1022,0,0,165.456449,0.01529300000001399,534623,0
"172.16.133.84",58907,"172.16.139.250",5440,12,1142,14084,0,0,12,1142,0,0,165.458544,0.00624899999999684,1461993,0
"172.16.133.132",33372,"107.21.236.54",80,6,412,14085,0,0,4,272,2,140,165.526641,0.04734099999998875,45964,23658
"172.16.133.49",55899,"172.16.139.250",5440,12,1142,14086,0,0,12,1142,0,0,165.536012,0.006385999999992009,1430629,0
"172.16.133.95",57074,"172.16.139.250",5440,12,1142,14087,0,0,12,1142,0,0,165.575649,0.006391000000007807,1429510,0
"172.16.133.92",57787,"172.16.139.250",5440,10,1022,14088,0,0,10,1022,0,0,165.601725,0.005542000000019698,1475279,0
"172.16.133.163",3585,"63.140.58.150",443,32,16994,14089,0,0,19,10478,13,6516,165.603415,113.53439499999999,738,459
"172.16.133.29",61072,"172.16.139.250",5440,10,1022,14090,0,0,10,1022,0,0,165.623757,0.00574100000000044,1424142,0
"172.16.133.44",64942,"172.16.139.250",5440,10,1022,14091,0,0,10,1022,0,0,165.627578,0.015163000000001148,539207,0
"172.16.133.207",56038,"172.16.139.250",5440,12,1142,14092,0,0,12,1142,0,0,165.652001,0.017315999999993892,527604,0
"172.16.133.83",57195,"172.16.139.250",5440,12,1142,14093,0,0,12,1142,0,0,165.660593,0.004666999999983545,"",""
"172.16.133.93",60866,"172.16.139.250",5440,12,1142,14094,0,0,12,1142,0,0,165.676927,0.004968999999988455,"",""
"172.16.133.11",55263,"172.16.139.250",5440,10,1022,14095,0,0,10,1022,0,0,165.693301,0.005482000000000653,1491426,0
"172.16.133.55",57737,"172.16.139.250",5440,10,1022,14096,0,0,10,1022,0,0,165.698422,0.005579000000011547,1465495,0
"172.16.133.29",61073,"173.194.43.60",80,17,5432,14097,0,0,9,2844,8,2588,165.711193,96.12019899999999,236,215
"172.16.133.73",60796,"172.16.139.250",5440,10,1022,14098,0,0,10,1022,0,0,165.721672,0.015226999999981672,536940,0
"172.16.133.53",54223,"172.16.139.250",5440,12,1142,14099,0,0,12,1142,0,0,165.724994,0.02056699999999978,444206,0
"172.16.133.21",53298,"172.16.139.250",5440,10,1022,14100,0,0,10,1022,0,0,165.725883,0.02254499999997961,362652,0
"172.16.133.30",62766,"172.16.139.250",5440,10,1022,14101,0,0,10,1022,0,0,165.732569,0.008544000000000551,956928,0
"172.16.133.25",63594,"172.16.139.250",5440,12,1142,14102,0,0,12,1142,0,0,165.737712,0.014959000000004608,610736,0
"172.16.133.34",50566,"172.16.139.250",5440,10,1022,14103,0,0,10,1022,0,0,165.747908,0.008423999999990883,970560,0
"172.16.133.97",59499,"172.16.139.250",5440,10,1022,14104,0,0,10,1022,0,0,165.757969,0.005255000000005339,1555851,0
"172.16.133.29",61074,"23.0.49.244",80,6,372,14105,0,0,4,246,2,126,165.781141,15.31487100000001,128,65
"172.16.133.29",61075,"23.0.49.244",80,6,372,14106,0,0,4,246,2,126,165.781298,15.315652999999998,128,65
"172.16.133.29",61076,"208.111.161.254",80,92,76556,14107,0,0,31,4636,61,71920,165.782947,65.316336,567,8808
"172.16.133.33",58009,"172.16.139.250",5440,10,1022,14108,0,0,10,1022,0,0,165.829391,0.005514000000005126,1482771,0
"172.16.133.68",60865,"172.16.139.250",5440,10,1022,14109,0,0,10,1022,0,0,165.863411,0.015682999999995673,521328,0
"172.16.133.12",59886,"172.16.139.250",5440,10,1022,14110,0,0,10,1022,0,0,165.877722,0.005885000000006357,1389294,0
"172.16.133.63",54007,"172.16.139.250",5440,12,1142,14111,0,0,12,1142,0,0,165.886966,0.006011000000000877,1519880,0
"172.16.133.66",54011,"172.16.139.250",5440,10,1022,14112,0,0,10,1022,0,0,165.899835,0.005618999999995822,1455063,0
"172.16.133.82",61523,"172.16.139.250",5440,10,1022,14113,0,0,10,1022,0,0,165.913624,0.02150299999999561,380226,0
"172.16.133.37",60737,"172.16.139.250",5440,10,1022,14114,0,0,10,1022,0,0,165.927719,0.011743999999993093,696185,0
"172.16.133.29",61077,"138.108.6.20",80,5,318,14115,0,0,3,192,2,126,165.989981,13.222261000000003,116,76
"172.16.133.29",61078,"64.94.107.11",80,9,1761,14116,0,0,6,1298,3,463,165.997934,6.199774000000019,1674,597
"172.16.133.78",59338,"172.16.139.250",5440,10,1022,14117,0,0,10,1022,0,0,166.083853,0.015557999999998628,525517,0
"172.16.133.67",56104,"172.16.139.250",5440,10,1022,14118,0,0,10,1022,0,0,166.138344,0.005215000000021064,1567785,0
"172.16.133.56",61545,"172.16.139.250",5440,10,1022,14119,0,0,10,1022,0,0,166.161338,0.01480000000000814,552432,0
"172.16.133.41",53258,"172.16.139.250",5440,12,1142,14120,0,0,12,1142,0,0,166.216902,0.006279000000006363,1455008,0
"172.16.133.29",61079,"138.108.6.20",80,11,3011,14121,0,0,6,1881,5,1130,166.240263,17.495010000000008,860,516
"172.16.133.29",61080,"64.94.107.11",80,8,1609,14122,0,0,5,1146,3,463,166.248144,0.0886910000000114,103370,41762
"172.16.133.42",57230,"172.16.139.250",5440,12,1142,14123,0,0,12,1142,0,0,166.276167,0.032567000000000235,280529,0
"172.16.133.85",52380,"172.16.139.250",5440,10,1022,14124,0,0,10,1022,0,0,166.28075,0.005383999999992284,1518573,0
"172.16.133.43",57889,"172.16.139.250",5440,12,1142,14125,0,0,12,1142,0,0,166.289064,0.006243000000011989,1463399,0
"172.16.133.13",53144,"172.16.139.250",5440,10,1022,14126,0,0,10,1022,0,0,166.306476,0.014818999999988591,551724,0
"172.16.133.20",62518,"172.16.139.250",5440,10,1022,14127,0,0,10,1022,0,0,166.355733,0.014510000000001355,563473,0
"172.16.133.75",51083,"172.16.139.250",5440,10,1022,14128,0,0,10,1022,0,0,166.371924,0.0058569999999917854,1395936,0
"172.16.133.28",49229,"172.16.139.250",5440,12,1142,14129,0,0,12,1142,0,0,166.385871,0.006025999999991427,1516096,0
"172.16.133.99",56173,"172.16.139.250",5440,10,1022,14130,0,0,10,1022,0,0,166.413309,0.005112999999994372,1599061,0
"172.16.133.87",60341,"172.16.139.250",5440,10,1022,14131,0,0,10,1022,0,0,166.437743,0.005293999999992138,1544389,0
"172.16.133.35",50080,"172.16.139.250",5440,12,1142,14132,0,0,12,1142,0,0,166.443782,0.03597500000000764,253954,0
"172.16.133.116",53694,"172.16.139.250",5440,10,1022,14133,0,0,10,1022,0,0,166.450435,0.0057419999999979154,1423894,0
"172.16.133.116",53695,"172.16.139.250",5440,12,1142,14134,0,0,12,1142,0,0,166.457188,0.0077839999999866905,1173689,0
"172.16.133.116",53696,"172.16.139.250",5440,10,1022,14135,0,0,10,1022,0,0,166.465889,0.005227999999988242,1563886,0
"172.16.133.84",58908,"172.16.139.250",5440,12,1142,14136,0,0,12,1142,0,0,166.472746,0.016224999999991496,563081,0
"172.16.133.55",57738,"172.16.128.169",8014,11,1714,14137,0,0,7,1116,4,598,166.536833,10.196628000000004,875,469
"172.16.133.49",55900,"172.16.139.250",5440,12,1142,14138,0,0,12,1142,0,0,166.548993,0.005884000000008882,1552685,0
"172.16.133.95",57075,"172.16.139.250",5440,10,1022,14139,0,0,10,1022,0,0,166.589329,0.014649000000019896,558126,0
"172.16.133.92",57788,"172.16.139.250",5440,10,1022,14140,0,0,10,1022,0,0,166.615888,0.0057829999999796655,1413799,0
"172.16.133.29",61081,"172.16.139.250",5440,10,1022,14141,0,0,10,1022,0,0,166.635179,0.00643600000000788,1270354,0
"172.16.133.44",64943,"172.16.139.250",5440,10,1022,14142,0,0,10,1022,0,0,166.640224,0.005467000000010103,1495518,0
"172.16.133.207",56039,"172.16.139.250",5440,10,1022,14143,0,0,10,1022,0,0,166.665754,0.005188000000003967,1575944,0
"172.16.133.83",57196,"172.16.139.250",5440,12,1142,14144,0,0,12,1142,0,0,166.674641,0.014178999999984399,644333,0
"172.16.133.93",60867,"172.16.139.250",5440,10,1022,14145,0,0,10,1022,0,0,166.690289,0.0046859999999924185,"",""
"172.16.133.11",55264,"172.16.139.250",5440,12,1142,14146,0,0,12,1142,0,0,166.707345,0.006385999999992009,1430629,0
"172.16.133.55",57739,"172.16.139.250",5440,10,1022,14147,0,0,10,1022,0,0,166.711648,0.015139000000004899,540062,0
"172.16.133.73",60797,"172.16.139.250",5440,10,1022,14148,0,0,10,1022,0,0,166.734977,0.017287000000010266,472956,0
"172.16.133.53",54224,"172.16.139.250",5440,10,1022,14149,0,0,10,1022,0,0,166.739113,0.005268000000000939,1552012,0
"172.16.133.21",53299,"172.16.139.250",5440,10,1022,14150,0,0,10,1022,0,0,166.741076,0.007428000000004431,1100700,0
"172.16.133.30",62767,"172.16.139.250",5440,10,1022,14151,0,0,10,1022,0,0,166.745866,0.01593299999998976,513148,0
"172.16.133.25",63595,"172.16.139.250",5440,10,1022,14152,0,0,10,1022,0,0,166.752105,0.004718999999994367,"",""
"172.16.133.34",50567,"172.16.139.250",5440,10,1022,14153,0,0,10,1022,0,0,166.761598,0.01458500000001095,560575,0
"172.16.133.97",59500,"172.16.139.250",5440,12,1142,14154,0,0,12,1142,0,0,166.771823,0.016165000000000873,565171,0
"172.16.133.33",58010,"172.16.139.250",5440,10,1022,14155,0,0,10,1022,0,0,166.84323,0.005978999999996404,1367452,0
"172.16.133.68",60866,"172.16.139.250",5440,10,1022,14156,0,0,10,1022,0,0,166.877605,0.01558400000001825,524640,0
"172.16.133.12",59887,"172.16.139.250",5440,10,1022,14157,0,0,10,1022,0,0,166.891891,0.018688000000025795,437499,0
"172.16.133.63",54008,"172.16.139.250",5440,10,1022,14158,0,0,10,1022,0,0,166.901323,0.005380999999999858,1519420,0
"172.16.133.66",54012,"172.16.139.250",5440,10,1022,14159,0,0,10,1022,0,0,166.914349,0.005938000000014654,1376894,0
"172.16.133.82",61524,"172.16.139.250",5440,10,1022,14160,0,0,10,1022,0,0,166.92791,0.01530600000000959,534169,0
"172.16.133.37",60738,"172.16.139.250",5440,10,1022,14161,0,0,10,1022,0,0,166.942538,0.005726999999978943,1427623,0
"172.16.133.78",59339,"172.16.139.250",5440,12,1142,14162,0,0,12,1142,0,0,167.098106,0.006315000000000737,1446714,0
"172.16.133.67",56105,"172.16.139.250",5440,12,1142,14163,0,0,12,1142,0,0,167.152287,0.006031000000007225,1514839,0
"172.16.133.113",55664,"172.16.139.250",135,8,492,14164,0,0,8,492,0,0,167.173888,0.005683000000004768,692591,0
"172.16.133.56",61546,"172.16.139.250",5440,10,1022,14165,0,0,10,1022,0,0,167.176783,0.004899999999992133,"",""
"172.16.133.113",55665,"172.16.139.250",5462,10,696,14166,0,0,10,696,0,0,167.180446,0.5063780000000122,10995,0
"172.16.133.41",53259,"172.16.139.250",5440,10,1022,14167,0,0,10,1022,0,0,167.23085,0.005414000000001806,1510158,0
"172.16.133.42",57231,"172.16.139.250",5440,12,1142,14168,0,0,12,1142,0,0,167.282952,0.017166000000003123,532214,0
"172.16.133.85",52381,"172.16.139.250",5440,10,1022,14169,0,0,10,1022,0,0,167.294461,0.017955999999998085,455335,0
"172.16.133.43",57890,"172.16.139.250",5440,10,1022,14170,0,0,10,1022,0,0,167.301701,0.005574999999993224,1466547,0
"172.16.133.13",53145,"172.16.139.250",5440,12,1142,14171,0,0,12,1142,0,0,167.321561,0.006430999999992082,1420618,0
"172.16.133.20",62519,"172.16.139.250",5440,12,1142,14172,0,0,12,1142,0,0,167.370799,0.0051379999999880965,1778123,0
"172.16.133.75",51084,"172.16.139.250",5440,10,1022,14173,0,0,10,1022,0,0,167.38603,0.005406999999991058,1512113,0
"172.16.133.28",49230,"172.16.139.250",5440,10,1022,14174,0,0,10,1022,0,0,167.399779,0.014648999999991474,558126,0
"172.16.133.99",56174,"172.16.139.250",5440,10,1022,14175,0,0,10,1022,0,0,167.426781,0.014487000000002581,564368,0
"172.16.133.87",60342,"172.16.139.250",5440,12,1142,14176,0,0,12,1142,0,0,167.450917,0.005863000000005059,1558246,0
"172.16.133.35",50081,"172.16.139.250",5440,12,1142,14177,0,0,12,1142,0,0,167.458301,0.019670999999988226,464440,0
"172.16.133.116",53697,"172.16.139.250",5440,12,1142,14178,0,0,12,1142,0,0,167.463572,0.009027000000003227,1012074,0
"172.16.133.116",53698,"172.16.139.250",5440,10,1022,14179,0,0,10,1022,0,0,167.473567,0.004942999999997255,"",""
"172.16.133.116",53699,"172.16.139.250",5440,10,1022,14180,0,0,10,1022,0,0,167.479543,0.01610499999998183,507668,0
"172.16.133.84",58910,"172.16.139.250",5440,10,1022,14181,0,0,10,1022,0,0,167.486315,0.0055110000000127,1483578,0
"172.16.133.49",55901,"172.16.139.250",5440,10,1022,14182,0,0,10,1022,0,0,167.564442,0.015281999999984919,535008,0
"172.16.133.95",57076,"172.16.139.250",5440,10,1022,14183,0,0,10,1022,0,0,167.603575,0.00597099999998818,1369284,0
"172.16.133.92",57789,"172.16.139.250",5440,10,1022,14184,0,0,10,1022,0,0,167.630148,0.0055450000000121236,1474481,0
"172.16.133.29",61082,"172.16.139.250",5440,12,1142,14185,0,0,12,1142,0,0,167.648819,0.006477999999987105,1410311,0
"172.16.133.44",64944,"172.16.139.250",5440,10,1022,14186,0,0,10,1022,0,0,167.655164,0.005827999999979738,1402882,0
"172.16.133.207",56040,"172.16.139.250",5440,12,1142,14187,0,0,12,1142,0,0,167.678898,0.014624999999995225,624683,0
"172.16.133.83",57197,"172.16.139.250",5440,12,1142,14188,0,0,12,1142,0,0,167.688824,0.00838999999999146,1088915,0
"172.16.133.93",60868,"172.16.139.250",5440,10,1022,14189,0,0,10,1022,0,0,167.703906,0.014482000000015205,564562,0
"172.16.133.11",55265,"172.16.139.250",5440,10,1022,14190,0,0,10,1022,0,0,167.721599,0.0059870000000046275,1365625,0
"172.16.133.55",57740,"172.16.139.250",5440,10,1022,14191,0,0,10,1022,0,0,167.725643,0.014875000000017735,549647,0
"172.16.133.73",60798,"172.16.139.250",5440,10,1022,14192,0,0,10,1022,0,0,167.749606,0.01523599999998737,536623,0
"172.16.133.53",54225,"172.16.139.250",5440,12,1142,14193,0,0,12,1142,0,0,167.751677,0.0062910000000044874,1452233,0
"172.16.133.21",53300,"172.16.139.250",5440,10,1022,14194,0,0,10,1022,0,0,167.754162,0.006862999999981412,1191315,0
"172.16.133.30",62768,"172.16.139.250",5440,10,1022,14195,0,0,10,1022,0,0,167.759853,0.009162000000003445,892381,0
"172.16.133.25",63596,"172.16.139.250",5440,10,1022,14196,0,0,10,1022,0,0,167.766154,0.006394999999997708,1278498,0
"172.16.133.34",50568,"172.16.139.250",5440,12,1142,14197,0,0,12,1142,0,0,167.775785,0.0049849999999764805,"",""
"172.16.133.97",59501,"172.16.139.250",5440,12,1142,14198,0,0,12,1142,0,0,167.784566,0.006075999999978876,1503620,0
"172.16.133.33",58011,"172.16.139.250",5440,12,1142,14199,0,0,12,1142,0,0,167.857247,0.006378000000012207,1432423,0
"172.16.133.68",60867,"172.16.139.250",5440,10,1022,14200,0,0,10,1022,0,0,167.891438,0.01625699999999597,502921,0
"172.16.133.12",59888,"172.16.139.250",5440,12,1142,14201,0,0,12,1142,0,0,167.906115,0.006781999999986965,1347095,0
"172.16.133.63",54009,"172.16.139.250",5440,12,1142,14202,0,0,12,1142,0,0,167.915236,0.0060520000000110485,1509583,0
"172.16.133.66",54013,"172.16.139.250",5440,10,1022,14203,0,0,10,1022,0,0,167.927881,0.005354999999980237,1526797,0
"172.16.133.82",61525,"172.16.139.250",5440,10,1022,14204,0,0,10,1022,0,0,167.942839,0.00584299999999871,1399281,0
"172.16.133.37",60739,"172.16.139.250",5440,10,1022,14205,0,0,10,1022,0,0,167.956773,0.0156120000000044,523699,0
"172.16.133.78",59340,"172.16.139.250",5440,10,1022,14206,0,0,10,1022,0,0,168.1125,0.005558999999976777,1470768,0
"172.16.128.233",50915,"172.16.133.233",22,167,19584,14207,0,0,50,4180,117,15404,168.129588,8.02763299999998,4165,15350
"172.16.133.67",56106,"172.16.139.250",5440,10,1022,14208,0,0,10,1022,0,0,168.167274,0.005481000000003178,1491698,0
"172.16.133.56",61547,"172.16.139.250",5440,12,1142,14209,0,0,12,1142,0,0,168.189564,0.005358000000001084,1705113,0
"172.16.133.41",53260,"172.16.139.250",5440,12,1142,14210,0,0,12,1142,0,0,168.24498,0.016435999999998785,555853,0
"172.16.133.42",57232,"172.16.139.250",5440,12,1142,14211,0,0,12,1142,0,0,168.296688,0.01159300000000485,788061,0
"172.16.133.85",52382,"172.16.139.250",5440,10,1022,14212,0,0,10,1022,0,0,168.308761,0.005458000000004404,1497984,0
"172.16.133.43",57891,"172.16.139.250",5440,12,1142,14213,0,0,12,1142,0,0,168.315308,0.015351000000009662,595140,0
"172.16.133.13",53146,"172.16.139.250",5440,12,1142,14214,0,0,12,1142,0,0,168.335904,0.016687999999987824,547459,0
"172.16.133.126",61965,"138.108.6.20",80,8,1491,14215,0,0,4,833,4,658,168.381227,11.818117,563,445
"172.16.133.20",62520,"172.16.139.250",5440,12,1142,14216,0,0,12,1142,0,0,168.383749,0.005071000000015147,1801617,0
"172.16.133.75",51085,"172.16.139.250",5440,10,1022,14217,0,0,10,1022,0,0,168.400212,0.005403000000001157,1513233,0
"172.16.133.28",49231,"172.16.139.250",5440,10,1022,14218,0,0,10,1022,0,0,168.414092,0.005419999999986658,1508487,0
"172.16.133.99",56175,"172.16.139.250",5440,10,1022,14219,0,0,10,1022,0,0,168.440744,0.014857000000006337,550312,0
"172.16.133.87",60343,"172.16.139.250",5440,10,1022,14220,0,0,10,1022,0,0,168.4651,0.007487999999995054,1091880,0
"172.16.133.35",50082,"172.16.139.250",5440,12,1142,14221,0,0,12,1142,0,0,168.473891,0.01755899999997723,520302,0
"172.16.133.116",53700,"172.16.139.250",5440,10,1022,14222,0,0,10,1022,0,0,168.478926,0.005874000000005708,1391896,0
"172.16.133.116",53701,"172.16.139.250",5440,10,1022,14223,0,0,10,1022,0,0,168.485428,0.007122999999978674,1147830,0
"172.16.133.116",53702,"172.16.139.250",5440,10,1022,14224,0,0,10,1022,0,0,168.493161,0.016616000000027498,492055,0
"172.16.133.84",58911,"172.16.139.250",5440,10,1022,14225,0,0,10,1022,0,0,168.500709,0.005471000000000004,1494425,0
"172.16.133.49",55902,"172.16.139.250",5440,10,1022,14226,0,0,10,1022,0,0,168.577918,0.005567999999982476,1468390,0
"172.16.133.95",57077,"172.16.139.250",5440,10,1022,14227,0,0,10,1022,0,0,168.617764,0.00562400000001162,1453769,0
"172.16.133.92",57790,"172.16.139.250",5440,10,1022,14228,0,0,10,1022,0,0,168.643981,0.005966000000000804,1370432,0
"172.16.133.29",61083,"172.16.139.250",5440,10,1022,14229,0,0,10,1022,0,0,168.662041,0.016857000000015887,485021,0
"172.16.133.44",64945,"172.16.139.250",5440,10,1022,14230,0,0,10,1022,0,0,168.66866,0.006495000000001028,1258814,0
"172.16.133.207",56041,"172.16.139.250",5440,12,1142,14231,0,0,12,1142,0,0,168.693826,0.004988999999994803,"",""
"172.16.133.83",57198,"172.16.139.250",5440,12,1142,14232,0,0,12,1142,0,0,168.702992,0.005049000000013848,1809467,0
"172.16.133.93",60869,"172.16.139.250",5440,12,1142,14233,0,0,12,1142,0,0,168.718288,0.00494399999999473,"",""
"172.16.133.11",55266,"172.16.139.250",5440,12,1142,14234,0,0,12,1142,0,0,168.735739,0.0062819999999987886,1454313,0
"172.16.133.55",57741,"172.16.139.250",5440,10,1022,14235,0,0,10,1022,0,0,168.741103,0.006002999999992653,1361985,0
"172.16.133.73",60799,"172.16.139.250",5440,10,1022,14236,0,0,10,1022,0,0,168.762501,0.015383000000014135,531495,0
"172.16.133.53",54226,"172.16.139.250",5440,10,1022,14237,0,0,10,1022,0,0,168.766782,0.0053959999999904085,1515196,0
"172.16.133.21",53301,"172.16.139.250",5440,10,1022,14238,0,0,10,1022,0,0,168.767939,0.017748999999980697,460645,0
"172.16.133.30",62769,"172.16.139.250",5440,10,1022,14239,0,0,10,1022,0,0,168.77301,0.009028000000000702,905626,0
"172.16.133.25",63597,"172.16.139.250",5440,12,1142,14240,0,0,12,1142,0,0,168.778938,0.011471000000000231,796443,0
"172.16.133.34",50569,"172.16.139.250",5440,10,1022,14241,0,0,10,1022,0,0,168.791383,0.005053000000003749,1618048,0
"172.16.133.97",59502,"172.16.139.250",5440,12,1142,14242,0,0,12,1142,0,0,168.798656,0.005865999999997484,1557449,0
"172.16.133.33",58012,"172.16.139.250",5440,10,1022,14243,0,0,10,1022,0,0,168.871814,0.015290999999990618,534693,0
"172.16.133.68",60868,"172.16.139.250",5440,10,1022,14244,0,0,10,1022,0,0,168.908282,0.015008999999992056,544739,0
"172.16.133.12",59889,"172.16.139.250",5440,10,1022,14245,0,0,10,1022,0,0,168.920007,0.007163999999988846,1141261,0
"172.16.133.63",54011,"172.16.139.250",5440,10,1022,14246,0,0,10,1022,0,0,168.929277,0.005617000000000871,1455581,0
"172.16.133.66",54014,"172.16.139.250",5440,12,1142,14247,0,0,12,1142,0,0,168.942025,0.006162999999986596,1482394,0
"172.16.133.82",61526,"172.16.139.250",5440,10,1022,14248,0,0,10,1022,0,0,168.956682,0.01587900000001241,514893,0
"172.16.133.37",60740,"172.16.139.250",5440,10,1022,14249,0,0,10,1022,0,0,168.968866,0.007459000000011429,1096125,0
"172.16.133.39",64279,"174.129.24.9",443,239,234549,14250,0,0,79,8312,160,226237,169.048367,11.517392999999998,5773,157144
"172.16.133.78",59341,"172.16.139.250",5440,10,1022,14251,0,0,10,1022,0,0,169.126541,0.0055109999999842785,1483578,0
"172.16.133.67",56107,"172.16.139.250",5440,12,1142,14252,0,0,12,1142,0,0,169.180628,0.015987999999993008,571428,0
"172.16.133.56",61548,"172.16.139.250",5440,10,1022,14253,0,0,10,1022,0,0,169.203516,0.004940000000004829,"",""
"172.16.133.41",53261,"172.16.139.250",5440,12,1142,14254,0,0,12,1142,0,0,169.259069,0.016215999999985797,563394,0
"172.16.133.42",57233,"172.16.139.250",5440,12,1142,14255,0,0,12,1142,0,0,169.320014,0.012247999999999593,745917,0
"172.16.133.85",52383,"172.16.139.250",5440,10,1022,14256,0,0,10,1022,0,0,169.322717,0.015580999999997402,524741,0
"172.16.133.43",57892,"172.16.139.250",5440,10,1022,14257,0,0,10,1022,0,0,169.331146,0.014746000000002368,554455,0
"172.16.133.13",53148,"172.16.139.250",5440,10,1022,14258,0,0,10,1022,0,0,169.349517,0.005321000000009235,1536553,0
"172.16.133.20",62521,"172.16.139.250",5440,10,1022,14259,0,0,10,1022,0,0,169.398026,0.004753000000022212,"",""
"172.16.133.75",51086,"172.16.139.250",5440,10,1022,14260,0,0,10,1022,0,0,169.414356,0.0052540000000078635,1556147,0
"172.16.133.28",49232,"172.16.139.250",5440,10,1022,14261,0,0,10,1022,0,0,169.427877,0.005330000000014934,1533958,0
"172.16.133.99",56176,"172.16.139.250",5440,10,1022,14262,0,0,10,1022,0,0,169.455321,0.004919999999998481,"",""
"172.16.133.87",60344,"172.16.139.250",5440,10,1022,14263,0,0,10,1022,0,0,169.479513,0.015644000000008873,522628,0
"172.16.133.35",50083,"172.16.139.250",5440,12,1142,14264,0,0,12,1142,0,0,169.488229,0.07447799999999916,122667,0
"172.16.133.116",53703,"172.16.139.250",5440,10,1022,14265,0,0,10,1022,0,0,169.492403,0.008974999999992406,910974,0
"172.16.133.116",53704,"172.16.139.250",5440,10,1022,14266,0,0,10,1022,0,0,169.500061,0.007842000000010785,1042591,0
"172.16.133.116",53705,"172.16.139.250",5440,12,1142,14267,0,0,12,1142,0,0,169.508537,0.005344000000008009,1709580,0
"172.16.133.84",58912,"172.16.139.250",5440,10,1022,14268,0,0,10,1022,0,0,169.513819,0.015431999999975687,529808,0
"172.16.133.49",55903,"172.16.139.250",5440,12,1142,14269,0,0,12,1142,0,0,169.590957,0.015477000000004182,590295,0
"172.16.133.95",57078,"172.16.139.250",5440,10,1022,14270,0,0,10,1022,0,0,169.631589,0.005565000000018472,1469182,0
"172.16.133.42",57234,"172.16.139.250",5440,12,1136,14271,0,0,12,1136,0,0,169.63592,0.029980999999992264,303125,0
"172.16.133.92",57791,"172.16.139.250",5440,10,1022,14272,0,0,10,1022,0,0,169.657834,0.016476999999980535,496206,0
"172.16.133.29",61084,"172.16.139.250",5440,12,1142,14273,0,0,12,1142,0,0,169.675427,0.006087999999977001,1500657,0
"172.16.133.44",64946,"172.16.139.250",5440,10,1022,14274,0,0,10,1022,0,0,169.683404,0.005954000000002679,1373194,0
"172.16.133.116",53706,"23.0.49.244",80,12,2636,14275,0,0,6,799,6,1837,169.684701,90.09926099999998,70,163
"172.16.133.116",53707,"23.0.49.244",80,11,2553,14276,0,0,6,799,5,1754,169.685172,90.109928,70,155
"172.16.133.116",53708,"23.0.49.244",80,7,432,14277,0,0,4,246,3,186,169.685554,12.467209999999994,157,119
"172.16.133.207",56042,"172.16.139.250",5440,12,1142,14278,0,0,12,1142,0,0,169.707973,0.004815999999976839,"",""
"172.16.133.83",57199,"172.16.139.250",5440,10,1022,14279,0,0,10,1022,0,0,169.716809,0.004572999999993499,"",""
"172.16.133.93",60870,"172.16.139.250",5440,12,1142,14280,0,0,12,1142,0,0,169.733203,0.014519000000007054,629244,0
"172.16.133.11",55267,"172.16.139.250",5440,10,1022,14281,0,0,10,1022,0,0,169.749488,0.005554999999986876,1471827,0
"172.16.133.55",57742,"172.16.139.250",5440,10,1022,14282,0,0,10,1022,0,0,169.753839,0.005520999999987453,1480891,0
"172.16.133.73",60800,"172.16.139.250",5440,12,1142,14283,0,0,12,1142,0,0,169.77792,0.006205999999991718,1472123,0
"172.16.133.53",54227,"172.16.139.250",5440,10,1022,14284,0,0,10,1022,0,0,169.780862,0.016419999999982338,497929,0
"172.16.133.21",53302,"172.16.139.250",5440,12,1142,14285,0,0,12,1142,0,0,169.783121,0.018889999999998963,483642,0
"172.16.133.30",62770,"172.16.139.250",5440,10,1022,14286,0,0,10,1022,0,0,169.788119,0.005523000000010825,1480354,0
"172.16.133.25",63598,"172.16.139.250",5440,10,1022,14287,0,0,10,1022,0,0,169.797144,0.007944000000009055,1029204,0
"172.16.133.34",50570,"172.16.139.250",5440,10,1022,14288,0,0,10,1022,0,0,169.803818,0.005628000000001521,1452736,0
"172.16.133.97",59503,"172.16.139.250",5440,10,1022,14289,0,0,10,1022,0,0,169.812862,0.005406999999991058,1512113,0
"172.16.133.36",65086,"132.245.2.22",443,68,24535,14290,0,0,34,10135,34,14400,169.838351,120.99475999999999,670,952
"172.16.133.33",58013,"172.16.139.250",5440,10,1022,14291,0,0,10,1022,0,0,169.885453,0.005553999999989401,1472092,0
"172.16.133.42",57235,"64.4.11.25",80,8,1898,14292,0,0,5,1218,3,680,169.895279,0.6164160000000152,15807,8825
"172.16.133.68",60869,"172.16.139.250",5440,10,1022,14293,0,0,10,1022,0,0,169.919705,0.0055949999999995725,1461304,0
"172.16.133.12",59890,"172.16.139.250",5440,10,1022,14294,0,0,10,1022,0,0,169.933959,0.005356000000006134,1526512,0
"172.16.133.63",54012,"172.16.139.250",5440,10,1022,14295,0,0,10,1022,0,0,169.944079,0.005724000000014939,1428371,0
"172.16.133.66",54015,"172.16.139.250",5440,10,1022,14296,0,0,10,1022,0,0,169.956209,0.005430999999987307,1505431,0
"172.16.133.82",61527,"172.16.139.250",5440,10,1022,14297,0,0,10,1022,0,0,169.97074,0.006993999999991729,1169002,0
"172.16.133.37",60741,"172.16.139.250",5440,12,1142,14298,0,0,12,1142,0,0,169.98245,0.007453999999995631,1225650,0
"172.16.133.78",59342,"172.16.139.250",5440,10,1022,14299,0,0,10,1022,0,0,170.139878,0.005613999999980024,1456359,0
"172.16.133.67",56108,"172.16.139.250",5440,12,1142,14300,0,0,12,1142,0,0,170.194192,0.006202000000001817,1473073,0
"172.16.133.56",61549,"172.16.139.250",5440,10,1022,14301,0,0,10,1022,0,0,170.219951,0.004807999999997037,"",""
"172.16.133.41",53262,"172.16.139.250",5440,12,1142,14302,0,0,12,1142,0,0,170.272882,0.006154999999978372,1484321,0
"172.16.133.42",57236,"204.160.99.126",80,51,43066,14303,0,0,19,1526,32,41540,170.321048,8.99124900000001,1357,36960
"172.16.133.85",52384,"172.16.139.250",5440,10,1022,14304,0,0,10,1022,0,0,170.336545,0.017244000000005144,474135,0
"172.16.133.42",57237,"172.16.139.250",5440,12,1142,14305,0,0,12,1142,0,0,170.342443,0.013250999999996793,689457,0
"172.16.133.43",57893,"172.16.139.250",5440,12,1142,14306,0,0,12,1142,0,0,170.34341,0.015467999999998483,590638,0
"172.16.133.13",53149,"172.16.139.250",5440,10,1022,14307,0,0,10,1022,0,0,170.361954,0.005690000000015516,1436906,0
"172.16.133.20",62522,"172.16.139.250",5440,12,1142,14308,0,0,12,1142,0,0,170.411929,0.014540000000010878,628335,0
"172.16.133.75",51087,"172.16.139.250",5440,10,1022,14309,0,0,10,1022,0,0,170.428399,0.0060560000000009495,1350066,0
"172.16.133.28",49233,"172.16.139.250",5440,10,1022,14310,0,0,10,1022,0,0,170.440889,0.0057419999999979154,1423894,0
"172.16.133.99",56177,"172.16.139.250",5440,10,1022,14311,0,0,10,1022,0,0,170.468702,0.014693999999991547,556417,0
"172.16.133.87",60345,"172.16.139.250",5440,10,1022,14312,0,0,10,1022,0,0,170.493098,0.017977999999999383,454778,0
"172.16.133.35",50084,"172.16.139.250",5440,12,1142,14313,0,0,12,1142,0,0,170.500456,0.013945999999975811,655098,0
"172.16.133.116",53709,"172.16.139.250",5440,10,1022,14314,0,0,10,1022,0,0,170.505779,0.00903100000002155,905326,0
"172.16.133.116",53710,"172.16.139.250",5440,10,1022,14315,0,0,10,1022,0,0,170.515676,0.0053269999999940865,1534822,0
"172.16.133.116",53711,"172.16.139.250",5440,10,1022,14316,0,0,10,1022,0,0,170.521847,0.004868999999985135,"",""
"172.16.133.84",58913,"172.16.139.250",5440,10,1022,14317,0,0,10,1022,0,0,170.527644,0.0055339999999830525,1477412,0
"172.16.133.132",37310,"23.67.243.43",80,6,412,14318,0,0,4,272,2,140,170.590155,0.037866999999977224,57464,29577
"172.16.133.49",55904,"172.16.139.250",5440,10,1022,14319,0,0,10,1022,0,0,170.606145,0.0054189999999891825,1508765,0
"172.16.133.132",33121,"67.217.177.125",80,6,593,14320,0,0,4,266,2,327,170.637476,0.05819500000001199,36566,44952
"172.16.133.95",57079,"172.16.139.250",5440,10,1022,14321,0,0,10,1022,0,0,170.645895,0.005724000000014939,1428371,0
"172.16.133.92",57792,"172.16.139.250",5440,10,1022,14322,0,0,10,1022,0,0,170.672214,0.0062410000000170385,1310046,0
"172.16.133.29",61085,"172.16.139.250",5440,10,1022,14323,0,0,10,1022,0,0,170.689064,0.005629999999996471,1452220,0
"172.16.133.44",64947,"172.16.139.250",5440,10,1022,14324,0,0,10,1022,0,0,170.696676,0.014945000000011532,547072,0
"172.16.133.207",56043,"172.16.139.250",5440,12,1142,14325,0,0,12,1142,0,0,170.721098,0.014380999999985988,635282,0
"172.16.133.83",57200,"172.16.139.250",5440,12,1142,14326,0,0,12,1142,0,0,170.730858,0.00830499999997869,1100060,0
"172.16.133.93",60871,"172.16.139.250",5440,12,1142,14327,0,0,12,1142,0,0,170.747098,0.01481699999999364,616589,0
"172.16.133.11",55268,"172.16.139.250",5440,12,1142,14328,0,0,12,1142,0,0,170.767032,0.00563700000000722,1620720,0
"172.16.133.55",57743,"172.16.139.250",5440,10,1022,14329,0,0,10,1022,0,0,170.768001,0.008355999999992036,978458,0
"172.16.133.73",60801,"172.16.139.250",5440,10,1022,14330,0,0,10,1022,0,0,170.792869,0.005777999999992289,1415022,0
"172.16.133.53",54228,"172.16.139.250",5440,12,1142,14331,0,0,12,1142,0,0,170.793929,0.009309999999999263,981310,0
"172.16.133.21",53303,"172.16.139.250",5440,12,1142,14332,0,0,12,1142,0,0,170.79734,0.019472000000007483,469186,0
"172.16.133.30",62771,"172.16.139.250",5440,10,1022,14333,0,0,10,1022,0,0,170.800713,0.00561300000001097,1456618,0
"172.16.133.25",63599,"172.16.139.250",5440,12,1142,14334,0,0,12,1142,0,0,170.807273,0.0050849999999798,1796656,0
"172.16.133.34",50571,"172.16.139.250",5440,10,1022,14335,0,0,10,1022,0,0,170.817913,0.004953000000000429,"",""
"172.16.133.97",59504,"172.16.139.250",5440,10,1022,14336,0,0,10,1022,0,0,170.826694,0.005317999999988388,1537420,0
"172.16.133.33",58014,"172.16.139.250",5440,12,1142,14337,0,0,12,1142,0,0,170.899094,0.0063560000000109085,1437382,0
"172.16.133.68",60870,"172.16.139.250",5440,10,1022,14338,0,0,10,1022,0,0,170.933493,0.005642999999992071,1448874,0
"172.16.133.12",59891,"172.16.139.250",5440,10,1022,14339,0,0,10,1022,0,0,170.94718,0.006281000000001313,1301703,0
"172.16.133.63",54013,"172.16.139.250",5440,12,1142,14340,0,0,12,1142,0,0,170.957404,0.005398000000013781,1692478,0
"172.16.133.66",54016,"172.16.139.250",5440,10,1022,14341,0,0,10,1022,0,0,170.96979,0.0055499999999995,1473153,0
"172.16.133.82",61528,"172.16.139.250",5440,10,1022,14342,0,0,10,1022,0,0,170.983872,0.015693999999996322,520963,0
"172.16.133.37",60742,"172.16.139.250",5440,12,1142,14343,0,0,12,1142,0,0,170.997902,0.017190999999996848,531440,0
"172.16.133.78",59343,"172.16.139.250",5440,10,1022,14344,0,0,10,1022,0,0,171.153885,0.005614000000008446,1456359,0
"172.16.133.67",56109,"172.16.139.250",5440,12,1142,14345,0,0,12,1142,0,0,171.209544,0.006731999999999516,1357100,0
"172.16.133.56",61550,"172.16.139.250",5440,12,1142,14346,0,0,12,1142,0,0,171.230742,0.005031999999999925,1815580,0
"172.16.133.41",53263,"172.16.139.250",5440,10,1022,14347,0,0,10,1022,0,0,171.28717,0.0053959999999904085,1515196,0
"172.16.133.42",57238,"172.16.139.250",5440,12,1142,14348,0,0,12,1142,0,0,171.336358,0.011963000000008606,763688,0
"172.16.133.85",52385,"172.16.139.250",5440,10,1022,14349,0,0,10,1022,0,0,171.350762,0.00544999999999618,1500183,0
"172.16.128.169",1358,"172.16.139.250",21,8,505,14350,0,0,4,242,4,263,171.352481,0.28780100000000175,6726,7310
"172.16.133.43",57894,"172.16.139.250",5440,12,1142,14351,0,0,12,1142,0,0,171.357626,0.016037999999980457,569647,0
"172.16.133.13",53152,"172.16.139.250",5440,10,1022,14352,0,0,10,1022,0,0,171.376834,0.019397999999995363,421486,0
"172.16.133.20",62523,"172.16.139.250",5440,12,1142,14353,0,0,12,1142,0,0,171.425928,0.004880000000014206,"",""
"172.16.133.75",51088,"172.16.139.250",5440,10,1022,14354,0,0,10,1022,0,0,171.442325,0.00563900000000217,1449902,0
"172.16.133.28",49234,"172.16.139.250",5440,12,1142,14355,0,0,12,1142,0,0,171.455924,0.0161549999999977,565521,0
"172.16.133.99",56178,"172.16.139.250",5440,10,1022,14356,0,0,10,1022,0,0,171.48273,0.014728999999988446,555095,0
"172.16.133.87",60346,"172.16.139.250",5440,12,1142,14357,0,0,12,1142,0,0,171.508252,0.005403000000001157,1690912,0
"172.16.133.35",50085,"172.16.139.250",5440,12,1142,14358,0,0,12,1142,0,0,171.513859,0.009332000000000562,978996,0
"172.16.133.116",53712,"172.16.139.250",5440,10,1022,14359,0,0,10,1022,0,0,171.519446,0.006289000000009537,1300047,0
"172.16.133.116",53713,"172.16.139.250",5440,12,1142,14360,0,0,12,1142,0,0,171.526696,0.014343000000025086,636965,0
"172.16.133.84",58914,"172.16.139.250",5440,10,1022,14361,0,0,10,1022,0,0,171.541638,0.014528999999981806,562736,0
"172.16.133.116",53714,"172.16.139.250",5440,10,1022,14362,0,0,10,1022,0,0,171.541932,0.01806999999999448,452462,0
"172.16.133.49",55905,"172.16.139.250",5440,12,1142,14363,0,0,12,1142,0,0,171.620137,0.016410000000007585,556733,0
"172.16.133.95",57080,"172.16.139.250",5440,10,1022,14364,0,0,10,1022,0,0,171.658596,0.015895000000000437,514375,0
"172.16.133.92",57793,"172.16.139.250",5440,10,1022,14365,0,0,10,1022,0,0,171.687404,0.005530000000021573,1478481,0
"172.16.133.113",55666,"172.16.139.250",135,8,492,14366,0,0,8,492,0,0,171.702934,0.0025190000000065993,"",""
"172.16.133.29",61086,"172.16.139.250",5440,10,1022,14367,0,0,10,1022,0,0,171.703043,0.018220999999982723,448713,0
"172.16.133.113",55667,"172.16.139.250",5462,10,696,14368,0,0,10,696,0,0,171.706455,0.5086619999999868,10946,0
"172.16.133.44",64948,"172.16.139.250",5440,12,1142,14369,0,0,12,1142,0,0,171.710724,0.006290000000007012,1452464,0
"172.16.133.207",56044,"172.16.139.250",5440,12,1142,14370,0,0,12,1142,0,0,171.734876,0.015016999999971858,608377,0
"172.16.133.83",57201,"172.16.139.250",5440,12,1142,14371,0,0,12,1142,0,0,171.74483,0.008684999999985621,1051928,0
"172.16.133.93",60872,"172.16.139.250",5440,12,1142,14372,0,0,12,1142,0,0,171.760211,0.004964999999998554,"",""
"172.16.133.29",61087,"208.111.161.254",80,28,14861,14373,0,0,11,2355,17,12506,171.776718,39.315833,479,2544
"172.16.133.29",61088,"208.111.161.254",80,39,20954,14374,0,0,15,3527,24,17427,171.77741,59.32153199999999,475,2350
"172.16.133.11",55269,"172.16.139.250",5440,10,1022,14375,0,0,10,1022,0,0,171.777716,0.00565399999999272,1446055,0
"172.16.133.55",57744,"172.16.139.250",5440,12,1142,14376,0,0,12,1142,0,0,171.782165,0.015557000000001153,587259,0
"172.16.133.29",61089,"208.111.161.254",80,39,24149,14377,0,0,15,3502,24,20647,171.78532,59.313826999999975,472,2784
"172.16.133.29",61090,"208.111.161.254",80,23,11766,14378,0,0,9,1741,14,10025,171.785946,39.306488,354,2040
"172.16.133.73",60802,"172.16.139.250",5440,12,1142,14379,0,0,12,1142,0,0,171.804761,0.006241999999986092,1463633,0
"172.16.133.53",54229,"172.16.139.250",5440,10,1022,14380,0,0,10,1022,0,0,171.808825,0.015177999999991698,538674,0
"172.16.133.21",53304,"172.16.139.250",5440,10,1022,14381,0,0,10,1022,0,0,171.810259,0.018712999999991098,436915,0
"172.16.133.30",62772,"172.16.139.250",5440,10,1022,14382,0,0,10,1022,0,0,171.814637,0.005313999999998487,1538577,0
"172.16.133.25",63600,"172.16.139.250",5440,12,1142,14383,0,0,12,1142,0,0,171.822056,0.009781000000003814,934055,0
"172.16.133.34",50572,"172.16.139.250",5440,12,1142,14384,0,0,12,1142,0,0,171.831834,0.005145000000027267,1775704,0
"172.16.133.97",59505,"172.16.139.250",5440,12,1142,14385,0,0,12,1142,0,0,171.84051,0.015474000000011756,590409,0
"172.16.133.29",61091,"208.111.160.6",80,8,492,14386,0,0,4,246,4,246,171.841719,19.25558799999999,102,102
"172.16.133.29",61092,"208.111.160.6",80,8,492,14387,0,0,4,246,4,246,171.841984,19.25949700000001,102,102
"172.16.133.29",61093,"208.111.160.6",80,8,492,14388,0,0,4,246,4,246,171.842168,19.254092000000014,102,102
"172.16.133.29",61094,"208.111.160.6",80,8,492,14389,0,0,4,246,4,246,171.842321,19.25402600000001,102,102
"172.16.133.29",61095,"208.111.160.6",80,8,492,14390,0,0,4,246,4,246,171.842426,19.255689000000018,102,102
"172.16.133.29",61096,"208.111.160.6",80,8,492,14391,0,0,4,246,4,246,171.842553,19.254698999999988,102,102
"172.16.133.33",58015,"172.16.139.250",5440,10,1022,14392,0,0,10,1022,0,0,171.914602,0.015514999999993506,526973,0
"172.16.133.68",60871,"172.16.139.250",5440,10,1022,14393,0,0,10,1022,0,0,171.947868,0.0057099999999934425,1431873,0
"172.16.133.18",50301,"96.43.146.176",443,23,4217,14394,0,0,14,3139,9,1078,171.949004,116.10551900000002,216,74
"172.16.133.12",59892,"172.16.139.250",5440,10,1022,14395,0,0,10,1022,0,0,171.962074,0.0055110000000127,1483578,0
"172.16.133.63",54014,"172.16.139.250",5440,10,1022,14396,0,0,10,1022,0,0,171.971509,0.005378000000007432,1520267,0
"172.16.133.66",54017,"172.16.139.250",5440,10,1022,14397,0,0,10,1022,0,0,171.984242,0.005698999999992793,1434637,0
"172.16.133.82",61529,"172.16.139.250",5440,10,1022,14398,0,0,10,1022,0,0,171.998785,0.00553899999999885,1476078,0
"172.16.133.37",60743,"172.16.139.250",5440,12,1142,14399,0,0,12,1142,0,0,172.011747,0.00624899999999684,1461993,0
"172.16.133.84",58915,"64.90.204.229",443,17,2863,14400,0,0,8,1788,9,1075,172.129759,9.068039999999996,1577,948
"172.16.133.78",59344,"172.16.139.250",5440,12,1142,14401,0,0,12,1142,0,0,172.167988,0.006353999999987536,1437834,0
"172.16.133.67",56110,"172.16.139.250",5440,10,1022,14402,0,0,10,1022,0,0,172.222628,0.005621000000019194,1454545,0
"172.16.133.56",61551,"172.16.139.250",5440,10,1022,14403,0,0,10,1022,0,0,172.244573,0.005053000000003749,1618048,0
"172.16.133.41",53264,"172.16.139.250",5440,12,1142,14404,0,0,12,1142,0,0,172.300945,0.015581999999994878,586317,0
"172.16.133.42",57239,"172.16.139.250",5440,12,1142,14406,0,0,12,1142,0,0,172.359808,0.1610040000000197,56743,0
"172.16.133.85",52386,"172.16.139.250",5440,10,1022,14407,0,0,10,1022,0,0,172.364842,0.005459999999999354,1497435,0
"172.16.133.43",57895,"172.16.139.250",5440,10,1022,14408,0,0,10,1022,0,0,172.371678,0.005617000000000871,1455581,0
"172.16.133.13",53153,"172.16.139.250",5440,10,1022,14409,0,0,10,1022,0,0,172.389841,0.005385000000018181,1518291,0
"172.16.133.20",62524,"172.16.139.250",5440,12,1142,14410,0,0,12,1142,0,0,172.439987,0.004946999999987156,"",""
"172.16.133.75",51089,"172.16.139.250",5440,10,1022,14411,0,0,10,1022,0,0,172.456073,0.005777999999992289,1415022,0
"172.16.133.28",49235,"172.16.139.250",5440,10,1022,14412,0,0,10,1022,0,0,172.468934,0.0054300000000182536,1505709,0
"172.16.133.99",56179,"172.16.139.250",5440,12,1142,14413,0,0,12,1142,0,0,172.497116,0.014386999999999261,635017,0
"172.16.133.87",60347,"172.16.139.250",5440,10,1022,14414,0,0,10,1022,0,0,172.52162,0.015592999999995527,524337,0
"172.16.133.35",50086,"172.16.139.250",5440,12,1142,14415,0,0,12,1142,0,0,172.533431,0.012134000000003198,752925,0
"172.16.133.116",53715,"172.16.139.250",5440,10,1022,14416,0,0,10,1022,0,0,172.533681,0.015758000000005268,518847,0
"172.16.133.116",53716,"172.16.139.250",5440,10,1022,14417,0,0,10,1022,0,0,172.550428,0.004978999999991629,"",""
"172.16.133.66",54018,"199.30.80.32",80,8,504,14418,0,0,5,312,3,192,172.552579,14.647912999999988,170,104
"172.16.133.66",54019,"199.30.80.32",80,8,504,14419,0,0,5,312,3,192,172.553486,14.647072000000009,170,104
"172.16.133.66",54020,"199.30.80.32",80,14,2465,14420,0,0,8,1138,6,1327,172.553684,64.665877,140,164
"172.16.133.66",54021,"199.30.80.32",80,8,504,14421,0,0,5,312,3,192,172.553825,14.64666600000001,170,104
"172.16.133.66",54022,"199.30.80.32",80,8,504,14422,0,0,5,312,3,192,172.553977,14.64658,170,104
"172.16.133.66",54023,"199.30.80.32",80,8,504,14423,0,0,5,312,3,192,172.554124,14.644757999999996,170,104
"172.16.133.66",54024,"174.36.237.101",80,6,372,14424,0,0,4,246,2,126,172.554739,14.591960999999998,134,69
"172.16.133.66",54025,"174.36.237.101",80,6,372,14425,0,0,4,246,2,126,172.554909,14.592946999999981,134,69
"172.16.133.66",54026,"174.36.237.101",80,6,372,14426,0,0,4,246,2,126,172.555252,14.591447000000016,134,69
"172.16.133.84",58916,"172.16.139.250",5440,10,1022,14427,0,0,10,1022,0,0,172.555871,0.015973999999999933,511831,0
"172.16.133.116",53717,"172.16.139.250",5440,10,1022,14428,0,0,10,1022,0,0,172.556301,0.0055490000000020245,1473418,0
"172.16.133.66",54027,"68.67.159.235",80,30,16866,14429,0,0,15,9052,15,7814,172.590499,24.527941999999996,2952,2548
"172.16.133.66",54028,"68.67.159.235",80,13,3958,14430,0,0,7,2913,6,1045,172.591007,24.526427000000012,950,340
"172.16.133.66",54029,"68.67.159.235",80,7,432,14431,0,0,4,246,3,186,172.591949,14.546739000000002,135,102
"172.16.133.66",54030,"67.202.66.160",80,8,694,14432,0,0,5,306,3,388,172.59288,5.480284999999981,446,566
"172.16.133.66",54031,"67.202.66.160",80,8,694,14433,0,0,5,306,3,388,172.598376,5.474545000000006,447,566
"172.16.133.66",54032,"67.202.66.160",80,8,694,14434,0,0,5,306,3,388,172.598803,5.474254999999999,447,567
"172.16.133.66",54033,"174.36.244.134",80,7,432,14435,0,0,5,306,2,126,172.599492,14.837128000000007,164,67
"172.16.133.66",54034,"174.36.244.134",80,7,432,14436,0,0,5,306,2,126,172.599645,14.837029000000001,164,67
"172.16.133.66",54035,"174.36.244.134",80,7,432,14437,0,0,5,306,2,126,172.599784,14.83596399999999,165,67
"172.16.133.66",54036,"173.193.216.81",80,13,5244,14438,0,0,6,842,7,4402,172.599946,14.546892000000014,463,2420
"172.16.133.66",54037,"173.193.216.81",80,6,372,14439,0,0,4,246,2,126,172.600161,14.547695999999974,135,69
"172.16.133.66",54038,"173.193.216.81",80,13,5274,14440,0,0,6,842,7,4432,172.600713,14.54621899999998,463,2437
"172.16.133.66",54039,"173.193.216.81",80,13,4469,14441,0,0,6,842,7,3627,172.600981,14.549149,462,1994
"172.16.133.66",54040,"173.193.216.81",80,6,372,14442,0,0,4,246,2,126,172.601264,14.54577900000001,135,69
"172.16.133.66",54041,"173.193.216.81",80,13,5323,14443,0,0,6,842,7,4481,172.601403,14.550115000000005,462,2463
"172.16.133.66",54042,"216.52.121.178",80,8,492,14444,0,0,5,306,3,186,172.602091,14.829851999999988,165,100
"172.16.133.66",54043,"216.52.121.178",80,9,1295,14445,0,0,5,802,4,493,172.602273,5.674777000000006,1130,695
"172.16.133.66",54044,"216.52.121.178",80,8,492,14446,0,0,5,306,3,186,172.602478,14.83332200000001,165,100
"172.16.133.66",54045,"23.6.17.224",80,6,372,14447,0,0,4,246,2,126,172.602739,14.558271999999988,135,69
"172.16.133.66",54046,"23.6.17.224",80,7,432,14448,0,0,4,246,3,186,172.602957,14.572205999999994,135,102
"172.16.133.66",54047,"23.6.17.224",80,8,492,14449,0,0,5,306,3,186,172.603213,14.843259999999987,164,100
"172.16.133.66",54048,"23.6.17.224",80,11,2237,14450,0,0,6,1555,5,682,172.603385,2.926189999999991,4251,1864
"172.16.133.66",54049,"23.6.17.224",80,7,432,14451,0,0,5,306,2,126,172.603534,14.831362000000013,165,67
"172.16.133.66",54050,"23.6.17.224",80,7,432,14452,0,0,5,306,2,126,172.603686,14.832992999999988,165,67
"172.16.133.66",54051,"173.194.74.121",80,67,69468,14453,0,0,16,2946,51,66522,172.60473,92.97941900000004,253,5723
"172.16.133.66",54052,"173.252.110.27",80,15,2143,14454,0,0,8,1312,7,831,172.604982,124.52389699999998,84,53
"172.16.133.66",54053,"173.252.110.27",80,8,492,14455,0,0,5,306,3,186,172.605421,14.850333000000006,164,100
"172.16.133.66",54054,"173.252.110.27",80,8,492,14456,0,0,5,306,3,186,172.605606,14.839303000000001,164,100
"172.16.133.66",54055,"173.252.110.27",80,7,432,14457,0,0,4,246,3,186,172.605688,14.557885000000027,135,102
"172.16.133.66",54056,"173.252.110.27",80,8,492,14458,0,0,5,306,3,186,172.605811,14.829988000000014,165,100
"172.16.133.66",54057,"173.252.110.27",80,8,492,14459,0,0,5,306,3,186,172.605935,14.836556999999999,164,100
"172.16.133.66",54058,"173.252.110.27",443,352,255974,14460,0,0,103,33846,249,222128,172.606058,88.764961,3050,20019
"172.16.133.49",55906,"172.16.139.250",5440,12,1142,14461,0,0,12,1142,0,0,172.632302,0.006215999999994892,1469755,0
"172.16.133.95",57081,"172.16.139.250",5440,10,1022,14462,0,0,10,1022,0,0,172.67298,0.015884999999997262,514699,0
"172.16.133.92",57794,"172.16.139.250",5440,10,1022,14463,0,0,10,1022,0,0,172.701,0.0055299999999931515,1478481,0
"172.16.133.29",61097,"172.16.139.250",5440,10,1022,14464,0,0,10,1022,0,0,172.71734,0.015184000000004971,538461,0
"172.16.133.44",64949,"172.16.139.250",5440,10,1022,14465,0,0,10,1022,0,0,172.72555,0.015320000000002665,533681,0
"172.16.133.207",56045,"172.16.139.250",5440,12,1142,14466,0,0,12,1142,0,0,172.748979,0.0050290000000075,1816663,0
"172.16.133.83",57202,"172.16.139.250",5440,12,1142,14467,0,0,12,1142,0,0,172.758933,0.013921999999979562,656227,0
"172.16.133.93",60873,"172.16.139.250",5440,10,1022,14468,0,0,10,1022,0,0,172.775264,0.00566499999999337,1443248,0
"172.16.133.11",55270,"172.16.139.250",5440,10,1022,14469,0,0,10,1022,0,0,172.791682,0.005538000000001375,1476345,0
"172.16.133.55",57745,"172.16.139.250",5440,10,1022,14470,0,0,10,1022,0,0,172.79629,0.006201000000004342,1318497,0
"172.16.133.73",60803,"172.16.139.250",5440,10,1022,14471,0,0,10,1022,0,0,172.81882,0.0053000000000054115,1542641,0
"172.16.133.53",54230,"172.16.139.250",5440,10,1022,14472,0,0,10,1022,0,0,172.821819,0.006296999999989339,1298396,0
"172.16.133.21",53305,"172.16.139.250",5440,10,1022,14473,0,0,10,1022,0,0,172.825351,0.014773999999988519,553404,0
"172.16.133.30",62773,"172.16.139.250",5440,10,1022,14474,0,0,10,1022,0,0,172.828387,0.019351999999997815,422488,0
"172.16.133.25",63601,"172.16.139.250",5440,10,1022,14475,0,0,10,1022,0,0,172.836462,0.007348999999976513,1112532,0
"172.16.133.34",50573,"172.16.139.250",5440,10,1022,14476,0,0,10,1022,0,0,172.84589,0.00580200000001696,1409169,0
"172.16.133.97",59506,"172.16.139.250",5440,10,1022,14477,0,0,10,1022,0,0,172.854812,0.0055490000000020245,1473418,0
"172.16.133.33",58016,"172.16.139.250",5440,10,1022,14478,0,0,10,1022,0,0,172.92759,0.0055299999999931515,1478481,0
"172.16.133.68",60872,"172.16.139.250",5440,10,1022,14479,0,0,10,1022,0,0,172.961718,0.005685999999997193,1437917,0
"172.16.133.12",59893,"172.16.139.250",5440,12,1142,14480,0,0,12,1142,0,0,172.975118,0.006169999999997344,1480713,0
"172.16.133.63",54015,"172.16.139.250",5440,12,1142,14481,0,0,12,1142,0,0,172.985554,0.015400999999997111,593208,0
"172.16.133.66",54059,"173.194.74.191",80,59,51165,14482,0,0,21,6168,38,44997,172.997222,93.37613300000001,528,3855
"172.16.133.66",54060,"172.16.139.250",5440,10,1022,14483,0,0,10,1022,0,0,172.999937,0.0077070000000105665,1060853,0
"172.16.133.66",54061,"216.137.33.37",80,27,16152,14484,0,0,11,1507,16,14645,173.006775,124.11045200000001,97,943
"172.16.133.66",54062,"216.137.33.37",80,22,9806,14485,0,0,10,1471,12,8335,173.006978,124.11005999999998,94,537
"172.16.133.82",61530,"172.16.139.250",5440,10,1022,14486,0,0,10,1022,0,0,173.011555,0.0052690000000268356,1551717,0
"172.16.133.37",60744,"172.16.139.250",5440,10,1022,14487,0,0,10,1022,0,0,173.025239,0.006149999999990996,1329430,0
"172.16.133.66",54063,"173.194.74.191",80,36,23395,14488,0,0,16,5288,20,18107,173.041775,91.19727800000001,463,1588
"172.16.133.66",54064,"173.194.74.191",80,112,129224,14489,0,0,22,1771,90,127453,173.045019,90.30280000000002,156,11291
"172.16.133.66",54065,"50.97.242.226",80,11,4897,14490,0,0,6,1981,5,2916,173.045781,0.31055299999999875,51031,75117
"172.16.133.66",54066,"173.194.43.58",80,14,2016,14491,0,0,8,1329,6,687,173.049749,93.12282200000001,114,59
"172.16.133.78",59345,"172.16.139.250",5440,10,1022,14492,0,0,10,1022,0,0,173.182041,0.00572800000000484,1427374,0
"172.16.133.66",54067,"173.194.43.42",80,81,82864,14493,0,0,22,1801,59,81063,173.220507,90.16540600000002,159,7192
"172.16.133.66",54068,"173.194.43.44",80,41,38328,14494,0,0,12,1201,29,37127,173.220987,90.15587300000001,106,3294
"172.16.133.66",54069,"173.194.74.191",80,11,2224,14495,0,0,6,787,5,1437,173.225833,90.15177600000001,69,127
"172.16.133.66",54070,"23.33.95.139",80,13,1523,14496,0,0,7,894,6,629,173.227145,63.912837999999994,111,78
"172.16.133.67",56111,"172.16.139.250",5440,12,1142,14497,0,0,12,1142,0,0,173.236401,0.006194999999991069,1474737,0
"172.16.133.66",54071,"173.194.74.191",80,12,3123,14498,0,0,6,782,6,2341,173.240642,90.14634199999998,69,207
"172.16.133.66",54072,"173.194.74.191",80,12,2747,14499,0,0,6,792,6,1955,173.240807,90.15705599999998,70,173
"172.16.133.66",54073,"173.194.43.33",80,92,101404,14500,0,0,21,1752,71,99652,173.242343,90.20219500000002,155,8838
"172.16.133.66",54074,"173.194.43.33",80,12,3739,14501,0,0,6,838,6,2901,173.242527,90.11807900000002,74,257
"172.16.133.66",54075,"173.194.43.33",80,12,3251,14502,0,0,6,838,6,2413,173.242697,90.10417200000003,74,214
"172.16.133.66",54076,"173.194.43.33",80,12,3225,14503,0,0,6,831,6,2394,173.24284,90.121219,73,212
"172.16.133.66",54077,"173.194.43.33",80,12,3076,14504,0,0,6,871,6,2205,173.242991,90.12123700000004,77,195
"172.16.133.66",54078,"173.194.43.33",80,12,4184,14505,0,0,6,838,6,3346,173.249169,4.6250940000000185,1449,5787
"172.16.133.66",54079,"173.194.43.33",80,16,7214,14506,0,0,8,1445,8,5769,173.249339,90.130324,128,512
"172.16.133.66",54080,"173.194.43.33",80,75,81524,14507,0,0,17,1512,58,80012,173.249517,90.187197,134,7097
"172.16.133.66",54081,"173.194.43.33",80,11,2994,14508,0,0,6,833,5,2161,173.24968,4.625480999999979,1440,3737
"172.16.133.66",54082,"173.194.43.33",80,16,6343,14509,0,0,8,1439,8,4904,173.249896,90.14819099999997,127,435
"172.16.133.66",54083,"173.194.43.33",80,12,4000,14510,0,0,6,831,6,3169,173.250174,90.125595,73,281
"172.16.133.66",54084,"173.194.43.37",80,13,4153,14511,0,0,6,840,7,3313,173.251091,90.12472899999997,74,294
"172.16.133.66",54085,"173.194.43.37",80,12,3768,14512,0,0,6,867,6,2901,173.251346,90.11251899999996,76,257
"172.16.133.66",54086,"173.194.43.37",80,12,3820,14513,0,0,6,833,6,2987,173.251516,90.10809399999997,73,265
"172.16.133.66",54087,"216.137.33.241",80,15,1761,14514,0,0,8,966,7,795,173.251729,123.864284,62,51
"172.16.133.56",61552,"172.16.139.250",5440,12,1142,14515,0,0,12,1142,0,0,173.25884,0.004826000000008435,"",""
"172.16.133.66",54088,"173.194.43.33",80,68,71882,14516,0,0,16,1486,52,70396,173.264843,90.15855200000001,131,6246
"172.16.133.66",54089,"173.194.43.33",80,16,6883,14517,0,0,8,1425,8,5458,173.265037,90.133152,126,484
"172.16.133.66",54090,"173.194.43.33",80,12,3479,14518,0,0,6,833,6,2646,173.265534,90.11314199999998,73,234
"172.16.133.66",54091,"173.194.43.33",80,12,3399,14519,0,0,6,833,6,2566,173.265751,90.102857,73,227
"172.16.133.66",54092,"173.194.43.33",80,12,3739,14520,0,0,6,827,6,2912,173.265968,90.11066199999999,73,258
"172.16.133.66",54093,"173.194.43.33",80,14,6415,14521,0,0,6,830,8,5585,173.266186,90.11956700000002,73,495
"172.16.133.78",59346,"216.219.118.244",443,6,366,14522,0,0,4,246,2,120,173.269229,0.23297099999999205,8447,4120
"172.16.133.78",59347,"216.115.219.126",443,6,366,14523,0,0,4,246,2,120,173.270171,0.4989060000000052,3944,1924
"172.16.133.78",59348,"78.108.118.250",443,6,366,14524,0,0,4,246,2,120,173.271186,0.23266899999998714,8458,4126
"172.16.133.78",59349,"68.64.24.250",443,6,366,14525,0,0,4,246,2,120,173.271187,0.12161599999998884,16182,7893
"172.16.133.41",53265,"172.16.139.250",5440,12,1142,14526,0,0,12,1142,0,0,173.315224,0.016379000000000588,557787,0
"172.16.133.66",54094,"173.194.43.41",443,14,4046,14527,0,0,8,961,6,3085,173.341886,1.1635899999999992,6607,21210
"172.16.133.66",54095,"208.47.254.81",80,17,2745,14528,0,0,9,1769,8,976,173.34828,63.792282,221,122
"172.16.133.66",54096,"208.47.254.81",80,7,432,14529,0,0,4,246,3,186,173.348487,13.778104999999982,142,107
"172.16.133.66",54097,"208.47.254.81",80,7,432,14530,0,0,4,246,3,186,173.349011,13.777641000000017,142,108
"172.16.133.66",54098,"173.194.43.60",443,29,8327,14531,0,0,16,6706,13,1621,173.349621,82.92082399999998,646,156
"172.16.133.66",54099,"173.194.43.45",80,17,6242,14532,0,0,9,3141,8,3101,173.351804,93.58143000000004,268,265
"172.16.133.66",54100,"173.194.43.45",80,7,432,14533,0,0,4,246,3,186,173.351983,13.788367000000022,142,107
"172.16.133.66",54101,"173.194.43.45",80,7,432,14534,0,0,4,246,3,186,173.352122,13.788229999999999,142,107
"172.16.133.66",54102,"173.194.43.45",80,6,372,14535,0,0,4,246,2,126,173.352297,13.787046000000004,142,73
"172.16.133.42",57240,"172.16.139.250",5440,12,1142,14536,0,0,12,1142,0,0,173.370643,0.008379999999988286,1090214,0
"172.16.133.85",52387,"172.16.139.250",5440,10,1022,14537,0,0,10,1022,0,0,173.378251,0.005783000000008087,1413799,0
"172.16.133.43",57896,"172.16.139.250",5440,12,1142,14538,0,0,12,1142,0,0,173.384634,0.016580000000004702,551025,0
"172.16.133.66",54103,"23.33.91.120",443,16,3289,14539,0,0,8,919,8,2370,173.389273,21.140589000000006,347,896
"172.16.133.66",54104,"23.33.91.120",443,16,3289,14540,0,0,8,919,8,2370,173.389715,21.142241000000013,347,896
"172.16.133.66",54105,"23.33.91.120",443,18,4156,14541,0,0,10,1534,8,2622,173.39002,91.408976,134,229
"172.16.133.66",54106,"66.119.34.40",80,11,2256,14542,0,0,6,1521,5,735,173.390203,33.74388999999999,360,174
"172.16.133.66",54107,"66.119.34.40",80,6,372,14543,0,0,4,246,2,126,173.390329,13.749014999999986,143,73
"172.16.133.66",54108,"66.119.34.40",80,11,2256,14544,0,0,6,1521,5,735,173.390461,33.743532000000016,360,174
"172.16.133.66",54109,"64.208.138.101",80,11,1431,14545,0,0,6,701,5,730,173.390627,13.734983999999997,408,425
"172.16.133.66",54110,"64.208.138.101",80,7,432,14546,0,0,4,246,3,186,173.39075,13.735051999999996,143,108
"172.16.133.66",54111,"64.208.138.101",80,7,432,14547,0,0,4,246,3,186,173.390873,13.735037000000005,143,108
"172.16.133.66",54112,"208.78.169.230",80,9,1665,14548,0,0,5,903,4,762,173.393825,0.14273600000001352,50610,42708
"172.16.133.66",54113,"208.78.169.230",80,9,2137,14549,0,0,5,1170,4,967,173.393986,0.1560649999999839,59975,49569
"172.16.133.66",54114,"208.78.169.230",80,9,1803,14550,0,0,5,994,4,809,173.402692,0.13262299999999527,59959,48799
"172.16.133.13",53154,"172.16.139.250",5440,12,1142,14551,0,0,12,1142,0,0,173.404803,0.006215000000025839,1469991,0
"172.16.133.20",62525,"172.16.139.250",5440,12,1142,14552,0,0,12,1142,0,0,173.454029,0.0054110000000093805,1688412,0
"172.16.133.75",51090,"172.16.139.250",5440,10,1022,14553,0,0,10,1022,0,0,173.469747,0.0307719999999847,265696,0
"172.16.133.28",49237,"172.16.139.250",5440,10,1022,14554,0,0,10,1022,0,0,173.482861,0.0211829999999793,385969,0
"172.16.133.99",56180,"172.16.139.250",5440,12,1142,14555,0,0,12,1142,0,0,173.510937,0.06305799999998385,144882,0
"172.16.133.87",60348,"172.16.139.250",5440,10,1022,14556,0,0,10,1022,0,0,173.535429,0.031731000000007725,257666,0
"172.16.133.35",50087,"172.16.139.250",5440,12,1142,14557,0,0,12,1142,0,0,173.542687,0.283253000000002,32253,0
"172.16.133.66",54115,"23.33.82.110",443,16,3255,14558,0,0,8,891,8,2364,173.54511,20.98452900000001,339,901
"172.16.133.66",54116,"23.33.82.110",443,16,3255,14559,0,0,8,891,8,2364,173.54551,20.984250000000003,339,901
"172.16.133.66",54117,"23.45.65.25",80,7,432,14560,0,0,5,306,2,126,173.546844,13.907271000000009,176,72
"172.16.133.66",54118,"23.45.65.25",80,7,432,14561,0,0,5,306,2,126,173.547016,13.911549999999977,175,72
"172.16.133.116",53718,"172.16.139.250",5440,10,1022,14562,0,0,10,1022,0,0,173.549053,0.02103600000000938,388667,0
"172.16.133.84",58917,"172.16.139.250",5440,12,1142,14563,0,0,12,1142,0,0,173.569847,0.016079999999988104,568159,0
"172.16.133.116",53719,"172.16.139.250",5440,12,1142,14564,0,0,12,1142,0,0,173.571042,0.018387999999987414,496845,0
"172.16.133.25",63602,"74.125.170.42",80,1748,1884556,14565,0,0,518,33097,1230,1851459,173.582784,34.272013999999984,7725,432179
"172.16.133.116",53720,"172.16.139.250",5440,10,1022,14566,0,0,10,1022,0,0,173.590445,0.005560000000002674,1470503,0
"172.16.133.66",54119,"208.78.169.230",80,9,2017,14567,0,0,5,1209,4,808,173.599801,0.14471399999999335,66835,44667
"172.16.133.66",54120,"64.94.107.25",80,8,1764,14568,0,0,5,854,3,910,173.600258,0.08220900000000597,83105,88554
"172.16.133.66",54121,"64.94.107.25",80,8,1549,14569,0,0,5,1086,3,463,173.645152,0.06659700000000157,130456,55618
"172.16.133.49",55907,"172.16.139.250",5440,12,1142,14570,0,0,12,1142,0,0,173.647111,0.016959000000014157,538711,0
"172.16.133.66",54122,"23.21.72.43",80,17,4259,14571,0,0,9,2117,8,2142,173.652721,63.49025999999998,266,269
"172.16.133.66",54123,"64.94.107.25",80,8,1332,14572,0,0,5,869,3,463,173.672349,0.0705650000000162,98519,52490
"172.16.133.95",57082,"172.16.139.250",5440,12,1142,14573,0,0,12,1142,0,0,173.686853,0.006352999999990061,1438060,0
"172.16.133.66",54124,"174.35.22.39",80,28,12666,14574,0,0,12,4044,16,8622,173.697613,13.731851000000006,2355,5023
"172.16.133.92",57795,"172.16.139.250",5440,12,1142,14575,0,0,12,1142,0,0,173.713385,0.008215000000006967,1112111,0
"172.16.133.29",61098,"172.16.139.250",5440,10,1022,14576,0,0,10,1022,0,0,173.730997,0.0181519999999864,450418,0
"172.16.133.44",64950,"172.16.139.250",5440,12,1142,14577,0,0,12,1142,0,0,173.739616,0.00595799999999258,1533400,0
"172.16.133.207",56046,"172.16.139.250",5440,10,1022,14578,0,0,10,1022,0,0,173.763074,0.005125000000020918,1595317,0
"172.16.133.83",57203,"172.16.139.250",5440,12,1142,14579,0,0,12,1142,0,0,173.773035,0.004856000000017957,"",""
"172.16.133.93",60874,"172.16.139.250",5440,12,1142,14580,0,0,12,1142,0,0,173.789144,0.014601999999996451,625667,0
"172.16.133.11",55271,"172.16.139.250",5440,10,1022,14581,0,0,10,1022,0,0,173.806077,0.01592300000001501,513471,0
"172.16.133.55",57746,"172.16.139.250",5440,10,1022,14582,0,0,10,1022,0,0,173.812468,0.005579000000011547,1465495,0
"172.16.133.6",1726,"172.16.128.202",139,24,5972,14583,0,0,13,1831,11,4141,173.820315,1.032308999999998,14189,32091
"172.16.133.73",60804,"172.16.139.250",5440,12,1142,14584,0,0,12,1142,0,0,173.832902,0.016758000000010043,545172,0
"172.16.133.53",54231,"172.16.139.250",5440,12,1142,14585,0,0,12,1142,0,0,173.835883,0.006329999999991287,1443285,0
"172.16.133.21",53306,"172.16.139.250",5440,12,1142,14586,0,0,12,1142,0,0,173.83937,0.006996999999984155,1305702,0
"172.16.133.30",62775,"172.16.139.250",5440,10,1022,14587,0,0,10,1022,0,0,173.843568,0.015471999999988384,528438,0
"172.16.133.25",63603,"172.16.139.250",5440,12,1142,14588,0,0,12,1142,0,0,173.849146,0.005223999999998341,1748851,0
"172.16.133.34",50574,"172.16.139.250",5440,10,1022,14589,0,0,10,1022,0,0,173.857879,0.006142000000011194,1331162,0
"172.16.133.97",59507,"172.16.139.250",5440,12,1142,14590,0,0,12,1142,0,0,173.86878,0.006381000000004633,1431750,0
"172.16.133.66",54125,"64.94.107.25",80,8,1239,14591,0,0,5,776,3,463,173.902292,0.15071500000001947,41190,24576
"172.16.133.66",54126,"64.94.107.25",80,8,1239,14592,0,0,5,776,3,463,173.902414,0.11267599999999334,55096,32873
"172.16.133.66",54127,"64.94.107.25",80,8,1622,14593,0,0,5,1159,3,463,173.902515,0.5997460000000103,15459,6175
"172.16.133.66",54128,"173.194.43.34",80,7,432,14594,0,0,5,306,2,126,173.902656,13.527383999999984,180,74
"172.16.133.66",54129,"173.194.43.34",80,11,2349,14595,0,0,6,1661,5,688,173.902759,90.570627,146,60
"172.16.133.66",54130,"204.93.223.148",80,7,432,14596,0,0,4,246,3,186,173.904287,13.255849999999981,148,112
"172.16.133.66",54131,"204.93.223.148",80,7,432,14597,0,0,4,246,3,186,173.904392,13.255743999999993,148,112
"172.16.133.66",54132,"204.93.223.148",80,8,1562,14598,0,0,4,1151,4,411,173.904799,33.52200400000001,274,98
"172.16.133.66",54133,"216.137.33.109",80,7,432,14599,0,0,4,246,3,186,173.905668,13.23367300000001,148,112
"172.16.133.66",54134,"216.137.33.109",80,7,432,14600,0,0,4,246,3,186,173.905774,13.232528000000002,148,112
"172.16.133.66",54135,"216.137.33.109",80,6,372,14601,0,0,4,246,2,126,173.905878,13.232325000000003,148,76
"172.16.133.66",54136,"207.171.163.14",80,6,372,14602,0,0,4,246,2,126,173.90628,13.232071999999988,148,76
"172.16.133.66",54137,"207.171.163.14",80,6,372,14603,0,0,4,246,2,126,173.906565,13.228981000000005,148,76
"172.16.133.66",54138,"207.171.163.14",80,6,372,14604,0,0,4,246,2,126,173.906659,13.229739000000023,148,76
"172.16.133.66",54139,"207.171.163.14",80,6,372,14605,0,0,4,246,2,126,173.906748,13.22969900000001,148,76
"172.16.133.66",54140,"207.171.163.14",80,6,372,14606,0,0,4,246,2,126,173.906869,13.228477999999996,148,76
"172.16.133.66",54141,"207.171.163.14",80,6,372,14607,0,0,4,246,2,126,173.906965,13.227447999999981,148,76
"172.16.133.66",54142,"207.171.163.14",80,6,372,14608,0,0,4,246,2,126,173.907417,13.228982000000002,148,76
"172.16.133.66",54143,"207.171.163.14",80,6,372,14609,0,0,4,246,2,126,173.907532,13.228864999999985,148,76
"172.16.133.66",54144,"207.171.163.14",80,6,372,14610,0,0,4,246,2,126,173.907641,13.228855999999979,148,76
"172.16.133.66",54145,"207.171.163.14",80,6,372,14611,0,0,4,246,2,126,173.908599,13.237281999999993,148,76
"172.16.133.66",54146,"207.171.163.14",80,6,372,14612,0,0,4,246,2,126,173.909163,13.237819000000002,148,76
"172.16.133.66",54147,"207.171.163.14",80,6,372,14613,0,0,4,246,2,126,173.909265,13.236565999999982,148,76
"172.16.133.66",54148,"207.171.163.14",80,6,372,14614,0,0,4,246,2,126,173.909358,13.236422000000005,148,76
"172.16.133.66",54149,"207.171.163.14",80,6,372,14615,0,0,4,246,2,126,173.909475,13.236310000000003,148,76
"172.16.133.66",54150,"207.171.163.14",80,6,372,14616,0,0,4,246,2,126,173.909567,13.235311999999993,148,76
"172.16.133.66",54151,"207.171.163.14",80,6,372,14617,0,0,4,246,2,126,173.909658,13.236067999999989,148,76
"172.16.133.66",54152,"207.171.163.14",80,6,372,14618,0,0,4,246,2,126,173.909751,13.236131999999998,148,76
"172.16.128.202",2062,"172.16.133.6",139,24,5501,14619,0,0,13,1831,11,3670,173.922744,1.047048000000018,13989,28040
"172.16.133.33",58017,"172.16.139.250",5440,12,1142,14620,0,0,12,1142,0,0,173.941353,0.0077530000000081145,1178382,0
"172.16.133.66",54153,"207.171.163.14",80,6,372,14621,0,0,4,246,2,126,173.947316,13.199617999999987,149,76
"172.16.133.66",54154,"207.171.163.14",80,6,372,14622,0,0,4,246,2,126,173.947641,13.198144999999982,149,76
"172.16.133.66",54155,"207.171.163.14",80,6,372,14623,0,0,4,246,2,126,173.947756,13.199227000000008,149,76
"172.16.133.66",54156,"207.171.163.14",80,6,372,14624,0,0,4,246,2,126,173.947858,13.197867000000002,149,76
"172.16.133.66",54157,"72.21.214.200",80,6,372,14625,0,0,4,246,2,126,173.947946,13.188551999999987,149,76
"172.16.133.66",54158,"72.21.214.200",80,6,372,14626,0,0,4,246,2,126,173.948091,13.188456000000002,149,76
"172.16.133.66",54159,"72.21.214.200",80,6,372,14627,0,0,4,246,2,126,173.948188,13.188268000000022,149,76
"172.16.133.66",54160,"72.21.214.200",80,6,372,14628,0,0,4,246,2,126,173.948286,13.190066999999999,149,76
"172.16.133.66",54161,"108.162.205.83",80,20,5397,14629,0,0,8,1306,12,4091,173.948396,53.168251,196,615
"172.16.133.68",60873,"172.16.139.250",5440,10,1022,14630,0,0,10,1022,0,0,173.975681,0.0055569999999818265,1471297,0
"172.16.133.66",54162,"67.217.177.126",80,11,5415,14631,0,0,6,2287,5,3128,173.979251,0.26010299999998665,70341,96208
"172.16.133.12",59894,"172.16.139.250",5440,10,1022,14632,0,0,10,1022,0,0,173.989053,0.005545999999981177,1474215,0
"172.16.133.66",54163,"67.217.177.126",80,11,5433,14633,0,0,6,2287,5,3146,173.994538,0.2585559999999987,70762,97340
"172.16.133.66",54164,"208.78.169.230",80,9,1954,14634,0,0,5,1146,4,808,173.99952,0.14614800000001082,62730,44229
"172.16.133.63",54016,"172.16.139.250",5440,12,1142,14635,0,0,12,1142,0,0,173.999521,0.00655100000000175,1394596,0
"172.16.133.66",54165,"172.16.139.250",5440,12,1142,14636,0,0,12,1142,0,0,174.015161,0.006127999999989697,1490861,0
"172.16.133.82",61531,"172.16.139.250",5440,10,1022,14637,0,0,10,1022,0,0,174.026177,0.006042000000007874,1353194,0
"172.16.133.66",54166,"173.194.75.103",80,7,432,14638,0,0,5,306,2,126,174.032804,13.413719000000015,182,75
"172.16.133.66",54167,"173.194.75.103",80,7,432,14639,0,0,5,306,2,126,174.033066,13.413459000000017,182,75
"172.16.133.66",54168,"173.194.75.103",80,7,432,14640,0,0,5,306,2,126,174.033295,13.409255000000002,182,75
"172.16.133.66",54169,"173.194.75.103",80,7,432,14641,0,0,5,306,2,126,174.03355,13.403126000000015,182,75
"172.16.133.66",54170,"173.194.41.111",80,14,2946,14642,0,0,8,2150,6,796,174.035183,106.57992800000002,161,59
"172.16.133.66",54171,"173.194.41.111",80,6,372,14643,0,0,4,246,2,126,174.035429,13.157512999999994,149,76
"172.16.133.66",54172,"173.194.41.111",80,6,372,14644,0,0,4,246,2,126,174.035552,13.156508000000002,149,76
"172.16.133.66",54173,"67.217.177.187",80,10,3081,14645,0,0,6,2174,4,907,174.038278,0.10716899999999896,162285,67706
"172.16.133.37",60745,"172.16.139.250",5440,10,1022,14646,0,0,10,1022,0,0,174.038784,0.005404999999996107,1512673,0
"172.16.133.66",54174,"173.194.43.42",80,7,432,14647,0,0,5,306,2,126,174.076735,13.354293999999982,183,75
"172.16.133.66",54175,"173.194.43.42",80,7,432,14648,0,0,5,306,2,126,174.076738,13.351669999999984,183,75
"172.16.133.66",54176,"173.194.43.42",80,7,432,14649,0,0,5,306,2,126,174.076867,13.353271000000007,183,75
"172.16.133.66",54177,"173.194.43.43",80,58,51994,14650,0,0,17,4402,41,47592,174.093598,90.92799100000002,387,4187
"172.16.133.66",54178,"173.194.43.43",80,15,3299,14651,0,0,8,2011,7,1288,174.093713,90.65800399999998,177,113
"172.16.133.66",54179,"173.194.43.43",80,13,2645,14652,0,0,7,1884,6,761,174.093806,90.67446199999998,166,67
"172.16.133.66",54180,"173.194.43.43",80,7,432,14653,0,0,5,306,2,126,174.093904,13.337126999999981,183,75
"172.16.133.66",54181,"173.194.43.43",80,13,2585,14654,0,0,7,1857,6,728,174.093991,90.67810800000004,163,64
"172.16.133.66",54182,"173.194.74.191",80,7,432,14655,0,0,5,306,2,126,174.120817,13.317926,183,75
"172.16.133.66",54183,"204.11.51.34",80,9,2142,14656,0,0,5,888,4,1254,174.170663,0.13319500000000062,53335,75318
"172.16.133.78",59350,"172.16.139.250",5440,12,1142,14657,0,0,12,1142,0,0,174.19587,0.006319999999988113,1445569,0
"172.16.133.67",56112,"172.16.139.250",5440,12,1142,14658,0,0,12,1142,0,0,174.250902,0.006090000000000373,1500164,0
"172.16.133.56",61553,"172.16.139.250",5440,10,1022,14659,0,0,10,1022,0,0,174.272736,0.004756999999983691,"",""
"172.16.133.41",53266,"172.16.139.250",5440,12,1142,14660,0,0,12,1142,0,0,174.328294,0.016266999999999143,561627,0
"172.16.133.55",57747,"72.32.20.63",80,8,1554,14661,0,0,4,1022,4,532,174.354606,0.24225300000000516,33749,17568
"172.16.133.66",54184,"69.171.235.16",443,22,6900,14662,0,0,10,1247,12,5653,174.365997,70.22930300000002,142,643
"172.16.133.66",54185,"69.171.235.16",443,21,6586,14663,0,0,10,1241,11,5345,174.365998,70.23490900000002,141,608
"172.16.133.66",54186,"69.171.235.16",443,20,6526,14664,0,0,9,1181,11,5345,174.366136,70.23382799999999,134,608
"172.16.133.66",54187,"69.171.235.16",443,22,6900,14665,0,0,10,1247,12,5653,174.366292,70.230064,142,643
"172.16.133.66",54188,"173.252.110.27",443,19,1886,14666,0,0,9,1034,10,852,174.367911,120.15681999999998,68,56
"172.16.133.66",54189,"67.217.177.187",80,10,3151,14667,0,0,6,2244,4,907,174.380387,0.13631199999997534,131697,53230
"172.16.133.42",57241,"172.16.139.250",5440,12,1142,14668,0,0,12,1142,0,0,174.384744,0.011258999999995467,811439,0
"172.16.133.66",54190,"67.217.177.187",80,11,3211,14669,0,0,6,2244,5,967,174.385767,0.13342900000000668,134543,57978
"172.16.133.66",54191,"204.11.51.34",80,9,1513,14670,0,0,5,919,4,594,174.386387,0.17200699999997937,42742,27626
"172.16.133.85",52388,"172.16.139.250",5440,10,1022,14671,0,0,10,1022,0,0,174.392613,0.014822999999978492,551575,0
"172.16.133.66",54192,"31.13.74.10",443,18,1830,14672,0,0,8,978,10,852,174.395565,120.18688399999999,65,56
"172.16.133.66",54193,"23.67.243.58",443,16,2559,14673,0,0,8,894,8,1665,174.396739,20.137115999999992,355,661
"172.16.133.66",54194,"23.67.243.58",443,14,2364,14674,0,0,7,828,7,1536,174.396904,20.13704199999998,328,610
"172.16.133.66",54195,"23.67.243.58",443,14,2364,14675,0,0,7,828,7,1536,174.397048,20.136704999999978,328,610
"172.16.133.66",54196,"23.67.243.58",443,15,2499,14676,0,0,7,834,8,1665,174.397179,20.13648600000002,331,661
"172.16.133.66",54197,"31.13.77.42",443,20,2726,14677,0,0,10,1617,10,1109,174.397788,83.25075300000003,155,106
"172.16.133.66",54198,"23.67.243.19",443,15,2502,14678,0,0,7,837,8,1665,174.397789,20.134540000000015,332,661
"172.16.133.66",54199,"23.67.243.19",443,15,2502,14679,0,0,7,837,8,1665,174.39779,20.134653000000014,332,661
"172.16.133.66",54200,"23.67.243.19",443,14,2367,14680,0,0,7,831,7,1536,174.397919,20.135200999999995,330,610
"172.16.133.66",54201,"23.67.243.19",443,14,2367,14681,0,0,7,831,7,1536,174.398015,20.13480900000002,330,610
"172.16.133.66",54202,"23.67.243.19",443,14,2367,14682,0,0,7,831,7,1536,174.398121,20.13441900000001,330,610
"172.16.133.66",54203,"23.67.243.19",443,14,2367,14683,0,0,7,831,7,1536,174.398225,20.133926000000002,330,610
"172.16.133.66",54204,"23.67.242.80",443,15,2497,14684,0,0,7,832,8,1665,174.398348,20.134379999999993,330,661
"172.16.133.66",54205,"23.67.242.80",443,15,2497,14685,0,0,7,832,8,1665,174.398447,20.134190999999987,330,661
"172.16.133.66",54206,"23.67.242.80",443,14,2362,14686,0,0,7,826,7,1536,174.398547,20.135012999999987,328,610
"172.16.133.66",54207,"23.67.242.80",443,14,2362,14687,0,0,7,826,7,1536,174.398645,20.134766000000013,328,610
"172.16.133.66",54208,"23.67.242.80",443,14,2362,14688,0,0,7,826,7,1536,174.398743,20.134172000000007,328,610
"172.16.133.66",54209,"23.67.242.80",443,14,2362,14689,0,0,7,826,7,1536,174.398837,20.135838000000007,328,610
"172.16.133.43",57897,"172.16.139.250",5440,12,1142,14690,0,0,12,1142,0,0,174.399428,0.016410000000007585,556733,0
"172.16.133.66",54210,"31.13.73.26",443,21,2063,14691,0,0,10,1104,11,959,174.4068,120.22663400000002,73,63
"172.16.133.96",53177,"132.245.1.150",443,2,120,14692,0,0,1,60,1,60,174.415541,0.00018500000001608896,"",""
"172.16.133.96",53170,"132.245.1.134",443,2,120,14693,0,0,1,60,1,60,174.417038,0.0003120000000080836,"",""
"172.16.133.96",53147,"184.73.225.104",443,2,132,14694,0,0,1,66,1,66,174.41704,0.00031100000001060835,"",""
"172.16.133.96",53356,"157.56.236.102",443,146,84956,14695,0,0,71,44133,75,40823,174.417047,115.85974999999999,3047,2818
"172.16.133.13",53155,"172.16.139.250",5440,10,1022,14696,0,0,10,1022,0,0,174.417837,0.005752999999998565,1421171,0
"172.16.133.66",54211,"67.217.177.126",80,12,6033,14697,0,0,6,2248,6,3785,174.420625,0.29696500000000015,60559,101964
"172.16.133.66",54212,"64.94.107.25",80,8,1328,14698,0,0,5,865,3,463,174.420871,0.12169699999998329,56862,30436
"172.16.133.66",54213,"64.208.138.176",80,17,7870,14699,0,0,8,3641,9,4229,174.433898,12.724902000000014,2289,2658
"172.16.133.66",54214,"64.208.138.176",80,17,7875,14700,0,0,8,3646,9,4229,174.434051,12.72426999999999,2292,2658
"172.16.133.66",54215,"173.194.43.59",443,15,3816,14701,0,0,8,965,7,2851,174.440942,10.082486999999986,765,2262
"172.16.133.20",62526,"172.16.139.250",5440,10,1022,14702,0,0,10,1022,0,0,174.467962,0.0050510000000087985,1618689,0
"172.16.133.75",51091,"172.16.139.250",5440,10,1022,14703,0,0,10,1022,0,0,174.484253,0.04190099999999575,195126,0
"172.16.133.28",49238,"172.16.139.250",5440,10,1022,14704,0,0,10,1022,0,0,174.497778,0.03225899999998205,253448,0
"172.16.133.36",63680,"96.43.146.176",443,11,6007,14705,0,0,6,5357,5,650,174.523591,0.14675499999998465,292024,35433
"172.16.133.99",56181,"172.16.139.250",5440,12,1142,14706,0,0,12,1142,0,0,174.524904,0.00899599999999623,1015562,0
"172.16.133.82",61532,"64.56.203.22",443,36,23327,14707,0,0,17,6347,19,16980,174.539319,11.306927000000002,4490,12013
"172.16.133.87",60349,"172.16.139.250",5440,10,1022,14708,0,0,10,1022,0,0,174.548476,0.00565199999999777,1446567,0
"172.16.133.35",50088,"172.16.139.250",5440,12,1142,14709,0,0,12,1142,0,0,174.559412,0.04322299999998336,211368,0
"172.16.133.116",53721,"172.16.139.250",5440,10,1022,14710,0,0,10,1022,0,0,174.562536,0.00576699999999164,1417721,0
"172.16.133.116",53722,"172.16.139.250",5440,12,1142,14711,0,0,12,1142,0,0,174.56929,0.0058989999999994325,1548737,0
"172.16.133.116",53723,"172.16.139.250",5440,10,1022,14712,0,0,10,1022,0,0,174.575945,0.005817000000007511,1405535,0
"172.16.133.84",58918,"172.16.139.250",5440,12,1142,14713,0,0,12,1142,0,0,174.583768,0.01518200000001002,601765,0
"172.16.133.66",54216,"216.246.14.25",80,10,1958,14714,0,0,5,996,5,962,174.631927,0.20040099999999939,39760,38403
"172.16.133.66",54217,"216.246.14.25",80,10,1958,14715,0,0,5,996,5,962,174.6321,0.20848699999999099,38218,36913
"172.16.133.49",55908,"172.16.139.250",5440,10,1022,14716,0,0,10,1022,0,0,174.661028,0.006657000000018343,1228180,0
"172.16.133.66",54218,"67.217.177.187",80,10,3142,14717,0,0,6,2235,4,907,174.690176,0.09368599999999105,190850,77450
"172.16.133.95",57083,"172.16.139.250",5440,10,1022,14718,0,0,10,1022,0,0,174.701018,0.005417999999991707,1509043,0
"172.16.133.66",54219,"23.67.243.66",80,19,6298,14719,0,0,9,1914,10,4384,174.725949,42.390915999999976,361,827
"172.16.133.92",57796,"172.16.139.250",5440,10,1022,14720,0,0,10,1022,0,0,174.72791899999999,0.015501000000000431,527449,0
"172.16.133.29",61099,"172.16.139.250",5440,10,1022,14721,0,0,10,1022,0,0,174.74564,0.01736199999999144,470913,0
"172.16.133.44",64951,"172.16.139.250",5440,10,1022,14722,0,0,10,1022,0,0,174.75373,0.0055220000000133496,1480622,0
"172.16.133.6",1727,"172.16.128.202",139,22,3396,14723,0,0,12,1771,10,1625,174.761136,1.0007480000000157,14157,12990
"172.16.133.207",56047,"172.16.139.250",5440,12,1142,14724,0,0,12,1142,0,0,174.776996,0.004864999999995234,"",""
"172.16.133.66",54220,"67.217.177.126",80,10,2963,14725,0,0,6,2221,4,742,174.778513,0.08779400000000237,202382,67612
"172.16.133.83",57204,"172.16.139.250",5440,12,1142,14726,0,0,12,1142,0,0,174.787029,0.014961999999997033,610613,0
"172.16.133.82",61533,"204.93.223.146",443,15,3436,14727,0,0,7,2752,8,684,174.78775,35.70491800000002,616,153
"172.16.133.82",61534,"204.93.223.146",443,10,1002,14728,0,0,4,509,6,493,174.787839,31.256315,130,126
"172.16.133.82",61535,"216.137.33.109",443,20,7920,14729,0,0,9,1150,11,6770,174.788115,30.987014999999985,296,1747
"172.16.133.82",61536,"216.137.33.109",443,12,1314,14730,0,0,6,825,6,489,174.788117,30.98831100000001,212,126
"172.16.133.82",61537,"23.22.135.102",443,16,5734,14731,0,0,8,899,8,4835,174.788366,10.992593999999997,654,3518
"172.16.133.82",61538,"23.22.135.102",443,18,5913,14732,0,0,9,965,9,4948,174.788428,10.993325999999996,702,3600
"172.16.133.82",61539,"23.22.135.102",443,16,5734,14733,0,0,8,899,8,4835,174.788513,10.992545000000007,654,3518
"172.16.133.82",61540,"72.44.52.222",443,17,5853,14734,0,0,8,905,9,4948,174.788802,10.998235999999991,658,3599
"172.16.133.82",61541,"72.44.52.222",443,23,9247,14735,0,0,12,3451,11,5796,174.788851,10.998075,2510,4216
"172.16.133.82",61542,"72.44.52.222",443,17,5853,14736,0,0,8,905,9,4948,174.789273,10.997653999999983,658,3599
"172.16.133.82",61543,"216.137.33.1",443,27,9150,14737,0,0,13,2013,14,7137,174.789344,120.98028300000001,133,471
"172.16.133.82",61544,"64.208.138.113",443,29,14089,14738,0,0,14,6047,15,8042,174.78963,10.986334,4403,5856
"172.16.133.82",61545,"204.232.201.76",443,12,1339,14739,0,0,6,834,6,505,174.78969,11.035440999999992,604,366
"172.16.133.82",61546,"204.232.201.76",443,19,3606,14740,0,0,9,2032,10,1574,174.789802,11.034415999999993,1473,1141
"172.16.133.93",60875,"172.16.139.250",5440,10,1022,14741,0,0,10,1022,0,0,174.802135,0.004905000000007931,"",""
"172.16.133.66",54221,"67.217.177.126",80,10,2977,14742,0,0,6,2235,4,742,174.802213,0.09083499999999844,196840,65349
"172.16.133.11",55272,"172.16.139.250",5440,12,1142,14743,0,0,12,1142,0,0,174.819818,0.016403999999994312,556937,0
"172.16.133.55",57748,"172.16.139.250",5440,10,1022,14744,0,0,10,1022,0,0,174.824516,0.005540000000024747,1475812,0
"172.16.133.73",60805,"172.16.139.250",5440,12,1142,14745,0,0,12,1142,0,0,174.84737,0.006355999999982487,1437382,0
"172.16.133.53",54232,"172.16.139.250",5440,10,1022,14746,0,0,10,1022,0,0,174.848986,0.007852000000013959,1041263,0
"172.16.133.21",53307,"172.16.139.250",5440,12,1142,14747,0,0,12,1142,0,0,174.853249,0.008356999999989512,1093215,0
"172.16.133.30",62776,"172.16.139.250",5440,12,1142,14748,0,0,12,1142,0,0,174.857645,0.00742400000001453,1230603,0
"172.16.133.25",63604,"172.16.139.250",5440,12,1142,14749,0,0,12,1142,0,0,174.863092,0.007556999999991376,1208945,0
"172.16.133.34",50575,"172.16.139.250",5440,10,1022,14750,0,0,10,1022,0,0,174.871911,0.004905999999976984,"",""
"172.16.128.202",2063,"172.16.133.6",139,22,3396,14751,0,0,12,1771,10,1625,174.876043,0.9993669999999781,14176,13008
"172.16.133.97",59508,"172.16.139.250",5440,12,1142,14752,0,0,12,1142,0,0,174.883262,0.015481999999991558,590104,0
"172.16.133.41",53267,"199.204.31.123",80,12,3370,14753,0,0,7,2746,5,624,174.904043,0.22729899999998793,96648,21962
"172.16.133.33",58018,"172.16.139.250",5440,12,1142,14754,0,0,12,1142,0,0,174.956366,0.016727000000003045,546182,0
"172.16.133.66",54222,"64.94.107.25",80,8,1374,14755,0,0,5,911,3,463,174.981597,0.07728099999999927,94305,47928
"172.16.133.68",60874,"172.16.139.250",5440,12,1142,14756,0,0,12,1142,0,0,174.989886,0.006453999999990856,1415556,0
"172.16.133.12",59895,"172.16.139.250",5440,12,1142,14757,0,0,12,1142,0,0,175.003126,0.006418999999993957,1423274,0
"172.16.133.66",54223,"23.15.129.231",80,20,7535,14758,0,0,10,2012,10,5523,175.006839,72.11675499999998,223,612
"172.16.133.66",54224,"184.172.28.158",80,12,4875,14759,0,0,6,1264,6,3611,175.008229,0.23119800000000623,43737,124949
"172.16.133.66",54225,"108.170.194.161",80,14,7088,14760,0,0,7,4163,7,2925,175.012913,0.22519099999999526,147892,103911
"172.16.133.66",54226,"199.38.164.155",80,10,2060,14761,0,0,6,1356,4,704,175.013269,90.08968300000001,120,62
"172.16.133.63",54017,"172.16.139.250",5440,12,1142,14762,0,0,12,1142,0,0,175.013333,0.005842000000001235,1563847,0
"172.16.133.66",54227,"172.16.139.250",5440,10,1022,14763,0,0,10,1022,0,0,175.026162,0.005193999999988819,1574123,0
"172.16.133.82",61547,"172.16.139.250",5440,12,1142,14764,0,0,12,1142,0,0,175.039598,0.005917999999979884,1543764,0
"172.16.133.37",60746,"172.16.139.250",5440,10,1022,14765,0,0,10,1022,0,0,175.054274,0.005634000000014794,1451189,0
"172.16.133.96",53357,"173.194.43.53",443,89,37403,14766,0,0,44,22196,45,15207,175.074757,60.365633,2941,2015
"172.16.133.99",56182,"172.16.139.250",5440,12,1136,14767,0,0,12,1136,0,0,175.163397,0.004073000000005322,"",""
"172.16.133.66",54228,"216.246.14.25",80,9,2052,14768,0,0,5,1128,4,924,175.167317,0.41564500000001203,21710,17784
"172.16.133.66",54229,"67.217.177.126",80,11,3266,14769,0,0,6,2212,5,1054,175.181409,0.11160200000000486,158563,75554
"172.16.133.66",54230,"72.21.91.19",80,13,2599,14770,0,0,7,1421,6,1178,175.183855,11.94065900000001,952,789
"172.16.133.66",54231,"50.17.197.129",80,17,2207,14771,0,0,9,1580,8,627,175.194336,61.94834800000001,204,80
"172.16.133.66",54232,"108.168.142.94",80,37,34877,14772,0,0,11,1245,26,33632,175.196304,0.3209760000000017,31030,838243
"172.16.133.78",59351,"172.16.139.250",5440,10,1022,14773,0,0,10,1022,0,0,175.21019,0.005797000000001162,1410384,0
"172.16.133.66",54233,"108.170.196.142",80,8,698,14774,0,0,5,306,3,392,175.215674,11.960291999999981,204,262
"172.16.133.82",61548,"216.137.33.81",443,20,7920,14775,0,0,9,1150,11,6770,175.239728,30.536906999999985,301,1773
"172.16.133.82",61549,"216.137.33.81",443,20,7920,14776,0,0,9,1150,11,6770,175.239838,30.536412000000013,301,1773
"172.16.133.82",61550,"216.137.33.81",443,21,7980,14777,0,0,10,1210,11,6770,175.23997,30.53656799999999,316,1773
"172.16.133.82",61551,"64.56.203.22",443,20,8129,14778,0,0,11,3480,9,4649,175.240248,10.607324000000006,2624,3506
"172.16.133.82",61552,"64.56.203.22",443,16,4109,14779,0,0,9,3087,7,1022,175.240249,10.606180999999992,2328,770
"172.16.133.82",61553,"64.56.203.22",443,22,9943,14780,0,0,12,3610,10,6333,175.24039,10.607289000000009,2722,4776
"172.16.133.66",54234,"174.36.237.101",80,26,15362,14781,0,0,11,1153,15,14209,175.263556,12.17134200000001,757,9339
"172.16.133.67",56113,"172.16.139.250",5440,12,1142,14782,0,0,12,1142,0,0,175.264436,0.006262000000020862,1458958,0
"172.16.133.82",61554,"184.72.158.31",443,19,7612,14783,0,0,9,2259,10,5353,175.271997,10.515719999999988,1718,4072
"172.16.133.56",61554,"172.16.139.250",5440,10,1022,14784,0,0,10,1022,0,0,175.286719,0.005155999999999494,1585725,0
"172.16.133.78",59352,"68.64.24.250",443,6,366,14785,0,0,4,246,2,120,175.33349,0.10587199999997665,18588,9067
"172.16.133.41",53268,"172.16.139.250",5440,10,1022,14786,0,0,10,1022,0,0,175.342033,0.006606000000004997,1237662,0
"172.16.133.78",59353,"78.108.118.250",443,6,366,14787,0,0,4,246,2,120,175.396474,0.2042069999999967,9637,4701
"172.16.133.78",59354,"216.219.118.244",443,7,426,14788,0,0,4,246,3,180,175.396625,0.20675499999998692,9518,6964
"172.16.133.42",57242,"172.16.139.250",5440,12,1142,14789,0,0,12,1142,0,0,175.405107,0.014574000000010301,626869,0
"172.16.133.85",52389,"172.16.139.250",5440,10,1022,14790,0,0,10,1022,0,0,175.406672,0.005512000000010175,1483309,0
"172.16.133.43",57898,"172.16.139.250",5440,12,1142,14791,0,0,12,1142,0,0,175.413613,0.006945000000001755,1315478,0
"172.16.133.96",53358,"173.194.43.41",443,37,10498,14792,0,0,21,5124,16,5374,175.42519,33.427366000000006,1226,1286
"172.16.133.66",54235,"108.170.196.142",80,13,5223,14793,0,0,7,4013,6,1210,175.429329,0.25270399999999427,127041,38305
"172.16.133.13",53159,"172.16.139.250",5440,12,1142,14794,0,0,12,1142,0,0,175.431863,0.00613400000000297,1489403,0
"172.16.133.20",62527,"172.16.139.250",5440,12,1142,14795,0,0,12,1142,0,0,175.48199,0.004919999999998481,"",""
"172.16.133.75",51092,"172.16.139.250",5440,10,1022,14796,0,0,10,1022,0,0,175.497929,0.00547599999998738,1493060,0
"172.16.133.28",49239,"172.16.139.250",5440,10,1022,14797,0,0,10,1022,0,0,175.511332,0.005339999999989686,1531086,0
"172.16.133.78",59355,"216.115.219.126",443,6,366,14798,0,0,4,246,2,120,175.528509,0.5017579999999953,3922,1913
"172.16.133.99",56183,"172.16.139.250",5440,10,1022,14799,0,0,10,1022,0,0,175.539649,0.015101000000015574,541421,0
"172.16.133.87",60350,"172.16.139.250",5440,12,1142,14800,0,0,12,1142,0,0,175.562791,0.015959000000009382,572466,0
"172.16.133.35",50089,"172.16.139.250",5440,12,1142,14801,0,0,12,1142,0,0,175.569902,0.08811399999999026,103683,0
"172.16.133.116",53724,"172.16.139.250",5440,10,1022,14802,0,0,10,1022,0,0,175.57601,0.0064710000000047785,1263483,0
"172.16.133.116",53725,"172.16.139.250",5440,10,1022,14803,0,0,10,1022,0,0,175.583613,0.006218999999987318,1314680,0
"172.16.133.116",53726,"172.16.139.250",5440,10,1022,14804,0,0,10,1022,0,0,175.590753,0.005240999999983842,1560007,0
"172.16.133.84",58919,"172.16.139.250",5440,10,1022,14805,0,0,10,1022,0,0,175.597491,0.005102000000022144,1602508,0
"172.16.133.6",1728,"172.16.128.202",445,29,6365,14806,0,0,16,4469,13,1896,175.647524,2.005184999999983,17829,7564
"172.16.133.6",1729,"172.16.128.202",139,3,184,14807,0,0,2,122,1,62,175.647613,0.11478199999999106,8503,4321
"172.16.133.49",55909,"172.16.139.250",5440,10,1022,14808,0,0,10,1022,0,0,175.675082,0.005707000000001017,1432626,0
"172.16.133.132",47152,"173.194.43.57",80,7,478,14809,0,0,4,272,3,206,175.681348,0.06289899999998738,34595,26200
"172.16.133.95",57084,"172.16.139.250",5440,10,1022,14810,0,0,10,1022,0,0,175.714859,0.0146220000000028,559157,0
"172.16.133.30",62777,"68.64.4.249",443,6,366,14811,0,0,4,246,2,120,175.740461,0.09493799999998487,20729,10111
"172.16.133.30",62778,"216.219.116.244",443,6,366,14812,0,0,4,246,2,120,175.740786,0.22586099999998055,8713,4250
"172.16.133.30",62779,"68.64.26.250",443,6,366,14813,0,0,4,246,2,120,175.741652,0.0994010000000003,19798,9657
"172.16.133.30",62780,"216.115.216.250",443,6,366,14814,0,0,4,246,2,120,175.741723,0.08124499999999557,24223,11816
"172.16.133.92",57797,"172.16.139.250",5440,10,1022,14815,0,0,10,1022,0,0,175.741972,0.015392999999988888,531150,0
"172.16.133.132",54272,"23.33.95.139",80,6,412,14816,0,0,4,272,2,140,175.748055,0.07458800000000565,29173,15015
"172.16.133.29",61100,"172.16.139.250",5440,10,1022,14817,0,0,10,1022,0,0,175.759481,0.005548000000004549,1473684,0
"172.16.133.44",64952,"172.16.139.250",5440,12,1142,14818,0,0,12,1142,0,0,175.766031,0.015729999999990696,580801,0
"172.16.133.207",56048,"172.16.139.250",5440,12,1142,14819,0,0,12,1142,0,0,175.791233,0.004951000000005479,"",""
"172.16.133.83",57205,"172.16.139.250",5440,12,1142,14820,0,0,12,1142,0,0,175.80099,0.004574999999988449,"",""
"172.16.133.93",60876,"172.16.139.250",5440,10,1022,14821,0,0,10,1022,0,0,175.817301,0.004843000000022357,"",""
"172.16.133.132",59511,"76.13.234.33",80,6,374,14822,0,0,4,254,2,120,175.825262,0.061881999999997106,32836,15513
"172.16.133.11",55273,"172.16.139.250",5440,10,1022,14823,0,0,10,1022,0,0,175.832731,0.015895999999997912,514343,0
"172.16.133.55",57749,"172.16.139.250",5440,10,1022,14824,0,0,10,1022,0,0,175.838198,0.0058939999999836346,1387173,0
"172.16.133.73",60806,"172.16.139.250",5440,10,1022,14825,0,0,10,1022,0,0,175.860781,0.0056219999999882475,1454286,0
"172.16.133.53",54233,"172.16.139.250",5440,10,1022,14826,0,0,10,1022,0,0,175.864452,0.01519500000000562,538071,0
"172.16.133.21",53308,"172.16.139.250",5440,10,1022,14827,0,0,10,1022,0,0,175.866354,0.0056679999999857955,1442484,0
"172.16.133.30",62781,"172.16.139.250",5440,10,1022,14828,0,0,10,1022,0,0,175.871017,0.01680600000000254,486492,0
"172.16.133.25",63605,"172.16.139.250",5440,10,1022,14829,0,0,10,1022,0,0,175.878379,0.005678000000017391,1439943,0
"172.16.133.34",50576,"172.16.139.250",5440,10,1022,14830,0,0,10,1022,0,0,175.886382,0.006035999999994601,1354539,0
"172.16.133.97",59509,"172.16.139.250",5440,10,1022,14831,0,0,10,1022,0,0,175.897885,0.00544999999999618,1500183,0
"172.16.133.132",35542,"63.135.90.139",80,6,374,14832,0,0,4,254,2,120,175.923754,0.05271799999999871,38544,18210
"172.16.133.33",58019,"172.16.139.250",5440,10,1022,14833,0,0,10,1022,0,0,175.970325,0.005808999999999287,1407471,0
"172.16.133.132",35391,"74.119.118.94",80,7,482,14834,0,0,4,272,3,210,175.980368,0.044176999999990585,49256,38028
"172.16.133.68",60875,"172.16.139.250",5440,12,1142,14835,0,0,12,1142,0,0,176.003851,0.006427999999999656,1421281,0
"172.16.133.12",59896,"172.16.139.250",5440,12,1142,14836,0,0,12,1142,0,0,176.017205,0.0054570000000069285,1674179,0
"172.16.133.63",54018,"172.16.139.250",5440,10,1022,14837,0,0,10,1022,0,0,176.027912,0.0053650000000118325,1523951,0
"172.16.133.66",54236,"208.43.249.2",80,21,10511,14838,0,0,10,1803,11,8708,176.035652,31.098540000000014,463,2240
"172.16.133.66",54237,"172.16.139.250",5440,10,1022,14839,0,0,10,1022,0,0,176.039579,0.0059679999999957545,1369973,0
"172.16.133.66",54238,"199.59.150.43",443,31,7767,14840,0,0,11,2176,20,5591,176.050979,83.880099,207,533
"172.16.133.82",61555,"172.16.139.250",5440,12,1142,14841,0,0,12,1142,0,0,176.05466,0.01942899999997394,470224,0
"172.16.133.132",41456,"216.38.162.167",80,7,482,14842,0,0,4,272,3,210,176.058581,0.14147099999999568,15381,11875
"172.16.133.37",60747,"172.16.139.250",5440,10,1022,14843,0,0,10,1022,0,0,176.066696,0.008127999999999247,1005905,0
"172.16.133.82",61556,"204.232.250.57",443,17,4774,14844,0,0,10,3794,7,980,176.070898,9.709844000000004,3125,807
"172.16.133.45",61374,"209.99.98.33",80,126,125940,14845,0,0,33,4959,93,120981,176.084834,11.771449999999987,3370,82219
"172.16.133.66",54239,"23.6.17.224",80,6,372,14846,0,0,4,246,2,126,176.085779,11.05067600000001,178,91
"172.16.133.66",54240,"23.6.17.224",80,13,2476,14847,0,0,7,1629,6,847,176.08595,61.05623,213,110
"172.16.133.66",54241,"23.6.17.224",80,19,3635,14848,0,0,10,2279,9,1356,176.086643,101.04428299999998,180,107
"172.16.133.66",54242,"23.6.17.224",80,6,372,14849,0,0,4,246,2,126,176.086807,11.07338900000002,177,91
"172.16.133.132",39785,"64.94.107.30",80,7,436,14850,0,0,4,254,3,182,176.204324,0.03506199999998216,57954,41526
"172.16.133.113",55668,"172.16.139.250",135,8,492,14851,0,0,8,492,0,0,176.216786,0.013147999999972626,299361,0
"172.16.133.78",59356,"172.16.139.250",5440,10,1022,14852,0,0,10,1022,0,0,176.223814,0.06657899999999017,122801,0
"172.16.133.113",55669,"172.16.139.250",5462,12,816,14853,0,0,12,816,0,0,176.230762,0.5186700000000144,12586,0
"172.16.133.132",60835,"173.194.43.58",80,6,412,14854,0,0,4,272,2,140,176.252652,0.05379099999998971,40452,20821
"172.16.133.67",56114,"172.16.139.250",5440,12,1142,14855,0,0,12,1142,0,0,176.278753,0.016035000000016453,569753,0
"172.16.133.56",61555,"172.16.139.250",5440,12,1142,14856,0,0,12,1142,0,0,176.301085,0.014398999999997386,634488,0
"172.16.133.45",61375,"209.99.98.33",80,106,106686,14857,0,0,27,4465,79,102221,176.350179,11.50622100000001,3104,71071
"172.16.133.132",51847,"74.122.143.73",80,7,482,14858,0,0,4,272,3,210,176.352061,0.05726500000000101,37998,29337
"172.16.133.41",53269,"172.16.139.250",5440,12,1142,14859,0,0,12,1142,0,0,176.356044,0.006290000000007012,1452464,0
"172.16.133.45",61376,"209.99.98.33",80,184,195748,14860,0,0,43,4991,141,190757,176.361575,11.49439700000002,3473,132765
"172.16.133.132",46023,"206.188.4.2",80,6,374,14861,0,0,4,254,2,120,176.415445,0.04114300000000526,49388,23333
"172.16.133.85",52390,"172.16.139.250",5440,10,1022,14862,0,0,10,1022,0,0,176.421073,0.00538699999998471,1517727,0
"172.16.133.42",57243,"172.16.139.250",5440,12,1142,14863,0,0,12,1142,0,0,176.423469,0.014037999999999329,650804,0
"172.16.133.43",57899,"172.16.139.250",5440,10,1022,14864,0,0,10,1022,0,0,176.426699,0.005499999999983629,1486545,0
"172.16.133.13",53160,"172.16.139.250",5440,12,1142,14865,0,0,12,1142,0,0,176.447008,0.006142999999980248,1487221,0
"172.16.133.132",38403,"207.171.163.14",80,6,380,14866,0,0,4,254,2,126,176.461479,0.053727000000009184,37820,18761
"172.16.133.45",61377,"209.99.98.33",80,30,17658,14867,0,0,13,3675,17,13983,176.475774,11.379097999999999,2583,9830
"172.16.133.45",61378,"209.99.98.33",80,48,44812,14868,0,0,14,1418,34,43394,176.476102,11.380438999999996,996,30504
"172.16.133.20",62528,"172.16.139.250",5440,12,1142,14869,0,0,12,1142,0,0,176.496143,0.004934000000019978,"",""
"172.16.133.75",51093,"172.16.139.250",5440,12,1142,14870,0,0,12,1142,0,0,176.51189,0.00649900000001935,1405754,0
"172.16.133.28",49246,"172.16.139.250",5440,12,1142,14871,0,0,12,1142,0,0,176.524878,0.006344000000012784,1440100,0
"172.16.133.99",56184,"172.16.139.250",5440,10,1022,14872,0,0,10,1022,0,0,176.553111,0.015103000000010525,541349,0
"172.16.133.87",60351,"172.16.139.250",5440,12,1142,14873,0,0,12,1142,0,0,176.576564,0.016633000000013,549269,0
"172.16.133.35",50090,"172.16.139.250",5440,12,1142,14874,0,0,12,1142,0,0,176.588493,0.0141179999999963,647117,0
"172.16.133.116",53727,"172.16.139.250",5440,10,1022,14875,0,0,10,1022,0,0,176.590096,0.006309000000015885,1295926,0
"172.16.133.116",53728,"172.16.139.250",5440,10,1022,14876,0,0,10,1022,0,0,176.597354,0.006844999999998436,1194448,0
"172.16.133.116",53729,"172.16.139.250",5440,12,1142,14877,0,0,12,1142,0,0,176.605125,0.006114000000025044,1494275,0
"172.16.133.84",58920,"172.16.139.250",5440,12,1142,14878,0,0,12,1142,0,0,176.611723,0.01533599999999069,595722,0
"172.16.133.49",55910,"172.16.139.250",5440,10,1022,14879,0,0,10,1022,0,0,176.6885,0.00643800000000283,1269959,0
"172.16.133.95",57085,"172.16.139.250",5440,12,1142,14880,0,0,12,1142,0,0,176.729074,0.01608300000000895,568053,0
"172.16.133.92",57798,"172.16.139.250",5440,12,1142,14881,0,0,12,1142,0,0,176.755459,0.005977999999998929,1528270,0
"172.16.133.29",61101,"172.16.139.250",5440,10,1022,14882,0,0,10,1022,0,0,176.773358,0.005605000000002747,1458697,0
"172.16.133.44",64953,"172.16.139.250",5440,12,1142,14883,0,0,12,1142,0,0,176.780408,0.01631299999999669,560044,0
"172.16.133.207",56049,"172.16.139.250",5440,10,1022,14884,0,0,10,1022,0,0,176.805218,0.01459400000001665,560230,0
"172.16.133.83",57206,"172.16.139.250",5440,12,1142,14885,0,0,12,1142,0,0,176.815262,0.00826200000000199,1105785,0
"172.16.133.66",54243,"64.94.107.25",80,8,1979,14886,0,0,5,1516,3,463,176.819673,0.13664199999999482,88757,27107
"172.16.133.66",54244,"64.94.107.34",80,10,2459,14887,0,0,6,1962,4,497,176.82235,0.1339659999999867,117164,29679
"172.16.133.93",60877,"172.16.139.250",5440,10,1022,14888,0,0,10,1022,0,0,176.830386,0.004749000000003889,"",""
"172.16.133.11",55274,"172.16.139.250",5440,12,1142,14889,0,0,12,1142,0,0,176.846836,0.11913499999999999,76686,0
"172.16.133.55",57750,"172.16.139.250",5440,10,1022,14890,0,0,10,1022,0,0,176.852315,0.1174350000000004,69621,0
"172.16.133.73",60807,"172.16.139.250",5440,12,1142,14891,0,0,12,1142,0,0,176.875099,0.12101099999998155,75497,0
"172.16.133.53",54234,"172.16.139.250",5440,10,1022,14892,0,0,10,1022,0,0,176.877014,0.12221900000000119,66896,0
"172.16.133.21",53309,"172.16.139.250",5440,10,1022,14893,0,0,10,1022,0,0,176.880374,0.13773100000000227,59362,0
"172.16.133.30",62782,"172.16.139.250",5440,10,1022,14894,0,0,10,1022,0,0,176.884545,0.10735600000001,76157,0
"172.16.133.25",63606,"172.16.139.250",5440,10,1022,14895,0,0,10,1022,0,0,176.891494,0.11123499999999353,73502,0
"172.16.133.66",54245,"64.12.249.201",80,14,5146,14896,0,0,7,2742,7,2404,176.892334,20.229382999999984,1084,950
"172.16.133.66",54246,"23.67.243.43",80,11,2133,14897,0,0,6,1607,5,526,176.892652,90.11615799999998,142,46
"172.16.133.66",54247,"23.67.243.43",80,11,2635,14898,0,0,6,1514,5,1121,176.892881,90.10547400000002,134,99
"172.16.133.34",50577,"172.16.139.250",5440,10,1022,14899,0,0,10,1022,0,0,176.899888,0.10704300000000444,76380,0
"172.16.133.97",59510,"172.16.139.250",5440,10,1022,14900,0,0,10,1022,0,0,176.910866,0.10216800000000603,80025,0
"172.16.133.33",58020,"172.16.139.250",5440,10,1022,14901,0,0,10,1022,0,0,176.984299,0.04064500000001203,201156,0
"172.16.133.68",60876,"172.16.139.250",5440,10,1022,14902,0,0,10,1022,0,0,177.01675,0.012239999999991369,667973,0
"172.16.133.12",59897,"172.16.139.250",5440,12,1142,14903,0,0,12,1142,0,0,177.031366,0.006348000000002685,1439193,0
"172.16.133.66",54248,"64.12.239.201",80,10,1908,14904,0,0,6,1573,4,335,177.037549,20.084305999999998,626,133
"172.16.133.63",54019,"172.16.139.250",5440,10,1022,14905,0,0,10,1022,0,0,177.041624,0.005643999999989546,1448618,0
"172.16.133.45",61379,"209.99.98.33",80,25,13779,14906,0,0,11,2376,14,11403,177.050624,10.805540000000008,1759,8442
"172.16.133.66",54249,"172.16.139.250",5440,10,1022,14907,0,0,10,1022,0,0,177.054099,0.016404999999991787,498384,0
"172.16.133.82",61557,"172.16.139.250",5440,12,1142,14908,0,0,12,1142,0,0,177.068925,0.01812400000000025,504082,0
"172.16.133.37",60748,"172.16.139.250",5440,12,1142,14909,0,0,12,1142,0,0,177.081098,0.015085999999996602,605594,0
"172.16.133.66",54250,"173.194.43.59",80,27,21047,14910,0,0,10,2429,17,18618,177.102999,90.139949,215,1652
"172.16.133.66",54251,"38.97.103.136",80,34,25725,14911,0,0,13,4483,21,21242,177.116417,90.60643799999997,395,1875
"172.16.133.90",51559,"24.171.169.137",22817,3,194,14912,0,0,3,194,0,0,177.191153,8.998324999999994,172,0
"172.16.133.78",59357,"172.16.139.250",5440,10,1022,14913,0,0,10,1022,0,0,177.237906,0.0056029999999793745,1459218,0
"172.16.133.67",56115,"172.16.139.250",5440,12,1142,14914,0,0,12,1142,0,0,177.293694,0.008003000000002203,1141571,0
"172.16.133.56",61556,"172.16.139.250",5440,12,1142,14915,0,0,12,1142,0,0,177.314667,0.00490100000001803,"",""
"172.16.133.41",53270,"172.16.139.250",5440,10,1022,14916,0,0,10,1022,0,0,177.370481,0.015468999999995958,528540,0
"172.16.133.78",59358,"68.64.24.250",443,6,366,14917,0,0,4,246,2,120,177.398609,0.08354300000002013,23556,11491
"172.16.133.42",57244,"172.16.139.250",5440,12,1142,14918,0,0,12,1142,0,0,177.426861,0.029156000000000404,313348,0
"172.16.133.85",52391,"172.16.139.250",5440,10,1022,14919,0,0,10,1022,0,0,177.434859,0.015722000000010894,520035,0
"172.16.133.43",57900,"172.16.139.250",5440,10,1022,14920,0,0,10,1022,0,0,177.44039,0.01797399999998106,454879,0
"172.16.133.13",53161,"172.16.139.250",5440,12,1142,14921,0,0,12,1142,0,0,177.460021,0.00624899999999684,1461993,0
"172.16.133.41",53271,"199.204.31.83",80,12,3473,14922,0,0,7,2856,5,617,177.474028,0.27338000000000306,83575,18055
"172.16.133.78",59359,"78.108.118.250",443,6,366,14923,0,0,4,246,2,120,177.489382,0.20653599999999983,9528,4648
"172.16.133.78",59360,"216.219.118.244",443,6,366,14924,0,0,4,246,2,120,177.501318,0.1955120000000079,10065,4910
"172.16.133.20",62529,"172.16.139.250",5440,12,1142,14925,0,0,12,1142,0,0,177.508956,0.014631999999977552,624384,0
"172.16.133.75",51094,"172.16.139.250",5440,10,1022,14926,0,0,10,1022,0,0,177.526646,0.00544800000000123,1500734,0
"172.16.133.28",49247,"172.16.139.250",5440,12,1142,14927,0,0,12,1142,0,0,177.540001,0.006137000000023818,1488675,0
"172.16.133.99",56185,"172.16.139.250",5440,10,1022,14928,0,0,10,1022,0,0,177.567071,0.015691000000003896,521063,0
"172.16.133.87",60352,"172.16.139.250",5440,10,1022,14929,0,0,10,1022,0,0,177.590524,0.014615000000020473,559425,0
"172.16.133.25",63607,"172.16.139.250",5440,12,1142,14930,0,0,12,1142,0,0,177.595107,0.0050919999999905485,1794186,0
"172.16.133.35",50091,"172.16.139.250",5440,12,1142,14931,0,0,12,1142,0,0,177.6005,0.05766199999999344,158440,0
"172.16.133.116",53730,"172.16.139.250",5440,10,1022,14932,0,0,10,1022,0,0,177.604718,0.005200000000002092,1572307,0
"172.16.133.116",53731,"172.16.139.250",5440,10,1022,14933,0,0,10,1022,0,0,177.61092,0.007516000000009626,1087812,0
"172.16.133.116",53732,"172.16.139.250",5440,10,1022,14934,0,0,10,1022,0,0,177.61934,0.020017999999993208,408432,0
"172.16.133.84",58921,"172.16.139.250",5440,10,1022,14935,0,0,10,1022,0,0,177.62581,0.010027000000008002,815398,0
"172.16.133.49",55911,"172.16.139.250",5440,12,1142,14936,0,0,12,1142,0,0,177.702236,0.016341000000011263,559084,0
"172.16.133.66",54252,"205.210.187.119",80,7,432,14937,0,0,3,186,4,246,177.713848,5.226233999999977,284,376
"172.16.133.66",54253,"205.210.187.119",80,16,6300,14938,0,0,7,3934,9,2366,177.713982,6.030416000000002,5218,3138
"172.16.133.66",54254,"205.210.187.119",80,7,432,14939,0,0,3,186,4,246,177.714091,5.167434000000014,287,380
"172.16.133.66",54255,"209.190.70.254",80,6,368,14940,0,0,4,246,2,122,177.717873,19.42836600000001,101,50
"172.16.133.66",54256,"209.190.70.254",80,6,368,14941,0,0,4,246,2,122,177.718155,19.42721800000001,101,50
"172.16.133.66",54257,"209.190.70.254",80,16,6068,14942,0,0,8,5006,8,1062,177.71826,0.7943880000000263,50413,10695
"172.16.133.66",54258,"207.171.163.14",80,6,372,14943,0,0,4,246,2,126,177.718387,19.407534,101,51
"172.16.133.66",54259,"207.171.163.14",80,6,372,14944,0,0,4,246,2,126,177.718466,19.407404999999983,101,51
"172.16.133.66",54260,"207.171.163.14",80,6,372,14945,0,0,4,246,2,126,177.718578,19.406451000000004,101,51
"172.16.133.66",54261,"199.30.80.32",80,8,504,14946,0,0,5,312,3,192,177.720406,19.493555000000015,128,78
"172.16.133.66",54262,"54.243.243.51",80,6,372,14947,0,0,4,246,2,126,177.742212,19.381166000000007,101,52
"172.16.133.66",54263,"54.243.243.51",80,6,372,14948,0,0,4,246,2,126,177.742395,19.380935000000022,101,52
"172.16.133.66",54264,"54.243.243.51",80,6,372,14949,0,0,4,246,2,126,177.742717,19.380548000000005,101,52
"172.16.133.66",54265,"50.116.194.23",80,6,366,14950,0,0,4,246,2,120,177.743026,19.394281000000007,101,49
"172.16.133.66",54266,"50.116.194.23",80,6,366,14951,0,0,4,246,2,120,177.743157,19.393314000000004,101,49
"172.16.133.95",57086,"172.16.139.250",5440,12,1142,14952,0,0,12,1142,0,0,177.743158,0.016137000000014723,566152,0
"172.16.133.66",54267,"50.116.194.23",80,6,366,14953,0,0,4,246,2,120,177.74328,19.394025,101,49
"172.16.133.66",54268,"107.21.54.29",80,24,11679,14954,0,0,12,7042,12,4637,177.743479,69.38003699999999,811,534
"172.16.133.66",54269,"107.21.54.29",80,6,372,14955,0,0,4,246,2,126,177.74361,19.383161,101,52
"172.16.133.66",54270,"107.21.54.29",80,6,372,14956,0,0,4,246,2,126,177.743731,19.382142000000016,101,52
"172.16.133.66",54271,"107.6.106.10",80,6,368,14957,0,0,4,246,2,122,177.744291,19.376344999999986,101,50
"172.16.133.66",54272,"107.6.106.10",80,6,368,14958,0,0,4,246,2,122,177.74443,19.377093000000002,101,50
"172.16.133.66",54273,"107.6.106.10",80,15,5963,14959,0,0,8,4986,7,977,177.744491,1.1125549999999862,35852,7025
"172.16.133.66",54274,"174.129.214.80",80,6,554,14960,0,0,4,246,2,308,177.748751,19.378151000000003,101,127
"172.16.133.66",54275,"174.129.214.80",80,6,554,14961,0,0,4,246,2,308,177.748954,19.379715000000004,101,127
"172.16.133.66",54276,"174.129.214.80",80,6,554,14962,0,0,4,246,2,308,177.749162,19.377680999999995,101,127
"172.16.133.66",54277,"174.129.214.80",80,6,554,14963,0,0,4,246,2,308,177.749385,19.378417000000013,101,127
"172.16.133.66",54278,"174.129.214.80",80,6,554,14964,0,0,4,246,2,308,177.749561,19.38081199999999,101,127
"172.16.133.66",54279,"174.129.214.80",80,6,554,14965,0,0,4,246,2,308,177.74975,19.380724999999984,101,127
"172.16.133.92",57799,"172.16.139.250",5440,10,1022,14966,0,0,10,1022,0,0,177.77006,0.015390999999993937,531219,0
"172.16.133.30",62783,"216.115.216.250",443,6,366,14967,0,0,4,246,2,120,177.774136,0.04763900000000376,41310,20151
"172.16.133.78",59361,"216.115.219.126",443,6,366,14968,0,0,4,246,2,120,177.784569,0.4880369999999914,4032,1967
"172.16.133.29",61102,"172.16.139.250",5440,10,1022,14969,0,0,10,1022,0,0,177.787053,0.005527000000000726,1479283,0
"172.16.133.30",62784,"68.64.4.249",443,6,366,14970,0,0,4,246,2,120,177.792149,0.11244100000001822,17502,8537
"172.16.133.30",62785,"68.64.26.250",443,6,366,14971,0,0,4,246,2,120,177.792865,0.11077699999998458,17765,8666
"172.16.133.44",64954,"172.16.139.250",5440,10,1022,14972,0,0,10,1022,0,0,177.795295,0.005673999999999069,1440958,0
"172.16.133.66",54280,"67.202.66.160",80,11,3499,14973,0,0,5,1010,6,2489,177.816439,0.1425130000000081,56696,139720
"172.16.133.207",56050,"172.16.139.250",5440,12,1142,14974,0,0,12,1142,0,0,177.81932,0.006546999999983427,1395448,0
"172.16.133.83",57207,"172.16.139.250",5440,12,1142,14975,0,0,12,1142,0,0,177.829094,0.004671000000001868,"",""
"172.16.133.93",60878,"172.16.139.250",5440,10,1022,14976,0,0,10,1022,0,0,177.84446,0.014215000000007194,575167,0
"172.16.133.30",62786,"216.219.116.244",443,6,366,14977,0,0,4,246,2,120,177.859038,0.2261400000000151,8702,4245
"172.16.133.11",55275,"172.16.139.250",5440,10,1022,14978,0,0,10,1022,0,0,177.861009,0.006141000000013719,1331379,0
"172.16.133.55",57751,"172.16.139.250",5440,10,1022,14979,0,0,10,1022,0,0,177.866809,0.005475000000018326,1493333,0
"172.16.133.66",54281,"67.202.66.205",80,8,1501,14980,0,0,5,952,3,549,177.880808,0.22365800000000036,34051,19637
"172.16.133.73",60808,"172.16.139.250",5440,10,1022,14981,0,0,10,1022,0,0,177.889014,0.0055629999999951,1469710,0
"172.16.133.53",54235,"172.16.139.250",5440,10,1022,14982,0,0,10,1022,0,0,177.891004,0.0075649999999996,1080766,0
"172.16.133.21",53310,"172.16.139.250",5440,10,1022,14983,0,0,10,1022,0,0,177.894521,0.016871000000008962,484618,0
"172.16.133.30",62787,"172.16.139.250",5440,10,1022,14984,0,0,10,1022,0,0,177.899025,0.020473000000009733,399355,0
"172.16.133.66",54282,"67.202.66.179",80,9,2331,14985,0,0,5,1142,4,1189,177.904588,0.13132900000002223,69565,72428
"172.16.133.25",63608,"172.16.139.250",5440,10,1022,14986,0,0,10,1022,0,0,177.906375,0.008713999999997668,938260,0
"172.16.133.34",50578,"172.16.139.250",5440,12,1142,14987,0,0,12,1142,0,0,177.914351,0.008484999999978982,1076723,0
"172.16.133.97",59511,"172.16.139.250",5440,12,1142,14988,0,0,12,1142,0,0,177.924926,0.006076000000007298,1503620,0
"172.16.133.235",2702,"172.16.131.10",8080,18,3339,14989,0,0,9,1567,9,1772,177.980585,3.2183060000000125,3895,4404
"172.16.133.33",58021,"172.16.139.250",5440,10,1022,14990,0,0,10,1022,0,0,177.998457,0.01546199999998521,528780,0
"172.16.133.66",54283,"107.23.217.81",80,28,12381,14991,0,0,14,6863,14,5518,178.016192,69.107518,794,638
"172.16.133.68",60877,"172.16.139.250",5440,12,1142,14992,0,0,12,1142,0,0,178.030854,0.023500999999981786,388749,0
"172.16.133.66",54284,"67.202.66.160",80,8,1997,14993,0,0,5,922,3,1075,178.03222,0.20000100000001453,36879,42999
"172.16.133.66",54285,"70.42.33.241",80,9,1305,14994,0,0,5,819,4,486,178.033004,0.17790600000000723,36828,21854
"172.16.133.12",59898,"172.16.139.250",5440,12,1142,14995,0,0,12,1142,0,0,178.045396,0.01295199999998431,705373,0
"172.16.133.63",54020,"172.16.139.250",5440,12,1142,14996,0,0,12,1142,0,0,178.055482,0.005780999999984715,1580349,0
"172.16.133.66",54286,"67.202.66.160",80,9,1501,14997,0,0,5,954,4,547,178.062612,0.1301159999999868,58655,33631
"172.16.133.66",54287,"172.16.139.250",5440,10,1022,14998,0,0,10,1022,0,0,178.067849,0.006807000000009111,1201116,0
"172.16.133.82",61559,"172.16.139.250",5440,10,1022,14999,0,0,10,1022,0,0,178.081958,0.005660000000005994,1444522,0
"172.16.133.37",60749,"172.16.139.250",5440,12,1142,15000,0,0,12,1142,0,0,178.096111,0.006426000000004706,1421724,0
"172.16.133.66",54288,"67.202.66.160",80,9,1522,15001,0,0,5,969,4,553,178.235672,0.11977400000000671,64721,36936
"172.16.133.78",59362,"172.16.139.250",5440,10,1022,15002,0,0,10,1022,0,0,178.252272,0.005515000000002601,1482502,0
"172.16.133.66",54289,"173.194.43.58",80,11,2033,15003,0,0,6,885,5,1148,178.274356,90.10974099999999,78,101
"172.16.133.67",56116,"172.16.139.250",5440,10,1022,15004,0,0,10,1022,0,0,178.307168,0.01497400000002358,546013,0
"172.16.133.56",61557,"172.16.139.250",5440,10,1022,15005,0,0,10,1022,0,0,178.32881,0.0047089999999911925,"",""
"172.16.133.41",53272,"172.16.139.250",5440,12,1142,15006,0,0,12,1142,0,0,178.384076,0.006629000000003771,1378186,0
"172.16.133.85",52392,"172.16.139.250",5440,10,1022,15007,0,0,10,1022,0,0,178.448461,0.014962999999994508,546414,0
"172.16.133.42",57245,"172.16.139.250",5440,12,1142,15008,0,0,12,1142,0,0,178.451315,0.05454399999999282,167497,0
"172.16.133.43",57901,"172.16.139.250",5440,10,1022,15009,0,0,10,1022,0,0,178.455698,0.015311999999994441,533960,0
"172.16.133.13",53162,"172.16.139.250",5440,10,1022,15010,0,0,10,1022,0,0,178.473849,0.015058000000010452,542967,0
"172.16.133.20",62530,"172.16.139.250",5440,10,1022,15011,0,0,10,1022,0,0,178.522974,0.00491600000000858,"",""
"172.16.133.75",51095,"172.16.139.250",5440,10,1022,15012,0,0,10,1022,0,0,178.540149,0.005439999999993006,1502941,0
"172.16.133.28",49248,"172.16.139.250",5440,10,1022,15013,0,0,10,1022,0,0,178.553203,0.0055370000000039,1476611,0
"172.16.133.99",56186,"172.16.139.250",5440,12,1142,15014,0,0,12,1142,0,0,178.581418,0.005536999999975478,1649990,0
"172.16.133.87",60353,"172.16.139.250",5440,8,902,15015,0,0,8,902,0,0,178.604839,0.016166999999995824,446341,0
"172.16.133.116",53733,"172.16.139.250",5440,10,1022,15016,0,0,10,1022,0,0,178.618754,0.005893000000014581,1387408,0
"172.16.133.116",53734,"172.16.139.250",5440,10,1022,15017,0,0,10,1022,0,0,178.62581,0.005293999999992138,1544389,0
"172.16.133.35",50092,"172.16.139.250",5440,12,1142,15018,0,0,12,1142,0,0,178.62867,0.04409599999999614,207184,0
"172.16.133.116",53735,"172.16.139.250",5440,10,1022,15019,0,0,10,1022,0,0,178.63201,0.005767999999989115,1417475,0
"172.16.133.84",58922,"172.16.139.250",5440,10,1022,15020,0,0,10,1022,0,0,178.640146,0.005718000000001666,1429870,0
"172.16.133.49",55912,"172.16.139.250",5440,12,1142,15021,0,0,12,1142,0,0,178.716119,0.016490000000004557,554032,0
"172.16.133.95",57087,"172.16.139.250",5440,10,1022,15022,0,0,10,1022,0,0,178.757034,0.014408000000003085,567462,0
"172.16.133.92",57800,"172.16.139.250",5440,10,1022,15023,0,0,10,1022,0,0,178.784028,0.0055529999999919255,1472357,0
"172.16.133.29",61103,"172.16.139.250",5440,10,1022,15024,0,0,10,1022,0,0,178.801783,0.005336999999997261,1531946,0
"172.16.133.44",64955,"172.16.139.250",5440,10,1022,15025,0,0,10,1022,0,0,178.810028,0.014735000000001719,554869,0
"172.16.133.207",56051,"172.16.139.250",5440,12,1142,15026,0,0,12,1142,0,0,178.832883,0.014774999999985994,618341,0
"172.16.133.83",57208,"172.16.139.250",5440,12,1142,15027,0,0,12,1142,0,0,178.843198,0.008251999999998816,1107125,0
"172.16.133.93",60879,"172.16.139.250",5440,10,1022,15028,0,0,10,1022,0,0,178.858464,0.014163999999993848,577238,0
"172.16.133.11",55276,"172.16.139.250",5440,10,1022,15029,0,0,10,1022,0,0,178.874968,0.01572100000001342,520068,0
"172.16.133.55",57752,"172.16.139.250",5440,12,1142,15030,0,0,12,1142,0,0,178.880327,0.006171999999992295,1480233,0
"172.16.133.73",60809,"172.16.139.250",5440,10,1022,15031,0,0,10,1022,0,0,178.903156,0.015036000000009153,543761,0
"172.16.133.53",54236,"172.16.139.250",5440,10,1022,15032,0,0,10,1022,0,0,178.905392,0.006343999999984362,1288776,0
"172.16.133.21",53311,"172.16.139.250",5440,10,1022,15033,0,0,10,1022,0,0,178.908519,0.01737499999998704,470561,0
"172.16.133.30",62788,"172.16.139.250",5440,10,1022,15034,0,0,10,1022,0,0,178.913161,0.008799000000010437,929196,0
"172.16.133.25",63609,"172.16.139.250",5440,10,1022,15035,0,0,10,1022,0,0,178.927597,0.004951000000005479,"",""
"172.16.133.34",50579,"172.16.139.250",5440,10,1022,15036,0,0,10,1022,0,0,178.928215,0.007955000000009704,1027781,0
"172.16.133.97",59512,"172.16.139.250",5440,10,1022,15037,0,0,10,1022,0,0,178.93884,0.005839000000008809,1400239,0
"172.16.133.33",58022,"172.16.139.250",5440,10,1022,15038,0,0,10,1022,0,0,179.012472,0.005517999999995027,1481696,0
"172.16.133.68",60879,"172.16.139.250",5440,12,1142,15039,0,0,12,1142,0,0,179.044828,0.006263000000018337,1458725,0
"172.16.133.12",59899,"172.16.139.250",5440,10,1022,15040,0,0,10,1022,0,0,179.059265,0.005495999999993728,1487627,0
"172.16.133.63",54021,"172.16.139.250",5440,10,1022,15041,0,0,10,1022,0,0,179.069843,0.005314999999995962,1538287,0
"172.16.133.66",54290,"172.16.139.250",5440,10,1022,15042,0,0,10,1022,0,0,179.083224,0.005565999999987525,1468918,0
"172.16.133.96",53359,"173.194.43.53",443,40,15854,15043,0,0,21,6172,19,9682,179.092407,25.90010799999999,1906,2990
"172.16.133.96",53360,"173.194.43.53",443,33,8314,15044,0,0,18,5466,15,2848,179.092822,25.900491999999986,1688,879
"172.16.133.82",61560,"172.16.139.250",5440,10,1022,15045,0,0,10,1022,0,0,179.096991,0.005576999999988175,1466021,0
"172.16.133.37",60750,"172.16.139.250",5440,10,1022,15046,0,0,10,1022,0,0,179.109649,0.005521000000015874,1480891,0
"172.16.133.78",59363,"172.16.139.250",5440,10,1022,15047,0,0,10,1022,0,0,179.266102,0.004891000000014856,"",""
"172.16.133.67",56117,"172.16.139.250",5440,12,1142,15048,0,0,12,1142,0,0,179.320657,0.005929999999978008,1540640,0
"172.16.133.56",61558,"172.16.139.250",5440,12,1142,15049,0,0,12,1142,0,0,179.3429,0.0053150000000243836,1718908,0
"172.16.133.41",53273,"172.16.139.250",5440,12,1142,15050,0,0,12,1142,0,0,179.398234,0.015064999999992779,606438,0
"172.16.133.78",59364,"68.64.24.250",443,6,366,15051,0,0,4,246,2,120,179.441651,0.12712299999998322,15481,7551
"172.16.133.26",53099,"173.194.43.38",443,120,50150,15052,0,0,64,37050,56,13100,179.4452,101.86243000000002,2909,1028
"172.16.133.42",57246,"172.16.139.250",5440,12,1142,15053,0,0,12,1142,0,0,179.467707,0.10601700000000847,86174,0
"172.16.133.43",57902,"172.16.139.250",5440,12,1142,15054,0,0,12,1142,0,0,179.46943,0.014531000000005179,628724,0
"172.16.133.85",52393,"172.16.139.250",5440,12,1142,15055,0,0,12,1142,0,0,179.471347,0.006001999999995178,1522159,0
"172.16.133.13",53163,"172.16.139.250",5440,10,1022,15056,0,0,10,1022,0,0,179.488166,0.015884999999997262,514699,0
"172.16.133.20",62531,"172.16.139.250",5440,12,1142,15057,0,0,12,1142,0,0,179.537188,0.0049820000000124764,"",""
"172.16.133.75",51096,"172.16.139.250",5440,10,1022,15058,0,0,10,1022,0,0,179.553926,0.006649000000010119,1229658,0
"172.16.133.28",49249,"172.16.139.250",5440,10,1022,15059,0,0,10,1022,0,0,179.566889,0.014703999999994721,556039,0
"172.16.133.78",59365,"78.108.118.250",443,6,366,15060,0,0,4,246,2,120,179.594575,0.19964799999999627,9857,4808
"172.16.133.78",59366,"216.219.118.244",443,6,366,15061,0,0,4,246,2,120,179.596476,0.19870700000001307,9904,4831
"172.16.133.99",56187,"172.16.139.250",5440,10,1022,15062,0,0,10,1022,0,0,179.598362,0.0050229999999942265,1627712,0
"172.16.133.87",60354,"172.16.139.250",5440,10,1022,15063,0,0,10,1022,0,0,179.618799,0.005404999999996107,1512673,0
"172.16.133.35",50094,"172.16.139.250",5440,12,1142,15064,0,0,12,1142,0,0,179.625976,0.01735800000000154,526327,0
"172.16.133.116",53736,"172.16.139.250",5440,10,1022,15065,0,0,10,1022,0,0,179.632063,0.005076999999999998,1610399,0
"172.16.133.116",53737,"172.16.139.250",5440,10,1022,15066,0,0,10,1022,0,0,179.638128,0.014904999999998836,548540,0
"172.16.133.84",58923,"172.16.139.250",5440,10,1022,15067,0,0,10,1022,0,0,179.653735,0.005479999999977281,1491970,0
"172.16.133.116",53738,"172.16.139.250",5440,10,1022,15068,0,0,10,1022,0,0,179.654241,0.008881999999999834,920513,0
"172.16.133.49",55914,"172.16.139.250",5440,10,1022,15069,0,0,10,1022,0,0,179.730215,0.005500000000012051,1486545,0
"172.16.133.95",57088,"172.16.139.250",5440,10,1022,15070,0,0,10,1022,0,0,179.77124,0.005351999999987811,1527653,0
"172.16.133.92",57801,"172.16.139.250",5440,10,1022,15071,0,0,10,1022,0,0,179.796497,0.005202000000025464,1571703,0
"172.16.133.30",62789,"216.115.216.250",443,6,366,15072,0,0,4,246,2,120,179.804173,0.03974200000001815,49519,24155
"172.16.133.29",61104,"172.16.139.250",5440,10,1022,15073,0,0,10,1022,0,0,179.815534,0.005342999999982112,1530226,0
"172.16.133.44",64956,"172.16.139.250",5440,10,1022,15074,0,0,10,1022,0,0,179.82254,0.015439999999983911,529533,0
"172.16.133.30",62790,"68.64.26.250",443,6,366,15075,0,0,4,246,2,120,179.841051,0.09246500000000424,21283,10382
"172.16.133.207",56052,"172.16.139.250",5440,12,1142,15076,0,0,12,1142,0,0,179.847586,0.005036999999987302,1813778,0
"172.16.133.30",62791,"68.64.4.249",443,6,366,15077,0,0,4,246,2,120,179.850078,0.09732099999999377,20221,9864
"172.16.133.83",57209,"172.16.139.250",5440,12,1142,15078,0,0,12,1142,0,0,179.857331,0.004716000000001941,"",""
"172.16.133.93",60880,"172.16.139.250",5440,10,1022,15079,0,0,10,1022,0,0,179.872269,0.014639000000016722,558508,0
"172.16.133.11",55277,"172.16.139.250",5440,10,1022,15080,0,0,10,1022,0,0,179.88899,0.005773000000004913,1416248,0
"172.16.133.55",57753,"172.16.139.250",5440,10,1022,15081,0,0,10,1022,0,0,179.893522,0.01472599999999602,555208,0
"172.16.133.73",60810,"172.16.139.250",5440,10,1022,15082,0,0,10,1022,0,0,179.916105,0.005752999999998565,1421171,0
"172.16.133.53",54237,"172.16.139.250",5440,10,1022,15083,0,0,10,1022,0,0,179.919087,0.006687999999996919,1222488,0
"172.16.133.21",53312,"172.16.139.250",5440,10,1022,15084,0,0,10,1022,0,0,179.922382,0.014886999999987438,549204,0
"172.16.133.30",62792,"172.16.139.250",5440,10,1022,15085,0,0,10,1022,0,0,179.925643,0.005421999999981608,1507930,0
"172.16.133.25",63610,"172.16.139.250",5440,12,1142,15086,0,0,12,1142,0,0,179.933569,0.0073380000000042855,1245025,0
"172.16.133.34",50580,"172.16.139.250",5440,10,1022,15087,0,0,10,1022,0,0,179.942094,0.005101999999993723,1602508,0
"172.16.133.97",59513,"172.16.139.250",5440,12,1142,15088,0,0,12,1142,0,0,179.953258,0.006092999999992799,1499425,0
"172.16.133.30",62793,"216.219.116.244",443,6,366,15089,0,0,4,246,2,120,179.97811,0.30962400000001367,6356,3100
"172.16.133.16",59359,"208.85.46.33",80,41,36091,15090,0,0,15,2239,26,33852,180.006318,0.30505899999999997,58716,887749
"172.16.133.16",59360,"208.85.41.43",80,62,57510,15091,0,0,22,2659,40,54851,180.006879,0.8939220000000034,23796,490879
"172.16.133.16",59361,"208.85.44.32",80,38,33682,15092,0,0,14,2176,24,31506,180.007078,0.33948100000000636,51278,742450
"172.16.133.33",58023,"172.16.139.250",5440,10,1022,15093,0,0,10,1022,0,0,180.026476,0.005465999999984206,1495792,0
"172.16.133.78",59367,"216.115.219.126",443,6,366,15094,0,0,4,246,2,120,180.035591,0.5120739999999842,3843,1874
"172.16.133.68",60880,"172.16.139.250",5440,10,1022,15095,0,0,10,1022,0,0,180.058713,0.017853999999999814,457936,0
"172.16.133.12",59900,"172.16.139.250",5440,12,1142,15096,0,0,12,1142,0,0,180.073461,0.007309999999989714,1249794,0
"172.16.133.16",59362,"208.85.44.31",80,51,48269,15097,0,0,16,2300,35,45969,180.077416,0.39959799999999746,46046,920304
"172.16.133.63",54022,"172.16.139.250",5440,12,1142,15098,0,0,12,1142,0,0,180.083022,0.016448999999994385,555413,0
"172.16.133.66",54291,"172.16.139.250",5440,12,1142,15099,0,0,12,1142,0,0,180.096179,0.007079000000004498,1290577,0
"172.16.133.82",61561,"172.16.139.250",5440,12,1142,15100,0,0,12,1142,0,0,180.109732,0.01578799999998637,578667,0
"172.16.133.37",60751,"172.16.139.250",5440,12,1142,15101,0,0,12,1142,0,0,180.122898,0.006587999999993599,1386763,0
"172.16.133.78",59368,"172.16.139.250",5440,12,1142,15102,0,0,12,1142,0,0,180.279778,0.005977000000001453,1528526,0
"172.16.133.39",64281,"91.190.218.65",12350,21,2561,15103,0,0,10,1338,11,1223,180.330047,0.9694089999999846,11041,10092
"172.16.133.67",56118,"172.16.139.250",5440,12,1142,15104,0,0,12,1142,0,0,180.335702,0.016682000000002972,547656,0
"172.16.133.56",61559,"172.16.139.250",5440,10,1022,15106,0,0,10,1022,0,0,180.356799,0.005225999999993292,1564485,0
"172.16.133.78",59369,"68.55.65.201",57492,3,194,15107,0,0,3,194,0,0,180.373084,9.008316000000008,172,0
"172.16.133.41",53274,"172.16.139.250",5440,10,1022,15108,0,0,10,1022,0,0,180.412223,0.01566199999999185,522027,0
"172.16.133.26",53100,"173.194.43.43",443,130,70652,15109,0,0,55,15905,75,54747,180.459311,89.905933,1415,4871
"172.16.133.42",57247,"172.16.139.250",5440,12,1142,15110,0,0,12,1142,0,0,180.473818,0.045810000000017226,199432,0
"172.16.133.85",52394,"172.16.139.250",5440,10,1022,15111,0,0,10,1022,0,0,180.476952,0.017164999999977226,476318,0
"172.16.133.43",57903,"172.16.139.250",5440,12,1142,15112,0,0,12,1142,0,0,180.482628,0.016339999999985366,559118,0
"172.16.133.13",53164,"172.16.139.250",5440,10,1022,15113,0,0,10,1022,0,0,180.502181,0.015185000000002447,538426,0
"172.16.133.26",53101,"107.20.92.205",443,30,8783,15114,0,0,14,3051,16,5732,180.536884,112.00797800000004,217,409
"172.16.133.20",62532,"172.16.139.250",5440,12,1142,15115,0,0,12,1142,0,0,180.5511,0.005025000000017599,1818109,0
"172.16.133.75",51097,"172.16.139.250",5440,10,1022,15116,0,0,10,1022,0,0,180.568301,0.005381999999997333,1519137,0
"172.16.133.28",49255,"172.16.139.250",5440,12,1142,15117,0,0,12,1142,0,0,180.58108,0.005406000000022004,1689974,0
"172.16.133.121",56642,"96.43.146.49",443,293,171873,15118,0,0,131,36077,162,135796,180.589075,38.37877799999998,7520,28306
"172.16.133.99",56188,"172.16.139.250",5440,12,1142,15119,0,0,12,1142,0,0,180.60924,0.01478900000000749,617756,0
"172.16.133.87",60355,"172.16.139.250",5440,10,1022,15120,0,0,10,1022,0,0,180.63284,0.01568600000001652,521229,0
"172.16.133.35",50095,"172.16.139.250",5440,12,1142,15121,0,0,12,1142,0,0,180.638541,0.019024000000001706,480235,0
"172.16.133.116",53739,"172.16.139.250",5440,10,1022,15122,0,0,10,1022,0,0,180.645783,0.006478000000015527,1262117,0
"172.16.133.116",53740,"172.16.139.250",5440,12,1142,15123,0,0,12,1142,0,0,180.653217,0.00776899999999614,1175955,0
"172.16.133.116",53741,"172.16.139.250",5440,10,1022,15124,0,0,10,1022,0,0,180.663718,0.00540900000001443,1511554,0
"172.16.133.84",58924,"172.16.139.250",5440,12,1142,15125,0,0,12,1142,0,0,180.667785,0.015398000000004686,593323,0
"172.16.133.49",55915,"172.16.139.250",5440,10,1022,15126,0,0,10,1022,0,0,180.744301,0.005875000000003183,1391659,0
"172.16.133.113",55670,"172.16.139.250",135,8,492,15127,0,0,8,492,0,0,180.752581,0.018966000000006034,207529,0
"172.16.133.113",55671,"172.16.139.250",5462,10,696,15128,0,0,10,696,0,0,180.773256,0.5090059999999994,10938,0
"172.16.133.95",57089,"172.16.139.250",5440,10,1022,15129,0,0,10,1022,0,0,180.785003,0.00544800000000123,1500734,0
"172.16.133.92",57802,"172.16.139.250",5440,10,1022,15130,0,0,10,1022,0,0,180.812155,0.005470000000002528,1494698,0
"172.16.133.29",61105,"172.16.139.250",5440,12,1142,15131,0,0,12,1142,0,0,180.829247,0.006148999999993521,1485770,0
"172.16.133.44",64957,"172.16.139.250",5440,12,1142,15132,0,0,12,1142,0,0,180.837915,0.006123999999999796,1491835,0
"172.16.133.207",56053,"172.16.139.250",5440,12,1142,15133,0,0,12,1142,0,0,180.862373,0.017482000000001108,522594,0
"172.16.133.83",57210,"172.16.139.250",5440,12,1142,15134,0,0,12,1142,0,0,180.871185,0.004501000000004751,"",""
"172.16.133.63",54023,"96.43.146.50",443,11,1056,15135,0,0,6,627,5,429,180.878971,90.22530399999997,55,38
"172.16.133.63",54024,"96.43.146.50",443,11,1056,15136,0,0,6,627,5,429,180.879924,90.22478600000002,55,38
"172.16.133.63",54025,"96.43.146.50",443,11,1056,15137,0,0,6,627,5,429,180.880308,90.22466499999996,55,38
"172.16.133.63",54026,"96.43.146.50",443,52,29026,15138,0,0,26,18289,26,10737,180.880751,117.775635,1242,729
"172.16.133.63",54027,"96.43.146.50",443,11,1056,15139,0,0,6,627,5,429,180.881151,90.22347000000002,55,38
"172.16.133.63",54028,"96.43.146.50",443,11,1056,15140,0,0,6,627,5,429,180.881313,90.22349999999997,55,38
"172.16.133.63",54029,"64.56.203.22",443,35,22877,15141,0,0,16,6200,19,16677,180.881481,9.684722999999991,5121,13775
"172.16.133.63",54030,"64.56.203.22",443,11,1043,15142,0,0,6,621,5,422,180.881603,90.49819999999997,54,37
"172.16.133.63",54031,"96.43.146.178",443,46,24418,15143,0,0,24,15646,22,8772,180.881715,114.658558,1091,612
"172.16.133.63",54032,"96.43.146.178",443,11,1055,15144,0,0,6,626,5,429,180.881958,90.22243900000001,55,38
"172.16.133.63",54033,"96.43.146.178",443,11,1055,15145,0,0,6,626,5,429,180.882052,90.22322000000003,55,38
"172.16.133.63",54034,"96.43.146.178",443,11,1055,15146,0,0,6,626,5,429,180.882143,90.22302799999997,55,38
"172.16.133.63",54035,"96.43.146.178",443,11,1055,15147,0,0,6,626,5,429,180.882235,90.222836,55,38
"172.16.133.63",54036,"96.43.146.178",443,11,1055,15148,0,0,6,626,5,429,180.882327,90.22311399999998,55,38
"172.16.133.93",60881,"172.16.139.250",5440,12,1142,15149,0,0,12,1142,0,0,180.885302,0.005001999999990403,1826469,0
"172.16.133.11",55278,"172.16.139.250",5440,10,1022,15150,0,0,10,1022,0,0,180.90289,0.006409999999988258,1275507,0
"172.16.133.55",57754,"172.16.139.250",5440,12,1142,15151,0,0,12,1142,0,0,180.907713,0.006335000000007085,1442146,0
"172.16.133.63",54037,"107.20.170.67",443,20,5791,15152,0,0,10,1322,10,4469,180.915918,69.577226,152,513
"172.16.133.63",54038,"107.20.170.67",443,20,5791,15153,0,0,10,1322,10,4469,180.916026,69.57700200000002,152,513
"172.16.133.73",60811,"172.16.139.250",5440,12,1142,15154,0,0,12,1142,0,0,180.929893,0.0064250000000072305,1421945,0
"172.16.133.53",54238,"172.16.139.250",5440,12,1142,15155,0,0,12,1142,0,0,180.933254,0.007157000000006519,1276512,0
"172.16.133.21",53313,"172.16.139.250",5440,12,1142,15156,0,0,12,1142,0,0,180.937351,0.015729999999990696,580801,0
"172.16.133.30",62795,"172.16.139.250",5440,12,1142,15157,0,0,12,1142,0,0,180.940976,0.01924700000000712,474671,0
"172.16.133.25",63611,"172.16.139.250",5440,12,1142,15158,0,0,12,1142,0,0,180.947477,0.008739000000019814,1045428,0
"172.16.133.34",50581,"172.16.139.250",5440,10,1022,15159,0,0,10,1022,0,0,180.956218,0.014285999999998467,572308,0
"172.16.133.97",59514,"172.16.139.250",5440,10,1022,15160,0,0,10,1022,0,0,180.968113,0.005977000000001453,1367910,0
"172.16.133.33",58024,"172.16.139.250",5440,10,1022,15161,0,0,10,1022,0,0,181.040422,0.015527999999989106,526532,0
"172.16.133.68",60881,"172.16.139.250",5440,12,1142,15162,0,0,12,1142,0,0,181.072906,0.006286000000017111,1453388,0
"172.16.133.12",59901,"172.16.139.250",5440,12,1142,15163,0,0,12,1142,0,0,181.087149,0.016556999999977506,551790,0
"172.16.133.63",54041,"172.16.139.250",5440,12,1142,15164,0,0,12,1142,0,0,181.09759,0.010526999999996178,867863,0
"172.16.133.66",54292,"172.16.139.250",5440,12,1142,15165,0,0,12,1142,0,0,181.110428,0.006146000000001095,1486495,0
"172.16.133.82",61562,"172.16.139.250",5440,12,1142,15166,0,0,12,1142,0,0,181.124094,0.016506999999990057,553462,0
"172.16.133.37",60752,"172.16.139.250",5440,12,1142,15167,0,0,12,1142,0,0,181.137987,0.015365000000002738,594598,0
"172.16.133.63",54042,"96.43.146.176",443,146,108588,15168,0,0,57,29822,89,78766,181.146089,114.11128500000004,2090,5522
"172.16.133.63",54043,"96.43.146.176",443,11,1051,15169,0,0,6,622,5,429,181.146295,90.36706399999997,55,37
"172.16.133.63",54044,"96.43.146.176",443,11,1051,15170,0,0,6,622,5,429,181.146419,90.36714499999997,55,37
"172.16.133.63",54045,"96.43.146.22",443,11,1055,15171,0,0,6,626,5,429,181.146582,90.35871799999998,55,37
"172.16.133.63",54046,"96.43.146.22",443,11,1055,15172,0,0,6,626,5,429,181.14669,90.35880599999999,55,37
"172.16.133.63",54047,"96.43.146.22",443,11,1055,15173,0,0,6,626,5,429,181.1468,90.35880499999999,55,37
"172.16.133.63",54048,"96.43.146.22",443,11,1055,15174,0,0,6,626,5,429,181.14693,90.366738,55,37
"172.16.133.78",59370,"172.16.139.250",5440,10,1022,15175,0,0,10,1022,0,0,181.293147,0.08632299999999304,94714,0
"172.16.133.67",56119,"172.16.139.250",5440,10,1022,15176,0,0,10,1022,0,0,181.350027,0.03306699999998841,247255,0
"172.16.133.56",61560,"172.16.139.250",5440,10,1022,15177,0,0,10,1022,0,0,181.371204,0.015589000000005626,524472,0
"172.16.133.41",53275,"172.16.139.250",5440,10,1022,15178,0,0,10,1022,0,0,181.426239,0.014365999999995438,569121,0
"172.16.133.42",57248,"172.16.139.250",5440,12,1142,15179,0,0,12,1142,0,0,181.4872,0.01906900000000178,479102,0
"172.16.133.85",52395,"172.16.139.250",5440,12,1142,15180,0,0,12,1142,0,0,181.491065,0.00888299999999731,1028481,0
"172.16.133.43",57904,"172.16.139.250",5440,10,1022,15181,0,0,10,1022,0,0,181.496885,0.00823600000001079,992714,0
"172.16.133.132",59745,"23.23.139.110",80,6,412,15182,0,0,4,272,2,140,181.498988,0.07554300000001035,28804,14825
"172.16.133.13",53165,"172.16.139.250",5440,12,1142,15183,0,0,12,1142,0,0,181.515903,0.006149999999990996,1485528,0
"172.16.133.78",59371,"68.64.24.250",443,6,366,15184,0,0,4,246,2,120,181.528744,0.11719800000000191,16792,8191
"172.16.133.20",62533,"172.16.139.250",5440,10,1022,15185,0,0,10,1022,0,0,181.565252,0.004979000000020051,"",""
"172.16.133.75",51098,"172.16.139.250",5440,10,1022,15186,0,0,10,1022,0,0,181.582351,0.005571000000003323,1467600,0
"172.16.133.28",49256,"172.16.139.250",5440,10,1022,15187,0,0,10,1022,0,0,181.595303,0.005785000000003038,1413310,0
"172.16.133.99",56189,"172.16.139.250",5440,10,1022,15188,0,0,10,1022,0,0,181.624593,0.014353999999997313,569597,0
"172.16.133.87",60356,"172.16.139.250",5440,10,1022,15189,0,0,10,1022,0,0,181.647129,0.016439999999988686,497323,0
"172.16.133.35",50096,"172.16.139.250",5440,12,1142,15190,0,0,12,1142,0,0,181.653246,0.009342000000003736,977949,0
"172.16.133.116",53742,"172.16.139.250",5440,10,1022,15191,0,0,10,1022,0,0,181.663959,0.006141999999982772,1331162,0
"172.16.133.116",53743,"172.16.139.250",5440,12,1142,15192,0,0,12,1142,0,0,181.67128,0.0076190000000053715,1199107,0
"172.16.133.116",53744,"172.16.139.250",5440,10,1022,15193,0,0,10,1022,0,0,181.679489,0.006645000000020218,1230398,0
"172.16.133.84",58925,"172.16.139.250",5440,10,1022,15194,0,0,10,1022,0,0,181.682007,0.007672000000013668,1065693,0
"172.16.133.78",59372,"78.108.118.250",443,6,366,15195,0,0,4,246,2,120,181.698636,0.31814800000000787,6185,3017
"172.16.133.78",59373,"216.219.118.244",443,6,366,15196,0,0,4,246,2,120,181.699429,0.3263719999999921,6029,2941
"172.16.133.63",54049,"96.43.146.22",443,11,1063,15197,0,0,7,694,4,369,181.748106,93.176739,59,31
"172.16.133.63",54050,"96.43.146.22",443,26,11770,15198,0,0,16,9213,10,2557,181.748311,104.68604599999998,704,195
"172.16.133.49",55916,"172.16.139.250",5440,10,1022,15199,0,0,10,1022,0,0,181.758446,0.005482999999998128,1491154,0
"172.16.133.95",57090,"172.16.139.250",5440,10,1022,15200,0,0,10,1022,0,0,181.799232,0.00861400000002277,949152,0
"172.16.133.30",62797,"216.115.216.250",443,6,366,15201,0,0,4,246,2,120,181.824243,0.05914799999999332,33272,16230
"172.16.133.92",57803,"172.16.139.250",5440,12,1142,15202,0,0,12,1142,0,0,181.825339,0.016002999999983558,570892,0
"172.16.133.63",54051,"64.56.203.22",443,38,23057,15203,0,0,17,6260,21,16797,181.839089,87.230145,574,1540
"172.16.133.63",54052,"64.56.203.22",443,11,1043,15204,0,0,6,621,5,422,181.839474,90.45402999999999,54,37
"172.16.133.63",54053,"64.56.203.22",443,20,8082,15205,0,0,11,3433,9,4649,181.839603,8.725600999999983,3147,4262
"172.16.133.29",61106,"172.16.139.250",5440,12,1142,15206,0,0,12,1142,0,0,181.843576,0.006292999999999438,1451771,0
"172.16.133.44",64958,"172.16.139.250",5440,12,1142,15207,0,0,12,1142,0,0,181.850721,0.016208000000005995,563672,0
"172.16.133.63",54054,"74.125.226.222",443,31,8794,15208,0,0,16,7247,15,1547,181.852818,118.08152999999999,490,104
"172.16.133.207",56054,"172.16.139.250",5440,12,1142,15209,0,0,12,1142,0,0,181.875259,0.005214999999992642,1751869,0
"172.16.133.83",57211,"172.16.139.250",5440,10,1022,15210,0,0,10,1022,0,0,181.884272,0.004831999999993286,"",""
"172.16.133.30",62798,"68.64.26.250",443,6,366,15211,0,0,4,246,2,120,181.894169,0.09035800000000904,21780,10624
"172.16.133.30",62799,"68.64.4.249",443,6,366,15212,0,0,4,246,2,120,181.897121,0.1257150000000138,15654,7636
"172.16.133.93",60882,"172.16.139.250",5440,12,1142,15213,0,0,12,1142,0,0,181.8996,0.0049040000000104556,"",""
"172.16.133.11",55279,"172.16.139.250",5440,10,1022,15214,0,0,10,1022,0,0,181.916788,0.0065590000000099735,1246531,0
"172.16.133.37",60753,"172.16.139.250",5440,10,1022,15215,0,0,10,1022,0,0,181.920193,0.01607899999999063,508489,0
"172.16.133.55",57755,"172.16.139.250",5440,12,1142,15216,0,0,12,1142,0,0,181.921346,0.006454999999988331,1415336,0
"172.16.133.73",60812,"172.16.139.250",5440,10,1022,15217,0,0,10,1022,0,0,181.944248,0.005704000000008591,1433380,0
"172.16.133.53",54239,"172.16.139.250",5440,10,1022,15218,0,0,10,1022,0,0,181.947708,0.01766399999999635,462862,0
"172.16.133.21",53314,"172.16.139.250",5440,12,1142,15219,0,0,12,1142,0,0,181.951585,0.16188999999999965,56433,0
"172.16.133.30",62800,"172.16.139.250",5440,12,1142,15220,0,0,12,1142,0,0,181.954161,0.006866999999999734,1330420,0
"172.16.133.25",63612,"172.16.139.250",5440,12,1142,15221,0,0,12,1142,0,0,181.9628,0.15390800000000127,59360,0
"172.16.133.34",50582,"172.16.139.250",5440,12,1142,15222,0,0,12,1142,0,0,181.970238,0.1736539999999991,52610,0
"172.16.133.97",59515,"172.16.139.250",5440,12,1142,15223,0,0,12,1142,0,0,181.981868,0.16648200000000202,54876,0
"172.16.133.33",58025,"172.16.139.250",5440,12,1142,15224,0,0,12,1142,0,0,182.052342,0.0998559999999884,91491,0
"172.16.133.63",54055,"216.137.33.233",443,19,7386,15225,0,0,9,920,10,6466,182.053732,38.44164700000002,191,1345
"172.16.133.63",54056,"216.137.33.233",443,19,7386,15226,0,0,9,920,10,6466,182.053957,38.441609,191,1345
"172.16.133.63",54057,"216.137.33.233",443,19,7386,15227,0,0,9,920,10,6466,182.054137,38.44113100000001,191,1345
"172.16.133.63",54058,"216.137.33.233",443,18,7326,15228,0,0,8,860,10,6466,182.054252,38.44069200000001,178,1345
"172.16.133.63",54059,"216.137.33.233",443,18,7326,15229,0,0,8,860,10,6466,182.054403,38.44064,178,1345
"172.16.133.63",54060,"216.137.33.233",443,19,7386,15230,0,0,9,920,10,6466,182.054528,38.44094899999999,191,1345
"172.16.133.68",60882,"172.16.139.250",5440,12,1142,15231,0,0,12,1142,0,0,182.087165,0.06881300000000579,132765,0
"172.16.133.12",59902,"172.16.139.250",5440,12,1142,15232,0,0,12,1142,0,0,182.101163,0.05814699999999107,157119,0
"172.16.133.63",54061,"172.16.139.250",5440,12,1142,15233,0,0,12,1142,0,0,182.111917,0.08063099999998258,113306,0
"172.16.133.66",54293,"172.16.139.250",5440,12,1142,15234,0,0,12,1142,0,0,182.124022,0.0731619999999964,124873,0
"172.16.133.82",61563,"172.16.139.250",5440,10,1022,15235,0,0,10,1022,0,0,182.139304,0.11353499999998462,72013,0
"172.16.133.30",62801,"216.219.116.244",443,6,366,15236,0,0,4,246,2,120,182.149225,0.26497499999999263,7427,3622
"172.16.133.37",60754,"172.16.139.250",5440,12,1142,15237,0,0,12,1142,0,0,182.150819,0.10611099999999851,86098,0
"172.16.133.57",60632,"96.43.146.48",443,34,13584,15238,0,0,19,1882,15,11702,182.162538,0.320650999999998,46954,291956
"172.16.133.47",56566,"96.43.146.176",443,20,3576,15239,0,0,11,2582,9,994,182.20672,116.05164600000003,177,68
"172.16.133.25",63613,"96.43.146.48",443,22,5434,15240,0,0,13,3476,9,1958,182.220279,42.716376,650,366
"172.16.133.43",57905,"157.56.236.102",443,23,9723,15241,0,0,10,1972,13,7751,182.237086,0.5816199999999867,27124,106612
"172.16.133.78",59374,"172.16.139.250",5440,12,1142,15242,0,0,12,1142,0,0,182.307019,0.0064749999999946795,1410965,0
"172.16.133.78",59375,"216.115.219.126",443,6,366,15243,0,0,4,246,2,120,182.311444,0.48089000000001647,4092,1996
"172.16.133.67",56120,"172.16.139.250",5440,10,1022,15244,0,0,10,1022,0,0,182.363797,0.006006999999982554,1361078,0
"172.16.133.56",61561,"172.16.139.250",5440,12,1142,15245,0,0,12,1142,0,0,182.384951,0.005321000000009235,1716970,0
"173.194.43.46",80,"172.16.133.36",64988,4,258,15246,0,0,2,126,2,132,182.385653,8.232835000000023,122,128
"172.16.133.41",53276,"172.16.139.250",5440,12,1142,15247,0,0,12,1142,0,0,182.43999,0.00621900000001574,1469046,0
"74.125.226.192",443,"172.16.133.36",64982,8,630,15248,0,0,4,366,4,264,182.482913,0.027510000000006585,106434,76772
"172.16.133.85",52396,"172.16.139.250",5440,12,1142,15249,0,0,12,1142,0,0,182.504811,0.011448000000001457,798043,0
"172.16.133.42",57249,"172.16.139.250",5440,12,1142,15250,0,0,12,1142,0,0,182.508531,0.0739590000000021,123527,0
"172.16.133.43",57906,"172.16.139.250",5440,12,1142,15251,0,0,12,1142,0,0,182.510474,0.009613000000001648,950379,0
"172.16.133.13",53166,"172.16.139.250",5440,10,1022,15252,0,0,10,1022,0,0,182.529979,0.005680000000012342,1439436,0
"173.194.43.35",443,"172.16.133.36",65028,8,630,15253,0,0,4,366,4,264,182.575983,0.024660999999980504,118729,85641
"172.16.133.20",62534,"172.16.139.250",5440,12,1142,15254,0,0,12,1142,0,0,182.579232,0.014829000000020187,616090,0
"172.16.133.75",51099,"172.16.139.250",5440,10,1022,15255,0,0,10,1022,0,0,182.595997,0.005595999999997048,1461043,0
"172.16.133.28",49257,"172.16.139.250",5440,12,1142,15256,0,0,12,1142,0,0,182.609977,0.045445000000000846,201034,0
"172.16.133.99",56190,"172.16.139.250",5440,12,1142,15257,0,0,12,1142,0,0,182.636289,0.023260999999990872,392760,0
"172.16.133.87",60357,"172.16.139.250",5440,12,1142,15258,0,0,12,1142,0,0,182.660711,0.0062819999999987886,1454313,0
"172.16.133.35",50097,"172.16.139.250",5440,12,1142,15259,0,0,12,1142,0,0,182.667613,0.014176000000020395,644469,0
"172.16.133.116",53745,"172.16.139.250",5440,12,1142,15260,0,0,12,1142,0,0,182.673226,0.008156000000013819,1120156,0
"172.16.133.116",53746,"172.16.139.250",5440,12,1142,15261,0,0,12,1142,0,0,182.68236,0.005560000000002674,1643165,0
"172.16.133.116",53747,"172.16.139.250",5440,12,1142,15262,0,0,12,1142,0,0,182.688846,0.0057829999999796655,1579802,0
"172.16.133.84",58926,"172.16.139.250",5440,12,1142,15263,0,0,12,1142,0,0,182.69579,0.006276000000013937,1455704,0
"172.16.133.37",60755,"180.153.30.250",443,6,366,15264,0,0,4,246,2,120,182.710384,0.7104610000000093,2770,1351
"172.16.133.12",59903,"172.16.139.250",5440,10,1022,15265,0,0,10,1022,0,0,182.755324,0.015288999999995667,534763,0
"172.16.133.49",55917,"172.16.139.250",5440,10,1022,15266,0,0,10,1022,0,0,182.772585,0.005544000000014648,1474747,0
"172.16.133.85",52397,"172.16.139.250",5440,12,1142,15267,0,0,12,1142,0,0,182.789088,0.006039000000015449,1512833,0
"172.16.133.95",57091,"172.16.139.250",5440,10,1022,15268,0,0,10,1022,0,0,182.813499,0.005649000000005344,1447335,0
"172.16.133.85",52398,"96.43.146.176",443,38,20560,15269,0,0,18,8748,20,11812,182.81619,90.67562900000001,771,1042
"172.16.133.85",52399,"96.43.146.176",443,26,13091,15270,0,0,14,5365,12,7726,182.816349,90.56970799999999,473,682
"172.16.133.85",52400,"96.43.146.176",443,24,10687,15271,0,0,12,4679,12,6008,182.816489,90.32029399999999,414,532
"172.16.133.85",52011,"96.43.146.176",443,2,120,15272,0,0,1,60,1,60,182.826635,7.899999999949614e-05,"",""
"172.16.133.85",52401,"96.43.146.176",443,12,2269,15273,0,0,7,1477,5,792,182.827035,0.6689700000000016,17662,9471
"172.16.133.92",57804,"172.16.139.250",5440,10,1022,15274,0,0,10,1022,0,0,182.838557,0.005486999999988029,1490067,0
"172.16.133.63",54062,"204.232.250.57",443,17,4711,15275,0,0,10,3731,7,980,182.847413,7.6486170000000016,3902,1025
"172.16.133.29",61107,"172.16.139.250",5440,10,1022,15276,0,0,10,1022,0,0,182.857304,0.005275000000011687,1549952,0
"172.16.133.44",64959,"172.16.139.250",5440,12,1142,15277,0,0,12,1142,0,0,182.864518,0.006196999999986019,1474261,0
"172.16.133.207",56055,"172.16.139.250",5440,12,1142,15278,0,0,12,1142,0,0,182.889431,0.004919999999998481,"",""
"172.16.133.83",57212,"172.16.139.250",5440,12,1142,15279,0,0,12,1142,0,0,182.898429,0.014731000000011818,620188,0
"172.16.133.93",60883,"172.16.139.250",5440,10,1022,15280,0,0,10,1022,0,0,182.913331,0.014427000000011958,566715,0
"172.16.133.11",55280,"172.16.139.250",5440,10,1022,15281,0,0,10,1022,0,0,182.93144,0.005608999999992648,1457657,0
"172.16.133.55",57756,"172.16.139.250",5440,10,1022,15282,0,0,10,1022,0,0,182.935495,0.01491699999999696,548099,0
"172.16.133.73",60813,"172.16.139.250",5440,12,1142,15283,0,0,12,1142,0,0,182.958053,0.01851700000000278,493384,0
"172.16.133.53",54240,"172.16.139.250",5440,12,1142,15284,0,0,12,1142,0,0,182.961253,0.006524000000013075,1400367,0
"172.16.133.21",53315,"172.16.139.250",5440,12,1142,15285,0,0,12,1142,0,0,182.966051,0.006626000000011345,1378810,0
"172.16.133.30",62802,"172.16.139.250",5440,10,1022,15286,0,0,10,1022,0,0,182.969351,0.01026600000000144,796415,0
"172.16.133.25",63614,"172.16.139.250",5440,12,1142,15287,0,0,12,1142,0,0,182.975753,0.0077339999999992415,1181277,0
"172.16.133.34",50583,"172.16.139.250",5440,10,1022,15288,0,0,10,1022,0,0,182.984102,0.005235999999996466,1561497,0
"172.16.133.97",59516,"172.16.139.250",5440,10,1022,15289,0,0,10,1022,0,0,182.995978,0.014608999999978778,559655,0
"172.16.133.33",58026,"172.16.139.250",5440,10,1022,15290,0,0,10,1022,0,0,183.066304,0.006297999999986814,1298189,0
"172.16.133.68",60884,"172.16.139.250",5440,10,1022,15291,0,0,10,1022,0,0,183.100936,0.005622000000016669,1454286,0
"172.16.133.12",59904,"172.16.139.250",5440,12,1142,15292,0,0,12,1142,0,0,183.11456,0.006429999999994607,1420839,0
"172.16.133.63",54063,"172.16.139.250",5440,10,1022,15293,0,0,10,1022,0,0,183.125893,0.005348999999995385,1528510,0
"172.16.133.66",54294,"172.16.139.250",5440,12,1142,15294,0,0,12,1142,0,0,183.136858,0.015517000000016878,588773,0
"172.16.133.82",61564,"172.16.139.250",5440,12,1142,15295,0,0,12,1142,0,0,183.152231,0.005528999999995676,1652378,0
"172.16.133.37",60764,"172.16.139.250",5440,12,1142,15296,0,0,12,1142,0,0,183.165148,0.016588000000012926,550759,0
"172.16.133.78",59376,"172.16.139.250",5440,10,1022,15297,0,0,10,1022,0,0,183.321383,0.005581000000006497,1464970,0
"172.16.133.67",56121,"172.16.139.250",5440,10,1022,15298,0,0,10,1022,0,0,183.377665,0.07673699999998007,106545,0
"172.16.133.56",61562,"172.16.139.250",5440,10,1022,15299,0,0,10,1022,0,0,183.398857,0.055542000000002645,147203,0
"172.16.133.41",53277,"172.16.139.250",5440,12,1142,15300,0,0,12,1142,0,0,183.454278,0.015463000000011107,590829,0
"172.16.133.42",57250,"172.16.139.250",5440,12,1142,15301,0,0,12,1142,0,0,183.516824,0.014750999999989745,619347,0
"172.16.133.85",52402,"172.16.139.250",5440,10,1022,15302,0,0,10,1022,0,0,183.517734,0.005528999999995676,1478748,0
"172.16.133.43",57907,"172.16.139.250",5440,10,1022,15303,0,0,10,1022,0,0,183.524691,0.006433000000015454,1270946,0
"172.16.133.13",53167,"172.16.139.250",5440,12,1142,15304,0,0,12,1142,0,0,183.544392,0.00662700000000882,1378602,0
"172.16.133.20",62535,"172.16.139.250",5440,12,1142,15305,0,0,12,1142,0,0,183.593174,0.014586000000008426,626354,0
"172.16.133.75",51100,"172.16.139.250",5440,10,1022,15306,0,0,10,1022,0,0,183.609482,0.006071999999988975,1346508,0
"172.16.133.28",49258,"172.16.139.250",5440,10,1022,15307,0,0,10,1022,0,0,183.623304,0.007009000000010701,1166500,0
"172.16.133.99",56191,"172.16.139.250",5440,12,1142,15308,0,0,12,1142,0,0,183.651168,0.015163999999998623,602479,0
"172.16.133.87",60358,"172.16.139.250",5440,10,1022,15309,0,0,10,1022,0,0,183.674812,0.007374999999996135,1108610,0
"172.16.133.35",50098,"172.16.139.250",5440,12,1142,15310,0,0,12,1142,0,0,183.682558,0.018886000000009062,483744,0
"172.16.133.116",53748,"172.16.139.250",5440,12,1142,15311,0,0,12,1142,0,0,183.686797,0.006315999999998212,1446485,0
"172.16.133.116",53749,"172.16.139.250",5440,10,1022,15312,0,0,10,1022,0,0,183.693962,0.006085000000012997,1343631,0
"172.16.133.11",55281,"78.108.117.250",443,6,366,15313,0,0,4,246,2,120,183.6966,0.19807700000001205,9935,4846
"172.16.133.11",55282,"216.219.117.244",443,6,366,15314,0,0,4,246,2,120,183.698163,0.2055469999999957,9574,4670
"172.16.133.11",55283,"202.173.25.200",443,6,366,15315,0,0,4,246,2,120,183.698938,0.5160769999999957,3813,1860
"172.16.133.116",53750,"172.16.139.250",5440,10,1022,15316,0,0,10,1022,0,0,183.701137,0.005880000000018981,1390476,0
"172.16.133.11",55284,"67.217.95.254",443,6,366,15317,0,0,4,246,2,120,183.701839,0.04188299999998435,46988,22920
"172.16.133.84",58927,"172.16.139.250",5440,12,1142,15318,0,0,12,1142,0,0,183.710402,0.01580500000000029,578044,0
"172.16.133.49",55918,"172.16.139.250",5440,10,1022,15319,0,0,10,1022,0,0,183.787118,0.01954900000001203,418231,0
"172.16.133.95",57092,"172.16.139.250",5440,12,1142,15320,0,0,12,1142,0,0,183.830211,0.015318000000007714,596422,0
"172.16.133.92",57805,"172.16.139.250",5440,10,1022,15321,0,0,10,1022,0,0,183.854123,0.01571400000000267,520300,0
"172.16.133.30",62803,"216.115.216.250",443,6,366,15322,0,0,4,246,2,120,183.861201,0.03769500000001358,52208,25467
"172.16.133.29",61108,"172.16.139.250",5440,12,1142,15323,0,0,12,1142,0,0,183.871401,0.006175000000013142,1479514,0
"172.16.133.44",64960,"172.16.139.250",5440,10,1022,15324,0,0,10,1022,0,0,183.877453,0.005102999999991198,1602194,0
"172.16.133.207",56056,"172.16.139.250",5440,12,1142,15325,0,0,12,1142,0,0,183.903417,0.017555000000015752,520421,0
"172.16.133.83",57213,"172.16.139.250",5440,12,1142,15326,0,0,12,1142,0,0,183.912388,0.004784000000000788,"",""
"172.16.133.93",60884,"172.16.139.250",5440,10,1022,15327,0,0,10,1022,0,0,183.92755,0.004728999999997541,"",""
"172.16.133.30",62804,"68.64.26.250",443,6,366,15328,0,0,4,246,2,120,183.945241,0.07870599999998262,25004,12197
"172.16.133.11",55285,"172.16.139.250",5440,12,1142,15329,0,0,12,1142,0,0,183.945876,0.006596999999999298,1384871,0
"172.16.133.55",57757,"172.16.139.250",5440,10,1022,15330,0,0,10,1022,0,0,183.950022,0.0056880000000205655,1437412,0
"172.16.133.30",62805,"68.64.4.249",443,6,366,15331,0,0,4,246,2,120,183.963479,0.08110600000000545,24264,11836
"172.16.133.73",60814,"172.16.139.250",5440,10,1022,15332,0,0,10,1022,0,0,183.972321,0.005585999999993874,1463659,0
"172.16.133.53",54241,"172.16.139.250",5440,10,1022,15333,0,0,10,1022,0,0,183.975452,0.01548200000001998,528097,0
"172.16.133.21",53316,"172.16.139.250",5440,12,1142,15334,0,0,12,1142,0,0,183.978241,0.017556000000013228,520391,0
"172.16.133.30",62806,"172.16.139.250",5440,10,1022,15335,0,0,10,1022,0,0,183.981986,0.021203999999983125,385587,0
"172.16.133.25",63615,"172.16.139.250",5440,12,1142,15336,0,0,12,1142,0,0,183.990741,0.00841999999997256,1085035,0
"172.16.133.34",50584,"172.16.139.250",5440,10,1022,15337,0,0,10,1022,0,0,183.998556,0.015174000000001797,538816,0
"172.16.133.97",59517,"172.16.139.250",5440,10,1022,15338,0,0,10,1022,0,0,184.010442,0.00701099999997723,1166167,0
"172.16.133.33",58027,"172.16.139.250",5440,12,1142,15339,0,0,12,1142,0,0,184.080869,0.015196000000003096,601210,0
"172.16.133.68",60885,"172.16.139.250",5440,12,1142,15340,0,0,12,1142,0,0,184.115163,0.006131000000010545,1490132,0
"172.16.133.12",59905,"172.16.139.250",5440,12,1142,15341,0,0,12,1142,0,0,184.128337,0.006229000000018914,1466688,0
"172.16.133.63",54064,"172.16.139.250",5440,12,1142,15342,0,0,12,1142,0,0,184.140005,0.006104999999990923,1496478,0
"172.16.133.66",54295,"172.16.139.250",5440,12,1142,15343,0,0,12,1142,0,0,184.15257,0.01635500000000434,558605,0
"172.16.133.82",61565,"172.16.139.250",5440,12,1142,15344,0,0,12,1142,0,0,184.166302,0.0064710000000047785,1411837,0
"172.16.133.37",60765,"172.16.139.250",5440,10,1022,15345,0,0,10,1022,0,0,184.180044,0.005544999999983702,1474481,0
"172.16.133.30",62807,"216.219.116.244",443,6,366,15346,0,0,4,246,2,120,184.273969,0.2156310000000019,9126,4452
"172.16.133.60",62139,"96.43.146.22",443,17,4064,15347,0,0,10,3227,7,837,184.332622,90.217612,286,74
"172.16.133.78",59377,"172.16.139.250",5440,10,1022,15348,0,0,10,1022,0,0,184.338233,0.005513000000007651,1483040,0
"172.16.133.120",53458,"96.43.146.22",443,36,16306,15349,0,0,21,14385,15,1921,184.379339,113.12508600000004,1017,135
"172.16.133.120",53459,"96.43.146.22",443,17,5220,15350,0,0,10,4417,7,803,184.379682,90.76559199999997,389,70
"172.16.133.67",56122,"172.16.139.250",5440,10,1022,15351,0,0,10,1022,0,0,184.391124,0.015622000000007574,523364,0
"172.16.133.56",61563,"172.16.139.250",5440,10,1022,15352,0,0,10,1022,0,0,184.412834,0.004876999999993359,"",""
"172.16.133.41",53278,"172.16.139.250",5440,12,1142,15353,0,0,12,1142,0,0,184.468422,0.005453999999986081,1675100,0
"172.16.133.42",57251,"172.16.139.250",5440,12,1142,15354,0,0,12,1142,0,0,184.529,0.013297999999991816,687020,0
"172.16.133.85",52403,"172.16.139.250",5440,10,1022,15355,0,0,10,1022,0,0,184.53252,0.008251999999998816,990790,0
"172.16.133.43",57908,"172.16.139.250",5440,10,1022,15356,0,0,10,1022,0,0,184.539506,0.005723000000017464,1428621,0
"172.16.133.13",53168,"172.16.139.250",5440,12,1142,15357,0,0,12,1142,0,0,184.558355,0.015957999999983485,572502,0
"172.16.133.20",62536,"172.16.139.250",5440,10,1022,15358,0,0,10,1022,0,0,184.607342,0.0049960000000055516,"",""
"172.16.133.75",51101,"172.16.139.250",5440,10,1022,15359,0,0,10,1022,0,0,184.623654,0.005742000000026337,1423894,0
"172.16.133.28",49259,"172.16.139.250",5440,12,1142,15360,0,0,12,1142,0,0,184.638374,0.016146999999989475,565801,0
"172.16.133.99",56192,"172.16.139.250",5440,12,1142,15361,0,0,12,1142,0,0,184.665458,0.004913999999985208,"",""
"172.16.133.87",60359,"172.16.139.250",5440,12,1142,15362,0,0,12,1142,0,0,184.689641,0.006776999999999589,1348089,0
"172.16.133.35",50099,"172.16.139.250",5440,12,1142,15363,0,0,12,1142,0,0,184.695818,0.022770000000008395,401229,0
"172.16.133.116",53751,"172.16.139.250",5440,12,1142,15364,0,0,12,1142,0,0,184.700958,0.005906999999979234,1546639,0
"172.16.133.116",53752,"172.16.139.250",5440,10,1022,15365,0,0,10,1022,0,0,184.707964,0.005899999999996908,1385762,0
"172.16.133.116",53753,"172.16.139.250",5440,10,1022,15366,0,0,10,1022,0,0,184.714836,0.006276000000013937,1302740,0
"172.16.133.84",58928,"172.16.139.250",5440,10,1022,15367,0,0,10,1022,0,0,184.723987,0.0057340000000181135,1425880,0
"172.16.133.49",55919,"172.16.139.250",5440,12,1142,15368,0,0,12,1142,0,0,184.801529,0.005969000000021651,1530574,0
"172.16.133.95",57093,"172.16.139.250",5440,12,1142,15369,0,0,12,1142,0,0,184.841298,0.01532299999999509,596227,0
"172.16.133.92",57806,"172.16.139.250",5440,12,1142,15370,0,0,12,1142,0,0,184.867284,0.006292000000001963,1452002,0
"172.16.133.29",61109,"172.16.139.250",5440,10,1022,15371,0,0,10,1022,0,0,184.885557,0.005710999999990918,1431623,0
"172.16.133.44",64961,"172.16.139.250",5440,12,1142,15372,0,0,12,1142,0,0,184.892984,0.016127999999980602,566468,0
"172.16.133.207",56057,"172.16.139.250",5440,10,1022,15373,0,0,10,1022,0,0,184.917206,0.004681000000005042,"",""
"172.16.133.83",57214,"172.16.139.250",5440,12,1142,15374,0,0,12,1142,0,0,184.926293,0.0047430000000190375,"",""
"172.16.133.93",60885,"172.16.139.250",5440,10,1022,15375,0,0,10,1022,0,0,184.94244,0.004875999999995884,"",""
"172.16.133.11",55286,"172.16.139.250",5440,12,1142,15376,0,0,12,1142,0,0,184.95896,0.006143000000008669,1487221,0
"172.16.133.55",57758,"172.16.139.250",5440,12,1142,15377,0,0,12,1142,0,0,184.963695,0.0063600000000008095,1436477,0
"172.16.133.73",60815,"172.16.139.250",5440,12,1142,15378,0,0,12,1142,0,0,184.986409,0.016083999999978005,568017,0
"172.16.133.53",54242,"172.16.139.250",5440,10,1022,15379,0,0,10,1022,0,0,184.98974,0.019876999999979716,411329,0
"172.16.133.21",53317,"172.16.139.250",5440,10,1022,15380,0,0,10,1022,0,0,184.992706,0.02110999999999308,387304,0
"172.16.133.30",62808,"172.16.139.250",5440,10,1022,15381,0,0,10,1022,0,0,184.997554,0.008430000000004156,969869,0
"172.16.133.25",63616,"172.16.139.250",5440,12,1142,15382,0,0,12,1142,0,0,185.003887,0.013742000000007693,664823,0
"172.16.133.34",50585,"172.16.139.250",5440,12,1142,15383,0,0,12,1142,0,0,185.012273,0.009073000000000775,1006943,0
"172.16.133.97",59518,"172.16.139.250",5440,10,1022,15384,0,0,10,1022,0,0,185.023202,0.015574000000015076,524977,0
"172.16.133.37",60767,"180.153.30.250",443,6,366,15385,0,0,4,246,2,120,185.057544,0.6729919999999936,2924,1426
"172.16.133.33",58028,"172.16.139.250",5440,12,1142,15386,0,0,12,1142,0,0,185.095963,0.006392999999974336,1429063,0
"172.16.133.68",60886,"172.16.139.250",5440,12,1142,15387,0,0,12,1142,0,0,185.129063,0.016434000000003834,555920,0
"172.16.133.12",59906,"172.16.139.250",5440,12,1142,15388,0,0,12,1142,0,0,185.143796,0.00669199999998682,1365212,0
"172.16.133.63",54065,"172.16.139.250",5440,10,1022,15389,0,0,10,1022,0,0,185.154529,0.00543500000000563,1504323,0
"172.16.133.66",54296,"172.16.139.250",5440,10,1022,15390,0,0,10,1022,0,0,185.166472,0.004702000000008866,"",""
"172.16.133.82",61566,"172.16.139.250",5440,10,1022,15391,0,0,10,1022,0,0,185.179435,0.0055299999999931515,1478481,0
"172.16.133.37",60768,"172.16.139.250",5440,10,1022,15392,0,0,10,1022,0,0,185.193348,0.005122000000000071,1596251,0
"172.16.133.116",58991,"172.16.139.250",5500,10,8964,15393,0,0,10,8964,0,0,185.271107,0.2046359999999936,350436,0
"172.16.133.113",55672,"172.16.139.250",135,8,492,15394,0,0,8,492,0,0,185.284316,0.010373000000015509,379446,0
"172.16.133.113",55673,"172.16.139.250",5462,10,696,15395,0,0,10,696,0,0,185.295318,0.523635999999982,10633,0
"172.16.133.78",59378,"172.16.139.250",5440,10,1022,15396,0,0,10,1022,0,0,185.349132,0.011868999999990137,688853,0
"173.194.43.38",443,"172.16.133.71",57537,9,696,15397,0,0,4,366,5,330,185.392319,0.02566300000000865,114094,102871
"172.16.133.67",56123,"172.16.139.250",5440,10,1022,15398,0,0,10,1022,0,0,185.403835,0.014523000000025377,562969,0
"172.16.133.56",61564,"172.16.139.250",5440,12,1142,15399,0,0,12,1142,0,0,185.428177,0.005282999999991489,1729320,0
"172.16.133.41",53279,"172.16.139.250",5440,10,1022,15400,0,0,10,1022,0,0,185.482246,0.015582999999992353,524674,0
"172.16.133.85",52404,"172.16.139.250",5440,12,1142,15401,0,0,12,1142,0,0,185.545902,0.006347999999974263,1439193,0
"172.16.133.43",57909,"172.16.139.250",5440,10,1022,15402,0,0,10,1022,0,0,185.552541,0.005477000000013277,1492788,0
"172.16.133.42",57252,"172.16.139.250",5440,12,1142,15403,0,0,12,1142,0,0,185.561611,0.0413819999999987,220772,0
"172.16.133.13",53169,"172.16.139.250",5440,10,1022,15404,0,0,10,1022,0,0,185.572298,0.006142000000011194,1331162,0
"172.16.133.20",62537,"172.16.139.250",5440,12,1142,15405,0,0,12,1142,0,0,185.621522,0.004923999999988382,"",""
"172.16.133.75",51102,"172.16.139.250",5440,12,1142,15406,0,0,12,1142,0,0,185.637135,0.006542999999993526,1396301,0
"172.16.133.28",49260,"172.16.139.250",5440,10,1022,15407,0,0,10,1022,0,0,185.651193,0.005691999999982045,1436401,0
"172.16.133.99",56193,"172.16.139.250",5440,10,1022,15408,0,0,10,1022,0,0,185.678744,0.006002999999992653,1361985,0
"172.16.133.87",60361,"172.16.139.250",5440,12,1142,15409,0,0,12,1142,0,0,185.702544,0.0068770000000029086,1328486,0
"172.16.133.35",50100,"172.16.139.250",5440,12,1142,15410,0,0,12,1142,0,0,185.709028,0.01986600000000749,459881,0
"172.16.133.116",53754,"172.16.139.250",5440,10,1022,15411,0,0,10,1022,0,0,185.717026,0.005442999999985432,1502112,0
"172.16.133.11",55287,"67.217.95.254",443,6,366,15412,0,0,4,246,2,120,185.72469,0.05038999999999305,39055,19051
"172.16.133.116",53755,"172.16.139.250",5440,10,1022,15413,0,0,10,1022,0,0,185.725317,0.01669800000001942,489639,0
"172.16.133.84",58929,"172.16.139.250",5440,12,1142,15414,0,0,12,1142,0,0,185.738116,0.01618100000001732,564612,0
"172.16.133.116",53756,"172.16.139.250",5440,10,1022,15415,0,0,10,1022,0,0,185.743694,0.005249999999989541,1557333,0
"172.16.133.11",55288,"78.108.117.250",443,6,366,15416,0,0,4,246,2,120,185.7996,0.19884700000000066,9897,4827
"172.16.133.11",55289,"216.219.117.244",443,6,366,15417,0,0,4,246,2,120,185.805753,0.20481300000000147,9608,4687
"172.16.133.49",55920,"172.16.139.250",5440,12,1142,15418,0,0,12,1142,0,0,185.816086,0.006600999999989199,1384032,0
"172.16.133.95",57094,"172.16.139.250",5440,12,1142,15419,0,0,12,1142,0,0,185.855431,0.006055000000003474,1508835,0
"172.16.133.37",60769,"96.43.146.48",443,12,2243,15420,0,0,7,1427,5,816,185.863548,3.6856619999999793,3097,1771
"172.16.133.37",60770,"184.73.225.104",443,22,7388,15421,0,0,11,2094,11,5294,185.866039,5.300385000000006,3160,7990
"172.16.133.92",57807,"172.16.139.250",5440,12,1142,15422,0,0,12,1142,0,0,185.881785,0.00519799999997872,1757599,0
"172.16.133.29",61110,"172.16.139.250",5440,10,1022,15423,0,0,10,1022,0,0,185.899682,0.01555099999998788,525753,0
"172.16.133.44",64962,"172.16.139.250",5440,10,1022,15424,0,0,10,1022,0,0,185.906212,0.00528699999998139,1546434,0
"172.16.133.116",53757,"172.16.139.250",5440,10,1022,15425,0,0,10,1022,0,0,185.920048,0.005509999999986803,1483847,0
"172.16.133.207",56058,"172.16.139.250",5440,10,1022,15426,0,0,10,1022,0,0,185.931669,0.005031999999999925,1624801,0
"172.16.133.83",57215,"172.16.139.250",5440,12,1142,15427,0,0,12,1142,0,0,185.940467,0.043355999999988626,210720,0
"172.16.133.93",60886,"172.16.139.250",5440,10,1022,15428,0,0,10,1022,0,0,185.955371,0.07883199999997714,103714,0
"172.16.133.11",55290,"202.173.25.200",443,6,366,15429,0,0,4,246,2,120,185.956653,0.5155170000000169,3817,1862
"172.16.133.11",55291,"172.16.139.250",5440,12,1142,15430,0,0,12,1142,0,0,185.97341,0.06509099999999535,140357,0
"172.16.133.55",57759,"172.16.139.250",5440,12,1142,15431,0,0,12,1142,0,0,185.977584,0.06385699999998451,143069,0
"172.16.133.73",60816,"172.16.139.250",5440,12,1142,15432,0,0,12,1142,0,0,186.000242,0.06789500000002135,134560,0
"172.16.133.53",54243,"172.16.139.250",5440,12,1142,15433,0,0,12,1142,0,0,186.003374,0.06528099999999881,139948,0
"172.16.133.21",53318,"172.16.139.250",5440,12,1142,15434,0,0,12,1142,0,0,186.005726,0.05786799999998493,157876,0
"172.16.133.30",62809,"172.16.139.250",5440,10,1022,15435,0,0,10,1022,0,0,186.010448,0.03798499999999194,215242,0
"172.16.133.25",63617,"172.16.139.250",5440,12,1142,15436,0,0,12,1142,0,0,186.017427,0.03181699999998955,287142,0
"172.16.133.34",50586,"172.16.139.250",5440,12,1142,15437,0,0,12,1142,0,0,186.026347,0.047252000000014505,193346,0
"172.16.133.97",59519,"172.16.139.250",5440,10,1022,15438,0,0,10,1022,0,0,186.037203,0.04031799999998498,202787,0
"172.16.133.33",58029,"172.16.139.250",5440,10,1022,15439,0,0,10,1022,0,0,186.108386,0.005648000000007869,1447592,0
"172.16.133.37",60771,"157.56.234.137",443,6,374,15440,0,0,3,194,3,180,186.13965,1.2211479999999995,1270,1179
"172.16.133.68",60887,"172.16.139.250",5440,12,1142,15441,0,0,12,1142,0,0,186.142911,0.01578800000001479,578667,0
"172.16.133.12",59907,"172.16.139.250",5440,12,1142,15442,0,0,12,1142,0,0,186.156324,0.016504999999995107,553529,0
"172.16.133.63",54066,"172.16.139.250",5440,10,1022,15443,0,0,10,1022,0,0,186.167962,0.007738000000017564,1056603,0
"172.16.133.66",54297,"172.16.139.250",5440,12,1142,15444,0,0,12,1142,0,0,186.17924,0.005494999999996253,1662602,0
"172.16.133.82",61567,"172.16.139.250",5440,12,1142,15445,0,0,12,1142,0,0,186.192895,0.006080999999994674,1502384,0
"172.16.133.37",60772,"172.16.139.250",5440,10,1022,15446,0,0,10,1022,0,0,186.207362,0.01551000000000613,527143,0
"172.16.128.169",1825,"172.16.139.250",80,9,1229,15447,0,0,5,488,4,741,186.337787,0.33929299999999785,11506,17471
"172.16.133.78",59379,"172.16.139.250",5440,10,1022,15448,0,0,10,1022,0,0,186.363286,0.03235700000001884,252681,0
"172.16.133.67",56125,"172.16.139.250",5440,10,1022,15449,0,0,10,1022,0,0,186.417869,0.015276000000000067,535218,0
"172.16.133.56",61565,"172.16.139.250",5440,10,1022,15450,0,0,10,1022,0,0,186.441689,0.015050000000002228,543255,0
"172.16.133.41",53280,"172.16.139.250",5440,12,1142,15451,0,0,12,1142,0,0,186.496327,0.0060869999999795255,1500903,0
"172.16.133.85",52405,"172.16.139.250",5440,10,1022,15452,0,0,10,1022,0,0,186.560151,0.005487000000016451,1490067,0
"172.16.133.43",57910,"172.16.139.250",5440,12,1142,15453,0,0,12,1142,0,0,186.566583,0.014552999999978056,627774,0
"172.16.133.42",57253,"172.16.139.250",5440,12,1142,15454,0,0,12,1142,0,0,186.583431,0.03238799999999742,282079,0
"172.16.133.13",53170,"172.16.139.250",5440,10,1022,15455,0,0,10,1022,0,0,186.586203,0.01563099999998485,523063,0
"172.16.133.132",34776,"74.122.143.24",80,7,482,15456,0,0,4,272,3,210,186.603183,0.05155799999999999,42204,32584
"172.16.133.56",61566,"172.16.139.250",5440,12,1142,15457,0,0,12,1142,0,0,186.614456,0.005924000000021579,1542201,0
"172.16.133.20",62538,"172.16.139.250",5440,10,1022,15458,0,0,10,1022,0,0,186.635478,0.0052069999999844185,1570193,0
"172.16.133.75",51103,"172.16.139.250",5440,10,1022,15459,0,0,10,1022,0,0,186.651507,0.005747999999982767,1422407,0
"172.16.133.132",46062,"66.235.139.180",80,7,482,15460,0,0,4,272,3,210,186.661254,0.18308199999998465,11885,9176
"172.16.133.28",49261,"172.16.139.250",5440,12,1142,15461,0,0,12,1142,0,0,186.666181,0.006200000000006867,1473548,0
"172.16.133.49",55921,"172.16.139.250",5440,6,780,15462,0,0,6,780,0,0,186.685797,0.0014500000000055024,"",""
"172.16.133.99",56194,"172.16.139.250",5440,10,1022,15463,0,0,10,1022,0,0,186.692373,0.01585499999998774,515673,0
"172.16.133.27",60922,"172.16.128.105",443,14,3970,15464,0,0,8,684,6,3286,186.697825,0.4012400000000014,13637,65516
"172.16.133.99",56195,"172.16.139.250",5440,6,780,15465,0,0,6,780,0,0,186.701268,0.01045500000000743,596843,0
"172.16.133.82",61568,"172.16.139.250",5440,6,780,15466,0,0,6,780,0,0,186.701841,0.0014299999999991542,"",""
"172.16.133.87",60362,"172.16.139.250",5440,6,780,15467,0,0,6,780,0,0,186.701843,0.0015679999999917982,"",""
"172.16.133.87",60363,"172.16.139.250",5440,10,1022,15468,0,0,10,1022,0,0,186.716889,0.005368000000004258,1523099,0
"172.16.133.35",50101,"172.16.139.250",5440,12,1142,15469,0,0,12,1142,0,0,186.727489,0.0115430000000174,791475,0
"172.16.133.116",53758,"172.16.139.250",5440,12,1142,15470,0,0,12,1142,0,0,186.732259,0.01564500000000635,583956,0
"172.16.133.116",53759,"172.16.139.250",5440,10,1022,15471,0,0,10,1022,0,0,186.748586,0.015629000000018323,523130,0
"172.16.133.84",58930,"172.16.139.250",5440,12,1142,15472,0,0,12,1142,0,0,186.751657,0.01626999999999157,561524,0
"172.16.133.116",53760,"172.16.139.250",5440,12,1142,15473,0,0,12,1142,0,0,186.765674,0.016093000000012125,567700,0
"172.16.133.49",55922,"172.16.139.250",5440,12,1142,15474,0,0,12,1142,0,0,186.828083,0.006318000000021584,1446027,0
"172.16.133.132",59377,"67.202.66.160",80,6,589,15475,0,0,4,266,2,323,186.851597,0.08370199999998817,25423,30871
"172.16.133.95",57095,"172.16.139.250",5440,10,1022,15476,0,0,10,1022,0,0,186.869397,0.015328000000010888,533402,0
"172.16.133.22",53994,"184.72.243.110",80,9,882,15477,0,0,5,494,4,388,186.894657,0.08176000000000272,48336,37964
"172.16.133.92",57808,"172.16.139.250",5440,12,1142,15478,0,0,12,1142,0,0,186.895136,0.016429999999985512,556055,0
"172.16.133.29",61111,"172.16.139.250",5440,12,1142,15479,0,0,12,1142,0,0,186.913946,0.01968699999997625,464062,0
"172.16.133.44",64963,"172.16.139.250",5440,12,1142,15480,0,0,12,1142,0,0,186.920133,0.0059180000000083055,1543764,0
"172.16.133.75",51104,"172.16.139.250",5440,12,1142,15481,0,0,12,1142,0,0,186.920645,0.009648999999996022,946833,0
"172.16.133.207",56059,"172.16.139.250",5440,12,1142,15482,0,0,12,1142,0,0,186.945314,0.01792700000001446,509622,0
"172.16.133.83",57216,"172.16.139.250",5440,10,1022,15483,0,0,10,1022,0,0,186.954507,0.004631999999986647,"",""
"172.16.133.75",51105,"96.43.146.178",443,13,2352,15484,0,0,7,1499,6,853,186.956008,0.5765409999999918,20799,11836
"172.16.133.93",60887,"172.16.139.250",5440,10,1022,15485,0,0,10,1022,0,0,186.970617,0.014364000000000487,569200,0
"172.16.133.11",55292,"172.16.139.250",5440,12,1142,15486,0,0,12,1142,0,0,186.987616,0.006311000000010836,1447631,0
"172.16.133.55",57760,"172.16.139.250",5440,12,1142,15487,0,0,12,1142,0,0,186.99175,0.015202000000016369,600973,0
"172.16.133.73",60817,"172.16.139.250",5440,10,1022,15488,0,0,10,1022,0,0,187.01438,0.005672000000004118,1441466,0
"172.16.133.53",54244,"172.16.139.250",5440,10,1022,15489,0,0,10,1022,0,0,187.017436,0.007221999999984519,1132096,0
"172.16.133.21",53319,"172.16.139.250",5440,10,1022,15490,0,0,10,1022,0,0,187.021284,0.01601800000000253,510425,0
"172.16.133.30",62810,"172.16.139.250",5440,10,1022,15491,0,0,10,1022,0,0,187.024391,0.04256099999997787,192100,0
"172.16.133.25",63618,"172.16.139.250",5440,12,1142,15492,0,0,12,1142,0,0,187.031855,0.03672799999998233,248747,0
"172.16.133.34",50587,"172.16.139.250",5440,10,1022,15493,0,0,10,1022,0,0,187.040448,0.03667599999999993,222925,0
"172.16.133.97",59520,"172.16.139.250",5440,12,1142,15494,0,0,12,1142,0,0,187.051219,0.02176299999999287,419795,0
"172.16.133.33",58030,"172.16.139.250",5440,10,1022,15495,0,0,10,1022,0,0,187.12264,0.015413000000023658,530461,0
"172.16.133.68",60888,"172.16.139.250",5440,10,1022,15496,0,0,10,1022,0,0,187.157468,0.005746000000016238,1422902,0
"172.16.133.12",59908,"172.16.139.250",5440,12,1142,15497,0,0,12,1142,0,0,187.171336,0.005631999999991422,1622159,0
"172.16.133.63",54067,"172.16.139.250",5440,10,1022,15498,0,0,10,1022,0,0,187.180865,0.005531999999988102,1477946,0
"172.16.133.66",54298,"172.16.139.250",5440,10,1022,15499,0,0,10,1022,0,0,187.192888,0.015729999999990696,519771,0
"172.16.133.82",61569,"172.16.139.250",5440,12,1142,15500,0,0,12,1142,0,0,187.207253,0.006444999999985157,1417532,0
"172.16.133.37",60773,"172.16.139.250",5440,10,1022,15501,0,0,10,1022,0,0,187.221237,0.01468700000000922,556682,0
"172.16.133.163",3587,"66.235.139.153",80,9,3699,15502,0,0,5,2759,4,940,187.314254,10.441545999999988,2113,720
"172.16.133.57",60633,"157.56.242.198",443,57,22529,15503,0,0,28,8174,29,14355,187.35669,63.309178,1032,1813
"172.16.133.37",60774,"157.56.236.89",443,6,374,15504,0,0,3,194,3,180,187.361469,1.3173630000000003,1178,1093
"172.16.133.78",59380,"172.16.139.250",5440,12,1142,15505,0,0,12,1142,0,0,187.377672,0.008166000000016993,1118785,0
"172.16.133.37",60775,"180.153.30.250",443,6,366,15506,0,0,4,246,2,120,187.397102,0.6910400000000152,2847,1389
"172.16.133.67",56126,"172.16.139.250",5440,10,1022,15507,0,0,10,1022,0,0,187.431875,0.004802000000012185,"",""
"172.16.133.56",61567,"172.16.139.250",5440,12,1142,15508,0,0,12,1142,0,0,187.454924,0.020713000000000648,441075,0
"172.16.133.41",53281,"172.16.139.250",5440,10,1022,15509,0,0,10,1022,0,0,187.510492,0.005459000000001879,1497710,0
"172.16.133.42",57254,"172.16.139.250",5440,12,1142,15510,0,0,12,1142,0,0,187.572905,0.019220000000018445,475338,0
"172.16.133.85",52406,"172.16.139.250",5440,10,1022,15511,0,0,10,1022,0,0,187.574375,0.005505999999996902,1484925,0
"172.16.133.43",57911,"172.16.139.250",5440,12,1142,15512,0,0,12,1142,0,0,187.582423,0.01546199999998521,590867,0
"172.16.133.13",53171,"172.16.139.250",5440,10,1022,15513,0,0,10,1022,0,0,187.600207,0.00655100000000175,1248053,0
"172.16.133.20",62539,"172.16.139.250",5440,12,1142,15514,0,0,12,1142,0,0,187.649325,0.005239999999986367,1743511,0
"172.16.133.75",51106,"172.16.139.250",5440,10,1022,15515,0,0,10,1022,0,0,187.665362,0.016617000000024973,492026,0
"172.16.133.28",49262,"172.16.139.250",5440,10,1022,15516,0,0,10,1022,0,0,187.679203,0.01422900000000027,574601,0
"172.16.133.99",56196,"172.16.139.250",5440,12,1142,15517,0,0,12,1142,0,0,187.707617,0.005178000000000793,1764387,0
"172.16.133.87",60364,"172.16.139.250",5440,12,1142,15518,0,0,12,1142,0,0,187.743871,0.006772999999981266,1348885,0
"172.16.133.116",53761,"172.16.139.250",5440,10,1022,15519,0,0,10,1022,0,0,187.745153,0.015292000000016515,534658,0
"172.16.133.11",55293,"67.217.95.254",443,6,366,15520,0,0,4,246,2,120,187.751852,0.042519999999996116,46284,22577
"172.16.133.35",50102,"172.16.139.250",5440,12,1142,15521,0,0,12,1142,0,0,187.755124,0.04294300000000817,212747,0
"172.16.133.116",53762,"172.16.139.250",5440,10,1022,15522,0,0,10,1022,0,0,187.76107,0.005445000000008804,1501561,0
"172.16.133.84",58931,"172.16.139.250",5440,10,1022,15523,0,0,10,1022,0,0,187.765259,0.015360000000015361,532291,0
"172.16.133.116",53763,"172.16.139.250",5440,10,1022,15524,0,0,10,1022,0,0,187.767296,0.017192000000022745,475570,0
"172.16.133.45",61380,"209.99.98.33",80,34,24179,15525,0,0,14,2149,20,22030,187.783097,13.076316999999989,1314,13477
"172.16.133.49",55923,"172.16.139.250",5440,10,1022,15526,0,0,10,1022,0,0,187.842861,0.005417999999991707,1509043,0
"172.16.133.95",57096,"172.16.139.250",5440,10,1022,15527,0,0,10,1022,0,0,187.883573,0.015506999999985283,527245,0
"172.16.133.11",55294,"78.108.117.250",443,6,366,15528,0,0,4,246,2,120,187.903629,0.19757699999999545,9960,4858
"172.16.133.92",57809,"172.16.139.250",5440,10,1022,15529,0,0,10,1022,0,0,187.910729,0.005507999999991853,1484386,0
"172.16.133.11",55295,"216.219.117.244",443,6,366,15530,0,0,4,246,2,120,187.911482,0.19872399999999857,9903,4830
"172.16.133.29",61112,"172.16.139.250",5440,10,1022,15531,0,0,10,1022,0,0,187.92809,0.005287000000009812,1546434,0
"172.16.133.44",64964,"172.16.139.250",5440,10,1022,15532,0,0,10,1022,0,0,187.934905,0.005436000000003105,1504047,0
"172.16.133.207",56060,"172.16.139.250",5440,12,1142,15533,0,0,12,1142,0,0,187.959656,0.017606999999998152,518884,0
"172.16.133.83",57217,"172.16.139.250",5440,12,1142,15534,0,0,12,1142,0,0,187.968505,0.004892000000012331,"",""
"172.16.133.93",60888,"172.16.139.250",5440,12,1142,15535,0,0,12,1142,0,0,187.984523,0.014479999999991833,630939,0
"172.16.133.11",55296,"172.16.139.250",5440,10,1022,15536,0,0,10,1022,0,0,188.001537,0.005524999999977354,1479819,0
"172.16.133.55",57761,"172.16.139.250",5440,10,1022,15537,0,0,10,1022,0,0,188.00573,0.006273999999990565,1303155,0
"172.16.133.73",60818,"172.16.139.250",5440,10,1022,15538,0,0,10,1022,0,0,188.028298,0.015289999999993142,534728,0
"172.16.133.45",61381,"209.99.98.33",80,15,5365,15539,0,0,8,1793,7,3572,188.030544,12.824818000000022,1118,2228
"172.16.133.53",54245,"172.16.139.250",5440,10,1022,15540,0,0,10,1022,0,0,188.031919,0.019852000000014414,411847,0
"172.16.133.21",53320,"172.16.139.250",5440,10,1022,15541,0,0,10,1022,0,0,188.034048,0.03363199999998301,243101,0
"172.16.133.30",62811,"172.16.139.250",5440,10,1022,15542,0,0,10,1022,0,0,188.038476,0.009300999999993564,879045,0
"172.16.133.25",63619,"172.16.139.250",5440,12,1142,15543,0,0,12,1142,0,0,188.044689,0.017989999999997508,507837,0
"172.16.133.34",50588,"172.16.139.250",5440,12,1142,15544,0,0,12,1142,0,0,188.05428,0.016709999999989122,546738,0
"172.16.133.57",60634,"157.56.242.198",443,579,461404,15545,0,0,287,213090,292,248314,188.061279,61.82317899999998,27574,32132
"172.16.133.97",59521,"172.16.139.250",5440,12,1142,15546,0,0,12,1142,0,0,188.065224,0.01030099999999834,886904,0
"172.16.133.33",58031,"172.16.139.250",5440,12,1142,15547,0,0,12,1142,0,0,188.136341,0.006535000000013724,1398010,0
"172.16.133.68",60889,"172.16.139.250",5440,12,1142,15548,0,0,12,1142,0,0,188.171021,0.006501000000014301,1405322,0
"172.16.133.12",59909,"172.16.139.250",5440,10,1022,15549,0,0,10,1022,0,0,188.184502,0.006120999999978949,1335729,0
"172.16.133.63",54068,"172.16.139.250",5440,10,1022,15550,0,0,10,1022,0,0,188.196,0.005224999999995816,1564784,0
"172.16.133.66",54299,"172.16.139.250",5440,12,1142,15551,0,0,12,1142,0,0,188.207858,0.006576000000023896,1389294,0
"172.16.133.11",55297,"202.173.25.200",443,6,366,15552,0,0,4,246,2,120,188.21268,0.5415529999999933,3633,1772
"172.16.133.82",61570,"172.16.139.250",5440,10,1022,15553,0,0,10,1022,0,0,188.221444,0.005703000000011116,1433631,0
"172.16.133.116",53764,"96.43.146.48",443,24,7816,15554,0,0,14,3509,10,4307,188.229625,24.53864200000001,1143,1404
"172.16.133.37",60776,"172.16.139.250",5440,12,1142,15555,0,0,12,1142,0,0,188.233944,0.006440999999995256,1418413,0
"172.16.133.45",61382,"209.99.98.33",80,10,2096,15556,0,0,6,996,4,1100,188.240992,12.618526000000003,631,697
"172.16.133.45",61383,"209.99.98.33",80,10,1764,15557,0,0,6,1009,4,755,188.241176,12.618106000000012,639,478
"172.16.133.96",53361,"96.43.146.22",443,13,3929,15558,0,0,8,3164,5,765,188.26267,0.28251399999999194,89595,21662
"172.16.133.78",59381,"172.16.139.250",5440,10,1022,15559,0,0,10,1022,0,0,188.3915,0.005511999999981754,1483309,0
"172.16.133.67",56127,"172.16.139.250",5440,12,1142,15560,0,0,12,1142,0,0,188.445854,0.006412000000011631,1424828,0
"172.16.133.56",61568,"172.16.139.250",5440,12,1142,15561,0,0,12,1142,0,0,188.469296,0.008130999999991673,1123601,0
"172.16.133.41",53282,"172.16.139.250",5440,12,1142,15562,0,0,12,1142,0,0,188.524484,0.016268999999994094,561558,0
"172.16.133.67",56128,"64.4.11.25",80,13,4612,15563,0,0,8,2338,5,2274,188.550307,19.893226999999996,940,914
"172.16.133.85",52407,"172.16.139.250",5440,12,1142,15564,0,0,12,1142,0,0,188.588247,0.005367000000006783,1702254,0
"172.16.133.42",57255,"172.16.139.250",5440,12,1142,15565,0,0,12,1142,0,0,188.594846,0.060567000000020244,150841,0
"172.16.133.43",57912,"172.16.139.250",5440,12,1142,15566,0,0,12,1142,0,0,188.595912,0.015227000000010094,599986,0
"172.16.133.13",53172,"172.16.139.250",5440,10,1022,15567,0,0,10,1022,0,0,188.614942,0.006175999999982196,1323834,0
"172.16.133.96",53362,"173.194.43.53",443,23,4349,15568,0,0,13,2883,10,1466,188.621119,20.250574,1138,579
"172.16.133.96",53363,"173.194.43.53",443,26,5232,15569,0,0,15,2970,11,2262,188.624385,17.035687000000024,1394,1062
"172.16.133.67",56129,"172.16.139.250",5440,10,1016,15570,0,0,10,1016,0,0,188.662164,0.003934000000015203,"",""
"172.16.133.20",62540,"172.16.139.250",5440,10,1022,15571,0,0,10,1022,0,0,188.66358,0.006236999999998716,1310886,0
"172.16.133.37",60777,"157.56.240.137",443,6,374,15572,0,0,3,194,3,180,188.679355,1.1401380000000074,1361,1263
"172.16.133.28",49263,"172.16.139.250",5440,12,1142,15573,0,0,12,1142,0,0,188.692906,0.015467000000001008,590676,0
"172.16.133.99",56197,"172.16.139.250",5440,12,1142,15574,0,0,12,1142,0,0,188.720472,0.014993000000004031,609351,0
"172.16.133.75",51107,"172.16.139.250",5440,10,1022,15575,0,0,10,1022,0,0,188.730482,0.008499000000000478,961995,0
"172.16.133.87",60365,"172.16.139.250",5440,10,1022,15576,0,0,10,1022,0,0,188.745065,0.015647999999998774,522494,0
"172.16.133.35",50103,"172.16.139.250",5440,12,1142,15577,0,0,12,1142,0,0,188.752626,0.08324300000001017,109750,0
"172.16.133.116",53765,"172.16.139.250",5440,10,1022,15578,0,0,10,1022,0,0,188.757609,0.014489999999995007,564251,0
"172.16.133.29",61113,"23.0.49.244",80,6,372,15579,0,0,4,246,2,126,188.767623,12.335578000000027,159,81
"172.16.133.29",61114,"23.0.49.244",80,7,432,15580,0,0,4,246,3,186,188.767857,12.373034000000018,159,120
"172.16.133.116",53766,"172.16.139.250",5440,12,1142,15581,0,0,12,1142,0,0,188.772649,0.0060980000000085965,1498196,0
"172.16.133.84",58933,"172.16.139.250",5440,10,1022,15582,0,0,10,1022,0,0,188.779177,0.005453999999986081,1499083,0
"172.16.133.116",53767,"172.16.139.250",5440,10,1022,15583,0,0,10,1022,0,0,188.779896,0.009221999999994068,886575,0
"172.16.133.67",54003,"65.54.80.250",80,2,120,15584,0,0,1,60,1,60,188.782944,8.700000000771979e-05,"",""
"172.16.133.67",56130,"65.54.80.250",80,13,2170,15585,0,0,7,1540,6,630,188.78303,19.249040000000008,640,261
"172.16.133.49",55924,"172.16.139.250",5440,10,1022,15586,0,0,10,1022,0,0,188.856485,0.015396000000009735,531047,0
"172.16.133.75",51108,"216.219.115.183",443,19,5105,15587,0,0,9,1046,10,4059,188.883133,0.23880900000000338,35040,135974
"172.16.133.75",51109,"216.219.115.160",443,19,5105,15588,0,0,9,1046,10,4059,188.883978,0.23434899999998038,35707,138562
"172.16.133.95",57097,"172.16.139.250",5440,10,1022,15589,0,0,10,1022,0,0,188.897598,0.015448000000020556,529259,0
"172.16.133.92",57810,"172.16.139.250",5440,10,1022,15590,0,0,10,1022,0,0,188.924301,0.020717999999988024,394632,0
"172.16.133.29",61115,"172.16.139.250",5440,10,1022,15591,0,0,10,1022,0,0,188.941032,0.007931999999982509,1030761,0
"172.16.133.44",64965,"172.16.139.250",5440,10,1022,15592,0,0,10,1022,0,0,188.949325,0.005486000000018976,1490339,0
"172.16.133.207",56061,"172.16.139.250",5440,10,1022,15593,0,0,10,1022,0,0,188.974056,0.004863000000000284,"",""
"172.16.133.83",57218,"172.16.139.250",5440,12,1142,15594,0,0,12,1142,0,0,188.982559,0.004818999999997686,"",""
"172.16.133.93",60889,"172.16.139.250",5440,10,1022,15595,0,0,10,1022,0,0,188.99848,0.004742999999990616,"",""
"172.16.133.29",61116,"138.108.6.20",80,14,4774,15596,0,0,8,3172,6,1602,188.998766,26.732400000000013,949,479
"172.16.133.29",61117,"64.94.107.11",80,8,1982,15597,0,0,5,1519,3,463,189.012476,0.06736200000000281,180398,54986
"172.16.133.11",55298,"172.16.139.250",5440,10,1022,15598,0,0,10,1022,0,0,189.015417,0.015413999999992711,530426,0
"172.16.133.55",57762,"172.16.139.250",5440,10,1022,15599,0,0,10,1022,0,0,189.019828,0.015437000000019907,529636,0
"172.16.133.73",60819,"172.16.139.250",5440,10,1022,15600,0,0,10,1022,0,0,189.042371,0.005594000000002097,1461565,0
"172.16.133.53",54246,"172.16.139.250",5440,10,1022,15601,0,0,10,1022,0,0,189.045332,0.015940999999997985,512891,0
"172.16.133.21",53321,"172.16.139.250",5440,12,1142,15602,0,0,12,1142,0,0,189.048778,0.016145999999992,565836,0
"172.16.133.30",62812,"172.16.139.250",5440,10,1022,15603,0,0,10,1022,0,0,189.052524,0.016000999999988608,510968,0
"172.16.133.25",63620,"172.16.139.250",5440,10,1022,15604,0,0,10,1022,0,0,189.059548,0.012896999999981063,633945,0
"172.16.133.34",50589,"172.16.139.250",5440,10,1022,15605,0,0,10,1022,0,0,189.068446,0.007808000000011361,1047131,0
"172.16.133.25",63621,"72.28.142.76",35495,34,4312,15606,0,0,18,2279,16,2033,189.078008,106.90058299999998,170,152
"172.16.133.97",59522,"172.16.139.250",5440,10,1022,15607,0,0,10,1022,0,0,189.07941,0.005387000000013131,1517727,0
"172.16.133.75",51110,"64.74.80.185",443,16,4863,15608,0,0,8,923,8,3940,189.113413,0.21866799999997966,33768,144145
"172.16.133.33",58032,"172.16.139.250",5440,10,1022,15609,0,0,10,1022,0,0,189.150309,0.014901000000008935,548688,0
"172.16.133.103",63444,"172.16.139.250",5440,6,780,15610,0,0,6,780,0,0,189.172019,0.0014040000000079544,"",""
"172.16.133.68",60890,"172.16.139.250",5440,12,1142,15611,0,0,12,1142,0,0,189.185024,0.0061210000000073705,1492566,0
"172.16.133.12",59910,"172.16.139.250",5440,12,1142,15612,0,0,12,1142,0,0,189.198545,0.005450999999993655,1676022,0
"172.16.133.63",54069,"172.16.139.250",5440,10,1022,15613,0,0,10,1022,0,0,189.210213,0.005507999999991853,1484386,0
"172.16.133.85",52408,"132.245.1.150",443,23,9751,15614,0,0,10,1984,13,7767,189.216559,0.23275200000000495,68192,266962
"172.16.133.66",54300,"172.16.139.250",5440,10,1022,15615,0,0,10,1022,0,0,189.222642,0.005684000000002243,1438423,0
"172.16.133.82",61571,"172.16.139.250",5440,10,1022,15616,0,0,10,1022,0,0,189.235357,0.014724999999998545,555246,0
"172.16.133.37",60778,"172.16.139.250",5440,10,1022,15617,0,0,10,1022,0,0,189.24941,0.005704999999977645,1433128,0
"172.16.133.78",59382,"172.16.139.250",5440,10,1022,15618,0,0,10,1022,0,0,189.405218,0.005089999999995598,1606286,0
"172.16.133.68",60891,"173.194.43.36",443,25,7962,15619,0,0,14,3686,11,4276,189.449725,90.21983999999998,326,379
"172.16.133.67",56131,"172.16.139.250",5440,10,1022,15620,0,0,10,1022,0,0,189.461188,0.005547000000007074,1473949,0
"172.16.133.56",61569,"172.16.139.250",5440,12,1142,15621,0,0,12,1142,0,0,189.483483,0.005077999999997473,1799133,0
"172.16.133.41",53283,"172.16.139.250",5440,12,1142,15622,0,0,12,1142,0,0,189.538514,0.016013000000015154,570536,0
"172.16.133.85",52409,"172.16.139.250",5440,12,1142,15623,0,0,12,1142,0,0,189.601982,0.006253000000015163,1461058,0
"172.16.133.42",57256,"172.16.139.250",5440,12,1142,15624,0,0,12,1142,0,0,189.603051,0.029771000000010872,306875,0
"172.16.133.43",57913,"172.16.139.250",5440,10,1022,15625,0,0,10,1022,0,0,189.60848,0.0055490000000020245,1473418,0
"172.16.133.13",53173,"172.16.139.250",5440,12,1142,15626,0,0,12,1142,0,0,189.62809,0.015622000000007574,584816,0
"172.16.133.20",62541,"172.16.139.250",5440,12,1142,15627,0,0,12,1142,0,0,189.677439,0.004891000000014856,"",""
"172.16.133.28",49264,"172.16.139.250",5440,10,1022,15628,0,0,10,1022,0,0,189.707309,0.005438999999995531,1503217,0
"172.16.133.99",56198,"172.16.139.250",5440,12,1142,15629,0,0,12,1142,0,0,189.734336,0.016199000000000296,563985,0
"172.16.133.37",60779,"180.153.30.250",443,6,366,15630,0,0,4,246,2,120,189.739721,0.7736470000000111,2543,1240
"172.16.133.75",51111,"172.16.139.250",5440,12,1142,15631,0,0,12,1142,0,0,189.740635,0.0060709999999915,1504859,0
"172.16.133.87",60366,"172.16.139.250",5440,10,1022,15632,0,0,10,1022,0,0,189.759081,0.005935999999991282,1377358,0
"172.16.133.35",50104,"172.16.139.250",5440,12,1142,15633,0,0,12,1142,0,0,189.764592,0.008686000000011518,1051807,0
"172.16.133.116",53768,"172.16.139.250",5440,10,1022,15634,0,0,10,1022,0,0,189.771279,0.005975000000006503,1368368,0
"172.16.133.11",55299,"67.217.95.254",443,6,366,15635,0,0,4,246,2,120,189.772719,0.07112399999999752,27669,13497
"172.16.133.116",53769,"172.16.139.250",5440,10,1022,15636,0,0,10,1022,0,0,189.77868,0.005538000000001375,1476345,0
"172.16.133.82",61572,"64.56.203.22",443,34,20945,15637,0,0,15,5772,19,15173,189.78401,14.683542000000017,3144,8266
"172.16.133.116",53770,"172.16.139.250",5440,12,1142,15638,0,0,12,1142,0,0,189.786352,0.015949000000006208,572825,0
"172.16.133.84",58934,"172.16.139.250",5440,10,1022,15639,0,0,10,1022,0,0,189.792991,0.009905000000003383,825441,0
"172.16.133.37",60780,"157.56.244.217",443,6,374,15640,0,0,3,194,3,180,189.820076,1.151769999999999,1347,1250
"172.16.133.113",55674,"172.16.139.250",135,8,492,15641,0,0,8,492,0,0,189.820793,0.014415999999982887,273029,0
"172.16.133.113",55675,"172.16.139.250",5462,12,816,15642,0,0,12,816,0,0,189.835849,0.510546000000005,12786,0
"172.16.133.49",55925,"172.16.139.250",5440,12,1142,15643,0,0,12,1142,0,0,189.870221,0.01633300000000304,559358,0
"172.16.133.95",57098,"172.16.139.250",5440,10,1022,15644,0,0,10,1022,0,0,189.911556,0.01581600000000094,516944,0
"172.16.133.92",57811,"172.16.139.250",5440,12,1142,15645,0,0,12,1142,0,0,189.937382,0.006620999999995547,1379851,0
"172.16.133.29",61118,"172.16.139.250",5440,10,1022,15646,0,0,10,1022,0,0,189.954941,0.005701000000016165,1434134,0
"172.16.133.44",64966,"172.16.139.250",5440,10,1022,15647,0,0,10,1022,0,0,189.961959,0.015275000000002592,535253,0
"172.16.133.207",56062,"172.16.139.250",5440,10,1022,15648,0,0,10,1022,0,0,189.986399,0.005628000000001521,1452736,0
"172.16.133.83",57219,"172.16.139.250",5440,10,1022,15649,0,0,10,1022,0,0,189.996617,0.00472700000000259,"",""
"172.16.133.11",55300,"78.108.117.250",443,6,366,15650,0,0,4,246,2,120,190.00172,0.30032099999999673,6552,3196
"172.16.133.11",55301,"216.219.117.244",443,6,366,15651,0,0,4,246,2,120,190.009598,0.3011719999999798,6534,3187
"172.16.133.93",60890,"172.16.139.250",5440,10,1022,15652,0,0,10,1022,0,0,190.011458,0.004717999999996891,"",""
"172.16.133.11",55302,"172.16.139.250",5440,10,1022,15653,0,0,10,1022,0,0,190.029202,0.005550999999996975,1472887,0
"172.16.133.55",57763,"172.16.139.250",5440,10,1022,15654,0,0,10,1022,0,0,190.034038,0.01595100000000116,512569,0
"172.16.133.116",53771,"208.111.161.254",80,9,558,15655,0,0,5,312,4,246,190.040935,22.111373000000015,112,89
"172.16.133.116",53772,"208.111.161.254",80,9,558,15656,0,0,5,312,4,246,190.043817,22.108490000000018,112,89
"172.16.133.73",60820,"172.16.139.250",5440,12,1142,15657,0,0,12,1142,0,0,190.056298,0.015973999999999933,571929,0
"172.16.133.53",54247,"172.16.139.250",5440,10,1022,15658,0,0,10,1022,0,0,190.059395,0.0054980000000171,1487086,0
"172.16.133.21",53322,"172.16.139.250",5440,10,1022,15659,0,0,10,1022,0,0,190.062805,0.016821999999990567,486030,0
"172.16.133.30",62813,"172.16.139.250",5440,10,1022,15660,0,0,10,1022,0,0,190.066591,0.00881800000001931,927194,0
"172.16.133.25",63622,"172.16.139.250",5440,10,1022,15661,0,0,10,1022,0,0,190.072488,0.010461000000020704,781569,0
"172.16.133.34",50590,"172.16.139.250",5440,10,1022,15662,0,0,10,1022,0,0,190.082472,0.005337999999994736,1531659,0
"172.16.133.97",59523,"172.16.139.250",5440,10,1022,15663,0,0,10,1022,0,0,190.092298,0.015299999999996317,534379,0
"172.16.133.101",51139,"96.43.146.32",443,13,4287,15664,0,0,8,3451,5,836,190.107736,0.34130700000000047,80889,19595
"172.16.133.33",58033,"172.16.139.250",5440,10,1022,15665,0,0,10,1022,0,0,190.164489,0.01553999999998723,526126,0
"172.16.133.68",60892,"172.16.139.250",5440,10,1022,15666,0,0,10,1022,0,0,190.199603,0.01533399999999574,533194,0
"172.16.133.12",59911,"172.16.139.250",5440,12,1142,15667,0,0,12,1142,0,0,190.212495,0.006212000000004991,1470701,0
"172.16.133.63",54070,"172.16.139.250",5440,10,1022,15668,0,0,10,1022,0,0,190.224313,0.015706999999991922,520532,0
"172.16.133.66",54301,"172.16.139.250",5440,10,1022,15669,0,0,10,1022,0,0,190.235022,0.009563000000014199,854961,0
"172.16.133.82",61573,"172.16.139.250",5440,10,1022,15670,0,0,10,1022,0,0,190.248981,0.00582800000000816,1402882,0
"172.16.133.37",60781,"172.16.139.250",5440,10,1022,15671,0,0,10,1022,0,0,190.26236,0.0052849999999864394,1547019,0
"172.16.133.116",53773,"208.111.161.254",80,136,85207,15672,0,0,51,13480,85,71727,190.288114,103.28625499999998,1044,5555
"172.16.133.78",59383,"172.16.139.250",5440,10,1022,15673,0,0,10,1022,0,0,190.419397,0.005453999999986081,1499083,0
"172.16.133.67",56132,"172.16.139.250",5440,12,1142,15674,0,0,12,1142,0,0,190.473871,0.006205999999991718,1472123,0
"172.16.133.82",61574,"64.56.203.22",443,19,7975,15675,0,0,10,3326,9,4649,190.480289,14.586918999999995,1824,2549
"172.16.133.82",61575,"64.56.203.22",443,15,3955,15676,0,0,8,2933,7,1022,190.480347,13.988193999999993,1677,584
"172.16.133.82",61576,"64.56.203.22",443,21,9789,15677,0,0,11,3456,10,6333,190.480463,14.58773500000001,1895,3473
"172.16.133.11",55303,"202.173.25.200",443,6,366,15678,0,0,4,246,2,120,190.483744,0.5320250000000044,3699,1804
"172.16.133.56",61570,"172.16.139.250",5440,12,1142,15679,0,0,12,1142,0,0,190.49682,0.005066999999996824,1803039,0
"172.16.133.116",53774,"208.111.161.254",80,21,14062,15680,0,0,8,1779,13,12283,190.533841,31.616885999999994,450,3107
"172.16.133.41",53284,"172.16.139.250",5440,10,1022,15681,0,0,10,1022,0,0,190.552362,0.014493000000015854,564134,0
"172.16.133.85",52410,"172.16.139.250",5440,10,1022,15682,0,0,10,1022,0,0,190.616071,0.01685200000000009,485164,0
"172.16.133.42",57257,"172.16.139.250",5440,12,1142,15683,0,0,12,1142,0,0,190.616421,0.007569999999986976,1206869,0
"172.16.133.43",57914,"172.16.139.250",5440,10,1022,15684,0,0,10,1022,0,0,190.623577,0.00566499999999337,1443248,0
"172.16.133.116",53775,"208.111.161.254",80,95,57063,15685,0,0,37,10356,58,46707,190.629348,102.98236000000003,804,3628
"172.16.133.116",53776,"208.111.161.254",80,88,50067,15686,0,0,33,8751,55,41316,190.634352,102.820547,680,3214
"172.16.133.116",53777,"208.111.161.254",80,100,61417,15687,0,0,39,10957,61,50460,190.634895,102.95068899999998,851,3921
"172.16.133.13",53174,"172.16.139.250",5440,10,1022,15688,0,0,10,1022,0,0,190.64144,0.016514000000000806,495095,0
"172.16.133.20",62542,"172.16.139.250",5440,12,1142,15689,0,0,12,1142,0,0,190.691487,0.004817000000002736,"",""
"172.16.133.28",49265,"172.16.139.250",5440,10,1022,15690,0,0,10,1022,0,0,190.720598,0.0060380000000179734,1354090,0
"172.16.133.99",56199,"172.16.139.250",5440,10,1022,15691,0,0,10,1022,0,0,190.748665,0.016122000000024173,507133,0
"172.16.133.75",51112,"172.16.139.250",5440,10,1022,15692,0,0,10,1022,0,0,190.755363,0.00543700000000058,1503770,0
"172.16.133.87",60367,"172.16.139.250",5440,10,1022,15693,0,0,10,1022,0,0,190.77318,0.01962700000001405,416569,0
"172.16.133.35",50105,"172.16.139.250",5440,12,1142,15694,0,0,12,1142,0,0,190.779023,0.0120380000000182,758930,0
"172.16.133.116",53778,"172.16.139.250",5440,12,1142,15695,0,0,12,1142,0,0,190.786687,0.010481999999996106,871589,0
"172.16.133.116",53779,"172.16.139.250",5440,12,1142,15696,0,0,12,1142,0,0,190.797786,0.005887999999998783,1551630,0
"172.16.133.116",53780,"172.16.139.250",5440,12,1142,15697,0,0,12,1142,0,0,190.804271,0.006011999999998352,1519627,0
"172.16.133.84",58937,"172.16.139.250",5440,10,1022,15698,0,0,10,1022,0,0,190.807116,0.0062899999999785905,1299841,0
"172.16.133.49",55926,"172.16.139.250",5440,12,1142,15699,0,0,12,1142,0,0,190.885309,0.015069999999980155,606237,0
"172.16.133.96",53367,"204.236.235.239",80,11,1427,15700,0,0,6,904,5,523,190.915017,0.09039999999998827,80000,46283
"172.16.133.95",57099,"172.16.139.250",5440,10,1022,15701,0,0,10,1022,0,0,190.924406,0.007022000000006301,1164340,0
"172.16.133.92",57812,"172.16.139.250",5440,12,1142,15702,0,0,12,1142,0,0,190.952468,0.01566199999999185,583322,0
"172.16.133.29",61119,"172.16.139.250",5440,10,1022,15703,0,0,10,1022,0,0,190.970358,0.005244000000004689,1559115,0
"172.16.133.44",64967,"172.16.139.250",5440,12,1142,15704,0,0,12,1142,0,0,190.9764,0.006277999999980466,1455240,0
"172.16.133.37",60782,"65.55.171.159",443,6,374,15705,0,0,3,194,3,180,190.978948,1.0932410000000061,1419,1317
"172.16.133.207",56063,"172.16.139.250",5440,12,1142,15706,0,0,12,1142,0,0,191.0015,0.017848000000014963,511878,0
"172.16.133.83",57220,"172.16.139.250",5440,12,1142,15707,0,0,12,1142,0,0,191.010626,0.0047509999999988395,"",""
"172.16.133.93",60891,"172.16.139.250",5440,10,1022,15708,0,0,10,1022,0,0,191.026672,0.01420500000000402,575571,0
"172.16.133.11",55304,"172.16.139.250",5440,10,1022,15709,0,0,10,1022,0,0,191.043056,0.005791999999985364,1411602,0
"172.16.133.55",57764,"172.16.139.250",5440,10,1022,15710,0,0,10,1022,0,0,191.047906,0.005495999999993728,1487627,0
"172.16.133.73",60821,"172.16.139.250",5440,10,1022,15711,0,0,10,1022,0,0,191.070474,0.0054620000000227265,1496887,0
"172.16.133.53",54248,"172.16.139.250",5440,12,1142,15712,0,0,12,1142,0,0,191.073923,0.01523199999999747,599789,0
"172.16.133.21",53323,"172.16.139.250",5440,12,1142,15713,0,0,12,1142,0,0,191.076168,0.01695399999999836,538869,0
"172.16.133.30",62814,"172.16.139.250",5440,10,1022,15714,0,0,10,1022,0,0,191.08106,0.015924999999981537,513406,0
"172.16.133.25",63623,"172.16.139.250",5440,12,1142,15715,0,0,12,1142,0,0,191.087667,0.017940999999979113,509224,0
"172.16.133.34",50591,"172.16.139.250",5440,10,1022,15716,0,0,10,1022,0,0,191.09635,0.005255000000005339,1555851,0
"172.16.133.97",59524,"172.16.139.250",5440,12,1142,15717,0,0,12,1142,0,0,191.107199,0.014633000000003449,624342,0
"172.16.133.26",53102,"172.16.139.250",5440,6,780,15718,0,0,6,780,0,0,191.175507,0.001125000000001819,"",""
"172.16.133.33",58034,"172.16.139.250",5440,10,1022,15719,0,0,10,1022,0,0,191.17836,0.0057099999999934425,1431873,0
"172.16.133.68",60893,"172.16.139.250",5440,12,1142,15720,0,0,12,1142,0,0,191.213535,0.00645099999999843,1416214,0
"172.16.133.12",59912,"172.16.139.250",5440,10,1022,15721,0,0,10,1022,0,0,191.226636,0.005463999999989255,1496339,0
"172.16.133.116",53781,"138.108.7.20",80,8,1694,15722,0,0,4,1036,4,658,191.230023,13.458965000000006,615,391
"172.16.133.63",54071,"172.16.139.250",5440,12,1142,15723,0,0,12,1142,0,0,191.238246,0.006114999999994097,1494031,0
"172.16.133.116",53782,"64.94.107.62",80,8,1680,15724,0,0,5,1217,3,463,191.24813,0.0691889999999944,140716,53534
"172.16.133.66",54302,"172.16.139.250",5440,10,1022,15725,0,0,10,1022,0,0,191.248947,0.005652000000026192,1446567,0
"172.16.133.82",61577,"172.16.139.250",5440,12,1142,15726,0,0,12,1142,0,0,191.263483,0.0066740000000038435,1368894,0
"172.16.133.37",60783,"172.16.139.250",5440,10,1022,15727,0,0,10,1022,0,0,191.276123,0.005574999999993224,1466547,0
"172.16.133.82",61578,"204.232.250.57",443,18,4624,15728,0,0,10,3584,8,1040,191.348581,14.42818600000001,1987,576
"172.16.133.78",59384,"172.16.139.250",5440,10,1022,15729,0,0,10,1022,0,0,191.433145,0.007368000000013808,1109663,0
"172.16.133.67",56133,"172.16.139.250",5440,10,1022,15730,0,0,10,1022,0,0,191.487957,0.005011999999993577,1631284,0
"172.16.133.56",61571,"172.16.139.250",5440,10,1022,15731,0,0,10,1022,0,0,191.51034,0.047216999999989184,173157,0
"172.16.133.41",53285,"172.16.139.250",5440,10,1022,15732,0,0,10,1022,0,0,191.566381,0.014673999999985199,557175,0
"172.16.133.85",52411,"172.16.139.250",5440,10,1022,15733,0,0,10,1022,0,0,191.630186,0.005482000000000653,1491426,0
"172.16.133.42",57258,"172.16.139.250",5440,12,1142,15734,0,0,12,1142,0,0,191.631795,0.013373999999998887,683116,0
"172.16.133.43",57915,"172.16.139.250",5440,10,1022,15735,0,0,10,1022,0,0,191.637976,0.00577999999998724,1414532,0
"172.16.133.13",53175,"172.16.139.250",5440,12,1142,15736,0,0,12,1142,0,0,191.655197,0.00613200000000802,1489889,0
"172.16.133.20",62543,"172.16.139.250",5440,10,1022,15737,0,0,10,1022,0,0,191.705592,0.004704000000003816,"",""
"172.16.133.28",49266,"172.16.139.250",5440,10,1022,15738,0,0,10,1022,0,0,191.734558,0.005287000000009812,1546434,0
"172.16.133.99",56200,"172.16.139.250",5440,10,1022,15739,0,0,10,1022,0,0,191.762474,0.005289000000004762,1545849,0
"172.16.133.75",51113,"172.16.139.250",5440,10,1022,15740,0,0,10,1022,0,0,191.768697,0.005295999999987089,1543806,0
"172.16.133.87",60368,"172.16.139.250",5440,10,1022,15741,0,0,10,1022,0,0,191.787216,0.0054419999999879565,1502388,0
"172.16.133.116",53783,"172.16.139.250",5440,12,1142,15742,0,0,12,1142,0,0,191.799637,0.006005000000016025,1521398,0
"172.16.133.116",53784,"172.16.139.250",5440,12,1142,15743,0,0,12,1142,0,0,191.806095,0.005210000000005266,1753550,0
"172.16.133.116",53785,"172.16.139.250",5440,12,1142,15744,0,0,12,1142,0,0,191.811944,0.005972999999983131,1529549,0
"172.16.133.84",58938,"172.16.139.250",5440,10,1022,15745,0,0,10,1022,0,0,191.821141,0.05154299999998102,158624,0
"172.16.133.11",55305,"67.217.95.254",443,6,366,15746,0,0,4,246,2,120,191.826867,0.08184300000002054,24046,11729
"172.16.133.35",50106,"172.16.139.250",5440,12,1142,15747,0,0,12,1142,0,0,191.878215,0.010578999999978578,863597,0
"172.16.133.49",55927,"172.16.139.250",5440,12,1142,15748,0,0,12,1142,0,0,191.899313,0.006329999999991287,1443285,0
"172.16.133.132",38485,"23.32.181.109",80,6,412,15749,0,0,4,272,2,140,191.936421,0.044389999999992824,49020,25230
"172.16.133.95",57100,"172.16.139.250",5440,10,1022,15750,0,0,10,1022,0,0,191.938769,0.0064940000000035525,1259008,0
"172.16.133.92",57813,"172.16.139.250",5440,12,1142,15751,0,0,12,1142,0,0,191.98234,0.006073000000014872,1504363,0
"172.16.133.29",61120,"172.16.139.250",5440,10,1022,15752,0,0,10,1022,0,0,191.982513,0.009082999999975527,900143,0
"172.16.133.132",42149,"64.94.107.19",80,7,436,15753,0,0,4,254,3,182,191.988018,0.04603699999998412,44138,31626
"172.16.133.44",64968,"172.16.139.250",5440,12,1142,15754,0,0,12,1142,0,0,191.989825,0.01533200000000079,595877,0
"172.16.133.207",56064,"172.16.139.250",5440,10,1022,15755,0,0,10,1022,0,0,192.015604,0.014782999999994217,553067,0
"172.16.133.83",57221,"172.16.139.250",5440,12,1142,15756,0,0,12,1142,0,0,192.02487,0.01463699999999335,624171,0
"172.16.133.132",40340,"69.25.24.24",80,6,380,15757,0,0,4,254,2,126,192.038043,0.07395999999999958,27474,13628
"172.16.133.93",60892,"172.16.139.250",5440,10,1022,15758,0,0,10,1022,0,0,192.039768,0.004733999999984917,"",""
"172.16.133.11",55306,"172.16.139.250",5440,10,1022,15759,0,0,10,1022,0,0,192.057583,0.015355999999997039,532430,0
"172.16.133.55",57765,"172.16.139.250",5440,10,1022,15760,0,0,10,1022,0,0,192.061766,0.0055989999999894735,1460260,0
"172.16.133.37",60784,"157.56.234.137",80,8,884,15761,0,0,5,532,3,352,192.075753,0.220546000000013,19297,12768
"172.16.133.73",60822,"172.16.139.250",5440,10,1022,15762,0,0,10,1022,0,0,192.084805,0.014773000000019465,553442,0
"172.16.133.53",54249,"172.16.139.250",5440,12,1142,15763,0,0,12,1142,0,0,192.086451,0.01779399999998077,513431,0
"172.16.133.21",53324,"172.16.139.250",5440,10,1022,15764,0,0,10,1022,0,0,192.090797,0.01679099999998357,486927,0
"172.16.133.30",62815,"172.16.139.250",5440,10,1022,15765,0,0,10,1022,0,0,192.094644,0.020510999999999058,398615,0
"172.16.133.25",63624,"172.16.139.250",5440,10,1022,15766,0,0,10,1022,0,0,192.101015,0.010111000000023296,808624,0
"172.16.133.34",50592,"172.16.139.250",5440,10,1022,15767,0,0,10,1022,0,0,192.110616,0.015116000000006125,540883,0
"172.16.133.97",59525,"172.16.139.250",5440,12,1142,15768,0,0,12,1142,0,0,192.121259,0.01536399999997684,594636,0
"172.16.133.116",53786,"208.47.254.81",80,6,372,15769,0,0,4,246,2,126,192.140339,20.00497199999998,98,50
"172.16.133.132",46408,"23.13.210.227",80,6,412,15770,0,0,4,272,2,140,192.141135,0.05366900000001351,40544,20868
"172.16.133.37",60785,"180.153.30.250",443,6,366,15771,0,0,4,246,2,120,192.148717,0.814471999999995,2416,1178
"172.16.133.33",58035,"172.16.139.250",5440,10,1022,15772,0,0,10,1022,0,0,192.192275,0.05246400000001472,155840,0
"172.16.133.132",50482,"184.172.28.153",80,6,593,15773,0,0,4,266,2,327,192.197707,0.14156699999998068,15031,18478
"172.16.133.11",55307,"78.108.117.250",443,6,366,15774,0,0,4,246,2,120,192.209805,0.20946200000000204,9395,4583
"172.16.133.11",55308,"216.219.117.244",443,6,366,15775,0,0,4,246,2,120,192.216748,0.20427399999999807,9634,4699
"172.16.133.68",60895,"172.16.139.250",5440,12,1142,15776,0,0,12,1142,0,0,192.22637,0.024168000000003076,378020,0
"172.16.133.12",59913,"172.16.139.250",5440,12,1142,15777,0,0,12,1142,0,0,192.240609,0.01399200000000178,652944,0
"172.16.133.63",54072,"172.16.139.250",5440,12,1142,15778,0,0,12,1142,0,0,192.251253,0.015746000000007143,580210,0
"172.16.133.66",54303,"172.16.139.250",5440,10,1022,15779,0,0,10,1022,0,0,192.26414,0.016072000000008302,508710,0
"172.16.133.82",61579,"172.16.139.250",5440,12,1142,15780,0,0,12,1142,0,0,192.277987,0.015504999999990332,589229,0
"172.16.133.37",60786,"172.16.139.250",5440,10,1022,15781,0,0,10,1022,0,0,192.290307,0.007340999999996711,1113744,0
"172.16.133.6",1179,"172.16.128.201",2979,37,6894,15782,0,0,18,3921,19,2973,192.313276,100.062018,313,237
"172.16.133.132",40273,"23.0.51.167",80,6,412,15783,0,0,4,272,2,140,192.386096,0.06584799999998836,33045,17008
"172.16.128.201",2978,"172.16.133.6",1179,47,8453,15784,0,0,24,4277,23,4176,192.412366,100.09577400000003,341,333
"172.16.133.78",59385,"172.16.139.250",5440,12,1142,15785,0,0,12,1142,0,0,192.447933,0.005956999999995105,1533657,0
"172.16.133.132",49892,"173.241.242.7",80,6,374,15786,0,0,4,254,2,120,192.455,0.0468970000000013,43328,20470
"172.16.133.110",34507,"174.129.20.55",80,10,1098,15787,0,0,6,514,4,584,192.502046,0.09107699999998431,45148,51297
"172.16.133.67",56134,"172.16.139.250",5440,10,1022,15788,0,0,10,1022,0,0,192.503305,0.0065789999999879,1242742,0
"172.16.133.132",51995,"50.116.194.21",80,6,374,15789,0,0,4,254,2,120,192.509196,0.08512999999999238,23869,11276
"172.16.133.56",61572,"172.16.139.250",5440,12,1142,15790,0,0,12,1142,0,0,192.524296,0.005136000000021568,1778816,0
"172.16.133.41",53286,"172.16.139.250",5440,10,1022,15791,0,0,10,1022,0,0,192.580486,0.005387999999982185,1517446,0
"172.16.133.132",49688,"70.42.13.101",80,6,374,15792,0,0,4,254,2,120,192.597971,0.04107300000001146,49472,23373
"172.16.133.85",52412,"172.16.139.250",5440,12,1142,15793,0,0,12,1142,0,0,192.643883,0.018191000000001623,502226,0
"172.16.133.42",57259,"172.16.139.250",5440,12,1142,15794,0,0,12,1142,0,0,192.647031,0.010727000000002818,851682,0
"172.16.128.201",1060,"172.16.133.6",1643,60,11586,15795,0,0,28,6001,32,5585,192.648876,100.05453700000001,479,446
"172.16.133.6",1642,"172.16.128.201",1060,31,5100,15796,0,0,16,2612,15,2488,192.649074,89.44497099999998,233,222
"172.16.133.43",57916,"172.16.139.250",5440,12,1142,15797,0,0,12,1142,0,0,192.650589,0.007809000000008837,1169932,0
"172.16.133.13",53176,"172.16.139.250",5440,10,1022,15798,0,0,10,1022,0,0,192.669515,0.006067000000001599,1347618,0
"172.16.133.132",59895,"138.108.7.20",80,6,412,15799,0,0,4,272,2,140,192.670277,0.20352500000001328,10691,5503
"172.16.133.18",50303,"174.129.20.55",443,25,9524,15800,0,0,12,2270,13,7254,192.694505,10.32352400000002,1759,5621
"172.16.133.20",62544,"172.16.139.250",5440,12,1142,15801,0,0,12,1142,0,0,192.719402,0.004902999999984559,"",""
"172.16.133.28",49267,"172.16.139.250",5440,10,1022,15802,0,0,10,1022,0,0,192.750366,0.015308999999973594,534064,0
"172.16.133.57",60635,"17.164.0.36",443,37,7736,15803,0,0,20,2069,17,5667,192.752254,3.0318960000000175,5459,14953
"172.16.133.11",55309,"202.173.25.200",443,6,366,15804,0,0,4,246,2,120,192.752895,0.5406700000000058,3639,1775
"172.16.133.99",56201,"172.16.139.250",5440,10,1022,15805,0,0,10,1022,0,0,192.776575,0.016357999999996764,499816,0
"172.16.133.75",51114,"172.16.139.250",5440,10,1022,15806,0,0,10,1022,0,0,192.783578,0.005578999999983125,1465495,0
"172.16.133.87",60369,"172.16.139.250",5440,10,1022,15807,0,0,10,1022,0,0,192.80124,0.00544800000000123,1500734,0
"172.16.133.35",50107,"172.16.139.250",5440,12,1142,15808,0,0,12,1142,0,0,192.809775,0.027346999999991795,334076,0
"172.16.133.28",49268,"172.16.139.250",5440,12,1142,15809,0,0,12,1142,0,0,192.814277,0.020102000000008502,454482,0
"172.16.133.116",53787,"172.16.139.250",5440,10,1022,15810,0,0,10,1022,0,0,192.814401,0.005884000000008882,1389530,0
"172.16.133.116",53788,"172.16.139.250",5440,10,1022,15811,0,0,10,1022,0,0,192.820894,0.0052989999999795145,1542932,0
"172.16.133.116",53789,"172.16.139.250",5440,10,1022,15812,0,0,10,1022,0,0,192.826759,0.010728999999997768,762046,0
"172.16.133.84",58939,"172.16.139.250",5440,12,1142,15813,0,0,12,1142,0,0,192.835614,0.01602900000000318,569966,0
"172.16.133.49",55928,"172.16.139.250",5440,10,1022,15814,0,0,10,1022,0,0,192.911482,0.005576999999988175,1466021,0
"172.16.133.95",57101,"172.16.139.250",5440,10,1022,15815,0,0,10,1022,0,0,192.952899,0.005423000000007505,1507652,0
"172.16.133.132",46036,"23.67.242.73",80,6,412,15816,0,0,4,272,2,140,192.96065,0.09863500000000158,22061,11354
"172.16.133.92",57814,"172.16.139.250",5440,10,1022,15817,0,0,10,1022,0,0,192.979428,0.015430999999978212,529842,0
"172.16.133.29",61121,"172.16.139.250",5440,10,1022,15818,0,0,10,1022,0,0,192.996507,0.0058339999999930114,1401439,0
"172.16.133.44",64969,"172.16.139.250",5440,10,1022,15819,0,0,10,1022,0,0,193.004171,0.005504999999999427,1485195,0
"172.16.133.207",56065,"172.16.139.250",5440,12,1142,15820,0,0,12,1142,0,0,193.029448,0.0146000000000015,625753,0
"172.16.133.83",57222,"172.16.139.250",5440,10,1022,15821,0,0,10,1022,0,0,193.038719,0.01991600000002336,410524,0
"172.16.133.93",60893,"172.16.139.250",5440,10,1022,15822,0,0,10,1022,0,0,193.053605,0.008926000000002432,915975,0
"172.16.133.11",55310,"172.16.139.250",5440,10,1022,15823,0,0,10,1022,0,0,193.072364,0.005976000000003978,1368139,0
"172.16.133.55",57766,"172.16.139.250",5440,10,1022,15824,0,0,10,1022,0,0,193.075927,0.006237999999996191,1310676,0
"172.16.133.57",60636,"17.172.192.78",443,39,8166,15825,0,0,21,2662,18,5504,193.091817,59.708077,356,737
"172.16.133.132",53680,"74.121.142.248",80,6,412,15826,0,0,4,272,2,140,193.092113,0.059246000000001686,36728,18904
"172.16.133.73",60823,"172.16.139.250",5440,10,1022,15827,0,0,10,1022,0,0,193.098298,0.00561300000001097,1456618,0
"172.16.133.53",54250,"172.16.139.250",5440,10,1022,15828,0,0,10,1022,0,0,193.100489,0.007131999999984373,1146382,0
"172.16.133.21",53325,"172.16.139.250",5440,10,1022,15829,0,0,10,1022,0,0,193.103912,0.019162999999991825,426655,0
"172.16.133.30",62816,"172.16.139.250",5440,10,1022,15830,0,0,10,1022,0,0,193.108988,0.008902999999975236,918342,0
"172.16.133.25",63625,"172.16.139.250",5440,12,1142,15831,0,0,12,1142,0,0,193.115804,0.01774900000000912,514733,0
"172.16.133.34",50593,"172.16.139.250",5440,10,1022,15832,0,0,10,1022,0,0,193.124513,0.005216999999987593,1567184,0
"172.16.133.97",59526,"172.16.139.250",5440,10,1022,15833,0,0,10,1022,0,0,193.134376,0.014814000000001215,551910,0
"172.16.133.132",58576,"54.242.202.249",80,6,376,15834,0,0,4,254,2,122,193.155051,0.04759200000000874,42696,20507
"172.16.133.33",58036,"172.16.139.250",5440,10,1022,15835,0,0,10,1022,0,0,193.207496,0.00572800000000484,1427374,0
"172.16.133.68",60896,"172.16.139.250",5440,10,1022,15836,0,0,10,1022,0,0,193.241192,0.005570999999974902,1467600,0
"172.16.133.12",59914,"172.16.139.250",5440,10,1022,15837,0,0,10,1022,0,0,193.254181,0.005186000000009017,1576552,0
"172.16.133.63",54073,"172.16.139.250",5440,10,1022,15838,0,0,10,1022,0,0,193.266459,0.005381999999997333,1519137,0
"172.16.133.66",54304,"172.16.139.250",5440,10,1022,15839,0,0,10,1022,0,0,193.277414,0.0054990000000145756,1486815,0
"172.16.133.82",61580,"172.16.139.250",5440,10,1022,15840,0,0,10,1022,0,0,193.291649,0.005808999999999287,1407471,0
"172.16.133.37",60787,"172.16.139.250",5440,10,1022,15841,0,0,10,1022,0,0,193.304175,0.005420000000015079,1508487,0
"172.16.133.109",57914,"96.43.146.176",443,31,13403,15842,0,0,16,1680,15,11723,193.319773,0.2374369999999999,56604,394984
"172.16.133.78",59386,"172.16.139.250",5440,12,1142,15843,0,0,12,1142,0,0,193.461664,0.017638999999974203,517943,0
"172.16.133.109",52147,"23.33.81.213",443,42,26138,15844,0,0,19,1965,23,24173,193.515885,0.3085399999999936,50949,626771
"172.16.133.67",56135,"172.16.139.250",5440,12,1142,15845,0,0,12,1142,0,0,193.515973,0.0061979999999834945,1474023,0
"172.16.133.56",61573,"172.16.139.250",5440,10,1022,15846,0,0,10,1022,0,0,193.538113,0.005522999999982403,1480354,0
"172.16.133.41",53287,"172.16.139.250",5440,12,1142,15847,0,0,12,1142,0,0,193.594642,0.006570000000010623,1390563,0
"172.16.133.85",52413,"172.16.139.250",5440,10,1022,15848,0,0,10,1022,0,0,193.658252,0.005691999999982045,1436401,0
"172.16.133.43",57917,"172.16.139.250",5440,10,1022,15849,0,0,10,1022,0,0,193.664539,0.005459000000001879,1497710,0
"172.16.133.42",57260,"172.16.139.250",5440,12,1142,15850,0,0,12,1142,0,0,193.665236,0.04207800000000361,217120,0
"172.16.133.13",53177,"172.16.139.250",5440,10,1022,15851,0,0,10,1022,0,0,193.683233,0.014701000000002296,556152,0
"172.16.133.41",53288,"207.46.206.125",80,12,1157,15852,0,0,6,621,6,536,193.721686,3.669587000000007,1353,1168
"172.16.133.20",62545,"172.16.139.250",5440,10,1022,15853,0,0,10,1022,0,0,193.733504,0.014812999999975318,551947,0
"172.16.133.28",49269,"172.16.139.250",5440,12,1142,15854,0,0,12,1142,0,0,193.763472,0.006195999999988544,1474499,0
"172.16.133.99",56202,"172.16.139.250",5440,12,1142,15855,0,0,12,1142,0,0,193.790829,0.004896999999999707,"",""
"172.16.133.75",51115,"172.16.139.250",5440,10,1022,15856,0,0,10,1022,0,0,193.79649,0.014707999999984622,555887,0
"172.16.133.109",41704,"23.33.81.213",443,54,38354,15857,0,0,23,2261,31,36093,193.802691,0.3695189999999968,48950,781405
"172.16.133.87",60370,"172.16.139.250",5440,10,1022,15858,0,0,10,1022,0,0,193.815277,0.005485999999990554,1490339,0
"172.16.133.35",50108,"172.16.139.250",5440,12,1142,15859,0,0,12,1142,0,0,193.82431,0.017433000000011134,524063,0
"172.16.133.116",53790,"172.16.139.250",5440,10,1022,15860,0,0,10,1022,0,0,193.827366,0.00544800000000123,1500734,0
"172.16.133.116",53791,"172.16.139.250",5440,10,1022,15861,0,0,10,1022,0,0,193.833618,0.015008999999992056,544739,0
"172.16.133.84",58940,"172.16.139.250",5440,10,1022,15862,0,0,10,1022,0,0,193.849367,0.005459000000001879,1497710,0
"172.16.133.116",53792,"172.16.139.250",5440,10,1022,15863,0,0,10,1022,0,0,193.849486,0.01481499999999869,551873,0
"172.16.133.16",59363,"132.245.1.150",443,25,13620,15864,0,0,10,2033,15,11587,193.878637,0.8129059999999981,20007,114030
"172.16.133.49",55929,"172.16.139.250",5440,12,1142,15865,0,0,12,1142,0,0,193.926262,0.0062360000000012406,1465041,0
"172.16.133.95",57102,"172.16.139.250",5440,12,1142,15866,0,0,12,1142,0,0,193.966299,0.005887999999998783,1551630,0
"172.16.133.92",57815,"172.16.139.250",5440,10,1022,15867,0,0,10,1022,0,0,193.992865,0.005493000000001302,1488439,0
"172.16.133.29",61122,"172.16.139.250",5440,10,1022,15868,0,0,10,1022,0,0,194.010934,0.0055110000000127,1483578,0
"172.16.133.44",64970,"172.16.139.250",5440,12,1142,15869,0,0,12,1142,0,0,194.018195,0.006129000000015594,1490618,0
"172.16.133.207",56066,"172.16.139.250",5440,12,1142,15870,0,0,12,1142,0,0,194.04347,0.005151999999981172,1773291,0
"172.16.133.83",57223,"172.16.139.250",5440,12,1142,15871,0,0,12,1142,0,0,194.052629,0.011590000000012424,788265,0
"172.16.133.93",60894,"172.16.139.250",5440,10,1022,15872,0,0,10,1022,0,0,194.068799,0.004795999999998912,"",""
"172.16.133.11",55311,"172.16.139.250",5440,10,1022,15873,0,0,10,1022,0,0,194.086231,0.005638000000004695,1450159,0
"172.16.133.55",57767,"172.16.139.250",5440,10,1022,15874,0,0,10,1022,0,0,194.089851,0.014715999999992846,555585,0
"172.16.133.73",60824,"172.16.139.250",5440,10,1022,15875,0,0,10,1022,0,0,194.11248,0.015986999999995533,511415,0
"172.16.133.53",54251,"172.16.139.250",5440,10,1022,15876,0,0,10,1022,0,0,194.11471,0.005310000000008586,1539736,0
"172.16.133.21",53326,"172.16.139.250",5440,10,1022,15877,0,0,10,1022,0,0,194.118285,0.006299000000012711,1297983,0
"172.16.133.30",62817,"172.16.139.250",5440,10,1022,15878,0,0,10,1022,0,0,194.122884,0.015518000000014354,526872,0
"172.16.133.25",63626,"172.16.139.250",5440,10,1022,15879,0,0,10,1022,0,0,194.129749,0.004739000000000715,"",""
"172.16.133.34",50594,"172.16.139.250",5440,10,1022,15880,0,0,10,1022,0,0,194.13781,0.005180999999993219,1578073,0
"172.16.133.97",59528,"172.16.139.250",5440,12,1142,15881,0,0,12,1142,0,0,194.149426,0.007418000000001257,1231598,0
"172.16.133.44",64971,"180.153.31.250",443,6,366,15882,0,0,4,246,2,120,194.154484,0.465912000000003,4223,2060
"172.16.133.33",58037,"172.16.139.250",5440,10,1022,15883,0,0,10,1022,0,0,194.221359,0.015710999999981823,520399,0
"172.16.133.68",60897,"172.16.139.250",5440,10,1022,15884,0,0,10,1022,0,0,194.255244,0.0156549999999811,522261,0
"172.16.133.12",59915,"172.16.139.250",5440,12,1142,15885,0,0,12,1142,0,0,194.268667,0.007328999999998587,1246554,0
"172.16.133.63",54074,"172.16.139.250",5440,10,1022,15886,0,0,10,1022,0,0,194.279652,0.014341999999999189,570073,0
"172.16.133.66",54305,"172.16.139.250",5440,10,1022,15887,0,0,10,1022,0,0,194.29204,0.007599000000027445,1075931,0
"172.16.133.82",61581,"172.16.139.250",5440,10,1022,15888,0,0,10,1022,0,0,194.306511,0.015909999999990987,513890,0
"172.16.133.37",60788,"172.16.139.250",5440,10,1022,15889,0,0,10,1022,0,0,194.317909,0.014812000000006265,551984,0
"172.16.133.113",55676,"172.16.139.250",135,8,492,15890,0,0,8,492,0,0,194.350965,0.013610999999997375,289177,0
"172.16.133.113",55677,"172.16.139.250",5462,10,696,15891,0,0,10,696,0,0,194.382164,0.5126810000000148,10860,0
"172.16.133.78",59387,"172.16.139.250",5440,12,1142,15892,0,0,12,1142,0,0,194.47535,0.0058950000000095315,1549787,0
"172.16.133.37",60789,"157.56.240.22",443,24,9665,15893,0,0,11,2929,13,6736,194.493014,1.6952070000000106,13822,31788
"172.16.133.67",56136,"172.16.139.250",5440,10,1022,15894,0,0,10,1022,0,0,194.530636,0.014994000000001506,545284,0
"172.16.133.56",61574,"172.16.139.250",5440,12,1142,15895,0,0,12,1142,0,0,194.552233,0.005011999999993577,1822825,0
"172.16.133.41",53289,"172.16.139.250",5440,10,1022,15896,0,0,10,1022,0,0,194.607401,0.01493199999998751,547548,0
"172.16.133.85",52414,"172.16.139.250",5440,12,1142,15897,0,0,12,1142,0,0,194.672041,0.006329999999991287,1443285,0
"172.16.133.43",57918,"172.16.139.250",5440,12,1142,15898,0,0,12,1142,0,0,194.679126,0.006680000000017117,1367664,0
"172.16.133.42",57261,"172.16.139.250",5440,12,1142,15899,0,0,12,1142,0,0,194.681163,0.012965000000008331,704666,0
"172.16.133.13",53178,"172.16.139.250",5440,10,1022,15900,0,0,10,1022,0,0,194.697303,0.005344000000008009,1529940,0
"172.16.133.207",56067,"216.219.113.250",443,6,366,15901,0,0,4,246,2,120,194.736495,0.19970700000001784,9854,4807
"172.16.133.207",56068,"67.217.64.244",443,6,366,15902,0,0,4,246,2,120,194.738538,0.056263000000001284,34978,17062
"172.16.133.207",56069,"66.151.150.190",443,6,366,15903,0,0,4,246,2,120,194.738752,0.19303299999998558,10195,4973
"172.16.133.207",56070,"216.115.223.200",443,6,366,15904,0,0,4,246,2,120,194.739174,0.09551100000001611,20604,10051
"172.16.133.20",62546,"172.16.139.250",5440,10,1022,15905,0,0,10,1022,0,0,194.74768,0.014564000000007127,561384,0
"172.16.133.28",49270,"172.16.139.250",5440,10,1022,15906,0,0,10,1022,0,0,194.776443,0.005684000000002243,1438423,0
"172.16.133.99",56203,"172.16.139.250",5440,12,1142,15907,0,0,12,1142,0,0,194.806192,0.015197000000000571,601171,0
"172.16.133.75",51116,"172.16.139.250",5440,10,1022,15908,0,0,10,1022,0,0,194.810652,0.005421999999981608,1507930,0
"172.16.133.87",60371,"172.16.139.250",5440,10,1022,15909,0,0,10,1022,0,0,194.82833,0.005393999999995458,1515758,0
"172.16.133.116",53793,"172.16.139.250",5440,10,1022,15910,0,0,10,1022,0,0,194.841783,0.005588000000017246,1463135,0
"172.16.133.116",53794,"172.16.139.250",5440,10,1022,15911,0,0,10,1022,0,0,194.848163,0.005359999999996035,1525373,0
"172.16.133.116",53795,"172.16.139.250",5440,10,1022,15912,0,0,10,1022,0,0,194.854313,0.005318000000016809,1537420,0
"172.16.133.84",58944,"172.16.139.250",5440,10,1022,15913,0,0,10,1022,0,0,194.863079,0.006368000000009033,1283919,0
"172.16.133.35",50109,"172.16.139.250",5440,12,1142,15914,0,0,12,1142,0,0,194.863258,0.012886000000008835,708986,0
"172.16.133.49",55930,"172.16.139.250",5440,10,1022,15915,0,0,10,1022,0,0,194.939484,0.005680000000012342,1439436,0
"172.16.133.95",57103,"172.16.139.250",5440,10,1022,15916,0,0,10,1022,0,0,194.981181,0.005795000000006212,1410871,0
"172.16.133.92",57816,"172.16.139.250",5440,12,1142,15917,0,0,12,1142,0,0,195.005912,0.006001999999995178,1522159,0
"172.16.133.29",61123,"172.16.139.250",5440,12,1142,15918,0,0,12,1142,0,0,195.024833,0.006066000000004124,1506099,0
"172.16.133.44",64972,"172.16.139.250",5440,10,1022,15919,0,0,10,1022,0,0,195.031059,0.005367000000006783,1523383,0
"172.16.133.207",56071,"172.16.139.250",5440,12,1142,15920,0,0,12,1142,0,0,195.056742,0.014589999999998327,626182,0
"172.16.133.83",57224,"172.16.139.250",5440,12,1142,15921,0,0,12,1142,0,0,195.066895,0.00813600000000747,1122910,0
"172.16.133.93",60895,"172.16.139.250",5440,10,1022,15922,0,0,10,1022,0,0,195.0816,0.004965999999996029,"",""
"172.16.133.47",56568,"216.52.242.80",80,9,3113,15923,0,0,5,1808,4,1305,195.093264,1.061047000000002,13631,9839
"172.16.133.11",55312,"172.16.139.250",5440,10,1022,15924,0,0,10,1022,0,0,195.099493,0.005657000000013568,1445289,0
"172.16.133.55",57768,"172.16.139.250",5440,10,1022,15925,0,0,10,1022,0,0,195.10405,0.005560000000002674,1470503,0
"172.16.133.73",60825,"172.16.139.250",5440,10,1022,15926,0,0,10,1022,0,0,195.126373,0.005558000000007723,1471032,0
"172.16.133.53",54252,"172.16.139.250",5440,10,1022,15927,0,0,10,1022,0,0,195.128205,0.0073840000000018335,1107258,0
"172.16.133.21",53327,"172.16.139.250",5440,12,1142,15928,0,0,12,1142,0,0,195.13187,0.008592000000021471,1063314,0
"172.16.133.30",62818,"172.16.139.250",5440,10,1022,15929,0,0,10,1022,0,0,195.135747,0.008042999999986478,1016536,0
"172.16.133.25",63627,"172.16.139.250",5440,12,1142,15930,0,0,12,1142,0,0,195.143974,0.0050880000000006476,1795597,0
"172.16.133.34",50595,"172.16.139.250",5440,10,1022,15931,0,0,10,1022,0,0,195.151646,0.00495499999999538,"",""
"172.16.133.97",59529,"172.16.139.250",5440,12,1142,15932,0,0,12,1142,0,0,195.162905,0.006265000000013288,1458260,0
"172.16.133.71",57579,"173.252.110.27",443,22,5058,15933,0,0,11,1276,11,3782,195.176764,0.5733940000000075,17802,52766
"172.16.133.71",57580,"173.252.110.27",443,147,127597,15934,0,0,55,4199,92,123398,195.177153,2.332782000000009,14399,423178
"172.16.133.71",57581,"173.252.110.27",443,24,4884,15935,0,0,12,1380,12,3504,195.177551,0.3137670000000128,35185,89340
"172.16.133.71",57582,"173.252.110.27",443,24,5408,15936,0,0,12,1341,12,4067,195.178303,0.3604259999999897,29764,90270
"172.16.133.33",58038,"172.16.139.250",5440,12,1142,15937,0,0,12,1142,0,0,195.235572,0.005627000000004045,1623600,0
"172.16.128.201",2991,"172.16.133.6",1179,20,4938,15938,0,0,12,3017,8,1921,195.264294,97.13471599999997,248,158
"172.16.133.68",60898,"172.16.139.250",5440,10,1022,15939,0,0,10,1022,0,0,195.269335,0.0056029999999793745,1459218,0
"172.16.133.12",59916,"172.16.139.250",5440,12,1142,15940,0,0,12,1142,0,0,195.283067,0.006553000000025122,1394170,0
"172.16.133.63",54075,"172.16.139.250",5440,10,1022,15941,0,0,10,1022,0,0,195.293504,0.005316999999990912,1537709,0
"172.16.133.66",54306,"172.16.139.250",5440,10,1022,15942,0,0,10,1022,0,0,195.306351,0.014645999999999049,558241,0
"172.16.133.82",61582,"172.16.139.250",5440,10,1022,15943,0,0,10,1022,0,0,195.31957,0.0066129999999873235,1236352,0
"172.16.133.37",60790,"172.16.139.250",5440,10,1022,15944,0,0,10,1022,0,0,195.332288,0.005347000000000435,1529081,0
"172.16.133.78",59388,"172.16.139.250",5440,10,1022,15945,0,0,10,1022,0,0,195.489177,0.00547599999998738,1493060,0
"172.16.133.67",56137,"172.16.139.250",5440,10,1022,15946,0,0,10,1022,0,0,195.54411,0.01576200000002359,518715,0
"172.16.133.56",61575,"172.16.139.250",5440,10,1022,15947,0,0,10,1022,0,0,195.566526,0.005265999999977566,1552601,0
"172.16.133.41",53290,"172.16.139.250",5440,10,1022,15948,0,0,10,1022,0,0,195.621565,0.015502999999995382,527381,0
"172.16.133.57",60637,"17.164.0.8",443,45,9455,15949,0,0,23,2644,22,6811,195.673372,57.12569199999999,370,953
"172.16.133.85",52415,"172.16.139.250",5440,10,1022,15950,0,0,10,1022,0,0,195.686081,0.04725899999999683,173004,0
"172.16.133.42",57262,"172.16.139.250",5440,12,1142,15951,0,0,12,1142,0,0,195.691517,0.09963299999998299,91696,0
"172.16.133.43",57919,"172.16.139.250",5440,12,1142,15952,0,0,12,1142,0,0,195.692685,0.09121399999997948,100160,0
"172.16.133.13",53179,"172.16.139.250",5440,12,1142,15953,0,0,12,1142,0,0,195.711594,0.08148300000001996,112121,0
"172.16.133.20",62547,"172.16.139.250",5440,12,1142,15954,0,0,12,1142,0,0,195.761797,0.034583999999995285,264168,0
"172.16.133.28",49271,"172.16.139.250",5440,12,1142,15955,0,0,12,1142,0,0,195.790398,0.010093999999980952,905092,0
"172.16.133.99",56204,"172.16.139.250",5440,10,1022,15956,0,0,10,1022,0,0,195.819764,0.015533000000004904,526363,0
"172.16.133.75",51117,"172.16.139.250",5440,10,1022,15957,0,0,10,1022,0,0,195.825777,0.0055310000000190485,1478213,0
"172.16.133.87",60372,"172.16.139.250",5440,12,1142,15958,0,0,12,1142,0,0,195.842266,0.006246000000004415,1462696,0
"172.16.133.35",50110,"172.16.139.250",5440,12,1142,15959,0,0,12,1142,0,0,195.852073,0.03317900000001828,275354,0
"172.16.133.116",53796,"172.16.139.250",5440,12,1142,15960,0,0,12,1142,0,0,195.855655,0.007666000000000395,1191755,0
"172.16.133.116",53797,"172.16.139.250",5440,10,1022,15961,0,0,10,1022,0,0,195.86416,0.01441800000000626,567068,0
"172.16.133.84",58945,"172.16.139.250",5440,12,1142,15962,0,0,12,1142,0,0,195.877279,0.006413000000009106,1424606,0
"172.16.133.116",53798,"172.16.139.250",5440,10,1022,15963,0,0,10,1022,0,0,195.879445,0.007554999999996426,1082197,0
"172.16.128.201",2992,"172.16.133.6",1179,121,92968,15964,0,0,46,4563,75,88405,195.951815,86.87715800000001,420,8140
"172.16.133.49",55931,"172.16.139.250",5440,12,1142,15965,0,0,12,1142,0,0,195.953542,0.006304000000000087,1449238,0
"172.16.133.95",57104,"172.16.139.250",5440,12,1142,15966,0,0,12,1142,0,0,195.994838,0.016193000000015445,564194,0
"172.16.133.92",57817,"172.16.139.250",5440,10,1022,15967,0,0,10,1022,0,0,196.020665,0.01532100000000014,533646,0
"172.16.133.29",61124,"172.16.139.250",5440,10,1022,15968,0,0,10,1022,0,0,196.038666,0.005573999999995749,1466810,0
"172.16.133.44",64975,"172.16.139.250",5440,10,1022,15969,0,0,10,1022,0,0,196.046052,0.012174999999984948,671540,0
"172.16.133.207",56072,"172.16.139.250",5440,12,1142,15970,0,0,12,1142,0,0,196.07114,0.004843999999991411,"",""
"172.16.133.83",57225,"172.16.139.250",5440,12,1142,15971,0,0,12,1142,0,0,196.079798,0.014146999999979926,645790,0
"172.16.133.93",60896,"172.16.139.250",5440,12,1142,15972,0,0,12,1142,0,0,196.095535,0.005051999999977852,1808392,0
"172.16.133.11",55313,"172.16.139.250",5440,10,1022,15973,0,0,10,1022,0,0,196.113406,0.016441000000014583,497293,0
"172.16.133.55",57769,"172.16.139.250",5440,10,1022,15974,0,0,10,1022,0,0,196.118164,0.006180000000000518,1322977,0
"172.16.133.73",60826,"172.16.139.250",5440,12,1142,15975,0,0,12,1142,0,0,196.140455,0.025406000000003814,359600,0
"172.16.133.53",54253,"172.16.139.250",5440,12,1142,15976,0,0,12,1142,0,0,196.14281,0.010906000000005633,837704,0
"172.16.133.21",53328,"172.16.139.250",5440,12,1142,15977,0,0,12,1142,0,0,196.146907,0.011731999999994969,778724,0
"172.16.133.30",62819,"172.16.139.250",5440,10,1022,15978,0,0,10,1022,0,0,196.1497,0.01212699999999245,674198,0
"172.16.133.25",63628,"172.16.139.250",5440,12,1142,15979,0,0,12,1142,0,0,196.156894,0.012358000000006086,739278,0
"172.16.133.34",50596,"172.16.139.250",5440,12,1142,15980,0,0,12,1142,0,0,196.166952,0.01523199999999747,599789,0
"172.16.133.97",59530,"172.16.139.250",5440,12,1142,15981,0,0,12,1142,0,0,196.177477,0.015239999999977272,599475,0
"172.16.133.37",60791,"132.245.2.22",443,19,8503,15982,0,0,9,1923,10,6580,196.235229,0.2567510000000084,59917,205023
"172.16.133.33",58039,"172.16.139.250",5440,12,1142,15983,0,0,12,1142,0,0,196.249428,0.0063370000000020354,1441691,0
"172.16.133.68",60899,"172.16.139.250",5440,12,1142,15984,0,0,12,1142,0,0,196.282465,0.016244999999997844,562388,0
"172.16.133.12",59917,"172.16.139.250",5440,12,1142,15985,0,0,12,1142,0,0,196.296787,0.0055949999999995725,1632886,0
"172.16.133.63",54076,"172.16.139.250",5440,12,1142,15986,0,0,12,1142,0,0,196.307378,0.006296999999989339,1450849,0
"172.16.133.66",54307,"172.16.139.250",5440,10,1022,15987,0,0,10,1022,0,0,196.320451,0.015366999999997688,532049,0
"172.16.133.82",61583,"172.16.139.250",5440,10,1022,15988,0,0,10,1022,0,0,196.333633,0.005606000000000222,1458437,0
"172.16.133.37",60792,"172.16.139.250",5440,10,1022,15989,0,0,10,1022,0,0,196.346827,0.005707000000001017,1432626,0
"172.16.133.44",64976,"180.153.31.250",443,6,366,15990,0,0,4,246,2,120,196.383577,0.47101299999999924,4178,2038
"172.16.133.78",59389,"172.16.139.250",5440,10,1022,15991,0,0,10,1022,0,0,196.503504,0.005667000000016742,1442738,0
"172.16.133.67",56138,"172.16.139.250",5440,12,1142,15992,0,0,12,1142,0,0,196.559082,0.005974000000009028,1529293,0
"172.16.125.220",41223,"172.16.133.233",80,7,420,15993,0,0,4,240,3,180,196.576919,0.20486299999998892,9372,7029
"172.16.133.56",61576,"172.16.139.250",5440,10,1022,15994,0,0,10,1022,0,0,196.580433,0.004984000000007427,"",""
"172.16.133.41",53291,"172.16.139.250",5440,12,1142,15995,0,0,12,1142,0,0,196.635502,0.015622000000007574,584816,0
"172.16.133.85",52416,"172.16.139.250",5440,12,1142,15996,0,0,12,1142,0,0,196.700395,0.00624700000000189,1462461,0
"172.16.133.43",57920,"172.16.139.250",5440,10,1022,15997,0,0,10,1022,0,0,196.705855,0.005453999999986081,1499083,0
"172.16.133.42",57263,"172.16.139.250",5440,12,1142,15998,0,0,12,1142,0,0,196.719284,0.07130500000002371,128125,0
"172.16.133.13",53181,"172.16.139.250",5440,10,1022,15999,0,0,10,1022,0,0,196.725378,0.014404999999982238,567580,0
"172.16.133.207",56073,"67.217.64.244",443,6,366,16000,0,0,4,246,2,120,196.765221,0.0659430000000043,29843,14558
"172.16.133.20",62548,"172.16.139.250",5440,12,1142,16001,0,0,12,1142,0,0,196.774531,0.00522000000000844,1750191,0
"172.16.133.207",56074,"216.115.223.200",443,6,366,16002,0,0,4,246,2,120,196.796193,0.08271500000000742,23792,11606
"172.16.133.28",49272,"172.16.139.250",5440,10,1022,16003,0,0,10,1022,0,0,196.804452,0.015312999999991916,533925,0
"172.16.133.99",56205,"172.16.139.250",5440,10,1022,16004,0,0,10,1022,0,0,196.832911,0.021028999999998632,388796,0
"172.16.133.75",51118,"172.16.139.250",5440,10,1022,16005,0,0,10,1022,0,0,196.83887,0.018938000000019883,431724,0
"172.16.133.207",56075,"66.151.150.190",443,6,366,16006,0,0,4,246,2,120,196.841499,0.17939100000000963,10970,5351
"172.16.133.207",56076,"216.219.113.250",443,6,366,16007,0,0,4,246,2,120,196.841995,0.18645200000000273,10554,5148
"172.16.133.87",60373,"172.16.139.250",5440,10,1022,16008,0,0,10,1022,0,0,196.856707,0.005415999999996757,1509601,0
"172.16.133.35",50111,"172.16.139.250",5440,12,1142,16009,0,0,12,1142,0,0,196.86292,0.008898999999985335,1026632,0
"172.16.133.116",53799,"172.16.139.250",5440,10,1022,16010,0,0,10,1022,0,0,196.869482,0.005167000000000144,1582349,0
"172.16.133.116",53800,"172.16.139.250",5440,10,1022,16011,0,0,10,1022,0,0,196.875757,0.005472999999994954,1493879,0
"172.16.133.116",53801,"172.16.139.250",5440,10,1022,16012,0,0,10,1022,0,0,196.881961,0.005451000000022077,1499908,0
"172.16.133.84",58946,"172.16.139.250",5440,10,1022,16013,0,0,10,1022,0,0,196.891141,0.014465000000001282,565226,0
"172.16.133.49",55932,"172.16.139.250",5440,10,1022,16014,0,0,10,1022,0,0,196.967721,0.01534499999999639,532811,0
"172.16.133.95",57105,"172.16.139.250",5440,10,1022,16015,0,0,10,1022,0,0,197.008533,0.1122880000000066,72812,0
"172.16.133.92",57818,"172.16.139.250",5440,10,1022,16016,0,0,10,1022,0,0,197.036075,0.08855699999998023,92324,0
"172.16.133.29",61125,"172.16.139.250",5440,12,1142,16017,0,0,12,1142,0,0,197.054863,0.10772399999999038,84809,0
"172.16.133.44",64977,"172.16.139.250",5440,10,1022,16018,0,0,10,1022,0,0,197.059148,0.06923700000001531,118087,0
"172.16.133.29",61126,"208.111.160.6",80,8,492,16019,0,0,4,246,4,246,197.077793,14.015131999999994,140,140
"172.16.133.29",61127,"208.111.160.6",80,8,492,16020,0,0,4,246,4,246,197.077922,14.016755999999987,140,140
"172.16.133.29",61128,"208.111.160.6",80,8,492,16021,0,0,4,246,4,246,197.07803,14.01670999999999,140,140
"172.16.133.29",61129,"208.111.160.6",80,8,492,16022,0,0,4,246,4,246,197.078163,14.015674000000018,140,140
"172.16.133.67",56139,"172.16.139.250",5440,10,1016,16023,0,0,10,1016,0,0,197.079109,0.08341500000000224,97440,0
"172.16.133.207",56077,"172.16.139.250",5440,10,1022,16024,0,0,10,1022,0,0,197.084608,0.06591900000000805,124031,0
"172.16.133.83",57226,"172.16.139.250",5440,12,1142,16025,0,0,12,1142,0,0,197.093829,0.0605329999999924,150925,0
"172.16.133.93",60897,"172.16.139.250",5440,12,1142,16026,0,0,12,1142,0,0,197.110975,0.04750400000000354,192320,0
"172.16.133.11",55314,"172.16.139.250",5440,10,1022,16027,0,0,10,1022,0,0,197.127371,0.05107799999998974,160068,0
"172.16.133.55",57770,"172.16.139.250",5440,12,1142,16028,0,0,12,1142,0,0,197.131575,0.035896000000008144,254513,0
"172.16.133.29",61130,"208.111.160.6",80,8,492,16029,0,0,4,246,4,246,197.139589,13.957704000000007,140,140
"172.16.133.29",61131,"208.111.160.6",80,8,492,16030,0,0,4,246,4,246,197.139755,13.95759799999999,140,140
"172.16.133.29",61132,"173.194.43.45",443,15,3612,16031,0,0,8,967,7,2645,197.140607,4.004119000000003,1932,5284
"172.16.133.73",60827,"172.16.139.250",5440,10,1022,16032,0,0,10,1022,0,0,197.154822,0.01574899999999957,519144,0
"172.16.133.53",54254,"172.16.139.250",5440,10,1022,16033,0,0,10,1022,0,0,197.157208,0.017848000000014963,458090,0
"172.16.133.21",53329,"172.16.139.250",5440,10,1022,16034,0,0,10,1022,0,0,197.161489,0.028711000000015474,284768,0
"172.16.133.67",56140,"172.16.139.250",5440,12,1414,16035,0,0,12,1414,0,0,197.1637,0.07852399999998738,144057,0
"172.16.133.30",62820,"172.16.139.250",5440,10,1022,16036,0,0,10,1022,0,0,197.163905,0.01872099999999932,436728,0
"172.16.133.25",63629,"172.16.139.250",5440,12,1142,16037,0,0,12,1142,0,0,197.171376,0.03241199999999367,281870,0
"172.16.133.34",50597,"172.16.139.250",5440,12,1142,16038,0,0,12,1142,0,0,197.179703,0.02975399999999695,307051,0
"172.16.133.97",59531,"172.16.139.250",5440,10,1022,16039,0,0,10,1022,0,0,197.191675,0.021368999999992866,382610,0
"172.16.133.67",56141,"172.16.139.250",5440,10,1016,16040,0,0,10,1016,0,0,197.243676,0.002541000000007898,"",""
"172.16.133.67",56142,"172.16.139.250",5440,10,1294,16041,0,0,10,1294,0,0,197.247085,0.002387999999996282,"",""
"172.16.133.33",58040,"172.16.139.250",5440,10,1022,16042,0,0,10,1022,0,0,197.262322,0.005757999999985941,1419937,0
"172.16.133.68",60900,"172.16.139.250",5440,12,1142,16043,0,0,12,1142,0,0,197.296659,0.006461000000001604,1414022,0
"172.16.133.12",59918,"172.16.139.250",5440,12,1142,16044,0,0,12,1142,0,0,197.310728,0.015513999999996031,588887,0
"172.16.133.63",54077,"172.16.139.250",5440,10,1022,16045,0,0,10,1022,0,0,197.321766,0.009094000000004598,899054,0
"172.16.133.66",54308,"172.16.139.250",5440,10,1022,16046,0,0,10,1022,0,0,197.332945,0.005310000000008586,1539736,0
"172.16.133.87",60374,"67.210.115.228",80,240,277548,16047,0,0,55,3652,185,273896,197.334189,8.028406999999987,3639,272926
"172.16.133.82",61584,"172.16.139.250",5440,12,1142,16048,0,0,12,1142,0,0,197.347958,0.007543999999995776,1211028,0
"172.16.133.37",60793,"172.16.139.250",5440,10,1022,16049,0,0,10,1022,0,0,197.360921,0.005796000000003687,1410628,0
"172.16.133.67",56143,"172.16.139.250",5440,6,780,16050,0,0,6,780,0,0,197.390775,0.0007549999999980628,"",""
"172.16.133.67",56144,"172.16.139.250",5440,10,1026,16051,0,0,10,1026,0,0,197.390776,0.006503000000009251,1262186,0
"172.16.133.87",60375,"67.210.115.228",80,10,636,16052,0,0,6,378,4,258,197.400718,17.958517999999998,168,114
"172.16.133.29",61133,"64.94.107.11",80,8,1722,16053,0,0,5,1259,3,463,197.40547,0.07321699999999964,137563,50589
"172.16.133.67",56145,"172.16.139.250",5440,10,1016,16054,0,0,10,1016,0,0,197.447196,0.01191199999999526,682337,0
"172.16.133.71",57583,"173.252.110.27",443,22,5119,16055,0,0,11,1346,11,3773,197.474399,0.9133309999999994,11789,33048
"172.16.133.87",60376,"74.125.226.16",80,17,9515,16056,0,0,7,839,10,8676,197.481218,90.21551399999998,74,769
"172.16.133.87",60377,"74.125.226.16",80,15,8381,16057,0,0,6,779,9,7602,197.481349,90.20567400000002,69,674
"172.16.133.87",60378,"74.125.226.16",80,16,7314,16058,0,0,7,839,9,6475,197.482591,90.19302999999996,74,574
"172.16.133.87",60379,"74.125.226.16",80,18,10302,16059,0,0,7,839,11,9463,197.482737,90.216184,74,839
"172.16.133.87",60380,"74.125.226.16",80,26,17321,16060,0,0,10,1025,16,16296,197.482869,90.256349,90,1444
"172.16.133.87",60381,"74.125.226.17",80,18,11089,16061,0,0,7,839,11,10250,197.483027,90.20382000000001,74,909
"172.16.133.87",60382,"74.125.226.17",80,19,10781,16062,0,0,8,899,11,9882,197.483153,90.25612600000002,79,875
"172.16.133.87",60383,"74.125.226.16",80,6,372,16063,0,0,4,246,2,126,197.510673,17.78704400000001,110,56
"172.16.133.87",60384,"74.125.226.16",80,6,372,16064,0,0,4,246,2,126,197.510821,17.785942000000006,110,56
"172.16.133.87",60385,"74.125.226.17",80,7,432,16065,0,0,4,246,3,186,197.511591,17.786068,110,83
"172.16.133.78",59390,"172.16.139.250",5440,12,1142,16066,0,0,12,1142,0,0,197.517464,0.014817000000022063,616589,0
"172.16.133.46",64586,"192.147.107.14",8883,8,521,16067,0,0,5,335,3,186,197.543188,0.09908400000000483,27047,15017
"172.16.133.67",56146,"172.16.139.250",5440,12,1142,16068,0,0,12,1142,0,0,197.572552,0.005966999999998279,1531087,0
"172.16.133.56",61577,"172.16.139.250",5440,10,1022,16069,0,0,10,1022,0,0,197.59436,0.005827000000010685,1403123,0
"172.16.133.67",56147,"172.16.139.250",5440,12,1142,16070,0,0,12,1142,0,0,197.622515,0.005862000000007583,1558512,0
"172.16.133.41",53292,"172.16.139.250",5440,10,1022,16071,0,0,10,1022,0,0,197.649498,0.014730000000014343,555057,0
"172.16.133.85",52417,"172.16.139.250",5440,12,1142,16072,0,0,12,1142,0,0,197.714813,0.0053880000000106065,1695619,0
"172.16.133.43",57921,"172.16.139.250",5440,12,1142,16073,0,0,12,1142,0,0,197.721624,0.0059830000000147265,1526993,0
"172.16.133.13",53182,"172.16.139.250",5440,12,1142,16074,0,0,12,1142,0,0,197.739642,0.006117999999986523,1493298,0
"172.16.133.42",57264,"172.16.139.250",5440,12,1142,16075,0,0,12,1142,0,0,197.763111,0.10730599999999413,85139,0
"172.16.133.20",62549,"172.16.139.250",5440,12,1142,16076,0,0,12,1142,0,0,197.789094,0.00476599999998939,"",""
"172.16.133.28",49273,"172.16.139.250",5440,10,1022,16077,0,0,10,1022,0,0,197.8183,0.00534799999999791,1528795,0
"172.16.133.99",56206,"172.16.139.250",5440,10,1022,16078,0,0,10,1022,0,0,197.846806,0.014796000000018239,552581,0
"172.16.133.75",51119,"172.16.139.250",5440,10,1022,16079,0,0,10,1022,0,0,197.852779,0.01551000000000613,527143,0
"172.16.133.71",57584,"173.252.110.27",80,12,1513,16080,0,0,7,729,5,784,197.858724,60.034559,97,104
"172.16.133.87",60386,"172.16.139.250",5440,10,1022,16081,0,0,10,1022,0,0,197.870416,0.014832999999981666,551203,0
"172.16.133.35",50112,"172.16.139.250",5440,12,1142,16082,0,0,12,1142,0,0,197.876045,0.041402000000005046,220665,0
"172.16.133.116",53802,"172.16.139.250",5440,10,1022,16083,0,0,10,1022,0,0,197.883218,0.005672000000004118,1441466,0
"172.16.133.116",53803,"172.16.139.250",5440,10,1022,16084,0,0,10,1022,0,0,197.88976,0.007961999999992031,1026877,0
"172.16.133.116",53804,"172.16.139.250",5440,10,1022,16085,0,0,10,1022,0,0,197.898834,0.015434999999996535,529705,0
"172.16.133.84",58947,"172.16.139.250",5440,10,1022,16086,0,0,10,1022,0,0,197.905169,0.014566999999999553,561268,0
"172.16.133.49",55933,"172.16.139.250",5440,12,1142,16087,0,0,12,1142,0,0,197.98355,0.006186999999982845,1476644,0
"172.16.133.95",57106,"172.16.139.250",5440,10,1022,16088,0,0,10,1022,0,0,198.023129,0.015605999999991127,523901,0
"172.16.133.92",57819,"172.16.139.250",5440,10,1022,16089,0,0,10,1022,0,0,198.048386,0.010048000000011825,813694,0
"172.16.133.29",61134,"172.16.139.250",5440,12,1142,16090,0,0,12,1142,0,0,198.066515,0.006078000000002248,1503126,0
"172.16.133.44",64978,"172.16.139.250",5440,12,1142,16091,0,0,12,1142,0,0,198.073274,0.00615999999999417,1483116,0
"172.16.133.207",56078,"172.16.139.250",5440,10,1022,16092,0,0,10,1022,0,0,198.098834,0.015187999999994872,538319,0
"172.16.133.83",57227,"172.16.139.250",5440,12,1142,16093,0,0,12,1142,0,0,198.107959,0.013747999999992544,664533,0
"172.16.133.93",60898,"172.16.139.250",5440,12,1142,16094,0,0,12,1142,0,0,198.123717,0.014693999999991547,621750,0
"172.16.133.11",55315,"172.16.139.250",5440,12,1142,16095,0,0,12,1142,0,0,198.140463,0.016821999999990567,543098,0
"172.16.133.55",57771,"172.16.139.250",5440,12,1142,16096,0,0,12,1142,0,0,198.146035,0.014828999999991765,616090,0
"172.16.133.73",60828,"172.16.139.250",5440,12,1142,16097,0,0,12,1142,0,0,198.168499,0.02036499999999819,448612,0
"172.16.133.53",54255,"172.16.139.250",5440,10,1022,16098,0,0,10,1022,0,0,198.170633,0.006277999999980466,1302325,0
"172.16.133.21",53330,"172.16.139.250",5440,12,1142,16099,0,0,12,1142,0,0,198.174275,0.005993000000017901,1524445,0
"172.16.133.30",62822,"172.16.139.250",5440,12,1142,16100,0,0,12,1142,0,0,198.177785,0.007130999999986898,1281166,0
"172.16.133.25",63630,"172.16.139.250",5440,12,1142,16101,0,0,12,1142,0,0,198.185127,0.006988000000006878,1307384,0
"172.16.133.34",50598,"172.16.139.250",5440,12,1142,16102,0,0,12,1142,0,0,198.193829,0.00511800000001017,1785072,0
"172.16.133.97",59532,"172.16.139.250",5440,10,1022,16103,0,0,10,1022,0,0,198.205501,0.0146000000000015,559999,0
"172.16.133.132",45111,"23.67.243.66",80,7,478,16104,0,0,4,272,3,206,198.218379,0.05056999999999334,43029,32588
"172.16.133.33",58041,"172.16.139.250",5440,12,1142,16105,0,0,12,1142,0,0,198.277341,0.006975999999980331,1309633,0
"172.16.133.132",57625,"184.173.190.13",80,6,374,16106,0,0,4,254,2,120,198.298905,0.08234900000002199,24675,11657
"172.16.133.68",60901,"172.16.139.250",5440,10,1022,16107,0,0,10,1022,0,0,198.310414,0.005876999999998134,1391185,0
"172.16.133.12",59919,"172.16.139.250",5440,10,1022,16108,0,0,10,1022,0,0,198.324836,0.00567799999998897,1439943,0
"172.16.133.85",52418,"216.219.115.183",443,19,5105,16109,0,0,9,1046,10,4059,198.326092,0.24653000000000702,33943,131716
"172.16.133.85",52419,"216.219.115.160",443,19,5105,16110,0,0,9,1046,10,4059,198.327183,0.24198300000000472,34580,134191
"172.16.133.85",52420,"68.64.28.20",443,18,4928,16111,0,0,9,977,9,3951,198.333384,1.154356000000007,6770,27381
"172.16.133.63",54078,"172.16.139.250",5440,10,1022,16112,0,0,10,1022,0,0,198.33559,0.005638000000004695,1450159,0
"172.16.133.66",54309,"172.16.139.250",5440,10,1022,16113,0,0,10,1022,0,0,198.348446,0.005618999999995822,1455063,0
"172.16.133.82",61585,"172.16.139.250",5440,12,1142,16114,0,0,12,1142,0,0,198.36165,0.006372999999996409,1433547,0
"172.16.133.37",60794,"172.16.139.250",5440,10,1022,16115,0,0,10,1022,0,0,198.374827,0.005485999999990554,1490339,0
"172.16.133.132",47004,"23.33.44.79",80,6,412,16116,0,0,4,272,2,140,198.412342,0.039396000000010645,55234,28429
"172.16.133.132",59415,"85.90.254.45",80,7,478,16117,0,0,4,272,3,206,198.453858,0.2415730000000167,9007,6821
"172.16.133.78",59391,"172.16.139.250",5440,10,1022,16118,0,0,10,1022,0,0,198.531266,0.005474000000020851,1493606,0
"172.16.133.41",53293,"67.69.196.66",80,9,1262,16119,0,0,5,576,4,686,198.53144,0.33643699999998944,13696,16312
"172.16.133.67",56148,"172.16.139.250",5440,10,1022,16120,0,0,10,1022,0,0,198.587146,0.005869000000018332,1393082,0
"172.16.133.56",61578,"172.16.139.250",5440,10,1022,16121,0,0,10,1022,0,0,198.608486,0.004804000000007136,"",""
"172.16.133.37",60795,"216.219.115.183",443,19,5105,16122,0,0,9,1046,10,4059,198.612132,0.2719579999999837,30769,119400
"172.16.133.37",60796,"216.219.115.160",443,19,5105,16123,0,0,9,1046,10,4059,198.613048,0.27118200000001025,30857,119742
"172.16.133.44",64979,"180.153.31.250",443,8,486,16124,0,0,5,306,3,180,198.623857,3.4933440000000076,700,412
"172.16.133.41",53294,"172.16.139.250",5440,10,1022,16125,0,0,10,1022,0,0,198.663558,0.005583999999998923,1464183,0
"172.16.133.43",57922,"172.16.139.250",5440,12,1142,16126,0,0,12,1142,0,0,198.733717,0.006535999999982778,1397796,0
"172.16.133.42",57265,"172.16.139.250",5440,12,1142,16127,0,0,12,1142,0,0,198.735276,0.02550700000000461,358176,0
"172.16.133.13",53183,"172.16.139.250",5440,10,1022,16128,0,0,10,1022,0,0,198.756648,0.005572999999998274,1467073,0
"172.16.133.207",56079,"67.217.64.244",443,6,366,16129,0,0,4,246,2,120,198.799215,0.0674280000000067,29186,14237
"172.16.133.85",52421,"172.16.139.250",5440,12,1142,16130,0,0,12,1142,0,0,198.801402,0.006372999999996409,1433547,0
"172.16.133.20",62550,"172.16.139.250",5440,10,1022,16131,0,0,10,1022,0,0,198.802631,0.00813600000000747,1004916,0
"172.16.133.28",49274,"172.16.139.250",5440,10,1022,16132,0,0,10,1022,0,0,198.832857,0.006500000000016826,1257846,0
"172.16.133.207",56080,"216.115.223.200",443,6,366,16133,0,0,4,246,2,120,198.841164,0.08503899999999476,23142,11288
"172.16.133.99",56207,"172.16.139.250",5440,10,1022,16134,0,0,10,1022,0,0,198.860689,0.01475199999998722,554229,0
"172.16.133.37",60797,"64.74.80.185",443,16,4863,16135,0,0,8,923,8,3940,198.864516,0.17133199999997828,43097,183970
"172.16.133.75",51120,"172.16.139.250",5440,10,1022,16136,0,0,10,1022,0,0,198.866064,0.0053690000000017335,1522816,0
"172.16.133.87",60387,"172.16.139.250",5440,12,1142,16137,0,0,12,1142,0,0,198.884377,0.08161499999999933,111940,0
"172.16.133.35",50113,"172.16.139.250",5440,12,1142,16138,0,0,12,1142,0,0,198.894135,0.1240099999999984,73671,0
"172.16.133.113",55678,"172.16.139.250",135,8,492,16139,0,0,8,492,0,0,198.897882,0.013984999999991032,281444,0
"172.16.133.116",53805,"172.16.139.250",5440,10,1022,16140,0,0,10,1022,0,0,198.898184,0.08366000000000895,97728,0
"172.16.133.113",55679,"172.16.139.250",5462,10,696,16141,0,0,10,696,0,0,198.914184,0.5088379999999972,10942,0
"172.16.133.84",58948,"172.16.139.250",5440,12,1142,16142,0,0,12,1142,0,0,198.922487,0.07501800000000003,121784,0
"172.16.133.207",56081,"66.151.150.190",443,6,366,16143,0,0,4,246,2,120,198.931323,0.18858299999999417,10435,5090
"172.16.133.207",56082,"216.219.113.250",443,8,486,16144,0,0,5,306,3,180,198.935167,3.1921769999999867,766,451
"172.16.133.163",3589,"74.125.226.226",443,23,6183,16145,0,0,12,1963,11,4220,198.970676,90.16672700000001,174,374
"172.16.133.116",53806,"172.16.139.250",5440,10,1022,16146,0,0,10,1022,0,0,198.98277,0.021578000000005204,378904,0
"172.16.133.49",55934,"172.16.139.250",5440,12,1142,16147,0,0,12,1142,0,0,198.998085,0.010639999999995098,858646,0
"172.16.133.116",53807,"172.16.139.250",5440,12,1142,16148,0,0,12,1142,0,0,199.005283,0.017109000000004926,533987,0
"172.16.133.95",57107,"172.16.139.250",5440,10,1022,16149,0,0,10,1022,0,0,199.037226,0.020913000000007287,390952,0
"172.16.133.92",57820,"172.16.139.250",5440,12,1142,16150,0,0,12,1142,0,0,199.063532,0.019626999999985628,465481,0
"172.16.133.29",61135,"172.16.139.250",5440,12,1142,16151,0,0,12,1142,0,0,199.080825,0.008255999999988717,1106589,0
"172.16.133.44",64980,"172.16.139.250",5440,12,1142,16152,0,0,12,1142,0,0,199.087274,0.01792399999999361,509707,0
"172.16.133.207",56083,"172.16.139.250",5440,10,1022,16153,0,0,10,1022,0,0,199.112699,0.01482400000000439,551538,0
"172.16.133.83",57228,"172.16.139.250",5440,10,1022,16154,0,0,10,1022,0,0,199.122127,0.01482799999999429,551389,0
"172.16.133.93",60899,"172.16.139.250",5440,12,1142,16155,0,0,12,1142,0,0,199.138049,0.006766999999996415,1350081,0
"172.16.133.11",55316,"172.16.139.250",5440,12,1142,16156,0,0,12,1142,0,0,199.155493,0.00637499999999136,1433098,0
"172.16.133.55",57772,"172.16.139.250",5440,12,1142,16157,0,0,12,1142,0,0,199.159487,0.006529999999997926,1399081,0
"172.16.133.73",60829,"172.16.139.250",5440,10,1022,16158,0,0,10,1022,0,0,199.181401,0.005770000000012487,1416984,0
"172.16.133.53",54256,"172.16.139.250",5440,10,1022,16159,0,0,10,1022,0,0,199.184662,0.0065590000000099735,1246531,0
"172.16.133.21",53331,"172.16.139.250",5440,10,1022,16160,0,0,10,1022,0,0,199.188054,0.007035000000001901,1162189,0
"172.16.133.30",62823,"172.16.139.250",5440,12,1142,16161,0,0,12,1142,0,0,199.192109,0.006894000000016831,1325210,0
"172.16.133.25",63631,"172.16.139.250",5440,10,1022,16162,0,0,10,1022,0,0,199.200245,0.004955999999992855,"",""
"172.16.133.34",50599,"172.16.139.250",5440,10,1022,16163,0,0,10,1022,0,0,199.208067,0.005252000000012913,1556740,0
"172.16.133.97",59533,"172.16.139.250",5440,10,1022,16164,0,0,10,1022,0,0,199.218961,0.015202999999985423,537788,0
"172.16.133.71",57585,"173.252.110.27",80,12,1523,16165,0,0,7,741,5,782,199.245797,58.658671999999996,101,106
"172.16.133.71",57586,"23.66.231.48",80,15,6310,16166,0,0,7,772,8,5538,199.285161,58.59909300000001,105,756
"172.16.133.33",58042,"172.16.139.250",5440,10,1022,16167,0,0,10,1022,0,0,199.290815,0.015253999999998769,535990,0
"172.16.133.68",60902,"172.16.139.250",5440,10,1022,16168,0,0,10,1022,0,0,199.32467,0.005500000000012051,1486545,0
"172.16.133.12",59920,"172.16.139.250",5440,10,1022,16169,0,0,10,1022,0,0,199.33867,0.005522999999982403,1480354,0
"172.16.133.63",54080,"172.16.139.250",5440,10,1022,16170,0,0,10,1022,0,0,199.349637,0.00553899999999885,1476078,0
"172.16.133.66",54310,"172.16.139.250",5440,10,1022,16171,0,0,10,1022,0,0,199.361331,0.005498999999986154,1486815,0
"172.16.133.82",61586,"172.16.139.250",5440,10,1022,16172,0,0,10,1022,0,0,199.375525,0.005643999999989546,1448618,0
"172.16.133.37",60798,"172.16.139.250",5440,10,1022,16173,0,0,10,1022,0,0,199.389572,0.005597000000022945,1460782,0
"172.16.133.78",59392,"172.16.139.250",5440,12,1142,16174,0,0,12,1142,0,0,199.546209,0.013920999999982087,656274,0
"172.16.133.41",53295,"172.16.139.250",5440,10,1022,16175,0,0,10,1022,0,0,199.570744,0.015456000000000358,528985,0
"172.16.133.67",56149,"172.16.139.250",5440,10,1022,16176,0,0,10,1022,0,0,199.600162,0.01676899999998227,487566,0
"172.16.133.56",61579,"172.16.139.250",5440,10,1022,16177,0,0,10,1022,0,0,199.622242,0.00485299999999711,"",""
"172.16.133.71",57587,"23.67.243.89",80,12,3718,16178,0,0,6,697,6,3021,199.655964,58.22412799999998,95,415
"172.16.133.6",1730,"172.16.128.203",1026,13,2708,16179,0,0,7,2005,6,703,199.672661,0.48017699999999763,33404,11712
"172.16.133.41",53296,"172.16.139.250",5440,12,1142,16180,0,0,12,1142,0,0,199.677417,0.006284000000022161,1453851,0
"172.16.133.42",57266,"172.16.139.250",5440,12,1142,16181,0,0,12,1142,0,0,199.748117,0.06004799999999477,152144,0
"172.16.133.43",57923,"172.16.139.250",5440,10,1022,16182,0,0,10,1022,0,0,199.74818,0.015239000000008218,536518,0
"172.16.133.13",53184,"172.16.139.250",5440,12,1142,16183,0,0,12,1142,0,0,199.767466,0.006222999999977219,1468102,0
"172.16.133.85",52424,"172.16.139.250",5440,10,1022,16184,0,0,10,1022,0,0,199.773688,0.005313999999998487,1538577,0
"172.16.133.55",57773,"172.16.128.169",8014,14,4838,16185,0,0,7,2018,7,2820,199.77587,38.356502000000006,420,588
"172.16.133.20",62551,"172.16.139.250",5440,12,1142,16186,0,0,12,1142,0,0,199.816812,0.014545999999995729,628076,0
"172.16.133.28",49275,"172.16.139.250",5440,10,1022,16187,0,0,10,1022,0,0,199.846299,0.005170000000020991,1581431,0
"172.16.133.28",49276,"216.52.242.80",80,100,87817,16188,0,0,38,18743,62,69074,199.846827,63.551164,2359,8695
"172.16.133.99",56208,"172.16.139.250",5440,12,1142,16189,0,0,12,1142,0,0,199.875938,0.01488900000001081,613607,0
"172.16.133.75",51121,"172.16.139.250",5440,10,1022,16190,0,0,10,1022,0,0,199.879919,0.005288000000007287,1546142,0
"172.16.133.87",60388,"172.16.139.250",5440,10,1022,16191,0,0,10,1022,0,0,199.898995,0.01658499999999208,492975,0
"172.16.133.35",50114,"172.16.139.250",5440,12,1142,16192,0,0,12,1142,0,0,199.904973,0.009632999999979575,948406,0
"172.16.133.116",53810,"172.16.139.250",5440,10,1022,16193,0,0,10,1022,0,0,199.911633,0.007695000000012442,1062508,0
"172.16.133.116",53811,"172.16.139.250",5440,10,1022,16194,0,0,10,1022,0,0,199.920138,0.04420399999997926,184960,0
"172.16.133.84",58949,"172.16.139.250",5440,10,1022,16195,0,0,10,1022,0,0,199.93356,0.10158699999999499,80482,0
"172.16.133.116",53812,"172.16.139.250",5440,10,1022,16196,0,0,10,1022,0,0,199.965273,0.07321699999999964,111668,0
"172.16.133.49",55935,"172.16.139.250",5440,10,1022,16197,0,0,10,1022,0,0,200.009744,0.036031999999977415,226909,0
"172.16.133.39",64283,"173.194.43.33",443,112,68327,16198,0,0,47,16147,65,52180,200.024111,86.66196100000002,1490,4816
"172.16.133.95",57108,"172.16.139.250",5440,10,1022,16199,0,0,10,1022,0,0,200.050666,0.014772999999991043,553442,0
"172.16.133.92",57821,"172.16.139.250",5440,10,1022,16200,0,0,10,1022,0,0,200.077867,0.005567000000013422,1468654,0
"172.16.133.29",61136,"172.16.139.250",5440,10,1022,16201,0,0,10,1022,0,0,200.095468,0.005482000000000653,1491426,0
"172.16.133.44",64981,"172.16.139.250",5440,12,1142,16202,0,0,12,1142,0,0,200.102383,0.016317999999984067,559872,0
"172.16.133.207",56084,"172.16.139.250",5440,10,1022,16203,0,0,10,1022,0,0,200.127778,0.008603999999991174,950255,0
"172.16.133.83",57229,"172.16.139.250",5440,12,1142,16204,0,0,12,1142,0,0,200.135891,0.013822000000004664,660975,0
"172.16.133.93",60900,"172.16.139.250",5440,10,1022,16205,0,0,10,1022,0,0,200.150793,0.004906000000005406,"",""
"172.16.133.11",55317,"172.16.139.250",5440,10,1022,16206,0,0,10,1022,0,0,200.169683,0.005532000000016524,1477946,0
"172.16.133.55",57774,"172.16.139.250",5440,10,1022,16207,0,0,10,1022,0,0,200.172952,0.0060320000000047,1355437,0
"172.16.133.73",60830,"172.16.139.250",5440,12,1142,16208,0,0,12,1142,0,0,200.195838,0.0062819999999987886,1454313,0
"172.16.133.53",54257,"172.16.139.250",5440,12,1142,16209,0,0,12,1142,0,0,200.199081,0.01596799999998666,572144,0
"172.16.133.21",53332,"172.16.139.250",5440,10,1022,16210,0,0,10,1022,0,0,200.201869,0.005848000000014508,1398084,0
"172.16.133.30",62824,"172.16.139.250",5440,10,1022,16211,0,0,10,1022,0,0,200.206186,0.018166000000007898,450071,0
"172.16.133.25",63632,"172.16.139.250",5440,12,1142,16212,0,0,12,1142,0,0,200.213991,0.0055720000000007985,1639626,0
"172.16.133.34",50600,"172.16.139.250",5440,12,1142,16213,0,0,12,1142,0,0,200.221733,0.014571999999986929,626955,0
"172.16.133.128",65092,"96.43.146.22",443,17,4143,16214,0,0,10,3306,7,837,200.225253,90.21035899999998,293,74
"172.16.133.97",59534,"172.16.139.250",5440,10,1022,16215,0,0,10,1022,0,0,200.233422,0.014836000000002514,551091,0
"172.16.133.33",58043,"172.16.139.250",5440,12,1142,16216,0,0,12,1142,0,0,200.305474,0.006244000000009464,1463164,0
"172.16.133.68",60903,"172.16.139.250",5440,12,1142,16217,0,0,12,1142,0,0,200.338317,0.014792999999997392,617589,0
"172.16.133.12",59921,"172.16.139.250",5440,12,1142,16218,0,0,12,1142,0,0,200.352996,0.006280000000003838,1454777,0
"172.16.133.63",54081,"172.16.139.250",5440,10,1022,16219,0,0,10,1022,0,0,200.364138,0.005354000000011183,1527082,0
"172.16.133.66",54311,"172.16.139.250",5440,12,1142,16220,0,0,12,1142,0,0,200.375429,0.005357000000003609,1705432,0
"172.16.133.82",61587,"172.16.139.250",5440,10,1022,16221,0,0,10,1022,0,0,200.389946,0.016089999999991278,508141,0
"172.16.133.37",60799,"172.16.139.250",5440,12,1142,16222,0,0,12,1142,0,0,200.402352,0.007720000000006166,1183419,0
"172.16.133.25",63633,"172.16.139.250",5440,12,1142,16223,0,0,12,1142,0,0,200.526591,0.013891000000000986,657692,0
"172.16.133.78",59393,"172.16.139.250",5440,10,1022,16224,0,0,10,1022,0,0,200.559449,0.005546000000009599,1474215,0
"172.16.133.67",56150,"172.16.139.250",5440,12,1142,16225,0,0,12,1142,0,0,200.614123,0.016254000000003543,562077,0
"172.16.133.56",61580,"172.16.139.250",5440,12,1142,16226,0,0,12,1142,0,0,200.63695,0.00528699999998139,1728012,0
"172.16.133.41",53297,"172.16.139.250",5440,10,1022,16227,0,0,10,1022,0,0,200.691573,0.01551200000000108,527075,0
"172.16.133.18",50304,"157.56.238.6",443,748,715426,16228,0,0,361,361712,387,353714,200.749069,94.535942,30609,29932
"172.16.133.43",57924,"172.16.139.250",5440,12,1142,16229,0,0,12,1142,0,0,200.761487,0.014825000000001864,616256,0
"172.16.133.42",57267,"172.16.139.250",5440,12,1142,16230,0,0,12,1142,0,0,200.769407,0.028349999999988995,322257,0
"172.16.133.13",53185,"172.16.139.250",5440,12,1142,16231,0,0,12,1142,0,0,200.781748,0.019802999999996018,461344,0
"172.16.133.184",58158,"205.216.16.228",80,127,102210,16232,0,0,54,3346,73,98864,200.782141,0.6896690000000092,38812,1146799
"172.16.133.85",52425,"172.16.139.250",5440,10,1022,16233,0,0,10,1022,0,0,200.787071,0.017482999999998583,467654,0
"172.16.133.6",1528,"172.16.128.201",1060,2,120,16234,0,0,1,60,1,60,200.828694,0.09974099999999453,4812,4812
"172.16.133.20",62552,"172.16.139.250",5440,12,1142,16235,0,0,12,1142,0,0,200.831084,0.004925999999983333,"",""
"172.16.133.207",56085,"67.217.64.244",443,6,366,16236,0,0,4,246,2,120,200.840339,0.06831399999998666,28808,14052
"172.16.133.28",49277,"172.16.139.250",5440,12,1142,16237,0,0,12,1142,0,0,200.860463,0.006204999999994243,1472360,0
"172.16.133.44",64982,"180.153.31.250",443,6,366,16238,0,0,4,246,2,120,200.883736,0.4838479999999947,4067,1984
"172.16.133.99",56209,"172.16.139.250",5440,10,1022,16239,0,0,10,1022,0,0,200.888779,0.015252000000003818,536060,0
"172.16.133.207",56086,"216.115.223.200",443,6,366,16240,0,0,4,246,2,120,200.890199,0.1058360000000107,18594,9070
"172.16.133.75",51122,"172.16.139.250",5440,10,1022,16241,0,0,10,1022,0,0,200.89373,0.014578999999997677,560806,0
"172.16.133.87",60389,"172.16.139.250",5440,12,1142,16242,0,0,12,1142,0,0,200.912745,0.006140999999985297,1487705,0
"172.16.133.35",50115,"172.16.139.250",5440,12,1142,16243,0,0,12,1142,0,0,200.917626,0.008118999999993548,1125261,0
"172.16.133.116",53817,"172.16.139.250",5440,12,1142,16244,0,0,12,1142,0,0,200.925356,0.005985000000009677,1526482,0
"172.16.133.116",53818,"172.16.139.250",5440,12,1142,16245,0,0,12,1142,0,0,200.932429,0.016687999999987824,547459,0
"172.16.133.84",58950,"172.16.139.250",5440,10,1022,16246,0,0,10,1022,0,0,200.947339,0.005792000000013786,1411602,0
"172.16.133.116",53819,"172.16.139.250",5440,12,1142,16247,0,0,12,1142,0,0,200.949968,0.0069769999999778065,1309445,0
"172.16.133.6",1731,"172.16.128.201",1060,6828,5454375,16248,0,0,2406,190212,4422,5264163,201.003568,98.929092,15381,425691
"172.16.133.49",55936,"172.16.139.250",5440,12,1142,16249,0,0,12,1142,0,0,201.023968,0.006284999999991214,1453619,0
"172.16.133.207",56087,"66.151.150.190",443,6,366,16250,0,0,4,246,2,120,201.030252,0.1929049999999961,10201,4976
"172.16.133.207",56088,"216.219.113.250",443,6,366,16251,0,0,4,246,2,120,201.038219,0.20594800000000646,9555,4661
"172.16.133.95",57109,"172.16.139.250",5440,10,1022,16252,0,0,10,1022,0,0,201.065148,0.021685000000019272,377034,0
"172.16.133.92",57822,"172.16.139.250",5440,10,1022,16253,0,0,10,1022,0,0,201.09339,0.005671000000006643,1441721,0
"172.16.133.29",61137,"172.16.139.250",5440,10,1022,16254,0,0,10,1022,0,0,201.108998,0.01651099999997996,495185,0
"172.16.133.44",64983,"172.16.139.250",5440,10,1022,16255,0,0,10,1022,0,0,201.115029,0.0146090000000072,559655,0
"172.16.133.207",56089,"172.16.139.250",5440,10,1022,16256,0,0,10,1022,0,0,201.140902,0.01777699999999527,459920,0
"172.16.133.83",57230,"172.16.139.250",5440,10,1022,16257,0,0,10,1022,0,0,201.149946,0.004660999999998694,"",""
"172.16.133.93",60901,"172.16.139.250",5440,12,1142,16258,0,0,12,1142,0,0,201.16575,0.004951000000005479,"",""
"172.16.133.18",50305,"157.56.238.6",443,38,18913,16259,0,0,19,5916,19,12997,201.180361,91.71344699999997,516,1133
"172.16.133.11",55318,"172.16.139.250",5440,10,1022,16260,0,0,10,1022,0,0,201.182817,0.015342000000003964,532916,0
"172.16.133.55",57775,"172.16.139.250",5440,12,1142,16261,0,0,12,1142,0,0,201.187078,0.006173999999987245,1479753,0
"172.16.133.73",60831,"172.16.139.250",5440,12,1142,16262,0,0,12,1142,0,0,201.209598,0.007812000000001262,1169482,0
"172.16.133.53",54258,"172.16.139.250",5440,12,1142,16263,0,0,12,1142,0,0,201.212836,0.017939999999981637,509253,0
"172.16.133.21",53333,"172.16.139.250",5440,12,1142,16264,0,0,12,1142,0,0,201.216038,0.006759000000016613,1351679,0
"172.16.133.30",62825,"172.16.139.250",5440,12,1142,16265,0,0,12,1142,0,0,201.219894,0.006724999999988768,1358513,0
"172.16.133.25",63634,"172.16.139.250",5440,12,1142,16266,0,0,12,1142,0,0,201.228061,0.006011000000000877,1519880,0
"172.16.133.34",50601,"172.16.139.250",5440,10,1022,16267,0,0,10,1022,0,0,201.235715,0.004925000000014279,"",""
"172.16.133.97",59535,"172.16.139.250",5440,10,1022,16268,0,0,10,1022,0,0,201.246596,0.014620999999976902,559195,0
"172.16.133.33",58044,"172.16.139.250",5440,12,1142,16269,0,0,12,1142,0,0,201.319317,0.0064519999999959055,1415995,0
"172.16.133.68",60904,"172.16.139.250",5440,10,1022,16270,0,0,10,1022,0,0,201.352446,0.015863000000024385,515413,0
"172.16.133.12",59922,"172.16.139.250",5440,12,1142,16271,0,0,12,1142,0,0,201.365959,0.006804999999985739,1342542,0
"172.16.133.63",54082,"172.16.139.250",5440,10,1022,16272,0,0,10,1022,0,0,201.377716,0.005547000000007074,1473949,0
"172.16.133.184",57588,"204.14.232.101",443,31,13386,16273,0,0,16,1681,15,11705,201.386802,0.17679600000002438,76065,529649
"172.16.133.66",54312,"172.16.139.250",5440,10,1022,16274,0,0,10,1022,0,0,201.389427,0.005366999999978361,1523383,0
"172.16.133.82",61588,"172.16.139.250",5440,10,1022,16275,0,0,10,1022,0,0,201.403645,0.00559099999998125,1462350,0
"172.16.133.37",60800,"172.16.139.250",5440,10,1022,16276,0,0,10,1022,0,0,201.416403,0.006348000000002685,1287964,0
"172.16.133.78",59394,"172.16.139.250",5440,10,1022,16277,0,0,10,1022,0,0,201.572322,0.005406999999991058,1512113,0
"172.16.133.93",60902,"199.48.204.30",80,15,7134,16278,0,0,7,1217,8,5917,201.589934,5.9680250000000115,1631,7931
"172.16.133.67",56151,"172.16.139.250",5440,12,1142,16279,0,0,12,1142,0,0,201.629034,0.01579200000000469,578520,0
"172.16.133.56",61581,"172.16.139.250",5440,10,1022,16280,0,0,10,1022,0,0,201.650407,0.00472500000000764,"",""
"172.16.133.41",53298,"172.16.139.250",5440,10,1022,16281,0,0,10,1022,0,0,201.705727,0.01564500000000635,522595,0
"172.16.133.6",1732,"172.16.128.201",135,12,1208,16282,0,0,7,682,5,526,201.713833,91.53810200000001,59,45
"172.16.133.78",59395,"172.16.128.169",8014,9,1412,16283,0,0,6,1050,3,362,201.744089,15.18390199999999,553,190
"172.16.133.43",57925,"172.16.139.250",5440,12,1142,16284,0,0,12,1142,0,0,201.775908,0.006216000000023314,1469755,0
"172.16.133.42",57268,"172.16.139.250",5440,12,1142,16285,0,0,12,1142,0,0,201.780762,0.02750399999999331,332169,0
"172.16.133.13",53186,"172.16.139.250",5440,10,1022,16286,0,0,10,1022,0,0,201.795638,0.006540999999998576,1249961,0
"172.16.133.85",52426,"172.16.139.250",5440,10,1022,16287,0,0,10,1022,0,0,201.802764,0.005252000000012913,1556740,0
"172.16.133.20",62553,"172.16.139.250",5440,12,1142,16288,0,0,12,1142,0,0,201.844802,0.005316000000021859,1718585,0
"172.16.133.28",49278,"172.16.139.250",5440,10,1022,16289,0,0,10,1022,0,0,201.874422,0.01567899999997735,521461,0
"172.16.133.99",56210,"172.16.139.250",5440,12,1142,16290,0,0,12,1142,0,0,201.902885,0.014960999999999558,610654,0
"172.16.133.75",51123,"172.16.139.250",5440,10,1022,16291,0,0,10,1022,0,0,201.908224,0.005363000000016882,1524519,0
"172.16.133.87",60390,"172.16.139.250",5440,10,1022,16292,0,0,10,1022,0,0,201.926613,0.005374999999986585,1521116,0
"172.16.133.35",50116,"172.16.139.250",5440,12,1142,16293,0,0,12,1142,0,0,201.931767,0.012577999999990652,726347,0
"172.16.133.116",53820,"172.16.139.250",5440,10,1022,16294,0,0,10,1022,0,0,201.938209,0.006315000000000737,1294695,0
"172.16.133.116",53821,"172.16.139.250",5440,10,1022,16295,0,0,10,1022,0,0,201.945412,0.006481000000007953,1261533,0
"172.16.133.116",53822,"172.16.139.250",5440,12,1142,16296,0,0,12,1142,0,0,201.952871,0.005737000000010539,1592469,0
"172.16.133.84",58951,"172.16.139.250",5440,12,1142,16297,0,0,12,1142,0,0,201.961273,0.015211999999991122,600578,0
"172.16.133.93",60903,"168.215.63.101",80,9,1214,16298,0,0,5,799,4,415,201.978182,0.14833699999999794,43091,22381
"172.16.133.49",55937,"172.16.139.250",5440,12,1142,16299,0,0,12,1142,0,0,202.037529,0.006346000000007734,1439647,0
"172.16.133.95",57110,"172.16.139.250",5440,10,1022,16300,0,0,10,1022,0,0,202.079078,0.0054419999999879565,1502388,0
"172.16.133.92",57823,"172.16.139.250",5440,10,1022,16301,0,0,10,1022,0,0,202.105004,0.07618800000000192,107313,0
"172.16.133.29",61138,"172.16.139.250",5440,10,1022,16302,0,0,10,1022,0,0,202.122873,0.062422999999995454,130977,0
"172.16.133.44",64984,"172.16.139.250",5440,12,1142,16303,0,0,12,1142,0,0,202.12927,0.06019399999999564,151775,0
"172.16.133.207",56090,"172.16.139.250",5440,12,1142,16304,0,0,12,1142,0,0,202.154633,0.0412860000000137,221285,0
"172.16.133.83",57231,"172.16.139.250",5440,12,1142,16305,0,0,12,1142,0,0,202.164096,0.028132999999996855,324743,0
"172.16.133.93",60904,"172.16.139.250",5440,10,1022,16306,0,0,10,1022,0,0,202.179923,0.019561000000010154,417974,0
"172.16.133.11",55319,"172.16.139.250",5440,10,1022,16307,0,0,10,1022,0,0,202.198756,0.0056219999999882475,1454286,0
"172.16.133.55",57776,"172.16.139.250",5440,10,1022,16308,0,0,10,1022,0,0,202.201111,0.008307000000002063,984230,0
"172.16.133.73",60832,"172.16.139.250",5440,12,1142,16309,0,0,12,1142,0,0,202.223523,0.01603800000000888,569647,0
"172.16.133.53",54259,"172.16.139.250",5440,10,1022,16310,0,0,10,1022,0,0,202.2268,0.015793000000002166,517697,0
"172.16.133.21",53334,"172.16.139.250",5440,12,1142,16311,0,0,12,1142,0,0,202.230349,0.017027000000013004,536559,0
"172.16.133.30",62826,"172.16.139.250",5440,12,1142,16312,0,0,12,1142,0,0,202.233939,0.021046000000012555,434096,0
"172.16.133.25",63635,"172.16.139.250",5440,12,1142,16313,0,0,12,1142,0,0,202.241197,0.009489999999999554,962697,0
"172.16.133.34",50602,"172.16.139.250",5440,10,1022,16314,0,0,10,1022,0,0,202.250181,0.007977000000011003,1024946,0
"172.16.133.97",59536,"172.16.139.250",5440,10,1022,16315,0,0,10,1022,0,0,202.260583,0.015378999999995813,531634,0
"172.16.133.33",58045,"172.16.139.250",5440,10,1022,16316,0,0,10,1022,0,0,202.332455,0.005674999999996544,1440704,0
"172.16.133.68",60905,"172.16.139.250",5440,10,1022,16317,0,0,10,1022,0,0,202.366476,0.005767999999989115,1417475,0
"172.16.133.12",59923,"172.16.139.250",5440,12,1142,16318,0,0,12,1142,0,0,202.380607,0.006198000000011916,1474023,0
"172.16.133.63",54083,"172.16.139.250",5440,12,1142,16319,0,0,12,1142,0,0,202.391737,0.00708499999998935,1289484,0
"172.16.133.66",54313,"172.16.139.250",5440,10,1022,16320,0,0,10,1022,0,0,202.403573,0.006078000000002248,1345179,0
"172.16.133.82",61589,"172.16.139.250",5440,8,902,16321,0,0,8,902,0,0,202.417935,0.005576999999988175,1293885,0
"172.16.133.40",50239,"108.162.199.98",80,82,37424,16322,0,0,26,4947,56,32477,202.425399,59.880014999999986,660,4338
"172.16.133.37",60801,"172.16.139.250",5440,10,1022,16323,0,0,10,1022,0,0,202.430504,0.014641999999980726,558393,0
"172.16.133.6",1733,"172.16.128.201",1060,11,2653,16324,0,0,7,2049,4,604,202.521519,90.61954099999997,180,53
"172.16.133.6",1734,"172.16.128.201",1060,12,3225,16325,0,0,7,2257,5,968,202.521797,90.61914200000001,199,85
"172.16.133.113",55682,"184.73.225.104",443,26,9155,16326,0,0,13,2958,13,6197,202.555479,5.620497,4210,8820
"172.16.133.78",59396,"172.16.139.250",5440,10,1022,16327,0,0,10,1022,0,0,202.587632,0.005543999999986227,1474747,0
"172.16.133.67",56152,"172.16.139.250",5440,12,1142,16328,0,0,12,1142,0,0,202.642043,0.006417999999996482,1423496,0
"172.16.133.56",61582,"172.16.139.250",5440,12,1142,16329,0,0,12,1142,0,0,202.664473,0.004985000000004902,"",""
"172.16.133.41",53299,"172.16.139.250",5440,12,1142,16330,0,0,12,1142,0,0,202.719235,0.005905000000012706,1547163,0
"172.16.133.43",57926,"172.16.139.250",5440,10,1022,16331,0,0,10,1022,0,0,202.790513,0.016743999999988546,488294,0
"172.16.133.42",57269,"172.16.139.250",5440,12,1142,16332,0,0,12,1142,0,0,202.802906,0.014111999999983027,647392,0
"172.16.133.13",53187,"172.16.139.250",5440,10,1022,16333,0,0,10,1022,0,0,202.809553,0.0054379999999980555,1503493,0
"172.16.133.85",52427,"172.16.139.250",5440,12,1142,16334,0,0,12,1142,0,0,202.815871,0.015937000000008084,573257,0
"172.16.133.20",62554,"172.16.139.250",5440,12,1142,16335,0,0,12,1142,0,0,202.858712,0.004864999999995234,"",""
"172.16.133.207",56091,"67.217.64.244",443,6,366,16336,0,0,4,246,2,120,202.876409,0.06123400000001311,32139,15677
"172.16.128.233",50928,"172.16.133.233",22,163,19344,16337,0,0,46,3940,117,15404,202.880885,7.955700000000007,3961,15489
"172.16.133.28",49279,"172.16.139.250",5440,12,1142,16338,0,0,12,1142,0,0,202.888209,0.015325000000018463,596150,0
"172.16.133.28",49280,"23.0.49.244",80,6,372,16339,0,0,4,246,2,126,202.917287,16.71301200000002,117,60
"172.16.133.28",49281,"23.0.49.244",80,6,372,16340,0,0,4,246,2,126,202.917426,16.711960000000005,117,60
"172.16.133.99",56211,"172.16.139.250",5440,10,1022,16341,0,0,10,1022,0,0,202.917611,0.004849000000007209,"",""
"172.16.133.75",51124,"172.16.139.250",5440,10,1022,16342,0,0,10,1022,0,0,202.921818,0.014631000000008498,558813,0
"172.16.133.87",60391,"172.16.139.250",5440,10,1022,16343,0,0,10,1022,0,0,202.941088,0.005509999999986803,1483847,0
"172.16.133.35",50117,"172.16.139.250",5440,12,1142,16344,0,0,12,1142,0,0,202.945346,0.009679000000005544,943899,0
"172.16.133.116",53823,"172.16.139.250",5440,10,1022,16345,0,0,10,1022,0,0,202.953408,0.014280000000013615,572549,0
"172.16.133.207",56092,"216.115.223.200",443,6,366,16346,0,0,4,246,2,120,202.956246,0.08657300000001555,22732,11088
"172.16.133.116",53824,"172.16.139.250",5440,12,1142,16347,0,0,12,1142,0,0,202.968716,0.01678899999998862,544165,0
"172.16.133.84",58952,"172.16.139.250",5440,12,1142,16348,0,0,12,1142,0,0,202.97554,0.006112000000001672,1494764,0
"172.16.133.116",53825,"172.16.139.250",5440,10,1022,16349,0,0,10,1022,0,0,202.986411,0.0068119999999964875,1200234,0
"172.16.133.49",55938,"172.16.139.250",5440,10,1022,16350,0,0,10,1022,0,0,203.051495,0.006985000000014452,1170508,0
"172.16.133.95",57111,"172.16.139.250",5440,12,1142,16351,0,0,12,1142,0,0,203.094356,0.015162000000003673,602559,0
"172.16.133.113",55683,"157.56.236.89",443,6,374,16352,0,0,3,194,3,180,203.098611,1.2801519999999869,1212,1124
"172.16.133.92",57824,"172.16.139.250",5440,10,1022,16353,0,0,10,1022,0,0,203.118751,0.015737000000001444,519539,0
"172.16.133.207",56093,"66.151.150.190",443,6,366,16354,0,0,4,246,2,120,203.121394,0.18220099999999206,10801,5268
"172.16.133.44",64985,"180.153.31.250",443,6,366,16355,0,0,4,246,2,120,203.128741,0.472801000000004,4162,2030
"172.16.133.29",61139,"172.16.139.250",5440,10,1022,16356,0,0,10,1022,0,0,203.13846,0.006945999999999231,1177080,0
"172.16.133.44",64986,"172.16.139.250",5440,12,1142,16357,0,0,12,1142,0,0,203.144971,0.015565000000009377,586957,0
"172.16.133.207",56094,"216.219.113.250",443,6,366,16358,0,0,4,246,2,120,203.146344,0.20405500000001098,9644,4704
"172.16.133.6",1735,"172.16.128.201",1060,463,318953,16359,0,0,185,23184,278,295769,203.159334,93.009029,1994,25440
"172.16.133.41",53300,"207.46.206.125",80,12,1157,16360,0,0,6,621,6,536,203.166976,3.195668999999981,1554,1341
"172.16.133.207",56095,"172.16.139.250",5440,10,1022,16361,0,0,10,1022,0,0,203.169994,0.004706999999996242,"",""
"172.16.133.83",57232,"172.16.139.250",5440,10,1022,16362,0,0,10,1022,0,0,203.178068,0.004644000000013193,"",""
"172.16.133.93",60905,"172.16.139.250",5440,12,1142,16363,0,0,12,1142,0,0,203.192885,0.014386000000001786,635061,0
"172.16.133.11",55320,"172.16.139.250",5440,12,1142,16364,0,0,12,1142,0,0,203.211619,0.015330999999974892,595916,0
"172.16.133.55",57777,"172.16.139.250",5440,10,1022,16365,0,0,10,1022,0,0,203.215249,0.005606999999997697,1458177,0
"172.16.133.73",60833,"172.16.139.250",5440,10,1022,16366,0,0,10,1022,0,0,203.23767,0.005685999999997193,1437917,0
"172.16.133.53",54260,"172.16.139.250",5440,12,1142,16367,0,0,12,1142,0,0,203.241048,0.007024999999998727,1300498,0
"172.16.133.21",53335,"172.16.139.250",5440,12,1142,16368,0,0,12,1142,0,0,203.244351,0.007812999999998738,1169333,0
"172.16.133.30",62827,"172.16.139.250",5440,12,1142,16369,0,0,12,1142,0,0,203.248124,0.008001000000007252,1141857,0
"172.16.133.25",63636,"172.16.139.250",5440,12,1142,16370,0,0,12,1142,0,0,203.255121,0.014730999999983396,620188,0
"172.16.133.34",50603,"172.16.139.250",5440,12,1142,16371,0,0,12,1142,0,0,203.264302,0.015100000000018099,605033,0
"172.16.133.97",59537,"172.16.139.250",5440,10,1022,16372,0,0,10,1022,0,0,203.275602,0.014724999999998545,555246,0
"172.16.133.60",62142,"173.194.75.106",443,23,4541,16373,0,0,12,3137,11,1404,203.331158,90.227383,278,124
"172.16.133.33",58046,"172.16.139.250",5440,12,1142,16374,0,0,12,1142,0,0,203.345418,0.006309000000015885,1448090,0
"172.16.133.68",60906,"172.16.139.250",5440,10,1022,16375,0,0,10,1022,0,0,203.380623,0.015468999999995958,528540,0
"172.16.133.63",54084,"172.16.139.250",5440,10,1022,16376,0,0,10,1022,0,0,203.405846,0.005612000000013495,1456878,0
"172.16.133.12",59924,"172.16.139.250",5440,12,1142,16377,0,0,12,1142,0,0,203.407111,0.024025000000023056,380270,0
"172.16.133.66",54314,"172.16.139.250",5440,10,1022,16378,0,0,10,1022,0,0,203.417515,0.007944999999978108,1029074,0
"172.16.133.67",56153,"96.43.146.176",443,17,4153,16379,0,0,10,2554,7,1599,203.422462,3.0090079999999944,6790,4251
"172.16.133.113",55684,"172.16.139.250",135,8,492,16380,0,0,8,492,0,0,203.423609,0.009774999999990541,402659,0
"172.16.133.82",61590,"172.16.139.250",5440,12,1142,16381,0,0,12,1142,0,0,203.433541,0.008798000000012962,1038417,0
"172.16.133.113",55685,"172.16.139.250",5462,10,696,16382,0,0,10,696,0,0,203.43415,0.5104010000000017,10909,0
"172.16.133.37",60802,"172.16.139.250",5440,10,1022,16383,0,0,10,1022,0,0,203.444532,0.014678000000003522,557024,0
"172.16.133.132",42355,"216.185.152.144",80,40,24714,16384,0,0,21,1370,19,23344,203.469846,0.4106660000000204,26688,454753
"172.16.133.60",62143,"66.199.173.81",80,11,2153,16385,0,0,6,854,5,1299,203.547848,5.824784000000022,1172,1784
"172.16.133.132",33826,"64.12.96.147",80,6,380,16386,0,0,4,254,2,126,203.579515,0.049979000000007545,40657,20168
"172.16.133.78",59397,"172.16.139.250",5440,10,1022,16387,0,0,10,1022,0,0,203.600627,0.00646199999999908,1265242,0
"172.16.133.67",56154,"172.16.139.250",5440,10,1022,16388,0,0,10,1022,0,0,203.656296,0.005749000000008664,1422160,0
"172.16.133.56",61583,"172.16.139.250",5440,10,1022,16389,0,0,10,1022,0,0,203.678593,0.0048929999999813845,"",""
"172.16.133.41",53301,"172.16.139.250",5440,12,1142,16390,0,0,12,1142,0,0,203.733681,0.05868499999999699,155678,0
"172.16.133.43",57927,"172.16.139.250",5440,12,1142,16391,0,0,12,1142,0,0,203.803481,0.015811999999982618,577789,0
"172.16.133.132",53962,"96.43.146.48",443,36,13748,16392,0,0,19,1872,17,11876,203.810164,3.978995000000026,3763,23877
"172.16.133.42",57270,"172.16.139.250",5440,12,1142,16393,0,0,12,1142,0,0,203.812317,0.08116400000000112,112562,0
"172.16.133.13",53188,"172.16.139.250",5440,10,1022,16394,0,0,10,1022,0,0,203.823588,0.016300999999998567,501564,0
"172.16.133.85",52428,"172.16.139.250",5440,12,1142,16395,0,0,12,1142,0,0,203.829203,0.015710999999981823,581503,0
"172.16.133.20",62555,"172.16.139.250",5440,10,1022,16396,0,0,10,1022,0,0,203.872625,0.004604000000000497,"",""
"172.16.133.28",49282,"172.16.139.250",5440,12,1142,16397,0,0,12,1142,0,0,203.902676,0.00650299999998083,1404890,0
"172.16.133.99",56212,"172.16.139.250",5440,12,1142,16398,0,0,12,1142,0,0,203.929817,0.016826999999977943,542936,0
"172.16.133.75",51125,"172.16.139.250",5440,12,1142,16399,0,0,12,1142,0,0,203.935917,0.007114000000001397,1284228,0
"172.16.133.40",50240,"108.162.199.98",80,19,4815,16400,0,0,9,2901,10,1914,203.944117,48.39988099999999,479,316
"172.16.133.87",60392,"172.16.139.250",5440,12,1142,16401,0,0,12,1142,0,0,203.954297,0.005837000000013859,1565187,0
"172.16.133.116",53826,"172.16.139.250",5440,10,1022,16402,0,0,10,1022,0,0,203.966557,0.014189000000015994,576221,0
"172.16.133.35",50118,"172.16.139.250",5440,12,1142,16403,0,0,12,1142,0,0,203.980631,0.014962000000025455,610613,0
"172.16.133.116",53827,"172.16.139.250",5440,12,1142,16404,0,0,12,1142,0,0,203.981793,0.005721999999991567,1596644,0
"172.16.133.116",53828,"172.16.139.250",5440,12,1142,16405,0,0,12,1142,0,0,203.988505,0.006755999999995765,1352279,0
"172.16.133.84",58953,"172.16.139.250",5440,10,1022,16406,0,0,10,1022,0,0,203.989661,0.01524899999998297,536166,0
"172.16.133.49",55939,"172.16.139.250",5440,10,1022,16407,0,0,10,1022,0,0,204.066767,0.009332999999998037,876031,0
"172.16.133.95",57112,"172.16.139.250",5440,10,1022,16408,0,0,10,1022,0,0,204.107146,0.0418679999999938,195280,0
"172.16.133.92",57825,"172.16.139.250",5440,12,1142,16409,0,0,12,1142,0,0,204.134004,0.019737999999989597,462863,0
"172.16.133.29",61140,"172.16.139.250",5440,12,1142,16410,0,0,12,1142,0,0,204.150975,0.01097200000000953,832664,0
"172.16.133.44",64987,"172.16.139.250",5440,12,1142,16411,0,0,12,1142,0,0,204.158129,0.01262199999999325,723815,0
"172.16.133.60",62144,"173.194.43.34",80,24,7687,16412,0,0,14,6539,10,1148,204.164645,94.49712699999998,553,97
"172.16.133.60",62145,"173.194.75.106",80,27,8231,16413,0,0,15,6813,12,1418,204.171395,94.56863799999999,576,119
"172.16.133.207",56096,"172.16.139.250",5440,12,1142,16414,0,0,12,1142,0,0,204.183028,0.017752000000001544,514646,0
"172.16.133.83",57233,"172.16.139.250",5440,10,1022,16415,0,0,10,1022,0,0,204.192113,0.004750000000001364,"",""
"172.16.133.93",60906,"172.16.139.250",5440,10,1022,16416,0,0,10,1022,0,0,204.206924,0.004817000000002736,"",""
"172.16.133.11",55321,"172.16.139.250",5440,12,1142,16417,0,0,12,1142,0,0,204.225853,0.006529999999997926,1399081,0
"172.16.133.55",57778,"172.16.139.250",5440,12,1142,16418,0,0,12,1142,0,0,204.229267,0.015434999999996535,591901,0
"172.16.133.73",60834,"172.16.139.250",5440,12,1142,16419,0,0,12,1142,0,0,204.251549,0.01826899999997522,500082,0
"172.16.133.53",54261,"172.16.139.250",5440,12,1142,16420,0,0,12,1142,0,0,204.255542,0.00652500000001055,1400153,0
"172.16.133.21",53336,"172.16.139.250",5440,12,1142,16421,0,0,12,1142,0,0,204.257688,0.0077070000000105665,1185415,0
"172.16.133.30",62828,"172.16.139.250",5440,12,1142,16422,0,0,12,1142,0,0,204.262021,0.016482999999993808,554268,0
"172.16.133.25",63637,"172.16.139.250",5440,10,1022,16423,0,0,10,1022,0,0,204.268906,0.005115000000017744,1598435,0
"172.16.133.60",62146,"208.98.232.43",80,10,1491,16424,0,0,5,633,5,858,204.273871,0.23341899999999782,21694,29406
"172.16.133.34",50604,"172.16.139.250",5440,12,1142,16425,0,0,12,1142,0,0,204.277871,0.015937000000008084,573257,0
"172.16.133.97",59538,"172.16.139.250",5440,10,1022,16426,0,0,10,1022,0,0,204.289833,0.007614000000017995,1073811,0
"172.16.133.33",58047,"172.16.139.250",5440,12,1142,16427,0,0,12,1142,0,0,204.359624,0.006282999999996264,1454082,0
"172.16.133.113",55686,"157.56.240.137",443,6,374,16428,0,0,3,194,3,180,204.382619,1.0894830000000013,1424,1321
"172.16.133.29",61141,"173.194.43.60",80,7,432,16429,0,0,4,246,3,186,204.387123,16.702604000000008,117,89
"172.16.133.29",61142,"64.94.107.46",80,7,428,16430,0,0,4,246,3,182,204.387418,16.701269999999994,117,87
"172.16.133.29",61143,"64.94.107.46",80,7,428,16431,0,0,4,246,3,182,204.387602,16.70542500000002,117,87
"172.16.133.29",61144,"64.94.107.46",80,7,428,16432,0,0,4,246,3,182,204.387728,16.699871,117,87
"172.16.133.29",61145,"64.94.107.11",80,7,428,16433,0,0,4,246,3,182,204.388217,16.70328599999999,117,87
"172.16.133.29",61146,"64.94.107.11",80,7,428,16434,0,0,4,246,3,182,204.388404,16.704431999999997,117,87
"172.16.133.29",61147,"64.94.107.11",80,8,1664,16435,0,0,5,1201,3,463,204.388563,0.8548049999999989,11239,4333
"172.16.133.29",61148,"138.108.6.20",80,4,252,16436,0,0,2,126,2,126,204.388844,10.347519000000005,97,97
"172.16.133.29",61149,"138.108.6.20",80,4,252,16437,0,0,2,126,2,126,204.388962,11.353227000000004,88,88
"172.16.133.29",61150,"23.0.49.244",80,7,432,16438,0,0,4,246,3,186,204.389172,16.718061000000006,117,89
"172.16.133.29",61151,"23.0.49.244",80,6,372,16439,0,0,4,246,2,126,204.389359,16.710000999999977,117,60
"172.16.133.29",61152,"23.0.49.244",80,6,372,16440,0,0,4,246,2,126,204.38949,16.708080999999993,117,60
"172.16.133.29",61153,"23.0.49.244",80,7,432,16441,0,0,4,246,3,186,204.389638,16.717593000000022,117,89
"172.16.133.29",61154,"23.0.49.244",80,6,372,16442,0,0,4,246,2,126,204.389777,16.708713999999986,117,60
"172.16.133.29",61155,"23.0.49.244",80,6,372,16443,0,0,4,246,2,126,204.38988,16.708608999999996,117,60
"172.16.133.29",61156,"216.52.242.80",80,6,372,16444,0,0,4,246,2,126,204.390078,16.77783100000002,117,60
"172.16.133.29",61157,"216.52.242.80",80,6,372,16445,0,0,4,246,2,126,204.39022,16.776794999999993,117,60
"172.16.133.29",61158,"216.52.242.80",80,6,372,16446,0,0,4,246,2,126,204.390356,16.776487000000003,117,60
"172.16.133.29",61159,"216.52.242.80",80,6,372,16447,0,0,4,246,2,126,204.390491,16.78014300000001,117,60
"172.16.133.29",61160,"173.194.43.58",80,6,372,16448,0,0,4,246,2,126,204.390815,16.703025999999994,117,60
"172.16.133.29",61161,"173.194.43.58",80,6,372,16449,0,0,4,246,2,126,204.390974,16.702867999999995,117,60
"172.16.133.68",60907,"172.16.139.250",5440,12,1142,16450,0,0,12,1142,0,0,204.394536,0.015329000000008364,595994,0
"172.16.133.12",59925,"172.16.139.250",5440,12,1142,16451,0,0,12,1142,0,0,204.40903,0.006322000000011485,1445112,0
"172.16.133.63",54085,"172.16.139.250",5440,10,1022,16452,0,0,10,1022,0,0,204.419959,0.03662399999998911,223241,0
"172.16.133.66",54315,"172.16.139.250",5440,10,1022,16453,0,0,10,1022,0,0,204.431697,0.028277999999971826,289129,0
"172.16.133.82",61591,"172.16.139.250",5440,10,1022,16454,0,0,10,1022,0,0,204.444924,0.01891300000002616,432295,0
"172.16.133.37",60803,"172.16.139.250",5440,10,1022,16455,0,0,10,1022,0,0,204.460192,0.007499999999993179,1090133,0
"172.16.133.40",50241,"173.252.110.27",80,11,1952,16456,0,0,6,1215,5,737,204.556786,90.74304899999998,107,64
"172.16.133.37",60804,"68.64.28.20",443,16,4808,16457,0,0,8,917,8,3891,204.571973,0.7936999999999728,9242,39218
"172.16.133.40",50242,"23.6.17.224",80,32,26396,16458,0,0,11,1860,21,24536,204.591488,67.717453,219,2898
"172.16.133.153",52057,"141.101.123.194",80,100,82893,16459,0,0,43,2946,57,79947,204.599912,0.2681390000000192,87894,2385240
"172.16.133.78",59398,"172.16.139.250",5440,10,1022,16460,0,0,10,1022,0,0,204.615782,0.005512000000010175,1483309,0
"172.16.133.67",56155,"172.16.139.250",5440,12,1142,16461,0,0,12,1142,0,0,204.670589,0.016279999999994743,561179,0
"172.16.133.56",61584,"172.16.139.250",5440,12,1142,16462,0,0,12,1142,0,0,204.692441,0.005052000000006274,1808392,0
"172.16.133.28",49283,"208.111.160.6",80,89,52516,16463,0,0,33,11511,56,41005,204.735707,34.89498900000001,2639,9400
"172.16.133.28",49285,"208.111.160.6",80,100,63414,16464,0,0,35,13064,65,50350,204.736006,44.895816999999994,2327,8971
"172.16.133.28",49286,"208.111.160.6",80,79,42265,16465,0,0,30,10628,49,31637,204.73626,44.895883000000026,1893,5637
"172.16.133.28",49287,"208.111.160.6",80,92,66945,16466,0,0,30,12027,62,54918,204.736563,44.895471000000015,2143,9785
"172.16.133.28",49288,"208.111.160.6",80,35,30492,16467,0,0,10,2276,25,28216,204.737136,34.893215,521,6469
"172.16.133.28",49289,"208.111.160.6",80,8,492,16468,0,0,4,246,4,246,204.737396,14.898245000000003,132,132
"172.16.133.28",49290,"208.111.160.6",80,29,22383,16469,0,0,9,2221,20,20162,204.737725,34.893079,509,4622
"172.16.133.28",49291,"208.111.160.6",80,43,39551,16470,0,0,11,3876,32,35675,204.738041,34.892528999999996,888,8179
"172.16.133.28",49292,"23.0.49.244",80,7,432,16471,0,0,4,246,3,186,204.741399,14.897561999999994,132,99
"172.16.133.28",49293,"23.0.49.244",80,6,372,16472,0,0,4,246,2,126,204.74167,14.893144000000007,132,67
"172.16.133.41",53302,"172.16.139.250",5440,12,1142,16473,0,0,12,1142,0,0,204.747758,0.016130000000003974,566398,0
"172.16.133.40",50243,"4.71.33.182",80,14,7454,16474,0,0,7,3130,7,4324,204.759942,0.3252250000000174,76992,106363
"172.16.133.153",41863,"64.17.236.31",80,62,40983,16475,0,0,32,2357,30,38626,204.776452,12.066080999999997,1562,25609
"172.16.133.40",50244,"23.6.17.224",80,13,2825,16476,0,0,7,2048,6,777,204.78404,90.21018199999997,181,68
"172.16.133.40",50245,"199.59.148.86",443,32,9424,16477,0,0,14,3864,18,5560,204.785978,31.308127000000013,987,1420
"172.16.133.101",51140,"96.43.146.48",443,19,9116,16478,0,0,10,3881,9,5235,204.802682,0.466194999999999,66598,89833
"172.16.133.40",50246,"199.59.148.86",443,19,5809,16479,0,0,9,1284,10,4525,204.803339,30.558553000000018,336,1184
"172.16.133.43",57928,"172.16.139.250",5440,10,1022,16480,0,0,10,1022,0,0,204.818962,0.005596999999994523,1460782,0
"172.16.133.42",57271,"172.16.139.250",5440,12,1142,16481,0,0,12,1142,0,0,204.825826,0.014694999999989022,621708,0
"172.16.133.13",53189,"172.16.139.250",5440,10,1022,16482,0,0,10,1022,0,0,204.837931,0.005722999999989042,1428621,0
"172.16.133.85",52429,"172.16.139.250",5440,10,1022,16483,0,0,10,1022,0,0,204.843653,0.005366000000009308,1523667,0
"172.16.133.40",50247,"23.6.17.224",80,13,2495,16484,0,0,7,1649,6,846,204.873035,57.43720400000004,229,117
"172.16.133.20",62556,"172.16.139.250",5440,12,1142,16485,0,0,12,1142,0,0,204.886889,0.0049960000000055516,"",""
"172.16.133.40",50248,"23.67.243.19",443,15,2459,16486,0,0,7,863,8,1596,204.900704,20.431718000000018,337,624
"172.16.133.40",50250,"23.67.243.19",443,15,2459,16487,0,0,7,863,8,1596,204.900862,20.43439700000002,337,624
"172.16.133.40",50251,"23.67.243.19",443,22,7697,16488,0,0,10,1666,12,6031,204.901022,50.380469999999974,264,957
"172.16.133.40",50252,"23.67.243.19",443,21,6251,16489,0,0,10,1666,11,4585,204.901129,50.38134099999999,264,728
"172.16.133.40",50253,"23.45.65.42",443,16,2557,16490,0,0,8,892,8,1665,204.90236,20.44210700000002,349,651
"172.16.133.28",49294,"172.16.139.250",5440,12,1142,16491,0,0,12,1142,0,0,204.916669,0.015422000000000935,592400,0
"172.16.133.99",56213,"172.16.139.250",5440,10,1022,16492,0,0,10,1022,0,0,204.944947,0.014650999999986425,558050,0
"172.16.133.75",51126,"172.16.139.250",5440,10,1022,16493,0,0,10,1022,0,0,204.950085,0.015434999999996535,529705,0
"172.16.133.87",60393,"172.16.139.250",5440,10,1022,16494,0,0,10,1022,0,0,204.968354,0.005055999999996175,1617088,0
"172.16.133.35",50119,"172.16.139.250",5440,12,1142,16495,0,0,12,1142,0,0,204.974914,0.015505999999987807,589191,0
"172.16.133.116",53829,"172.16.139.250",5440,10,1022,16496,0,0,10,1022,0,0,204.98009,0.006986000000011927,1170340,0
"172.16.133.116",53830,"172.16.139.250",5440,10,1022,16497,0,0,10,1022,0,0,204.987983,0.01476299999998787,553816,0
"172.16.133.84",58954,"172.16.139.250",5440,10,1022,16498,0,0,10,1022,0,0,205.003393,0.014647000000024946,558203,0
"172.16.133.116",53831,"172.16.139.250",5440,10,1022,16499,0,0,10,1022,0,0,205.003738,0.004900999999989608,"",""
"172.16.133.40",50254,"208.47.254.81",80,6,372,16500,0,0,4,246,2,126,205.029484,17.28340399999999,113,58
"172.16.133.40",50255,"208.47.254.81",80,18,4167,16501,0,0,10,3191,8,976,205.02974,67.274993,379,116
"172.16.133.49",55940,"172.16.139.250",5440,10,1022,16502,0,0,10,1022,0,0,205.080483,0.0057380000000080145,1424886,0
"172.16.133.95",57113,"172.16.139.250",5440,10,1022,16503,0,0,10,1022,0,0,205.12211,0.00529400000002056,1544389,0
"172.16.133.92",57826,"172.16.139.250",5440,10,1022,16504,0,0,10,1022,0,0,205.146587,0.015816999999998416,516912,0
"172.16.133.29",61162,"172.16.139.250",5440,12,1142,16505,0,0,12,1142,0,0,205.164698,0.016484000000019705,554234,0
"172.16.133.44",64988,"172.16.139.250",5440,10,1022,16506,0,0,10,1022,0,0,205.171309,0.005451999999991131,1499633,0
"172.16.133.207",56097,"172.16.139.250",5440,10,1022,16507,0,0,10,1022,0,0,205.197028,0.0046780000000126165,"",""
"172.16.133.83",57234,"172.16.139.250",5440,10,1022,16508,0,0,10,1022,0,0,205.206107,0.004555000000010523,"",""
"172.16.133.93",60907,"172.16.139.250",5440,12,1142,16509,0,0,12,1142,0,0,205.22087,0.014803999999998041,617130,0
"172.16.133.68",60908,"173.194.43.32",80,15,4187,16510,0,0,8,1964,7,2223,205.228928,50.473059000000006,311,352
"172.16.133.11",55322,"172.16.139.250",5440,12,1142,16511,0,0,12,1142,0,0,205.239478,0.005387000000013131,1695934,0
"172.16.133.55",57779,"172.16.139.250",5440,10,1022,16512,0,0,10,1022,0,0,205.243367,0.005727000000007365,1427623,0
"172.16.133.40",50256,"173.192.61.226",80,8,1684,16513,0,0,5,1063,3,621,205.247926,0.2337479999999914,36381,21253
"172.16.133.73",60835,"172.16.139.250",5440,10,1022,16514,0,0,10,1022,0,0,205.265612,0.005611999999985073,1456878,0
"172.16.133.53",54262,"172.16.139.250",5440,10,1022,16515,0,0,10,1022,0,0,205.268804,0.006122000000004846,1335511,0
"172.16.133.21",53337,"172.16.139.250",5440,10,1022,16516,0,0,10,1022,0,0,205.271546,0.0156470000000013,522528,0
"172.16.133.30",62829,"172.16.139.250",5440,10,1022,16517,0,0,10,1022,0,0,205.27675,0.005432000000013204,1505154,0
"172.16.133.25",63638,"172.16.139.250",5440,12,1142,16518,0,0,12,1142,0,0,205.282915,0.008073999999993475,1131533,0
"172.16.133.68",60909,"173.194.43.40",80,117,118181,16519,0,0,32,2975,85,115206,205.286259,87.40589600000001,272,10544
"172.16.133.34",50605,"172.16.139.250",5440,10,1022,16520,0,0,10,1022,0,0,205.292078,0.005087000000003172,1607234,0
"172.16.133.97",59539,"172.16.139.250",5440,10,1022,16521,0,0,10,1022,0,0,205.302657,0.014919999999989386,547989,0
"172.16.133.33",58048,"172.16.139.250",5440,12,1142,16522,0,0,12,1142,0,0,205.374504,0.019329999999996517,472633,0
"172.16.133.66",54316,"202.173.27.250",443,7,426,16523,0,0,4,246,3,180,205.37756,0.5446220000000039,3613,2644
"172.16.133.66",54317,"216.219.120.244",443,6,366,16524,0,0,4,246,2,120,205.380303,0.18030999999999153,10914,5324
"172.16.133.66",54318,"216.115.220.254",443,6,366,16525,0,0,4,246,2,120,205.380525,0.4634149999999977,4246,2071
"172.16.133.66",54319,"216.115.217.254",443,6,366,16526,0,0,4,246,2,120,205.381336,0.04977499999998258,39537,19286
"172.16.133.68",60910,"172.16.139.250",5440,10,1022,16527,0,0,10,1022,0,0,205.408225,0.005414000000001806,1510158,0
"172.16.133.40",50257,"174.37.29.148",80,11,5679,16528,0,0,5,1666,6,4013,205.417226,0.4932770000000062,27019,65083
"172.16.133.40",50258,"174.37.29.148",80,8,1718,16529,0,0,5,1070,3,648,205.417432,0.42822100000000773,19989,12105
"172.16.133.40",50259,"174.37.29.148",80,8,2461,16530,0,0,5,1186,3,1275,205.41757,0.2280319999999847,41608,44730
"172.16.133.40",50260,"72.21.91.111",80,6,372,16531,0,0,4,246,2,126,205.418125,16.892173999999983,116,59
"172.16.133.40",50261,"72.21.91.111",80,6,372,16532,0,0,4,246,2,126,205.418267,16.892030000000005,116,59
"172.16.133.40",50262,"72.21.91.111",80,6,372,16533,0,0,4,246,2,126,205.418392,16.891842999999994,116,59
"172.16.133.12",59926,"172.16.139.250",5440,10,1022,16534,0,0,10,1022,0,0,205.421856,0.005387000000013131,1517727,0
"172.16.133.40",50263,"173.192.42.179",80,11,2448,16535,0,0,6,1936,5,512,205.421921,1.1676260000000127,13264,3507
"172.16.133.40",50264,"173.192.42.179",80,9,2206,16536,0,0,5,1754,4,452,205.422095,2.213518999999991,6339,1633
"172.16.133.40",50265,"67.228.244.117",80,11,2335,16537,0,0,6,1937,5,398,205.423799,1.1038819999999987,14037,2884
"172.16.133.40",50266,"67.228.244.117",80,7,432,16538,0,0,4,246,3,186,205.424022,2.136033999999995,921,696
"172.16.133.40",50267,"173.194.43.33",80,7,432,16539,0,0,4,246,3,186,205.424447,16.88683900000001,116,88
"172.16.133.40",50268,"72.21.91.121",80,6,372,16540,0,0,4,246,2,126,205.425275,16.88508999999999,116,59
"172.16.133.40",50269,"72.21.91.121",80,16,5487,16541,0,0,8,3586,8,1901,205.425412,16.884067000000016,1699,900
"172.16.133.40",50270,"72.21.91.121",80,13,2912,16542,0,0,7,1476,6,1436,205.425557,16.883689000000004,699,680
"172.16.133.40",50271,"72.21.91.121",80,6,372,16543,0,0,4,246,2,126,205.425665,16.885563999999988,116,59
"172.16.133.28",49297,"138.108.7.20",80,11,4055,16544,0,0,6,2925,5,1130,205.430901,15.063743999999986,1553,600
"172.16.133.63",54086,"172.16.139.250",5440,10,1022,16545,0,0,10,1022,0,0,205.434061,0.00538899999997966,1517164,0
"172.16.133.28",49298,"64.94.107.62",80,8,2052,16546,0,0,5,1589,3,463,205.439313,0.07630700000001411,166590,48540
"172.16.133.66",54320,"172.16.139.250",5440,10,1022,16547,0,0,10,1022,0,0,205.445319,0.005915999999984933,1382014,0
"172.16.133.40",50272,"23.67.243.25",80,7,432,16548,0,0,4,246,3,186,205.449305,16.86876699999999,116,88
"172.16.133.40",50273,"23.67.243.25",80,7,432,16549,0,0,4,246,3,186,205.449423,16.868650000000002,116,88
"172.16.133.82",61592,"172.16.139.250",5440,12,1142,16550,0,0,12,1142,0,0,205.459597,0.006137999999992871,1488432,0
"172.16.133.37",60805,"172.16.139.250",5440,10,1022,16551,0,0,10,1022,0,0,205.474903,0.006114999999994097,1337040,0
"172.16.133.113",55687,"157.56.244.217",443,6,374,16552,0,0,3,194,3,180,205.475505,1.1898260000000107,1304,1210
"172.16.133.78",59399,"172.16.139.250",5440,10,1022,16553,0,0,10,1022,0,0,205.629857,0.005484000000024025,1490882,0
"172.16.133.40",50274,"74.125.226.207",443,14,4029,16554,0,0,8,958,6,3071,205.654226,9.601110000000006,798,2558
"172.16.133.40",50275,"173.194.43.47",80,14,3785,16555,0,0,7,1404,7,2381,205.673154,90.27576299999998,124,210
"172.16.133.40",50276,"173.194.43.47",80,6,372,16556,0,0,4,246,2,126,205.673272,16.63709399999999,118,60
"172.16.133.67",56156,"172.16.139.250",5440,12,1142,16557,0,0,12,1142,0,0,205.684211,0.006090000000000373,1500164,0
"172.16.133.56",61585,"172.16.139.250",5440,12,1142,16558,0,0,12,1142,0,0,205.706668,0.004994999999979655,"",""
"172.16.133.40",50277,"67.228.30.242",80,10,1809,16559,0,0,5,1218,5,591,205.745655,0.27183299999998667,35845,17393
"172.16.133.40",50278,"64.94.107.58",80,8,2178,16560,0,0,5,1715,3,463,205.749077,0.06362300000000687,215645,58217
"172.16.133.53",54263,"168.87.1.242",80,11,1695,16561,0,0,6,949,5,746,205.757135,10.404209000000009,729,573
"172.16.133.41",53303,"172.16.139.250",5440,12,1142,16562,0,0,12,1142,0,0,205.76181,0.0061530000000118434,1484804,0
"172.16.133.42",57272,"172.16.139.250",5440,6,780,16563,0,0,6,780,0,0,205.773131,0.0036360000000001946,"",""
"172.16.133.43",57929,"172.16.139.250",5440,12,1142,16564,0,0,12,1142,0,0,205.834068,0.006338999999996986,1441236,0
"172.16.133.42",57273,"172.16.139.250",5440,12,1142,16565,0,0,12,1142,0,0,205.83761,0.010234999999994443,892623,0
"172.16.133.40",50279,"173.192.61.226",80,8,1895,16566,0,0,5,1098,3,797,205.844519,0.2702600000000075,32502,23592
"172.16.133.13",53190,"172.16.139.250",5440,12,1142,16567,0,0,12,1142,0,0,205.852419,0.0060750000000098225,1503868,0
"172.16.133.85",52430,"172.16.139.250",5440,10,1022,16568,0,0,10,1022,0,0,205.859245,0.009197000000000344,888985,0
"172.16.133.40",50280,"23.6.17.224",443,27,10182,16569,0,0,13,3527,14,6655,205.875708,69.40234899999999,406,767
"172.16.133.40",50281,"23.6.17.224",443,26,10000,16570,0,0,13,3197,13,6803,205.880625,69.39644499999997,368,784
"172.16.133.20",62557,"172.16.139.250",5440,12,1142,16571,0,0,12,1142,0,0,205.900931,0.005244999999973743,1741849,0
"172.16.133.28",49299,"172.16.139.250",5440,12,1142,16572,0,0,12,1142,0,0,205.930527,0.06883700000000204,132719,0
"172.16.133.99",56214,"172.16.139.250",5440,10,1022,16573,0,0,10,1022,0,0,205.95851,0.045736000000005106,178765,0
"172.16.133.75",51127,"172.16.139.250",5440,10,1022,16574,0,0,10,1022,0,0,205.963905,0.0438699999999983,186368,0
"172.16.133.87",60394,"172.16.139.250",5440,12,1142,16575,0,0,12,1142,0,0,205.982972,0.036565000000024384,249856,0
"172.16.133.35",50120,"172.16.139.250",5440,12,1142,16576,0,0,12,1142,0,0,205.98942,0.028906000000006316,316058,0
"172.16.133.116",53832,"172.16.139.250",5440,12,1142,16577,0,0,12,1142,0,0,205.995078,0.020628999999985353,442871,0
"172.16.133.84",58955,"172.16.139.250",5440,10,1022,16578,0,0,10,1022,0,0,206.016401,0.00623200000001134,1311938,0
"172.16.133.116",53833,"172.16.139.250",5440,12,1142,16579,0,0,12,1142,0,0,206.016563,0.015776000000016666,579107,0
"172.16.133.116",53834,"172.16.139.250",5440,12,1142,16580,0,0,12,1142,0,0,206.033013,0.006050999999985152,1509833,0
"172.16.133.49",55941,"172.16.139.250",5440,12,1142,16581,0,0,12,1142,0,0,206.094582,0.016187999999999647,564368,0
"172.16.133.95",57114,"172.16.139.250",5440,10,1022,16582,0,0,10,1022,0,0,206.135291,0.015581999999994878,524707,0
"172.16.133.40",50282,"174.37.29.148",80,10,2687,16583,0,0,6,1936,4,751,206.153635,0.24553099999999972,63079,24469
"172.16.133.92",57827,"172.16.139.250",5440,10,1022,16584,0,0,10,1022,0,0,206.162077,0.005620999999990772,1454545,0
"172.16.133.29",61163,"172.16.139.250",5440,12,1142,16585,0,0,12,1142,0,0,206.179445,0.016971000000012282,538330,0
"172.16.133.44",64989,"172.16.139.250",5440,12,1142,16586,0,0,12,1142,0,0,206.186367,0.006392000000005282,1429286,0
"172.16.133.207",56098,"172.16.139.250",5440,12,1142,16587,0,0,12,1142,0,0,206.209891,0.014760999999992919,618928,0
"172.16.133.83",57235,"172.16.139.250",5440,12,1142,16588,0,0,12,1142,0,0,206.220156,0.008205000000003793,1113467,0
"172.16.133.93",60908,"172.16.139.250",5440,12,1142,16589,0,0,12,1142,0,0,206.236036,0.018927999999988288,482671,0
"172.16.133.11",55323,"172.16.139.250",5440,12,1142,16590,0,0,12,1142,0,0,206.253501,0.006461000000001604,1414022,0
"172.16.133.55",57780,"172.16.139.250",5440,10,1022,16591,0,0,10,1022,0,0,206.258092,0.005566999999985001,1468654,0
"172.16.133.73",60836,"172.16.139.250",5440,10,1022,16592,0,0,10,1022,0,0,206.280124,0.005473999999992429,1493606,0
"172.16.133.40",50283,"75.126.109.194",80,36,3043,16593,0,0,14,1471,22,1572,206.283048,90.48544800000002,130,138
"172.16.133.53",54264,"172.16.139.250",5440,10,1022,16594,0,0,10,1022,0,0,206.283397,0.007103000000000748,1151062,0
"172.16.133.21",53338,"172.16.139.250",5440,12,1142,16595,0,0,12,1142,0,0,206.285473,0.009180000000014843,995206,0
"172.16.133.30",62830,"172.16.139.250",5440,10,1022,16596,0,0,10,1022,0,0,206.290209,0.0075259999999843785,1086367,0
"172.16.133.25",63639,"172.16.139.250",5440,12,1142,16597,0,0,12,1142,0,0,206.29727,0.005006000000008726,1825009,0
"172.16.133.34",50606,"172.16.139.250",5440,10,1022,16598,0,0,10,1022,0,0,206.305545,0.004991000000018175,"",""
"172.16.133.97",59540,"172.16.139.250",5440,12,1142,16599,0,0,12,1142,0,0,206.316601,0.0061760000000106174,1479274,0
"172.16.133.40",50284,"174.37.29.148",80,14,5291,16600,0,0,8,3426,6,1865,206.383081,1.1428109999999947,23982,13055
"172.16.133.33",58049,"172.16.139.250",5440,10,1022,16601,0,0,10,1022,0,0,206.388732,0.005652999999995245,1446311,0
"172.16.133.68",60911,"172.16.139.250",5440,12,1142,16602,0,0,12,1142,0,0,206.422697,0.007403000000010707,1234094,0
"172.16.133.12",59927,"172.16.139.250",5440,12,1142,16603,0,0,12,1142,0,0,206.435916,0.007712999999995418,1184493,0
"172.16.133.63",54087,"172.16.139.250",5440,10,1022,16604,0,0,10,1022,0,0,206.448635,0.007444999999989932,1098186,0
"172.16.133.66",54321,"172.16.139.250",5440,10,1022,16605,0,0,10,1022,0,0,206.458779,0.005390000000005557,1516883,0
"172.16.133.82",61593,"172.16.139.250",5440,10,1022,16606,0,0,10,1022,0,0,206.472379,0.008637000000021544,946624,0
"172.16.133.37",60807,"172.16.139.250",5440,12,1142,16607,0,0,12,1142,0,0,206.486671,0.007365999999990436,1240293,0
"172.16.133.39",64284,"68.64.24.250",443,6,366,16608,0,0,4,246,2,120,206.573732,0.12222599999998351,16101,7854
"172.16.133.39",64285,"216.115.219.126",443,6,366,16609,0,0,4,246,2,120,206.574068,0.518509999999992,3795,1851
"172.16.133.39",64286,"78.108.118.250",443,6,366,16610,0,0,4,246,2,120,206.575897,0.24264800000000264,8110,3956
"172.16.133.39",64287,"216.219.118.244",443,6,366,16611,0,0,4,246,2,120,206.576578,0.22277599999998188,8833,4309
"172.16.133.78",59400,"172.16.139.250",5440,10,1022,16612,0,0,10,1022,0,0,206.643536,0.07360499999998638,111079,0
"172.16.133.126",62038,"172.16.139.250",5440,6,780,16613,0,0,6,780,0,0,206.664012,0.00446399999998448,"",""
"172.16.133.113",55688,"157.56.234.137",443,6,374,16614,0,0,3,194,3,180,206.672047,1.243676000000022,1247,1157
"172.16.133.67",56157,"172.16.139.250",5440,12,1142,16615,0,0,12,1142,0,0,206.698352,0.024934000000001788,366407,0
"172.16.133.60",62147,"208.98.232.43",80,10,1326,16616,0,0,5,679,5,647,206.703993,0.2421500000000094,22432,21375
"172.16.133.60",62148,"208.98.232.43",80,10,2303,16617,0,0,5,679,5,1624,206.708647,0.2646389999999883,20526,49093
"172.16.133.60",62149,"208.98.232.43",80,10,1333,16618,0,0,5,681,5,652,206.709016,0.26452900000001023,20595,19718
"172.16.133.56",61586,"172.16.139.250",5440,12,1142,16619,0,0,12,1142,0,0,206.721198,0.015932000000020707,573437,0
"172.16.133.93",60909,"96.43.146.22",443,17,4146,16620,0,0,10,3309,7,837,206.727253,90.21731200000002,293,74
"172.16.133.41",53304,"172.16.139.250",5440,12,1142,16621,0,0,12,1142,0,0,206.775705,0.007875000000012733,1160126,0
"172.16.133.43",57930,"172.16.139.250",5440,10,1022,16622,0,0,10,1022,0,0,206.846179,0.0056909999999845695,1436654,0
"172.16.133.42",57274,"172.16.139.250",5440,12,1142,16623,0,0,12,1142,0,0,206.855827,0.010635000000007722,859050,0
"172.16.133.13",53191,"172.16.139.250",5440,12,1142,16624,0,0,12,1142,0,0,206.865796,0.006015000000019199,1518869,0
"172.16.133.85",52431,"172.16.139.250",5440,10,1022,16625,0,0,10,1022,0,0,206.872997,0.00534799999999791,1528795,0
"172.16.133.20",62558,"172.16.139.250",5440,12,1142,16626,0,0,12,1142,0,0,206.914793,0.004758000000009588,"",""
"172.16.133.113",55689,"63.147.189.115",80,17,6418,16627,0,0,8,1418,9,5000,206.938296,25.281442999999996,448,1582
"172.16.133.113",55690,"63.147.189.115",80,15,6286,16628,0,0,7,1352,8,4934,206.938914,0.4342099999999789,24909,90905
"172.16.133.28",49300,"172.16.139.250",5440,12,1142,16629,0,0,12,1142,0,0,206.944092,0.00597099999998818,1530061,0
"172.16.133.99",56215,"172.16.139.250",5440,10,1022,16630,0,0,10,1022,0,0,206.971989,0.015466000000003532,528643,0
"172.16.133.75",51128,"172.16.139.250",5440,10,1022,16631,0,0,10,1022,0,0,206.978102,0.005453999999986081,1499083,0
"172.16.133.87",60395,"172.16.139.250",5440,10,1022,16632,0,0,10,1022,0,0,206.996739,0.015904000000006135,514084,0
"172.16.133.35",50121,"172.16.139.250",5440,12,1142,16633,0,0,12,1142,0,0,207.001631,0.01250699999999938,730470,0
"172.16.133.116",53835,"172.16.139.250",5440,10,1022,16634,0,0,10,1022,0,0,207.008264,0.008845000000007985,924364,0
"172.16.133.116",53836,"172.16.139.250",5440,10,1022,16635,0,0,10,1022,0,0,207.018069,0.005354000000011183,1527082,0
"172.16.133.116",53837,"172.16.139.250",5440,10,1022,16636,0,0,10,1022,0,0,207.024429,0.005255000000005339,1555851,0
"172.16.133.84",58956,"172.16.139.250",5440,10,1022,16637,0,0,10,1022,0,0,207.030538,0.0056409999999971205,1449388,0
"172.16.133.49",55942,"96.43.146.22",443,17,4165,16638,0,0,10,3328,7,837,207.035971,90.323161,294,74
"172.16.133.49",55943,"172.16.139.250",5440,12,1142,16639,0,0,12,1142,0,0,207.107633,0.017858000000018137,511591,0
"172.16.133.40",50285,"204.93.223.146",80,9,2536,16640,0,0,5,2244,4,292,207.122561,35.29930200000001,508,66
"172.16.133.95",57115,"172.16.139.250",5440,10,1022,16641,0,0,10,1022,0,0,207.149627,0.005567999999982476,1468390,0
"172.16.133.92",57828,"172.16.139.250",5440,10,1022,16642,0,0,10,1022,0,0,207.176155,0.005557000000010248,1471297,0
"172.16.133.29",61164,"172.16.139.250",5440,10,1022,16643,0,0,10,1022,0,0,207.193209,0.005361999999990985,1524804,0
"172.16.133.44",64990,"172.16.139.250",5440,10,1022,16644,0,0,10,1022,0,0,207.199295,0.005250999999987016,1557036,0
"172.16.133.207",56099,"172.16.139.250",5440,12,1142,16645,0,0,12,1142,0,0,207.223968,0.014674999999982674,622555,0
"172.16.133.83",57236,"172.16.139.250",5440,12,1142,16646,0,0,12,1142,0,0,207.234497,0.014579999999995152,626611,0
"172.16.133.93",60910,"172.16.139.250",5440,10,1022,16647,0,0,10,1022,0,0,207.249079,0.004716000000001941,"",""
"172.16.133.11",55324,"172.16.139.250",5440,10,1022,16648,0,0,10,1022,0,0,207.267221,0.015162000000003673,539242,0
"172.16.133.55",57781,"172.16.139.250",5440,10,1022,16649,0,0,10,1022,0,0,207.271238,0.005684999999999718,1438170,0
"172.16.133.73",60837,"172.16.139.250",5440,12,1142,16650,0,0,12,1142,0,0,207.293984,0.005366000000009308,1702571,0
"172.16.133.53",54265,"172.16.139.250",5440,10,1022,16651,0,0,10,1022,0,0,207.296944,0.00622100000001069,1314258,0
"172.16.133.21",53339,"172.16.139.250",5440,12,1142,16652,0,0,12,1142,0,0,207.29924,0.015732000000014068,580727,0
"172.16.133.30",62831,"172.16.139.250",5440,10,1022,16653,0,0,10,1022,0,0,207.304015,0.018223000000006095,448663,0
"172.16.133.25",63640,"172.16.139.250",5440,10,1022,16654,0,0,10,1022,0,0,207.311213,0.00686799999999721,1190448,0
"172.16.133.34",50607,"172.16.139.250",5440,12,1142,16655,0,0,12,1142,0,0,207.32016,0.015118000000001075,604312,0
"172.16.133.97",59541,"172.16.139.250",5440,10,1022,16656,0,0,10,1022,0,0,207.329605,0.014644000000004098,558317,0
"172.16.133.35",50122,"216.115.208.199",443,58,15121,16657,0,0,26,5686,32,9435,207.337823,82.510434,551,914
"172.16.133.33",58050,"172.16.139.250",5440,10,1022,16658,0,0,10,1022,0,0,207.401317,0.006260999999994965,1305861,0
"172.16.133.66",54322,"216.115.217.254",443,6,366,16659,0,0,4,246,2,120,207.417942,0.06181599999999321,31836,15529
"172.16.133.68",60912,"172.16.139.250",5440,10,1022,16660,0,0,10,1022,0,0,207.436611,0.014646999999996524,558203,0
"172.16.133.12",59928,"172.16.139.250",5440,12,1142,16661,0,0,12,1142,0,0,207.450992,0.005459999999999354,1673260,0
"172.16.133.87",60396,"67.210.115.228",80,246,277952,16662,0,0,62,4116,184,273836,207.45414,6.500072000000017,5065,337025
"172.16.133.63",54088,"172.16.139.250",5440,10,1022,16663,0,0,10,1022,0,0,207.461876,0.005330000000014934,1533958,0
"172.16.133.40",50286,"174.37.29.148",80,11,4214,16664,0,0,6,1916,5,2298,207.472362,0.22685099999998215,67568,81039
"172.16.133.40",50287,"67.228.244.117",80,10,2153,16665,0,0,5,1755,5,398,207.473701,0.22649599999999737,61987,14057
"172.16.133.66",54323,"172.16.139.250",5440,10,1022,16666,0,0,10,1022,0,0,207.473703,0.004631999999986647,"",""
"172.16.133.66",54324,"216.219.120.244",443,6,366,16667,0,0,4,246,2,120,207.476955,0.1799919999999986,10933,5333
"172.16.133.82",61595,"172.16.139.250",5440,10,1022,16668,0,0,10,1022,0,0,207.486928,0.005438999999995531,1503217,0
"172.16.133.37",60808,"172.16.139.250",5440,10,1022,16669,0,0,10,1022,0,0,207.500851,0.005463999999989255,1496339,0
"172.16.133.66",54325,"216.115.220.254",443,6,366,16670,0,0,4,246,2,120,207.619107,0.5197689999999966,3786,1846
"172.16.133.66",54326,"202.173.27.250",443,6,366,16671,0,0,4,246,2,120,207.649084,0.5452350000000195,3609,1760
"172.16.133.78",59401,"172.16.139.250",5440,10,1022,16672,0,0,10,1022,0,0,207.656731,0.005969999999990705,1369514,0
"172.16.133.67",56158,"172.16.139.250",5440,12,1142,16673,0,0,12,1142,0,0,207.711209,0.006024999999993952,1516348,0
"172.16.133.56",61587,"172.16.139.250",5440,10,1022,16674,0,0,10,1022,0,0,207.734578,0.00484000000000151,"",""
"172.16.133.132",38497,"96.43.146.48",443,26,8240,16675,0,0,15,1635,11,6605,207.751526,0.4558789999999817,28691,115907
"172.16.133.41",53305,"172.16.139.250",5440,12,1142,16676,0,0,12,1142,0,0,207.789744,0.014505999999983032,629808,0
"172.16.133.43",57931,"172.16.139.250",5440,12,1142,16677,0,0,12,1142,0,0,207.8599,0.016248999999987745,562249,0
"172.16.133.42",57275,"172.16.139.250",5440,12,1142,16678,0,0,12,1142,0,0,207.871236,0.024670999999983678,370313,0
"172.16.133.13",53192,"172.16.139.250",5440,12,1142,16679,0,0,12,1142,0,0,207.879949,0.006018999999980679,1517860,0
"172.16.133.85",52432,"172.16.139.250",5440,10,1022,16680,0,0,10,1022,0,0,207.885728,0.00818599999999492,998778,0
"172.16.133.113",55691,"157.56.236.89",80,8,884,16681,0,0,5,532,3,352,207.923731,0.3161529999999857,13461,8907
"172.16.133.20",62559,"172.16.139.250",5440,12,1142,16682,0,0,12,1142,0,0,207.928934,0.004894000000007281,"",""
"172.16.133.113",55692,"172.16.139.250",135,8,492,16683,0,0,8,492,0,0,207.947109,0.004440999999985706,"",""
"172.16.133.113",55693,"172.16.139.250",5462,10,696,16684,0,0,10,696,0,0,207.952035,0.5161640000000034,10787,0
"172.16.133.28",49301,"172.16.139.250",5440,10,1022,16685,0,0,10,1022,0,0,207.958496,0.015493999999989683,527688,0
"172.16.133.99",56216,"172.16.139.250",5440,10,1022,16686,0,0,10,1022,0,0,207.985996,0.01535799999999199,532360,0
"172.16.133.75",51129,"172.16.139.250",5440,10,1022,16687,0,0,10,1022,0,0,207.992074,0.005497999999988679,1487086,0
"172.16.133.67",56159,"65.54.80.250",80,11,2050,16688,0,0,6,1480,5,570,208.007109,3.3163879999999892,3570,1374
"172.16.133.87",60397,"172.16.139.250",5440,12,1142,16689,0,0,12,1142,0,0,208.010871,0.006143999999977723,1486979,0
"172.16.133.35",50123,"172.16.139.250",5440,12,1142,16690,0,0,12,1142,0,0,208.015589,0.009443000000004531,967489,0
"172.16.133.116",53838,"172.16.139.250",5440,10,1022,16691,0,0,10,1022,0,0,208.022311,0.005017000000009375,1629659,0
"172.16.133.116",53839,"172.16.139.250",5440,10,1022,16692,0,0,10,1022,0,0,208.028285,0.005129999999979873,1593762,0
"172.16.133.116",53840,"172.16.139.250",5440,10,1022,16693,0,0,10,1022,0,0,208.034239,0.0048889999999914835,"",""
"172.16.133.84",58957,"172.16.139.250",5440,10,1022,16694,0,0,10,1022,0,0,208.044476,0.018509999999992033,441707,0
"172.16.133.67",56160,"172.16.139.250",5440,10,1016,16695,0,0,10,1016,0,0,208.108724,0.012467000000015105,651961,0
"172.16.133.49",55944,"172.16.139.250",5440,10,1022,16696,0,0,10,1022,0,0,208.121285,0.005688999999989619,1437159,0
"172.16.133.113",55694,"132.245.1.166",443,29,10965,16697,0,0,13,3689,16,7276,208.155702,2.6955389999999966,10948,21594
"172.16.133.95",57116,"172.16.139.250",5440,10,1022,16698,0,0,10,1022,0,0,208.164392,0.015445999999997184,529327,0
"172.16.133.132",38795,"96.43.146.48",443,23,7303,16699,0,0,13,1499,10,5804,208.166281,0.2604570000000024,46042,178271
"172.16.133.92",57829,"172.16.139.250",5440,10,1022,16700,0,0,10,1022,0,0,208.188904,0.005593000000004622,1461827,0
"172.16.133.29",61165,"172.16.139.250",5440,10,1022,16701,0,0,10,1022,0,0,208.206051,0.005315999999993437,1537998,0
"172.16.133.44",64991,"172.16.139.250",5440,10,1022,16702,0,0,10,1022,0,0,208.213504,0.005377000000009957,1520550,0
"172.16.133.207",56100,"172.16.139.250",5440,12,1142,16703,0,0,12,1142,0,0,208.237898,0.006499999999988404,1405538,0
"172.16.133.83",57237,"172.16.139.250",5440,12,1142,16704,0,0,12,1142,0,0,208.248196,0.013988999999980933,653084,0
"172.16.133.93",60911,"172.16.139.250",5440,12,1142,16705,0,0,12,1142,0,0,208.263941,0.014775000000014415,618341,0
"172.16.133.11",55325,"172.16.139.250",5440,10,1022,16706,0,0,10,1022,0,0,208.281403,0.014874999999989313,549647,0
"172.16.133.55",57782,"172.16.139.250",5440,10,1022,16707,0,0,10,1022,0,0,208.285657,0.005458000000004404,1497984,0
"172.16.133.73",60838,"172.16.139.250",5440,12,1142,16708,0,0,12,1142,0,0,208.307375,0.01704100000000608,536118,0
"172.16.133.53",54266,"172.16.139.250",5440,12,1142,16709,0,0,12,1142,0,0,208.310606,0.006104999999990923,1496478,0
"172.16.133.21",53340,"172.16.139.250",5440,10,1022,16710,0,0,10,1022,0,0,208.313631,0.00640800000002173,1275905,0
"172.16.133.30",62832,"172.16.139.250",5440,10,1022,16711,0,0,10,1022,0,0,208.31798,0.00975800000000504,837876,0
"172.16.133.28",49302,"208.111.160.6",80,99,60952,16712,0,0,37,13890,62,47062,208.323556,41.30893600000002,2689,9114
"172.16.133.28",49303,"208.111.160.6",80,93,58800,16713,0,0,35,11628,58,47172,208.323675,41.30802799999998,2251,9135
"172.16.133.25",63641,"172.16.139.250",5440,10,1022,16714,0,0,10,1022,0,0,208.323784,0.007862000000017133,1039938,0
"172.16.133.34",50608,"172.16.139.250",5440,10,1022,16715,0,0,10,1022,0,0,208.333909,0.005050999999980377,1618689,0
"172.16.133.97",59542,"172.16.139.250",5440,10,1022,16716,0,0,10,1022,0,0,208.343751,0.01457200000001535,561076,0
"172.16.133.132",52210,"96.43.146.48",443,23,7071,16717,0,0,13,1524,10,5547,208.387477,0.2751140000000021,44316,161300
"172.16.133.33",58051,"172.16.139.250",5440,12,1142,16718,0,0,12,1142,0,0,208.417531,0.006073000000014872,1504363,0
"172.16.133.68",60913,"172.16.139.250",5440,10,1022,16719,0,0,10,1022,0,0,208.449754,0.006247999999999365,1308578,0
"172.16.133.12",59929,"172.16.139.250",5440,10,1022,16720,0,0,10,1022,0,0,208.464904,0.0190730000000201,428668,0
"172.16.133.63",54089,"172.16.139.250",5440,10,1022,16721,0,0,10,1022,0,0,208.474913,0.0054070000000194796,1512113,0
"172.16.133.66",54327,"172.16.139.250",5440,10,1022,16722,0,0,10,1022,0,0,208.48662,0.014524000000022852,562930,0
"172.16.133.28",49304,"216.52.242.80",80,6,372,16723,0,0,4,246,2,126,208.489937,11.22019499999999,175,89
"172.16.133.28",49305,"173.194.43.59",80,6,372,16724,0,0,4,246,2,126,208.491711,11.132715999999988,176,90
"172.16.133.82",61596,"172.16.139.250",5440,12,1142,16725,0,0,12,1142,0,0,208.500651,0.006179000000003043,1478556,0
"172.16.133.37",60811,"172.16.139.250",5440,10,1022,16726,0,0,10,1022,0,0,208.514165,0.005249000000020487,1557630,0
"172.16.133.28",49306,"8.27.243.253",80,7,432,16727,0,0,4,246,3,186,208.521763,11.112218000000013,177,133
"172.16.133.28",49307,"8.27.243.253",80,6,372,16728,0,0,4,246,2,126,208.522122,11.111860000000007,177,90
"172.16.133.132",34802,"63.135.90.138",80,6,374,16729,0,0,4,254,2,120,208.611961,0.047358000000002676,42907,20271
"172.16.133.132",51071,"96.43.146.48",443,26,8097,16730,0,0,15,1635,11,6462,208.621313,0.29581699999999955,44216,174756
"172.16.133.39",64288,"68.64.24.250",443,6,366,16731,0,0,4,246,2,120,208.657961,0.09798200000000179,20085,9797
"172.16.133.132",49084,"157.56.134.97",80,5,340,16732,0,0,3,206,2,134,208.667216,0.05065500000000611,32533,21162
"172.16.133.78",59402,"172.16.139.250",5440,10,1022,16733,0,0,10,1022,0,0,208.671906,0.005765999999994165,1417967,0
"172.16.133.39",64289,"216.219.118.244",443,6,366,16734,0,0,4,246,2,120,208.702845,0.22229100000001267,8853,4318
"172.16.133.39",64290,"78.108.118.250",443,6,366,16735,0,0,4,246,2,120,208.711734,0.21434899999999857,9181,4478
"172.16.133.67",56161,"172.16.139.250",5440,12,1142,16736,0,0,12,1142,0,0,208.725301,0.006205999999991718,1472123,0
"172.16.133.56",61588,"172.16.139.250",5440,10,1022,16737,0,0,10,1022,0,0,208.748636,0.004729999999995016,"",""
"172.16.133.41",53306,"172.16.139.250",5440,10,1022,16738,0,0,10,1022,0,0,208.804136,0.01520400000001132,537753,0
"172.16.133.96",53369,"173.194.43.53",443,25,4907,16739,0,0,14,3011,11,1896,208.816494,26.628247999999985,904,569
"172.16.133.96",53370,"173.194.43.53",443,30,11724,16740,0,0,15,3181,15,8543,208.817129,26.627089000000012,955,2566
"172.16.133.96",53371,"173.194.43.53",443,23,5080,16741,0,0,13,3293,10,1787,208.817485,26.626732000000004,989,536
"172.16.133.96",53372,"173.194.43.41",443,29,4811,16742,0,0,16,3131,13,1680,208.829785,24.171232000000003,1036,556
"172.16.133.39",64291,"216.115.219.126",443,6,366,16743,0,0,4,246,2,120,208.856092,0.4991109999999992,3943,1923
"172.16.133.132",32972,"96.43.146.48",443,24,7433,16744,0,0,14,1564,10,5869,208.873774,0.2313530000000128,54081,202945
"172.16.133.43",57932,"172.16.139.250",5440,12,1142,16745,0,0,12,1142,0,0,208.874112,0.006127999999989697,1490861,0
"172.16.133.42",57276,"172.16.139.250",5440,12,1142,16746,0,0,12,1142,0,0,208.88322,0.009805999999997539,931674,0
"172.16.133.13",53193,"172.16.139.250",5440,10,1022,16747,0,0,10,1022,0,0,208.893657,0.006262000000020862,1305653,0
"172.16.133.85",52433,"172.16.139.250",5440,10,1022,16748,0,0,10,1022,0,0,208.906777,0.015326999999984992,533437,0
"172.16.133.96",53373,"173.194.43.53",443,23,4510,16749,0,0,13,3271,10,1239,208.940234,26.504402999999996,987,373
"172.16.133.20",62560,"172.16.139.250",5440,10,1022,16750,0,0,10,1022,0,0,208.943153,0.005106000000012045,1601253,0
"172.16.133.28",49308,"172.16.139.250",5440,12,1142,16751,0,0,12,1142,0,0,208.972343,0.015399999999999636,593246,0
"172.16.133.99",56217,"172.16.139.250",5440,10,1022,16752,0,0,10,1022,0,0,209.000323,0.015041999999994005,543544,0
"172.16.133.75",51130,"172.16.139.250",5440,10,1022,16753,0,0,10,1022,0,0,209.006084,0.0055770000000165965,1466021,0
"172.16.133.60",62150,"208.98.232.43",80,30,24707,16754,0,0,11,1115,19,23592,209.012829,0.3048209999999756,29263,619169
"172.16.133.87",60398,"172.16.139.250",5440,10,1022,16755,0,0,10,1022,0,0,209.02552,0.0057610000000067885,1419198,0
"172.16.133.35",50124,"172.16.139.250",5440,12,1142,16756,0,0,12,1142,0,0,209.029659,0.011782999999979893,775354,0
"172.16.133.116",53841,"172.16.139.250",5440,10,1022,16757,0,0,10,1022,0,0,209.036628,0.005150999999983696,1587264,0
"172.16.133.116",53842,"172.16.139.250",5440,10,1022,16758,0,0,10,1022,0,0,209.042706,0.012889999999998736,634290,0
"172.16.133.116",53843,"78.108.118.250",443,6,366,16759,0,0,4,246,2,120,209.048804,0.24482600000001753,8038,3921
"172.16.133.116",53844,"68.64.24.250",443,6,366,16760,0,0,4,246,2,120,209.051311,0.14028200000001334,14028,6843
"172.16.133.116",53845,"172.16.139.250",5440,10,1022,16761,0,0,10,1022,0,0,209.056751,0.005798999999996113,1409898,0
"172.16.133.84",58958,"172.16.139.250",5440,10,1022,16762,0,0,10,1022,0,0,209.058888,0.0150910000000124,541779,0
"172.16.133.132",46218,"96.43.146.48",443,23,7486,16763,0,0,13,1504,10,5982,209.061834,0.35070400000000745,34308,136456
"172.16.133.116",53846,"216.115.219.126",443,6,366,16764,0,0,4,246,2,120,209.064645,0.488427999999999,4029,1965
"172.16.133.116",53847,"216.219.118.244",443,6,366,16765,0,0,4,246,2,120,209.075388,0.21988799999999742,8950,4365
"172.16.133.49",55945,"172.16.139.250",5440,10,1022,16766,0,0,10,1022,0,0,209.135418,0.014835000000005039,551129,0
"172.16.133.95",57117,"172.16.139.250",5440,12,1142,16767,0,0,12,1142,0,0,209.177397,0.01626799999999662,561593,0
"172.16.133.92",57830,"172.16.139.250",5440,10,1022,16768,0,0,10,1022,0,0,209.204025,0.015364000000005262,532153,0
"172.16.133.29",61166,"172.16.139.250",5440,10,1022,16769,0,0,10,1022,0,0,209.220333,0.016426999999993086,497717,0
"172.16.133.44",64992,"172.16.139.250",5440,12,1142,16770,0,0,12,1142,0,0,209.227494,0.015470999999990909,590524,0
"172.16.133.207",56101,"172.16.139.250",5440,10,1022,16771,0,0,10,1022,0,0,209.252936,0.004805000000004611,"",""
"172.16.133.83",57238,"172.16.139.250",5440,12,1142,16772,0,0,12,1142,0,0,209.262346,0.004660000000001219,"",""
"172.16.133.60",62151,"208.98.232.43",80,28,23535,16773,0,0,10,1027,18,22508,209.265436,0.2756640000000061,29804,653200
"172.16.133.93",60912,"172.16.139.250",5440,10,1022,16774,0,0,10,1022,0,0,209.277163,0.0047319999999899665,"",""
"172.16.133.60",62152,"208.98.232.43",80,16,8866,16775,0,0,7,848,9,8018,209.277333,0.2979919999999936,22765,215254
"172.16.133.60",62153,"208.98.232.43",80,43,37820,16776,0,0,16,1380,27,36440,209.277595,0.29796799999999735,37050,978360
"172.16.133.60",62154,"208.98.232.43",80,57,50656,16777,0,0,20,1614,37,49042,209.27785,0.6689930000000004,19300,586457
"172.16.133.60",62155,"208.98.232.43",80,22,14947,16778,0,0,9,955,13,13992,209.278094,0.29692899999997735,25730,376979
"172.16.133.60",62156,"208.98.232.43",80,11,3598,16779,0,0,5,714,6,2884,209.278337,0.2971249999999941,19224,77650
"172.16.133.60",62157,"66.199.173.81",80,11,2187,16780,0,0,6,888,5,1299,209.27864,7.964772000000011,891,1304
"172.16.133.11",55326,"172.16.139.250",5440,10,1022,16781,0,0,10,1022,0,0,209.294919,0.015516000000019403,526939,0
"172.16.133.55",57783,"172.16.139.250",5440,12,1142,16782,0,0,12,1142,0,0,209.298998,0.01601800000000253,570358,0
"172.16.133.73",60839,"172.16.139.250",5440,10,1022,16783,0,0,10,1022,0,0,209.321787,0.00536099999999351,1525088,0
"172.16.133.53",54267,"172.16.139.250",5440,10,1022,16784,0,0,10,1022,0,0,209.325384,0.00600999999997498,1360399,0
"172.16.133.21",53341,"172.16.139.250",5440,10,1022,16785,0,0,10,1022,0,0,209.327429,0.0077950000000157615,1048877,0
"172.16.133.30",62834,"172.16.139.250",5440,10,1022,16786,0,0,10,1022,0,0,209.332152,0.007196999999990794,1136028,0
"172.16.133.25",63642,"172.16.139.250",5440,12,1142,16787,0,0,12,1142,0,0,209.339532,0.005053000000003749,1808034,0
"172.16.133.34",50609,"172.16.139.250",5440,10,1022,16788,0,0,10,1022,0,0,209.347803,0.015174999999999272,538780,0
"172.16.133.97",59543,"172.16.139.250",5440,10,1022,16789,0,0,10,1022,0,0,209.358884,0.014459000000016431,565460,0
"172.16.133.132",40172,"38.70.64.178",80,35,21315,16790,0,0,19,1447,16,19868,209.371764,0.3577669999999955,32356,444266
"172.16.133.26",53036,"91.190.218.58",12350,2,120,16791,0,0,1,60,1,60,209.3841,9.40000000184682e-05,"",""
"172.16.133.28",49309,"64.94.107.62",80,10,2396,16792,0,0,6,1873,4,523,209.417311,0.08297999999999206,180573,50421
"172.16.133.33",58052,"172.16.139.250",5440,12,1142,16793,0,0,12,1142,0,0,209.429324,0.006372999999996409,1433547,0
"172.16.133.66",54328,"216.115.217.254",443,6,366,16794,0,0,4,246,2,120,209.453102,0.06373199999998747,30879,15063
"172.16.133.68",60914,"172.16.139.250",5440,10,1022,16795,0,0,10,1022,0,0,209.463559,0.005409999999983484,1511275,0
"172.16.133.60",62158,"208.98.232.43",80,11,3829,16796,0,0,5,715,6,3114,209.467397,0.26589799999999286,21512,93690
"172.16.133.60",62159,"208.98.232.43",80,11,2672,16797,0,0,5,712,6,1960,209.472513,0.2556629999999984,22279,61330
"172.16.133.12",59930,"172.16.139.250",5440,10,1022,16798,0,0,10,1022,0,0,209.478183,0.0055260000000032505,1479551,0
"172.16.133.63",54090,"172.16.139.250",5440,10,1022,16799,0,0,10,1022,0,0,209.489136,0.005368000000004258,1523099,0
"172.16.133.66",54329,"172.16.139.250",5440,12,1142,16800,0,0,12,1142,0,0,209.500691,0.006273000000021511,1456400,0
"172.16.133.82",61597,"172.16.139.250",5440,10,1022,16801,0,0,10,1022,0,0,209.514678,0.005034999999992351,1623833,0
"172.16.133.37",60812,"172.16.139.250",5440,10,1022,16802,0,0,10,1022,0,0,209.527491,0.005406999999991058,1512113,0
"172.16.133.66",54330,"216.219.120.244",443,6,366,16803,0,0,4,246,2,120,209.573069,0.1702139999999872,11561,5639
"172.16.133.66",54331,"23.67.243.19",443,28,10120,16804,0,0,12,2461,16,7659,209.592957,54.930451000000005,358,1115
"172.16.133.66",54332,"23.67.243.19",443,13,1292,16805,0,0,6,664,7,628,209.593115,24.93238599999998,213,201
"172.16.133.66",54333,"23.67.243.19",443,18,4880,16806,0,0,8,1247,10,3633,209.593232,54.929156999999975,181,529
"172.16.133.66",54334,"23.67.243.19",443,24,6688,16807,0,0,11,1938,13,4750,209.593338,54.93026499999999,282,691
"172.16.133.66",54335,"23.67.243.19",443,19,5446,16808,0,0,8,1247,11,4199,209.593447,54.92643000000001,181,611
"172.16.133.66",54336,"23.67.243.19",443,13,1292,16809,0,0,6,664,7,628,209.593559,24.93175099999999,213,201
"172.16.133.66",54337,"23.67.242.80",443,13,1287,16810,0,0,6,659,7,628,209.593751,24.933515,211,201
"172.16.133.66",54338,"23.67.242.80",443,13,1287,16811,0,0,6,659,7,628,209.593866,24.944538000000023,211,201
"172.16.133.66",54339,"23.67.242.80",443,13,1287,16812,0,0,6,659,7,628,209.593972,24.935412999999983,211,201
"172.16.133.66",54340,"23.67.242.80",443,13,1287,16813,0,0,6,659,7,628,209.594075,24.934237999999993,211,201
"172.16.133.66",54341,"23.67.242.80",443,13,1287,16814,0,0,6,659,7,628,209.594155,24.933336999999995,211,201
"172.16.133.66",54342,"23.67.242.80",443,13,1287,16815,0,0,6,659,7,628,209.594282,24.945204000000018,211,201
"172.16.133.95",57118,"199.59.148.247",80,11,1721,16816,0,0,6,963,5,758,209.646516,40.280125999999996,191,150
"172.16.128.233",50929,"172.16.133.233",22,190,29016,16817,0,0,57,4600,133,24416,209.662176,8.05338900000001,4569,24254
"172.16.133.132",40944,"38.70.64.178",80,67,48889,16818,0,0,32,2262,35,46627,209.662772,0.5713570000000061,31671,652859
"172.16.133.78",59403,"172.16.139.250",5440,10,1022,16819,0,0,10,1022,0,0,209.68559,0.005988999999999578,1365169,0
"172.16.133.67",56162,"172.16.139.250",5440,12,1142,16820,0,0,12,1142,0,0,209.740285,0.015778000000011616,579034,0
"172.16.133.56",61589,"172.16.139.250",5440,12,1142,16821,0,0,12,1142,0,0,209.762032,0.056026000000002796,163067,0
"172.16.133.41",53307,"172.16.139.250",5440,10,1022,16822,0,0,10,1022,0,0,209.817756,0.01468700000000922,556682,0
"172.16.133.66",54343,"216.115.220.254",443,6,366,16823,0,0,4,246,2,120,209.851199,0.46455499999999006,4236,2066
"172.16.133.43",57933,"172.16.139.250",5440,10,1022,16824,0,0,10,1022,0,0,209.886938,0.005482000000000653,1491426,0
"172.16.133.42",57277,"172.16.139.250",5440,12,1142,16825,0,0,12,1142,0,0,209.895951,0.017327999999992016,527239,0
"172.16.133.60",62160,"208.98.232.43",80,33,26589,16826,0,0,13,1200,20,25389,209.901929,0.2739129999999932,35047,741520
"172.16.133.60",62161,"208.98.232.43",80,10,1373,16827,0,0,5,714,5,659,209.90298,0.3311479999999847,17249,15920
"172.16.133.60",62162,"208.98.232.43",80,89,85162,16828,0,0,31,2276,58,82886,209.903208,0.831973000000005,21885,797006
"172.16.133.60",62163,"208.98.232.43",80,30,23772,16829,0,0,12,1134,18,22638,209.903378,0.3310459999999864,27404,547065
"172.16.133.60",62164,"208.98.232.43",80,11,3042,16830,0,0,5,717,6,2325,209.90354,0.3309690000000103,17330,56198
"172.16.133.60",62165,"208.98.232.43",80,14,8070,16831,0,0,6,779,8,7291,209.903701,0.33188599999999724,18777,175747
"172.16.133.13",53194,"172.16.139.250",5440,12,1142,16832,0,0,12,1142,0,0,209.90644,0.015562999999986005,587033,0
"172.16.133.85",52434,"172.16.139.250",5440,10,1022,16833,0,0,10,1022,0,0,209.913167,0.01459800000000655,560076,0
"172.16.133.66",54344,"202.173.27.250",443,6,366,16834,0,0,4,246,2,120,209.927177,0.6213239999999871,3167,1545
"172.16.133.20",62561,"172.16.139.250",5440,10,1022,16835,0,0,10,1022,0,0,209.956896,0.0049080000000003565,"",""
"172.16.133.28",49310,"172.16.139.250",5440,10,1022,16836,0,0,10,1022,0,0,209.985839,0.004711000000014565,"",""
"172.16.133.99",56218,"172.16.139.250",5440,10,1022,16837,0,0,10,1022,0,0,210.014303,0.01573999999999387,519440,0
"172.16.133.75",51131,"172.16.139.250",5440,10,1022,16838,0,0,10,1022,0,0,210.020112,0.006600999999989199,1238600,0
"172.16.133.87",60399,"172.16.139.250",5440,12,1142,16839,0,0,12,1142,0,0,210.039283,0.006067000000001599,1505851,0
"172.16.133.35",50125,"172.16.139.250",5440,12,1142,16840,0,0,12,1142,0,0,210.045296,0.08342099999998709,109516,0
"172.16.133.116",53848,"172.16.139.250",5440,10,1022,16841,0,0,10,1022,0,0,210.050235,0.0115520000000231,707756,0
"172.16.133.116",53849,"172.16.139.250",5440,10,1022,16842,0,0,10,1022,0,0,210.062662,0.005785000000003038,1413310,0
"172.16.133.116",53850,"172.16.139.250",5440,12,1142,16843,0,0,12,1142,0,0,210.069875,0.006407999999993308,1425717,0
"172.16.133.84",58959,"172.16.139.250",5440,10,1022,16844,0,0,10,1022,0,0,210.072414,0.00750399999998308,1089552,0
"172.16.133.60",62166,"208.98.232.43",80,16,9229,16845,0,0,7,847,9,8382,210.093194,0.309363999999988,21903,216754
"172.16.133.60",62167,"208.98.232.43",80,10,1785,16846,0,0,5,715,5,1070,210.097533,0.3241309999999942,17647,26409
"172.16.133.49",55946,"172.16.139.250",5440,12,1142,16847,0,0,12,1142,0,0,210.149829,0.01603099999999813,569895,0
"172.16.133.95",57119,"172.16.139.250",5440,10,1022,16848,0,0,10,1022,0,0,210.192576,0.015386000000006561,531392,0
"172.16.133.128",65023,"96.43.146.176",443,4,240,16849,0,0,2,120,2,120,210.211611,0.06323199999999929,15182,15182
"172.16.133.128",65093,"96.43.146.176",443,20,6075,16850,0,0,11,2480,9,3595,210.212028,1.0267869999999846,19322,28009
"172.16.133.92",57831,"172.16.139.250",5440,10,1022,16851,0,0,10,1022,0,0,210.218338,0.005465000000015152,1496065,0
"172.16.133.29",61167,"172.16.139.250",5440,10,1022,16852,0,0,10,1022,0,0,210.235588,0.007039999999989277,1161363,0
"172.16.133.72",52250,"204.14.233.101",443,21,7213,16853,0,0,11,1532,10,5681,210.235848,66.69454199999998,183,681
"172.16.133.44",64994,"172.16.139.250",5440,10,1022,16854,0,0,10,1022,0,0,210.241467,0.005539999999996326,1475812,0
"172.16.133.68",60915,"173.194.68.95",80,38,21835,16855,0,0,16,2639,22,19196,210.261967,85.07263900000001,248,1805
"172.16.133.207",56102,"172.16.139.250",5440,12,1142,16856,0,0,12,1142,0,0,210.266292,0.014329000000003589,637588,0
"172.16.133.83",57239,"172.16.139.250",5440,10,1022,16857,0,0,10,1022,0,0,210.27638,0.013897000000014259,588328,0
"172.16.133.93",60913,"172.16.139.250",5440,12,1142,16858,0,0,12,1142,0,0,210.292011,0.014721000000008644,620610,0
"172.16.133.11",55327,"172.16.139.250",5440,12,1142,16859,0,0,12,1142,0,0,210.30994,0.0069729999999879055,1310196,0
"172.16.133.55",57784,"172.16.139.250",5440,10,1022,16860,0,0,10,1022,0,0,210.313192,0.014718000000016218,555510,0
"172.16.133.73",60840,"172.16.139.250",5440,12,1142,16861,0,0,12,1142,0,0,210.335706,0.0061720000000207165,1480233,0
"172.16.133.53",54268,"172.16.139.250",5440,10,1022,16862,0,0,10,1022,0,0,210.339031,0.006181999999995469,1322549,0
"172.16.133.21",53342,"172.16.139.250",5440,10,1022,16863,0,0,10,1022,0,0,210.341316,0.008761999999990167,933120,0
"172.16.133.30",62835,"172.16.139.250",5440,10,1022,16864,0,0,10,1022,0,0,210.346431,0.008641000000011445,946186,0
"172.16.133.25",63643,"172.16.139.250",5440,12,1142,16865,0,0,12,1142,0,0,210.352185,0.014575000000007776,626826,0
"172.16.133.34",50610,"172.16.139.250",5440,10,1022,16866,0,0,10,1022,0,0,210.362161,0.008526000000017575,958949,0
"172.16.133.97",59544,"172.16.139.250",5440,10,1022,16867,0,0,10,1022,0,0,210.372814,0.014569999999991978,561153,0
"172.16.133.68",60916,"72.233.127.217",80,140,143416,16868,0,0,42,3304,98,140112,210.400372,45.59184099999999,579,24585
"172.16.133.33",58053,"172.16.139.250",5440,12,1142,16869,0,0,12,1142,0,0,210.443601,0.006519999999994752,1401226,0
"172.16.133.68",60917,"172.16.139.250",5440,12,1142,16870,0,0,12,1142,0,0,210.477676,0.006260999999994965,1459191,0
"172.16.133.12",59931,"172.16.139.250",5440,10,1022,16871,0,0,10,1022,0,0,210.492254,0.006125999999994747,1334639,0
"172.16.133.63",54091,"172.16.139.250",5440,10,1022,16872,0,0,10,1022,0,0,210.504129,0.0054189999999891825,1508765,0
"172.16.133.66",54345,"172.16.139.250",5440,10,1022,16873,0,0,10,1022,0,0,210.514864,0.00543700000000058,1503770,0
"172.16.133.82",61598,"172.16.139.250",5440,10,1022,16874,0,0,10,1022,0,0,210.529121,0.00546299999999178,1496613,0
"172.16.133.37",60813,"172.16.139.250",5440,10,1022,16875,0,0,10,1022,0,0,210.542063,0.004977999999994154,"",""
"172.16.133.60",62168,"208.98.232.43",80,10,1594,16876,0,0,5,726,5,868,210.676965,0.24356800000001044,23845,28509
"172.16.133.66",54346,"23.67.243.58",443,32,16942,16878,0,0,12,2337,20,14605,210.698817,33.827324000000004,552,3454
"172.16.133.78",59404,"172.16.139.250",5440,10,1022,16879,0,0,10,1022,0,0,210.699719,0.005746000000016238,1422902,0
"172.16.133.67",56163,"172.16.139.250",5440,12,1142,16880,0,0,12,1142,0,0,210.75491,0.005566000000015947,1641394,0
"172.16.133.39",64296,"68.64.24.250",443,6,366,16881,0,0,4,246,2,120,210.758516,0.10502200000001949,18738,9140
"172.16.133.56",61590,"172.16.139.250",5440,12,1142,16882,0,0,12,1142,0,0,210.775609,0.0051109999999994216,1787517,0
"172.16.133.41",53308,"172.16.139.250",5440,10,1022,16883,0,0,10,1022,0,0,210.831884,0.016049000000009528,509439,0
"172.16.133.113",55695,"132.245.2.22",443,7,1448,16884,0,0,5,430,2,1018,210.853641,24.62851599999999,139,330
"172.16.133.39",64297,"216.219.118.244",443,6,366,16885,0,0,4,246,2,120,210.870288,0.21166500000001065,9297,4535
"172.16.133.39",64298,"78.108.118.250",443,6,366,16886,0,0,4,246,2,120,210.881355,0.20157099999997286,9763,4762
"172.16.133.43",57934,"172.16.139.250",5440,12,1142,16887,0,0,12,1142,0,0,210.900787,0.006278999999977941,1455008,0
"172.16.133.42",57278,"172.16.139.250",5440,12,1142,16888,0,0,12,1142,0,0,210.917002,0.015348000000017237,595256,0
"172.16.133.13",53195,"172.16.139.250",5440,10,1022,16889,0,0,10,1022,0,0,210.921725,0.015579999999999927,524775,0
"172.16.133.85",52435,"172.16.139.250",5440,10,1022,16890,0,0,10,1022,0,0,210.927485,0.014695000000017444,556379,0
"172.16.133.60",62169,"208.98.232.43",80,10,1491,16891,0,0,5,633,5,858,210.936871,0.2478010000000097,20435,27699
"172.16.133.20",62562,"172.16.139.250",5440,12,1142,16892,0,0,12,1142,0,0,210.971139,0.004944999999992206,"",""
"172.16.133.28",49311,"172.16.139.250",5440,10,1022,16893,0,0,10,1022,0,0,210.999507,0.014686000000011745,556720,0
"172.16.133.66",54347,"23.67.243.58",443,13,1289,16894,0,0,6,661,7,628,211.016266,23.510019999999997,224,213
"172.16.133.99",56219,"172.16.139.250",5440,12,1142,16895,0,0,12,1142,0,0,211.028053,0.01569200000000137,582207,0
"172.16.133.75",51132,"172.16.139.250",5440,10,1022,16896,0,0,10,1022,0,0,211.034154,0.005481000000003178,1491698,0
"172.16.133.66",54348,"23.67.243.48",443,27,14566,16897,0,0,11,1535,16,13031,211.04227,83.478128,147,1248
"172.16.133.87",60400,"172.16.139.250",5440,10,1022,16898,0,0,10,1022,0,0,211.053002,0.009176999999993996,890922,0
"172.16.133.72",52251,"96.43.146.176",443,314,258661,16899,0,0,109,10299,205,248362,211.054801,65.87667299999998,1250,30160
"172.16.133.35",50126,"172.16.139.250",5440,12,1142,16900,0,0,12,1142,0,0,211.058704,0.00931499999998664,980783,0
"172.16.133.116",53851,"172.16.139.250",5440,10,1022,16901,0,0,10,1022,0,0,211.065005,0.005953999999974258,1373194,0
"172.16.133.116",53852,"172.16.139.250",5440,10,1022,16902,0,0,10,1022,0,0,211.071897,0.005057999999991125,1616449,0
"172.16.133.116",53853,"172.16.139.250",5440,10,1022,16903,0,0,10,1022,0,0,211.077818,0.005934999999993806,1377590,0
"172.16.133.84",58960,"172.16.139.250",5440,10,1022,16904,0,0,10,1022,0,0,211.086489,0.005413000000004331,1510437,0
"172.16.133.116",53854,"68.64.24.250",443,6,366,16905,0,0,4,246,2,120,211.093708,0.09490600000000882,20736,10115
"172.16.133.49",55947,"172.16.139.250",5440,10,1022,16906,0,0,10,1022,0,0,211.163524,0.005484999999993079,1490610,0
"172.16.133.66",54349,"23.23.117.77",443,33,14546,16907,0,0,18,9508,15,5038,211.17236,73.35830899999999,1036,549
"172.16.133.66",54350,"63.241.108.124",443,22,14454,16908,0,0,12,8141,10,6313,211.173065,0.27402399999999716,237672,184305
"172.16.133.116",53855,"78.108.118.250",443,6,366,16909,0,0,4,246,2,120,211.19276,0.24559200000001624,8013,3908
"172.16.133.116",53856,"216.219.118.244",443,6,366,16910,0,0,4,246,2,120,211.194559,0.2447610000000111,8040,3922
"172.16.133.39",64299,"216.115.219.126",443,6,366,16911,0,0,4,246,2,120,211.204518,0.48781700000000683,4034,1967
"172.16.133.95",57120,"172.16.139.250",5440,12,1142,16912,0,0,12,1142,0,0,211.205527,0.016120999999998276,566714,0
"172.16.133.92",57832,"172.16.139.250",5440,10,1022,16913,0,0,10,1022,0,0,211.230948,0.005498999999986154,1486815,0
"172.16.133.29",61168,"172.16.139.250",5440,10,1022,16914,0,0,10,1022,0,0,211.248402,0.005339999999989686,1531086,0
"172.16.133.44",64995,"172.16.139.250",5440,10,1022,16915,0,0,10,1022,0,0,211.2556,0.005363000000016882,1524519,0
"172.16.133.207",56103,"172.16.139.250",5440,12,1142,16916,0,0,12,1142,0,0,211.28118,0.014390999999989162,634841,0
"172.16.133.83",57240,"172.16.139.250",5440,12,1142,16917,0,0,12,1142,0,0,211.290277,0.01383999999998764,660115,0
"172.16.133.93",60914,"172.16.139.250",5440,12,1142,16918,0,0,12,1142,0,0,211.305236,0.004923999999988382,"",""
"172.16.133.116",53857,"216.115.219.126",443,7,426,16919,0,0,4,246,3,180,211.313815,0.5291249999999934,3719,2721
"172.16.133.11",55328,"172.16.139.250",5440,10,1022,16920,0,0,10,1022,0,0,211.322794,0.014896000000021559,548872,0
"172.16.133.55",57785,"172.16.139.250",5440,12,1142,16921,0,0,12,1142,0,0,211.327577,0.016264000000006718,561731,0
"172.16.133.73",60841,"172.16.139.250",5440,10,1022,16922,0,0,10,1022,0,0,211.350244,0.014960999999999558,546487,0
"172.16.133.53",54269,"172.16.139.250",5440,10,1022,16923,0,0,10,1022,0,0,211.353334,0.015624000000002525,523297,0
"172.16.133.21",53343,"172.16.139.250",5440,10,1022,16924,0,0,10,1022,0,0,211.35546,0.005702000000013641,1433882,0
"172.16.133.30",62836,"172.16.139.250",5440,10,1022,16925,0,0,10,1022,0,0,211.359709,0.017147999999991725,476790,0
"172.16.133.25",63644,"172.16.139.250",5440,10,1022,16926,0,0,10,1022,0,0,211.367116,0.005995999999981905,1363575,0
"172.16.133.34",50611,"172.16.139.250",5440,10,1022,16927,0,0,10,1022,0,0,211.38323,0.01521900000000187,537223,0
"172.16.133.97",59545,"172.16.139.250",5440,10,1022,16928,0,0,10,1022,0,0,211.38592,0.005628000000001521,1452736,0
"172.16.133.33",58054,"172.16.139.250",5440,12,1142,16929,0,0,12,1142,0,0,211.457341,0.005940999999978658,1537788,0
"172.16.133.66",54351,"216.115.217.254",443,6,366,16930,0,0,4,246,2,120,211.490112,0.05567999999999529,35344,17241
"172.16.133.68",60918,"172.16.139.250",5440,12,1142,16931,0,0,12,1142,0,0,211.491962,0.0063370000000020354,1441691,0
"172.16.133.12",59932,"172.16.139.250",5440,12,1142,16932,0,0,12,1142,0,0,211.505863,0.006352999999990061,1438060,0
"172.16.133.63",54092,"172.16.139.250",5440,10,1022,16933,0,0,10,1022,0,0,211.517111,0.014668000000000347,557403,0
"172.16.133.66",54352,"172.16.139.250",5440,10,1022,16934,0,0,10,1022,0,0,211.528478,0.007476999999994405,1093486,0
"172.16.133.82",61599,"172.16.139.250",5440,10,1022,16935,0,0,10,1022,0,0,211.542765,0.014979000000010956,545830,0
"172.16.133.37",60814,"172.16.139.250",5440,10,1022,16936,0,0,10,1022,0,0,211.555662,0.006430999999992082,1271341,0
"172.16.133.11",55329,"74.125.226.228",443,22,6297,16937,0,0,12,2018,10,4279,211.634405,45.12307899999999,357,758
"172.16.133.66",54353,"216.219.120.244",443,6,366,16938,0,0,4,246,2,120,211.663053,0.1783450000000073,11034,5382
"172.16.133.78",59405,"172.16.139.250",5440,10,1022,16939,0,0,10,1022,0,0,211.712964,0.01563600000000065,522895,0
"172.16.133.11",55330,"173.194.43.36",443,44,17947,16940,0,0,21,2830,23,15117,211.734957,45.213751,500,2674
"172.16.133.67",56164,"172.16.139.250",5440,10,1022,16941,0,0,10,1022,0,0,211.767954,0.01525999999998362,535779,0
"172.16.133.56",61591,"172.16.139.250",5440,10,1022,16942,0,0,10,1022,0,0,211.789798,0.004886999999996533,"",""
"172.16.133.41",53309,"172.16.139.250",5440,12,1142,16943,0,0,12,1142,0,0,211.845711,0.006120000000009895,1492810,0
"172.16.133.39",64300,"206.190.57.60",80,37,20246,16944,0,0,17,9619,20,10627,211.85955,52.576233,1463,1617
"172.16.133.39",64301,"98.137.80.31",80,19,9777,16945,0,0,9,1518,10,8259,211.888527,26.965397999999993,450,2450
"172.16.133.43",57935,"172.16.139.250",5440,10,1022,16946,0,0,10,1022,0,0,211.915979,0.015557999999998628,525517,0
"172.16.133.42",57279,"172.16.139.250",5440,12,1142,16947,0,0,12,1142,0,0,211.928875,0.01541199999999776,592784,0
"172.16.133.13",53196,"172.16.139.250",5440,10,1022,16948,0,0,10,1022,0,0,211.934707,0.014794999999992342,552619,0
"172.16.133.85",52436,"172.16.139.250",5440,10,1022,16949,0,0,10,1022,0,0,211.941866,0.015284000000008291,534938,0
"172.16.133.20",62563,"172.16.139.250",5440,10,1022,16950,0,0,10,1022,0,0,211.984986,0.00484000000000151,"",""
"172.16.133.28",49312,"172.16.139.250",5440,12,1142,16951,0,0,12,1142,0,0,212.013757,0.015489999999999782,589799,0
"172.16.133.99",56220,"172.16.139.250",5440,12,1142,16952,0,0,12,1142,0,0,212.043616,0.005275000000011687,1731943,0
"172.16.133.75",51133,"172.16.139.250",5440,10,1022,16953,0,0,10,1022,0,0,212.048204,0.005403999999998632,1512953,0
"172.16.133.87",60401,"172.16.139.250",5440,12,1142,16954,0,0,12,1142,0,0,212.067626,0.005912000000023454,1545331,0
"172.16.133.35",50127,"172.16.139.250",5440,12,1142,16955,0,0,12,1142,0,0,212.071405,0.012144000000006372,752305,0
"172.16.133.116",53858,"172.16.139.250",5440,10,1022,16956,0,0,10,1022,0,0,212.079433,0.007075000000014597,1155618,0
"172.16.133.66",54354,"216.115.220.254",443,6,366,16957,0,0,4,246,2,120,212.08212,0.4503689999999949,4369,2131
"172.16.133.116",53859,"172.16.139.250",5440,10,1022,16958,0,0,10,1022,0,0,212.087046,0.00643800000000283,1269959,0
"172.16.133.116",53860,"172.16.139.250",5440,10,1022,16959,0,0,10,1022,0,0,212.093967,0.005519000000020924,1481427,0
"172.16.133.84",58961,"172.16.139.250",5440,10,1022,16960,0,0,10,1022,0,0,212.100734,0.015352000000007138,532569,0
"172.16.133.49",55948,"172.16.139.250",5440,10,1022,16961,0,0,10,1022,0,0,212.176984,0.005585999999993874,1463659,0
"172.16.133.95",57121,"172.16.139.250",5440,10,1022,16962,0,0,10,1022,0,0,212.219411,0.015298000000001366,534448,0
"172.16.133.92",57833,"172.16.139.250",5440,10,1022,16963,0,0,10,1022,0,0,212.246183,0.005530999999990627,1478213,0
"172.16.133.66",54355,"202.173.27.250",443,6,366,16964,0,0,4,246,2,120,212.246743,0.5486779999999953,3586,1749
"172.16.133.29",61169,"172.16.139.250",5440,10,1022,16965,0,0,10,1022,0,0,212.262462,0.005535000000008949,1477145,0
"172.16.133.44",64996,"172.16.139.250",5440,10,1022,16966,0,0,10,1022,0,0,212.269737,0.005354000000011183,1527082,0
"172.16.133.207",56104,"172.16.139.250",5440,10,1022,16967,0,0,10,1022,0,0,212.295031,0.004676000000017666,"",""
"172.16.133.83",57241,"172.16.139.250",5440,10,1022,16968,0,0,10,1022,0,0,212.304447,0.013880000000000337,589048,0
"172.16.133.93",60917,"172.16.139.250",5440,10,1022,16969,0,0,10,1022,0,0,212.319141,0.004726000000005115,"",""
"172.16.133.11",55331,"172.16.139.250",5440,12,1142,16970,0,0,12,1142,0,0,212.33701,0.005913000000020929,1545070,0
"172.16.133.55",57786,"172.16.139.250",5440,12,1142,16971,0,0,12,1142,0,0,212.342137,0.006277999999980466,1455240,0
"172.16.133.73",60842,"172.16.139.250",5440,10,1022,16972,0,0,10,1022,0,0,212.363859,0.015216000000009444,537329,0
"172.16.133.53",54270,"172.16.139.250",5440,10,1022,16973,0,0,10,1022,0,0,212.366523,0.016406999999986738,498323,0
"172.16.133.21",53344,"172.16.139.250",5440,12,1142,16974,0,0,12,1142,0,0,212.369438,0.018318999999991092,498717,0
"172.16.133.30",62837,"172.16.139.250",5440,10,1022,16975,0,0,10,1022,0,0,212.374733,0.019926999999995587,410297,0
"172.16.133.25",63645,"172.16.139.250",5440,10,1022,16976,0,0,10,1022,0,0,212.381689,0.009755000000012615,838134,0
"172.16.133.34",50612,"172.16.139.250",5440,10,1022,16977,0,0,10,1022,0,0,212.389965,0.00871600000002104,938044,0
"172.16.133.97",59546,"172.16.139.250",5440,10,1022,16978,0,0,10,1022,0,0,212.400748,0.014726999999993495,555170,0
"172.16.133.33",58055,"172.16.139.250",5440,10,1022,16979,0,0,10,1022,0,0,212.47165,0.03840900000000147,212866,0
"172.16.133.113",55696,"172.16.139.250",135,8,492,16980,0,0,8,492,0,0,212.478312,0.018290000000007467,215199,0
"172.16.133.113",55697,"172.16.139.250",5462,10,696,16981,0,0,10,696,0,0,212.498154,0.5243810000000053,10618,0
"172.16.133.68",60919,"172.16.139.250",5440,12,1142,16982,0,0,12,1142,0,0,212.505426,0.009883000000002085,924415,0
"172.16.133.12",59933,"172.16.139.250",5440,12,1142,16983,0,0,12,1142,0,0,212.520201,0.007805000000018936,1170531,0
"172.16.133.63",54093,"172.16.139.250",5440,12,1142,16984,0,0,12,1142,0,0,212.531332,0.01540800000000786,592938,0
"172.16.133.66",54356,"172.16.139.250",5440,10,1022,16985,0,0,10,1022,0,0,212.542314,0.008780000000001564,931207,0
"172.16.133.82",61600,"172.16.139.250",5440,12,1142,16986,0,0,12,1142,0,0,212.557402,0.01682999999999879,542840,0
"172.16.133.37",60818,"172.16.139.250",5440,12,1142,16987,0,0,12,1142,0,0,212.569592,0.008679999999998245,1052534,0
"172.16.133.116",53861,"208.111.161.254",80,50,28918,16988,0,0,19,4640,31,24278,212.688251,80.81864799999997,459,2403
"172.16.133.116",53862,"208.111.161.254",80,55,34816,16989,0,0,22,5686,33,29130,212.688511,80.81465800000001,562,2883
"172.16.133.78",59406,"67.149.51.94",60430,3,194,16990,0,0,3,194,0,0,212.690945,8.994069999999994,172,0
"172.16.133.78",59407,"172.16.139.250",5440,10,1022,16991,0,0,10,1022,0,0,212.726882,0.005790000000018836,1412089,0
"172.16.133.67",56165,"172.16.139.250",5440,10,1022,16992,0,0,10,1022,0,0,212.781544,0.005727000000007365,1427623,0
"172.16.133.56",61592,"172.16.139.250",5440,12,1142,16993,0,0,12,1142,0,0,212.803668,0.004884000000004107,"",""
"172.16.133.41",53310,"172.16.139.250",5440,12,1142,16994,0,0,12,1142,0,0,212.860879,0.015109999999992851,604632,0
"172.16.133.43",57936,"172.16.139.250",5440,10,1022,16995,0,0,10,1022,0,0,212.928857,0.005481000000003178,1491698,0
"172.16.133.42",57280,"172.16.139.250",5440,12,1142,16996,0,0,12,1142,0,0,212.942895,0.039776000000017575,229686,0
"172.16.133.13",53197,"172.16.139.250",5440,10,1022,16997,0,0,10,1022,0,0,212.948918,0.005446000000006279,1501285,0
"172.16.133.85",52437,"172.16.139.250",5440,10,1022,16998,0,0,10,1022,0,0,212.955518,0.01637199999998984,499389,0
"172.16.133.39",64302,"68.64.24.250",443,6,366,16999,0,0,4,246,2,120,212.965974,0.10026700000000233,19627,9574
"172.16.133.20",62564,"172.16.139.250",5440,12,1142,17000,0,0,12,1142,0,0,212.999248,0.0048580000000129075,"",""
"172.16.133.28",49313,"172.16.139.250",5440,10,1022,17001,0,0,10,1022,0,0,213.027597,0.005287000000009812,1546434,0
"172.16.133.99",56221,"172.16.139.250",5440,10,1022,17002,0,0,10,1022,0,0,213.057225,0.01470900000001052,555850,0
"172.16.133.75",51134,"172.16.139.250",5440,10,1022,17003,0,0,10,1022,0,0,213.062246,0.005367000000006783,1523383,0
"172.16.133.87",60402,"172.16.139.250",5440,12,1142,17004,0,0,12,1142,0,0,213.08123,0.016405999999989263,556869,0
"172.16.133.35",50128,"172.16.139.250",5440,12,1142,17005,0,0,12,1142,0,0,213.085877,0.010764999999992142,848676,0
"172.16.133.116",53863,"172.16.139.250",5440,10,1022,17006,0,0,10,1022,0,0,213.092651,0.0080600000000004,1014392,0
"172.16.133.116",53864,"172.16.139.250",5440,10,1022,17007,0,0,10,1022,0,0,213.101576,0.005850000000009459,1397606,0
"172.16.133.116",53865,"172.16.139.250",5440,12,1142,17008,0,0,12,1142,0,0,213.108376,0.005992000000020425,1524699,0
"172.16.133.39",64303,"216.219.118.244",443,6,366,17009,0,0,4,246,2,120,213.108837,0.20959300000001235,9389,4580
"172.16.133.39",64304,"78.108.118.250",443,6,366,17010,0,0,4,246,2,120,213.111737,0.20639499999998634,9535,4651
"172.16.133.84",58962,"172.16.139.250",5440,10,1022,17011,0,0,10,1022,0,0,213.114428,0.00533500000000231,1532521,0
"172.16.133.116",53866,"68.64.24.250",443,6,366,17012,0,0,4,246,2,120,213.144882,0.09407300000000873,20919,10204
"172.16.133.49",55949,"172.16.139.250",5440,10,1022,17013,0,0,10,1022,0,0,213.190955,0.015175999999996748,538745,0
"172.16.133.95",57122,"172.16.139.250",5440,12,1142,17014,0,0,12,1142,0,0,213.233047,0.0060839999999871,1501643,0
"172.16.133.92",57834,"172.16.139.250",5440,10,1022,17015,0,0,10,1022,0,0,213.26044,0.0055240000000083,1480086,0
"172.16.133.29",61170,"172.16.139.250",5440,10,1022,17016,0,0,10,1022,0,0,213.275852,0.01795500000000061,455360,0
"172.16.133.44",64997,"172.16.139.250",5440,12,1142,17017,0,0,12,1142,0,0,213.284565,0.006189000000006217,1476167,0
"172.16.133.116",53867,"78.108.118.250",443,6,366,17018,0,0,4,246,2,120,213.300981,0.20008799999999383,9835,4797
"172.16.133.116",53868,"216.219.118.244",443,6,366,17019,0,0,4,246,2,120,213.301789,0.20654299999998216,9528,4647
"172.16.133.207",56105,"172.16.139.250",5440,12,1142,17020,0,0,12,1142,0,0,213.308194,0.014763000000016291,618844,0
"172.16.133.83",57242,"172.16.139.250",5440,12,1142,17021,0,0,12,1142,0,0,213.31855,0.008741000000014765,1045189,0
"172.16.133.93",60918,"172.16.139.250",5440,12,1142,17022,0,0,12,1142,0,0,213.333065,0.01525799999998867,598767,0
"172.16.133.11",55332,"172.16.139.250",5440,10,1022,17023,0,0,10,1022,0,0,213.350796,0.0056679999999857955,1442484,0
"172.16.133.55",57787,"172.16.139.250",5440,10,1022,17024,0,0,10,1022,0,0,213.356048,0.005580000000009022,1465232,0
"172.16.133.73",60843,"172.16.139.250",5440,10,1022,17025,0,0,10,1022,0,0,213.37785,0.005594000000002097,1461565,0
"172.16.133.53",54271,"172.16.139.250",5440,12,1142,17026,0,0,12,1142,0,0,213.380037,0.007213000000007241,1266601,0
"172.16.133.21",53345,"172.16.139.250",5440,12,1142,17027,0,0,12,1142,0,0,213.38359,0.01581999999999084,577496,0
"172.16.133.30",62838,"172.16.139.250",5440,10,1022,17028,0,0,10,1022,0,0,213.388534,0.00574100000000044,1424142,0
"172.16.133.25",63646,"172.16.139.250",5440,10,1022,17029,0,0,10,1022,0,0,213.395176,0.007317999999997937,1117245,0
"172.16.133.34",50613,"172.16.139.250",5440,12,1142,17030,0,0,12,1142,0,0,213.403815,0.01484299999998484,615508,0
"172.16.133.97",59547,"172.16.139.250",5440,10,1022,17031,0,0,10,1022,0,0,213.413738,0.01471499999999537,555623,0
"172.16.133.33",58056,"172.16.139.250",5440,12,1142,17032,0,0,12,1142,0,0,213.486552,0.006200000000006867,1473548,0
"172.16.133.68",60920,"172.16.139.250",5440,10,1022,17033,0,0,10,1022,0,0,213.519713,0.005631999999991422,1451704,0
"172.16.133.66",54357,"216.115.217.254",443,6,366,17034,0,0,4,246,2,120,213.52519,0.061718999999982316,31886,15554
"172.16.133.39",64305,"216.115.219.126",443,6,366,17035,0,0,4,246,2,120,213.53102,0.4982909999999947,3949,1926
"172.16.133.12",59934,"172.16.139.250",5440,12,1142,17036,0,0,12,1142,0,0,213.534114,0.0060789999999997235,1502878,0
"172.16.133.63",54094,"172.16.139.250",5440,10,1022,17037,0,0,10,1022,0,0,213.546173,0.0058249999999873125,1403605,0
"172.16.133.66",54358,"172.16.139.250",5440,10,1022,17038,0,0,10,1022,0,0,213.556627,0.3545249999999953,23061,0
"172.16.133.82",61601,"172.16.139.250",5440,12,1142,17039,0,0,12,1142,0,0,213.571285,0.3402670000000114,26849,0
"172.16.133.37",60819,"172.16.139.250",5440,10,1022,17040,0,0,10,1022,0,0,213.584067,0.3312439999999981,24682,0
"172.16.133.116",53869,"216.115.219.126",443,6,366,17041,0,0,4,246,2,120,213.592949,0.48821399999999926,4031,1966
"172.16.133.132",40758,"23.62.194.77",80,7,478,17042,0,0,4,272,3,206,213.723914,0.09706499999998641,22417,16978
"172.16.133.78",59408,"172.16.139.250",5440,10,1022,17043,0,0,10,1022,0,0,213.742012,0.1785600000000045,45788,0
"172.16.139.250",4222,"69.42.109.196",443,20,6797,17044,0,0,10,1568,10,5229,213.743007,2.762484999999998,4540,15142
"172.16.133.66",54359,"216.219.120.244",443,8,486,17045,0,0,5,306,3,180,213.754318,3.1770939999999825,770,453
"172.16.133.103",63445,"216.52.242.80",80,10,2837,17046,0,0,6,1856,4,981,213.795542,45.331601999999975,327,173
"172.16.133.67",56166,"172.16.139.250",5440,10,1022,17047,0,0,10,1022,0,0,213.796058,0.12911900000000287,63321,0
"172.16.133.56",61593,"172.16.139.250",5440,10,1022,17048,0,0,10,1022,0,0,213.81782,0.11082599999997456,73773,0
"172.16.133.132",59510,"173.252.100.27",80,9,610,17049,0,0,5,338,4,272,213.851529,0.3215450000000146,8409,6767
"172.16.133.41",53311,"172.16.139.250",5440,10,1022,17050,0,0,10,1022,0,0,213.873157,0.05881800000000226,139005,0
"172.16.133.36",64990,"23.32.177.224",443,2,132,17051,0,0,1,66,1,66,213.898287,0.0055260000000032505,95548,95548
"172.16.133.132",40300,"173.194.43.33",80,8,552,17052,0,0,5,346,3,206,213.936111,3.04959199999999,907,540
"172.16.133.43",57937,"172.16.139.250",5440,12,1142,17053,0,0,12,1142,0,0,213.942766,0.0064239999999813335,1422166,0
"172.16.133.42",57281,"172.16.139.250",5440,12,1142,17054,0,0,12,1142,0,0,213.953426,0.011155999999999722,818931,0
"172.16.133.13",53198,"172.16.139.250",5440,10,1022,17055,0,0,10,1022,0,0,213.964335,0.006917999999984659,1181844,0
"172.16.133.85",52438,"172.16.139.250",5440,12,1142,17056,0,0,12,1142,0,0,213.969546,0.01564899999999625,583807,0
"172.16.133.20",62565,"172.16.139.250",5440,10,1022,17057,0,0,10,1022,0,0,214.012778,0.004666000000014492,"",""
"172.16.133.28",49314,"172.16.139.250",5440,10,1022,17058,0,0,10,1022,0,0,214.044701,0.01686699999999064,484733,0
"172.16.133.99",56222,"172.16.139.250",5440,10,1022,17059,0,0,10,1022,0,0,214.070174,0.015343000000001439,532881,0
"172.16.133.75",51135,"172.16.139.250",5440,10,1022,17060,0,0,10,1022,0,0,214.076144,0.0055629999999951,1469710,0
"172.16.133.87",60403,"172.16.139.250",5440,10,1022,17061,0,0,10,1022,0,0,214.093981,0.019055999999977757,429051,0
"172.16.133.35",50129,"172.16.139.250",5440,12,1142,17062,0,0,12,1142,0,0,214.106224,0.027469999999993888,332580,0
"172.16.133.116",53870,"172.16.139.250",5440,10,1022,17063,0,0,10,1022,0,0,214.107811,0.006772000000012213,1207324,0
"172.16.133.116",53871,"172.16.139.250",5440,10,1022,17064,0,0,10,1022,0,0,214.115678,0.006550000000004275,1248244,0
"172.16.133.83",57243,"157.56.237.150",443,27,14816,17065,0,0,11,2028,16,12788,214.116943,0.5512490000000128,29431,185585
"172.16.133.116",53872,"172.16.139.250",5440,10,1022,17066,0,0,10,1022,0,0,214.123884,0.005689999999987094,1436906,0
"172.16.133.84",58963,"172.16.139.250",5440,12,1142,17067,0,0,12,1142,0,0,214.128802,0.006050999999985152,1509833,0
"172.16.133.87",60404,"216.219.116.244",443,6,366,17068,0,0,4,246,2,120,214.140608,0.2890350000000126,6808,3321
"172.16.133.87",60405,"68.64.26.250",443,6,366,17069,0,0,4,246,2,120,214.141559,0.13772399999999152,14289,6970
"172.16.133.87",60406,"216.115.216.250",443,6,366,17070,0,0,4,246,2,120,214.142263,0.08160099999997783,24117,11764
"172.16.133.87",60407,"68.64.4.249",443,6,366,17071,0,0,4,246,2,120,214.142344,0.16134499999998297,12197,5949
"172.16.133.49",55950,"172.16.139.250",5440,12,1142,17072,0,0,12,1142,0,0,214.204479,0.0070430000000101245,1297174,0
"172.16.133.39",64306,"208.47.254.83",80,12,2562,17073,0,0,7,1644,5,918,214.221314,49.997433,263,146
"172.16.133.95",57123,"172.16.139.250",5440,12,1142,17074,0,0,12,1142,0,0,214.247585,0.006020000000006576,1517607,0
"172.16.133.92",57835,"172.16.139.250",5440,10,1022,17075,0,0,10,1022,0,0,214.27328,0.006271999999995614,1303571,0
"172.16.133.29",61171,"172.16.139.250",5440,10,1022,17076,0,0,10,1022,0,0,214.290267,0.018097000000011576,451787,0
"172.16.133.44",64998,"172.16.139.250",5440,12,1142,17077,0,0,12,1142,0,0,214.298866,0.006194999999991069,1474737,0
"172.16.133.66",54360,"216.115.220.254",443,6,366,17078,0,0,4,246,2,120,214.307283,0.4880709999999908,4032,1966
"172.16.133.207",56106,"172.16.139.250",5440,12,1142,17079,0,0,12,1142,0,0,214.322308,0.01453300000000013,628638,0
"172.16.133.83",57244,"172.16.139.250",5440,10,1022,17080,0,0,10,1022,0,0,214.332476,0.01620899999997505,504411,0
"172.16.133.93",60919,"172.16.139.250",5440,10,1022,17081,0,0,10,1022,0,0,214.347377,0.005099999999998772,1603137,0
"172.16.133.11",55333,"172.16.139.250",5440,12,1142,17082,0,0,12,1142,0,0,214.366127,0.0064250000000072305,1421945,0
"172.16.133.55",57788,"172.16.139.250",5440,12,1142,17083,0,0,12,1142,0,0,214.371023,0.0066549999999949705,1372802,0
"172.16.133.73",60844,"172.16.139.250",5440,12,1142,17084,0,0,12,1142,0,0,214.393507,0.015331000000003314,595916,0
"172.16.133.53",54272,"172.16.139.250",5440,12,1142,17085,0,0,12,1142,0,0,214.394107,0.006399000000016031,1427723,0
"172.16.133.21",53346,"172.16.139.250",5440,12,1142,17086,0,0,12,1142,0,0,214.397511,0.01937699999999154,471486,0
"172.16.133.30",62839,"172.16.139.250",5440,10,1022,17087,0,0,10,1022,0,0,214.402807,0.009298000000001139,879328,0
"172.16.133.25",63647,"172.16.139.250",5440,12,1142,17088,0,0,12,1142,0,0,214.408446,0.011739000000005717,778260,0
"172.16.133.34",50614,"172.16.139.250",5440,10,1022,17089,0,0,10,1022,0,0,214.417147,0.006878000000000384,1188717,0
"172.16.133.97",59548,"172.16.139.250",5440,10,1022,17090,0,0,10,1022,0,0,214.429366,0.005305000000021209,1541187,0
"172.16.133.39",64307,"98.139.240.22",80,12,3337,17091,0,0,6,2599,6,738,214.480135,0.19790600000001746,105059,29832
"172.16.133.20",62566,"172.16.139.250",5440,12,1142,17092,0,0,12,1142,0,0,214.481885,0.004757999999981166,"",""
"172.16.133.33",58057,"172.16.139.250",5440,12,1142,17093,0,0,12,1142,0,0,214.499344,0.01553400000000238,588129,0
"172.16.133.20",62567,"96.43.146.176",443,12,2268,17094,0,0,7,1475,5,793,214.519273,0.6341250000000116,18608,10004
"172.16.133.66",54361,"202.173.27.250",443,6,366,17095,0,0,4,246,2,120,214.521147,0.5558489999999949,3540,1727
"172.16.133.39",64308,"68.142.253.72",80,8,492,17096,0,0,5,306,3,186,214.523061,14.278222,171,104
"172.16.133.39",64309,"68.142.253.72",80,8,492,17097,0,0,5,306,3,186,214.523369,14.28274300000001,171,104
"172.16.133.39",64310,"98.139.225.43",80,30,17705,17098,0,0,15,10569,15,7136,214.523632,24.331342000000006,3475,2346
"172.16.133.39",64311,"98.139.225.43",80,30,17644,17099,0,0,15,10565,15,7079,214.523808,24.331060000000008,3473,2327
"172.16.133.68",60922,"172.16.139.250",5440,10,1022,17100,0,0,10,1022,0,0,214.534052,0.005467000000010103,1495518,0
"172.16.133.114",55341,"96.43.146.48",443,14,3324,17101,0,0,8,2527,6,797,214.536572,0.6885099999999795,29361,9260
"172.16.133.12",59935,"172.16.139.250",5440,12,1142,17102,0,0,12,1142,0,0,214.548324,0.006089000000002898,1500410,0
"172.16.133.63",54095,"172.16.139.250",5440,10,1022,17103,0,0,10,1022,0,0,214.560187,0.014721999999977697,555359,0
"172.16.133.39",64312,"98.138.47.199",80,12,3237,17104,0,0,6,2417,6,820,214.561597,0.19861799999998198,97352,33028
"172.16.133.39",64313,"50.19.93.194",80,7,432,17105,0,0,5,306,2,126,214.566709,14.119122000000004,173,71
"172.16.133.39",64314,"50.19.93.194",80,7,432,17106,0,0,5,306,2,126,214.567294,14.126131999999984,173,71
"172.16.133.39",64315,"50.19.93.194",80,7,432,17107,0,0,5,306,2,126,214.567898,14.120723999999996,173,71
"172.16.133.66",54362,"172.16.139.250",5440,10,1022,17108,0,0,10,1022,0,0,214.570703,0.008329000000003361,981630,0
"172.16.133.82",61602,"172.16.139.250",5440,10,1022,17109,0,0,10,1022,0,0,214.584798,0.014909999999986212,548356,0
"172.16.133.37",60820,"172.16.139.250",5440,10,1022,17110,0,0,10,1022,0,0,214.597555,0.006100000000003547,1340327,0
"172.16.133.66",54363,"69.171.235.16",443,25,11585,17111,0,0,10,4556,15,7029,214.694403,24.43411500000002,1491,2301
"172.16.133.78",59409,"172.16.139.250",5440,10,1022,17112,0,0,10,1022,0,0,214.755209,0.006472000000002254,1263288,0
"172.16.133.29",61172,"72.32.20.63",80,9,1419,17113,0,0,5,975,4,444,214.755406,0.21622100000001865,36074,16427
"172.16.133.67",56167,"172.16.139.250",5440,12,1142,17114,0,0,12,1142,0,0,214.810461,0.0063969999999926586,1428169,0
"172.16.133.56",61594,"172.16.139.250",5440,12,1142,17115,0,0,12,1142,0,0,214.831661,0.00495499999999538,"",""
"172.16.133.41",53312,"172.16.139.250",5440,10,1022,17116,0,0,10,1022,0,0,214.886786,0.014690000000001646,556569,0
"172.16.133.39",64316,"93.184.216.169",80,24,9887,17117,0,0,13,6246,11,3641,214.916406,13.766644000000014,3629,2115
"172.16.133.39",64317,"54.241.145.17",80,7,432,17118,0,0,5,306,2,126,214.94565,13.806803000000002,177,73
"172.16.133.39",64318,"54.241.145.17",80,7,432,17119,0,0,5,306,2,126,214.945845,13.807442000000009,177,73
"172.16.133.43",57938,"172.16.139.250",5440,12,1142,17120,0,0,12,1142,0,0,214.95724,0.00624899999999684,1461993,0
"172.16.133.42",57282,"172.16.139.250",5440,12,1142,17121,0,0,12,1142,0,0,214.967609,0.047993999999988546,190357,0
"172.16.133.13",53199,"172.16.139.250",5440,12,1142,17122,0,0,12,1142,0,0,214.977025,0.006023999999996477,1516600,0
"172.16.133.85",52439,"172.16.139.250",5440,12,1142,17123,0,0,12,1142,0,0,214.982972,0.015991000000013855,571321,0
"172.16.133.20",62568,"172.16.139.250",5440,12,1142,17124,0,0,12,1142,0,0,215.027613,0.00496799999999098,"",""
"172.16.133.39",64319,"93.184.216.169",80,15,5454,17125,0,0,8,2766,7,2688,215.041354,13.642786000000001,1621,1576
"172.16.133.28",49315,"172.16.139.250",5440,10,1022,17126,0,0,10,1022,0,0,215.055882,0.01738399999999274,470317,0
"172.16.133.99",56223,"172.16.139.250",5440,10,1022,17127,0,0,10,1022,0,0,215.084598,0.014293000000009215,572028,0
"172.16.133.75",51136,"172.16.139.250",5440,10,1022,17128,0,0,10,1022,0,0,215.090344,0.01686700000001906,484733,0
"172.16.133.39",64320,"68.64.24.250",443,6,366,17129,0,0,4,246,2,120,215.090459,0.09745699999999147,20193,9850
"172.16.133.39",64321,"23.67.243.48",80,12,3966,17130,0,0,7,2870,5,1096,215.096053,45.08079000000001,509,194
"172.16.133.39",64322,"216.137.33.117",80,13,5703,17131,0,0,6,1848,7,3855,215.105815,45.281552999999974,326,681
"172.16.133.39",64323,"216.137.33.117",80,7,432,17132,0,0,5,306,2,126,215.1063,13.578800000000001,180,74
"172.16.133.39",64324,"50.16.204.12",80,23,12611,17133,0,0,10,2109,13,10502,215.107275,63.822884000000016,264,1316
"172.16.133.39",64325,"50.16.204.12",80,31,13328,17134,0,0,15,5337,16,7991,215.109319,63.82095000000001,668,1001
"172.16.133.87",60409,"172.16.139.250",5440,12,1142,17135,0,0,12,1142,0,0,215.111551,0.006260999999994965,1459191,0
"172.16.133.116",53873,"172.16.139.250",5440,10,1022,17136,0,0,10,1022,0,0,215.120533,0.0053460000000029595,1529367,0
"172.16.133.116",53874,"172.16.139.250",5440,10,1022,17137,0,0,10,1022,0,0,215.126926,0.005690000000015516,1436906,0
"172.16.133.116",53875,"172.16.139.250",5440,10,1022,17138,0,0,10,1022,0,0,215.13363,0.005083999999982325,1608182,0
"172.16.133.35",50130,"172.16.139.250",5440,12,1142,17139,0,0,12,1142,0,0,215.137813,0.046808999999996104,195176,0
"172.16.133.84",58964,"172.16.139.250",5440,10,1022,17140,0,0,10,1022,0,0,215.142669,0.005345999999974538,1529367,0
"172.16.133.116",53876,"68.64.24.250",443,6,366,17141,0,0,4,246,2,120,215.196048,0.10366400000000908,18984,9260
"172.16.133.39",64326,"173.194.43.60",80,12,5066,17142,0,0,6,2162,6,2904,215.203478,45.09922100000003,383,515
"172.16.133.49",55951,"172.16.139.250",5440,10,1022,17143,0,0,10,1022,0,0,215.218627,0.005533000000013999,1477679,0
"172.16.133.68",60923,"173.255.204.239",80,29,25494,17144,0,0,9,1125,20,24369,215.250237,20.51051000000001,438,9504
"172.16.133.95",57124,"172.16.139.250",5440,12,1142,17145,0,0,12,1142,0,0,215.260566,0.006204999999994243,1472360,0
"172.16.133.92",57836,"172.16.139.250",5440,10,1022,17146,0,0,10,1022,0,0,215.285934,0.005662999999998419,1443757,0
"172.16.133.39",64328,"78.108.118.250",443,6,366,17147,0,0,4,246,2,120,215.304536,0.21225499999999897,9271,4522
"172.16.133.39",64327,"216.219.118.244",443,6,366,17148,0,0,4,246,2,120,215.304537,0.2149389999999869,9156,4466
"172.16.133.29",61173,"172.16.139.250",5440,10,1022,17149,0,0,10,1022,0,0,215.304877,0.005525000000005775,1479819,0
"172.16.133.44",64999,"172.16.139.250",5440,10,1022,17150,0,0,10,1022,0,0,215.310872,0.015200000000021419,537894,0
"172.16.133.207",56107,"172.16.139.250",5440,12,1142,17151,0,0,12,1142,0,0,215.337298,0.014426999999983536,633257,0
"172.16.133.83",57245,"172.16.139.250",5440,12,1142,17152,0,0,12,1142,0,0,215.346729,0.014702999999997246,621369,0
"172.16.133.93",60920,"172.16.139.250",5440,10,1022,17153,0,0,10,1022,0,0,215.361231,0.004760000000004538,"",""
"172.16.133.11",55334,"172.16.139.250",5440,10,1022,17154,0,0,10,1022,0,0,215.377897,0.01469800000000987,556266,0
"172.16.133.55",57789,"172.16.139.250",5440,12,1142,17155,0,0,12,1142,0,0,215.385836,0.017052999999975782,535741,0
"172.16.133.39",64329,"173.194.43.60",80,36,30440,17156,0,0,14,2290,22,28150,215.39415,45.100988,406,4993
"172.16.133.116",53877,"78.108.118.250",443,6,366,17157,0,0,4,246,2,120,215.397825,0.2103829999999789,9354,4563
"172.16.133.73",60845,"172.16.139.250",5440,10,1022,17158,0,0,10,1022,0,0,215.406389,0.015126000000009299,540526,0
"172.16.133.53",54273,"172.16.139.250",5440,10,1022,17159,0,0,10,1022,0,0,215.408684,0.020410999999995738,400568,0
"172.16.133.116",53878,"216.219.118.244",443,6,366,17160,0,0,4,246,2,120,215.40983,0.21154599999999846,9302,4538
"172.16.133.21",53347,"172.16.139.250",5440,10,1022,17161,0,0,10,1022,0,0,215.411999,0.0055069999999943775,1484655,0
"172.16.133.30",62840,"172.16.139.250",5440,10,1022,17162,0,0,10,1022,0,0,215.415821,0.009295000000008713,879612,0
"172.16.133.25",63648,"172.16.139.250",5440,10,1022,17163,0,0,10,1022,0,0,215.423012,0.009985000000000355,818828,0
"172.16.133.34",50615,"172.16.139.250",5440,12,1142,17164,0,0,12,1142,0,0,215.431379,0.0054379999999980555,1680029,0
"172.16.133.97",59549,"172.16.139.250",5440,12,1142,17165,0,0,12,1142,0,0,215.441871,0.015509000000008655,589077,0
"172.16.133.33",58058,"172.16.139.250",5440,10,1022,17166,0,0,10,1022,0,0,215.514644,0.0056869999999946685,1437664,0
"172.16.133.68",60924,"172.16.139.250",5440,12,1142,17167,0,0,12,1142,0,0,215.547572,0.006412000000011631,1424828,0
"172.16.133.12",59936,"172.16.139.250",5440,12,1142,17168,0,0,12,1142,0,0,215.562477,0.005582000000003973,1636689,0
"172.16.133.63",54096,"172.16.139.250",5440,10,1022,17169,0,0,10,1022,0,0,215.573726,0.005387000000013131,1517727,0
"172.16.133.66",54364,"172.16.139.250",5440,10,1022,17170,0,0,10,1022,0,0,215.592755,0.009817999999995664,832756,0
"172.16.133.82",61603,"172.16.139.250",5440,12,1142,17171,0,0,12,1142,0,0,215.599039,0.01652799999999388,552758,0
"172.16.133.37",60821,"172.16.139.250",5440,10,1022,17172,0,0,10,1022,0,0,215.612018,0.01580099999998197,517435,0
"172.16.133.78",59410,"172.16.139.250",5440,10,1022,17173,0,0,10,1022,0,0,215.769217,0.005763000000001739,1418705,0
"172.16.133.67",56168,"172.16.139.250",5440,12,1142,17174,0,0,12,1142,0,0,215.823373,0.0061749999999847205,1479514,0
"172.16.133.116",53879,"216.115.219.126",443,6,366,17175,0,0,4,246,2,120,215.845863,0.48013999999997736,4098,1999
"172.16.133.56",61595,"172.16.139.250",5440,10,1022,17176,0,0,10,1022,0,0,215.84628,0.0051200000000051205,1596874,0
"172.16.133.39",64330,"216.115.219.126",443,6,366,17177,0,0,4,246,2,120,215.882982,0.5065209999999922,3885,1895
"172.16.133.41",53313,"172.16.139.250",5440,10,1022,17178,0,0,10,1022,0,0,215.901851,0.01534499999999639,532811,0
"172.16.133.43",57939,"172.16.139.250",5440,10,1022,17179,0,0,10,1022,0,0,215.971753,0.005463999999989255,1496339,0
"172.16.133.40",50288,"173.194.43.47",80,9,1396,17180,0,0,5,788,4,608,215.976914,45.112983000000014,139,107
"172.16.133.40",50289,"173.194.43.47",80,9,1396,17181,0,0,5,788,4,608,215.977465,45.112431000000015,139,107
"172.16.133.42",57283,"172.16.139.250",5440,12,1142,17182,0,0,12,1142,0,0,215.983737,0.097627000000017,93580,0
"172.16.133.13",53200,"172.16.139.250",5440,12,1142,17183,0,0,12,1142,0,0,215.991061,0.005377000000009957,1699088,0
"172.16.133.85",52440,"172.16.139.250",5440,10,1022,17184,0,0,10,1022,0,0,215.996517,0.005426999999997406,1506541,0
"172.16.133.20",62569,"172.16.139.250",5440,10,1022,17185,0,0,10,1022,0,0,216.040556,0.01163599999998155,702646,0
"172.16.133.28",49316,"172.16.139.250",5440,12,1142,17186,0,0,12,1142,0,0,216.069815,0.005980999999991354,1527503,0
"172.16.133.23",55050,"64.90.204.229",443,17,2870,17187,0,0,8,1795,9,1075,216.088563,9.477096000000017,1515,907
"172.16.133.99",56224,"172.16.139.250",5440,10,1022,17188,0,0,10,1022,0,0,216.0994,0.014655000000004748,557898,0
"172.16.133.75",51137,"172.16.139.250",5440,12,1142,17189,0,0,12,1142,0,0,216.104204,0.015490999999997257,589761,0
"172.16.133.87",60410,"172.16.139.250",5440,10,1022,17190,0,0,10,1022,0,0,216.122277,0.005517999999995027,1481696,0
"172.16.133.35",50131,"172.16.139.250",5440,12,1142,17191,0,0,12,1142,0,0,216.12907,0.08039499999998156,113638,0
"172.16.133.116",53880,"172.16.139.250",5440,12,1142,17192,0,0,12,1142,0,0,216.134503,0.005922999999995682,1542461,0
"172.16.133.116",53881,"172.16.139.250",5440,10,1022,17193,0,0,10,1022,0,0,216.141468,0.014620000000007849,559233,0
"172.16.133.116",53882,"172.16.139.250",5440,12,1142,17194,0,0,12,1142,0,0,216.157017,0.006191000000001168,1475690,0
"172.16.133.84",58966,"172.16.139.250",5440,12,1142,17195,0,0,12,1142,0,0,216.157859,0.0161549999999977,565521,0
"172.16.133.87",60411,"216.115.216.250",443,6,366,17196,0,0,4,246,2,120,216.197813,0.07950199999999086,24754,12075
"172.16.133.87",60412,"68.64.4.249",443,6,366,17197,0,0,4,246,2,120,216.218824,0.10398200000000202,18926,9232
"172.16.133.87",60413,"68.64.26.250",443,6,366,17198,0,0,4,246,2,120,216.22165,0.08784799999997972,22402,10927
"172.16.133.49",55952,"172.16.139.250",5440,12,1142,17199,0,0,12,1142,0,0,216.232933,0.006087000000007947,1500903,0
"172.16.133.95",57125,"172.16.139.250",5440,12,1142,17200,0,0,12,1142,0,0,216.274741,0.016089999999991278,567806,0
"172.16.133.92",57837,"172.16.139.250",5440,10,1022,17201,0,0,10,1022,0,0,216.300373,0.00547799999998233,1492515,0
"172.16.133.87",60414,"216.219.116.244",443,6,366,17202,0,0,4,246,2,120,216.300725,0.2698699999999974,7292,3557
"172.16.133.29",61174,"172.16.139.250",5440,12,1142,17203,0,0,12,1142,0,0,216.318488,0.00584100000000376,1564115,0
"172.16.133.44",65000,"172.16.139.250",5440,10,1022,17204,0,0,10,1022,0,0,216.324615,0.005362000000019407,1524804,0
"172.16.133.66",54365,"63.241.108.124",443,21,12480,17205,0,0,11,6167,10,6313,216.349349,0.21749500000001376,226837,232207
"172.16.133.207",56108,"172.16.139.250",5440,10,1022,17206,0,0,10,1022,0,0,216.350183,0.010968000000019629,745441,0
"172.16.133.26",53103,"96.43.146.22",443,15,4042,17207,0,0,9,3265,6,777,216.35781,45.18796599999999,578,137
"172.16.133.83",57246,"172.16.139.250",5440,12,1142,17208,0,0,12,1142,0,0,216.359662,0.005418000000020129,1686231,0
"172.16.133.93",60921,"172.16.139.250",5440,10,1022,17209,0,0,10,1022,0,0,216.375297,0.014413000000018883,567265,0
"172.16.133.11",55335,"172.16.139.250",5440,10,1022,17210,0,0,10,1022,0,0,216.39213,0.005447000000003754,1501009,0
"172.16.133.55",57790,"172.16.139.250",5440,12,1142,17211,0,0,12,1142,0,0,216.397501,0.006238999999993666,1464337,0
"172.16.133.34",50616,"173.194.43.46",80,9,2238,17212,0,0,5,1452,4,786,216.402472,45.16810800000002,257,139
"172.16.133.73",60846,"172.16.139.250",5440,10,1022,17213,0,0,10,1022,0,0,216.42010199999999,0.005560000000002674,1470503,0
"172.16.133.53",54274,"172.16.139.250",5440,12,1142,17214,0,0,12,1142,0,0,216.422305,0.016492999999996982,553931,0
"172.16.133.21",53348,"172.16.139.250",5440,10,1022,17215,0,0,10,1022,0,0,216.425778,0.01728399999998942,473038,0
"172.16.133.30",62841,"172.16.139.250",5440,10,1022,17216,0,0,10,1022,0,0,216.429451,0.005513000000007651,1483040,0
"172.16.133.25",63649,"172.16.139.250",5440,12,1142,17217,0,0,12,1142,0,0,216.436591,0.010741999999993368,850493,0
"172.16.133.34",50617,"172.16.139.250",5440,10,1022,17218,0,0,10,1022,0,0,216.444842,0.006112000000001672,1337696,0
"172.16.133.34",50618,"74.125.228.113",80,9,2176,17219,0,0,5,1456,4,720,216.448155,45.167659999999984,257,127
"172.16.133.34",50619,"74.125.228.113",80,6,372,17220,0,0,4,246,2,126,216.448273,14.272061000000008,137,70
"172.16.133.97",59550,"172.16.139.250",5440,10,1022,17221,0,0,10,1022,0,0,216.456059,0.0053460000000029595,1529367,0
"172.16.133.33",58059,"172.16.139.250",5440,12,1142,17222,0,0,12,1142,0,0,216.528397,0.006291999999973541,1452002,0
"172.16.133.68",60925,"172.16.139.250",5440,12,1142,17223,0,0,12,1142,0,0,216.561906,0.01529100000001904,597475,0
"172.16.133.12",59937,"172.16.139.250",5440,10,1022,17224,0,0,10,1022,0,0,216.57634,0.0053380000000231576,1531659,0
"172.16.133.63",54097,"172.16.139.250",5440,10,1022,17225,0,0,10,1022,0,0,216.587331,0.015646000000003824,522561,0
"172.16.133.34",50620,"173.194.43.46",443,11,1496,17226,0,0,6,979,5,517,216.598569,45.22073799999998,173,91
"172.16.133.66",54366,"172.16.139.250",5440,10,1022,17227,0,0,10,1022,0,0,216.598624,0.008052999999989652,1015273,0
"172.16.133.34",50621,"173.194.43.39",443,14,4027,17228,0,0,8,958,6,3069,216.599175,9.65016399999999,794,2544
"172.16.133.34",50622,"173.194.43.33",443,11,1503,17229,0,0,6,986,5,517,216.600089,45.248782999999975,174,91
"172.16.133.34",50623,"74.125.228.119",443,16,5395,17230,0,0,9,1022,7,4373,216.600581,9.649699999999996,847,3625
"172.16.133.34",50624,"173.194.43.35",443,14,4029,17231,0,0,8,958,6,3071,216.60078,0.541893000000016,14143,45337
"172.16.133.34",50625,"74.125.226.207",443,16,5169,17232,0,0,9,1024,7,4145,216.601042,9.64991599999999,848,3436
"172.16.133.82",61604,"172.16.139.250",5440,10,1022,17233,0,0,10,1022,0,0,216.613664,0.005095000000011396,1604710,0
"172.16.133.37",60822,"172.16.139.250",5440,10,1022,17234,0,0,10,1022,0,0,216.626324,0.015291999999988093,534658,0
"172.16.133.34",50626,"74.125.226.201",443,14,4054,17235,0,0,8,969,6,3085,216.660437,9.589634999999987,808,2573
"172.16.133.34",50627,"173.194.43.37",443,14,4055,17236,0,0,8,969,6,3086,216.662144,9.587510999999978,808,2575
"172.16.133.34",50628,"173.194.43.32",443,14,4055,17237,0,0,8,969,6,3086,216.676623,9.573243999999988,809,2578
"172.16.128.233",50932,"172.16.133.233",22,206,22696,17238,0,0,58,4738,148,17958,216.749023,8.011825000000016,4731,17931
"172.16.133.78",59411,"172.16.139.250",5440,10,1022,17239,0,0,10,1022,0,0,216.78441,0.0055799999999806005,1465232,0
"172.16.133.153",47655,"64.17.236.31",80,122,102288,17240,0,0,54,3822,68,98466,216.784758,0.49159499999998957,62197,1602392
"172.16.133.67",56169,"172.16.139.250",5440,10,1022,17241,0,0,10,1022,0,0,216.83803,0.005697999999995318,1434889,0
"172.16.133.56",61596,"172.16.139.250",5440,10,1022,17242,0,0,10,1022,0,0,216.860492,0.004790000000014061,"",""
"172.16.133.41",53314,"172.16.139.250",5440,12,1142,17243,0,0,12,1142,0,0,216.916187,0.016394999999988613,557243,0
"172.16.133.60",62170,"208.98.232.43",80,29,23803,17244,0,0,11,1140,18,22663,216.928228,0.275084000000021,33153,659085
"172.16.133.43",57940,"172.16.139.250",5440,12,1142,17245,0,0,12,1142,0,0,216.984807,0.006212000000004991,1470701,0
"172.16.133.132",60866,"173.194.43.58",80,6,412,17246,0,0,4,272,2,140,216.987746,0.0489080000000115,44491,22900
"172.16.133.42",57284,"172.16.139.250",5440,12,1142,17247,0,0,12,1142,0,0,216.998281,0.017414999999999736,524605,0
"172.16.133.13",53202,"172.16.139.250",5440,10,1022,17248,0,0,10,1022,0,0,217.005245,0.006150999999988471,1329214,0
"172.16.133.85",52441,"172.16.139.250",5440,12,1142,17249,0,0,12,1142,0,0,217.01194,0.015237999999982321,599553,0
"172.16.133.132",41208,"199.27.208.20",80,6,374,17250,0,0,4,254,2,120,217.039255,0.07996199999999476,25412,12005
"172.16.133.20",62570,"172.16.139.250",5440,10,1022,17251,0,0,10,1022,0,0,217.054291,0.01504499999998643,543436,0
"172.16.133.113",55698,"172.16.139.250",135,8,492,17252,0,0,8,492,0,0,217.055666,0.030832000000003745,127659,0
"172.16.133.28",49317,"172.16.139.250",5440,10,1022,17253,0,0,10,1022,0,0,217.083641,0.015390999999993937,531219,0
"172.16.133.113",55699,"172.16.139.250",5462,12,816,17254,0,0,12,816,0,0,217.092851,0.5207860000000153,12534,0
"172.16.133.99",56225,"172.16.139.250",5440,10,1022,17255,0,0,10,1022,0,0,217.112326,0.01620700000000852,504473,0
"172.16.133.75",51138,"172.16.139.250",5440,12,1142,17256,0,0,12,1142,0,0,217.118461,0.015362000000010312,594714,0
"172.16.133.132",33944,"193.149.47.76",443,6,374,17257,0,0,4,254,2,120,217.120265,0.23907100000002401,8499,4015
"172.16.133.60",62171,"66.199.173.81",80,11,2178,17258,0,0,6,879,5,1299,217.134596,11.096948000000026,633,936
"172.16.133.87",60415,"172.16.139.250",5440,10,1022,17259,0,0,10,1022,0,0,217.136393,0.005700999999987744,1434134,0
"172.16.133.34",50629,"173.194.43.35",443,44,16772,17260,0,0,19,3981,25,12791,217.143036,45.37665199999998,701,2255
"172.16.133.35",50132,"172.16.139.250",5440,12,1142,17261,0,0,12,1142,0,0,217.1445,0.011749000000008891,777598,0
"172.16.133.116",53883,"172.16.139.250",5440,12,1142,17262,0,0,12,1142,0,0,217.148445,0.00665300000000002,1373215,0
"172.16.133.116",53884,"172.16.139.250",5440,12,1142,17263,0,0,12,1142,0,0,217.156295,0.015341000000006488,595528,0
"172.16.133.84",58967,"172.16.139.250",5440,10,1022,17264,0,0,10,1022,0,0,217.17077,0.006483000000002903,1261144,0
"172.16.133.116",53885,"172.16.139.250",5440,10,1022,17265,0,0,10,1022,0,0,217.172538,0.008487000000002354,963355,0
"172.16.133.153",44088,"209.112.253.15",80,183,151814,17266,0,0,77,5191,106,146623,217.228678,1.0331970000000013,40193,1135295
"172.16.133.49",55953,"172.16.139.250",5440,12,1142,17267,0,0,12,1142,0,0,217.246917,0.006331000000017184,1443057,0
"172.16.133.116",53886,"68.64.24.250",443,7,426,17268,0,0,4,246,3,180,217.256091,0.10453599999999597,18826,13775
"172.16.133.95",57126,"172.16.139.250",5440,10,1022,17269,0,0,10,1022,0,0,217.288975,0.005397000000016305,1514915,0
"172.16.133.92",57838,"172.16.139.250",5440,12,1142,17270,0,0,12,1142,0,0,217.31416,0.015455000000002883,591135,0
"172.16.133.29",61175,"172.16.139.250",5440,10,1022,17271,0,0,10,1022,0,0,217.332304,0.005375000000015007,1521116,0
"172.16.133.44",65001,"172.16.139.250",5440,10,1022,17272,0,0,10,1022,0,0,217.339714,0.005449000000027127,1500458,0
"172.16.133.60",62172,"208.98.232.43",80,10,1364,17273,0,0,5,705,5,659,217.357404,0.24459799999999632,23058,21553
"172.16.133.132",41356,"199.27.208.19",443,6,374,17274,0,0,4,254,2,120,217.363238,0.0805599999999913,25223,11916
"172.16.133.207",56109,"172.16.139.250",5440,10,1022,17275,0,0,10,1022,0,0,217.364213,0.014584999999982529,560575,0
"172.16.133.83",57247,"172.16.139.250",5440,12,1142,17276,0,0,12,1142,0,0,217.373588,0.013872999999989588,658545,0
"172.16.133.60",62173,"208.98.232.43",80,11,3701,17277,0,0,5,713,6,2988,217.373978,0.2412920000000156,23639,99066
"172.16.133.60",62174,"208.98.232.43",80,42,37088,17278,0,0,15,1306,27,35782,217.374566,0.255248000000023,40932,1121481
"172.16.133.60",62175,"208.98.232.43",80,28,21795,17279,0,0,11,1069,17,20726,217.374795,0.2644029999999873,32344,627103
"172.16.133.60",62176,"208.98.232.43",80,34,29217,17280,0,0,12,1127,22,28090,217.375178,0.26330999999998994,34241,853442
"172.16.133.93",60922,"172.16.139.250",5440,12,1142,17281,0,0,12,1142,0,0,217.389097,0.004787000000021635,"",""
"172.16.133.11",55336,"172.16.139.250",5440,10,1022,17282,0,0,10,1022,0,0,217.406311,0.015628000000020847,523163,0
"172.16.133.82",61605,"157.56.232.214",443,24,12149,17283,0,0,10,2585,14,9564,217.411692,2.7469680000000096,7528,27853
"172.16.133.55",57791,"172.16.139.250",5440,10,1022,17284,0,0,10,1022,0,0,217.411842,0.0057789999999897645,1414777,0
"172.16.133.60",62177,"208.98.232.43",80,18,12621,17285,0,0,7,829,11,11792,217.421732,0.2375380000000007,27919,397140
"172.16.133.73",60847,"172.16.139.250",5440,10,1022,17286,0,0,10,1022,0,0,217.434442,0.005733000000020638,1426129,0
"172.16.133.53",54275,"172.16.139.250",5440,10,1022,17287,0,0,10,1022,0,0,217.43628,0.007562999999976228,1081052,0
"172.16.133.21",53349,"172.16.139.250",5440,10,1022,17288,0,0,10,1022,0,0,217.439955,0.015653000000014572,522327,0
"172.16.133.30",62843,"172.16.139.250",5440,10,1022,17289,0,0,10,1022,0,0,217.443514,0.019359000000008564,422335,0
"172.16.133.132",42832,"108.168.136.156",443,6,412,17290,0,0,4,272,2,140,217.448583,0.14651399999999626,14851,7644
"172.16.133.25",63650,"172.16.139.250",5440,10,1022,17291,0,0,10,1022,0,0,217.450455,0.008433999999994057,969409,0
"172.16.133.34",50630,"172.16.139.250",5440,10,1022,17292,0,0,10,1022,0,0,217.460498,0.0063049999999975626,1296748,0
"172.16.133.97",59551,"172.16.139.250",5440,10,1022,17293,0,0,10,1022,0,0,217.47133,0.005279000000001588,1548778,0
"172.16.133.85",52443,"184.73.225.104",443,22,7276,17294,0,0,11,1982,11,5294,217.497791,5.316989000000007,2982,7965
"172.16.133.116",53887,"78.108.118.250",443,6,366,17295,0,0,4,246,2,120,217.51591,0.21454200000002288,9173,4474
"172.16.133.60",62178,"208.98.232.43",80,18,11763,17296,0,0,7,828,11,10935,217.518381,0.2882919999999842,22976,303442
"172.16.133.116",53888,"216.219.118.244",443,6,366,17297,0,0,4,246,2,120,217.527941,0.191504000000009,10276,5012
"172.16.133.60",62179,"208.98.232.43",80,19,12043,17298,0,0,8,882,11,11161,217.54013,0.272231000000005,25919,327986
"172.16.133.33",58060,"172.16.139.250",5440,10,1022,17299,0,0,10,1022,0,0,217.541578,0.006432000000017979,1271144,0
"172.16.133.60",62180,"208.98.232.43",80,24,18368,17300,0,0,9,952,15,17416,217.553204,0.2598650000000191,29307,536155
"172.16.133.68",60926,"172.16.139.250",5440,10,1022,17301,0,0,10,1022,0,0,217.575814,0.01461100000000215,559578,0
"172.16.133.12",59938,"172.16.139.250",5440,12,1142,17302,0,0,12,1142,0,0,217.59029,0.007114000000001397,1284228,0
"172.16.133.63",54098,"172.16.139.250",5440,10,1022,17303,0,0,10,1022,0,0,217.601294,0.005394999999992933,1515477,0
"172.16.133.66",54367,"172.16.139.250",5440,12,1142,17304,0,0,12,1142,0,0,217.613777,0.006431999999989557,1420398,0
"172.16.133.82",61606,"172.16.139.250",5440,10,1022,17305,0,0,10,1022,0,0,217.627189,0.0055770000000165965,1466021,0
"172.16.133.37",60823,"172.16.139.250",5440,10,1022,17306,0,0,10,1022,0,0,217.640156,0.005804000000011911,1408683,0
"172.16.133.78",59412,"172.16.139.250",5440,10,1022,17307,0,0,10,1022,0,0,217.798179,0.005569000000008373,1468127,0
"172.16.133.85",52444,"157.56.240.137",443,6,374,17308,0,0,3,194,3,180,217.818099,1.122318000000007,1382,1283
"172.16.133.67",56170,"172.16.139.250",5440,10,1022,17309,0,0,10,1022,0,0,217.851457,0.005924999999990632,1379915,0
"172.16.133.60",62181,"208.98.232.43",80,10,1491,17310,0,0,5,633,5,858,217.857652,0.2555839999999989,19813,26856
"172.16.133.56",61597,"172.16.139.250",5440,12,1142,17311,0,0,12,1142,0,0,217.874368,0.005021999999996751,1819195,0
"172.16.133.41",53315,"172.16.139.250",5440,12,1142,17312,0,0,12,1142,0,0,217.929944,0.006039999999984502,1512582,0
"172.16.133.26",53104,"107.20.103.220",443,183,102500,17313,0,0,116,75700,67,26800,217.93714,81.25493899999998,7453,2638
"172.16.133.43",57941,"172.16.139.250",5440,10,1022,17314,0,0,10,1022,0,0,217.999172,0.005488000000013926,1489795,0
"172.16.133.42",57285,"172.16.139.250",5440,12,1142,17315,0,0,12,1142,0,0,218.012811,0.008803000000000338,1037828,0
"172.16.133.13",53203,"172.16.139.250",5440,10,1022,17316,0,0,10,1022,0,0,218.019114,0.015520000000009304,526804,0
"172.16.133.85",52445,"172.16.139.250",5440,12,1142,17317,0,0,12,1142,0,0,218.025247,0.0065119999999865286,1402948,0
"172.16.133.20",62571,"172.16.139.250",5440,10,1022,17318,0,0,10,1022,0,0,218.068268,0.0048580000000129075,"",""
"172.16.133.116",53889,"216.115.219.126",443,6,366,17319,0,0,4,246,2,120,218.084894,0.4974740000000111,3955,1929
"172.16.133.28",49318,"172.16.139.250",5440,10,1022,17320,0,0,10,1022,0,0,218.097906,0.0053460000000029595,1529367,0
"172.16.133.99",56226,"172.16.139.250",5440,10,1022,17321,0,0,10,1022,0,0,218.127534,0.014781999999996742,553105,0
"172.16.133.75",51139,"172.16.139.250",5440,10,1022,17322,0,0,10,1022,0,0,218.132176,0.005380000000002383,1519702,0
"172.16.133.87",60416,"172.16.139.250",5440,12,1142,17323,0,0,12,1142,0,0,218.150546,0.016149000000012848,565731,0
"172.16.133.35",50133,"172.16.139.250",5440,12,1142,17324,0,0,12,1142,0,0,218.155576,0.048064000000010765,190079,0
"172.16.133.116",53890,"172.16.139.250",5440,10,1022,17325,0,0,10,1022,0,0,218.162894,0.006659000000013293,1227811,0
"172.16.133.153",40841,"23.33.83.78",80,63,44917,17326,0,0,31,2152,32,42765,218.162957,0.13831799999999816,124466,2473430
"172.16.133.116",53891,"172.16.139.250",5440,10,1022,17327,0,0,10,1022,0,0,218.170585,0.0051660000000026685,1582655,0
"172.16.133.116",53892,"172.16.139.250",5440,10,1022,17328,0,0,10,1022,0,0,218.176533,0.014516999999983682,563201,0
"172.16.133.84",58968,"172.16.139.250",5440,10,1022,17329,0,0,10,1022,0,0,218.184865,0.015355999999997039,532430,0
"172.16.133.87",60417,"216.115.216.250",443,6,366,17330,0,0,4,246,2,120,218.239877,0.06319899999999734,31139,15190
"172.16.133.49",55954,"172.16.139.250",5440,10,1022,17331,0,0,10,1022,0,0,218.260582,0.006340999999991936,1289386,0
"172.16.133.87",60418,"68.64.26.250",443,6,366,17332,0,0,4,246,2,120,218.261993,0.10190500000001634,19312,9420
"172.16.133.153",35668,"23.33.83.78",80,118,102752,17333,0,0,49,3375,69,99377,218.268259,0.15329700000000912,176128,5186115
"172.16.133.87",60419,"68.64.4.249",443,6,366,17334,0,0,4,246,2,120,218.276724,0.10196700000000192,19300,9414
"172.16.133.95",57127,"172.16.139.250",5440,10,1022,17335,0,0,10,1022,0,0,218.302732,0.005472999999994954,1493879,0
"172.16.133.92",57839,"172.16.139.250",5440,10,1022,17336,0,0,10,1022,0,0,218.328038,0.005630999999993946,1451962,0
"172.16.133.29",61176,"172.16.139.250",5440,10,1022,17337,0,0,10,1022,0,0,218.346684,0.01737899999997694,470452,0
"172.16.133.44",65002,"172.16.139.250",5440,10,1022,17338,0,0,10,1022,0,0,218.35447,0.005592000000007147,1462088,0
"172.16.133.207",56110,"172.16.139.250",5440,12,1142,17339,0,0,12,1142,0,0,218.378488,0.018180000000000973,502530,0
"172.16.133.83",57248,"172.16.139.250",5440,12,1142,17340,0,0,12,1142,0,0,218.387683,0.0050959999999804495,1792778,0
"172.16.133.153",48866,"184.84.3.78",80,235,216199,17341,0,0,92,6188,143,210011,218.400875,0.36383099999997626,136063,4617770
"172.16.133.93",60923,"172.16.139.250",5440,10,1022,17342,0,0,10,1022,0,0,218.403333,0.014239000000003443,574197,0
"172.16.133.11",55337,"172.16.139.250",5440,12,1142,17343,0,0,12,1142,0,0,218.421168,0.005922999999995682,1542461,0
"172.16.133.55",57792,"172.16.139.250",5440,10,1022,17344,0,0,10,1022,0,0,218.426768,0.006573000000003049,1243876,0
"172.16.133.87",60420,"216.219.116.244",443,6,366,17345,0,0,4,246,2,120,218.43181,0.258578,7610,3712
"172.16.133.73",60848,"172.16.139.250",5440,10,1022,17346,0,0,10,1022,0,0,218.447991,0.005631999999991422,1451704,0
"172.16.133.53",54276,"172.16.139.250",5440,10,1022,17347,0,0,10,1022,0,0,218.45059,0.006902999999994108,1184412,0
"172.16.133.21",53350,"172.16.139.250",5440,10,1022,17348,0,0,10,1022,0,0,218.453902,0.01553400000000238,526329,0
"172.16.133.30",62844,"172.16.139.250",5440,10,1022,17349,0,0,10,1022,0,0,218.457747,0.005494999999996253,1487898,0
"172.16.133.25",63651,"172.16.139.250",5440,12,1142,17350,0,0,12,1142,0,0,218.464428,0.014688000000006696,622004,0
"172.16.133.34",50631,"172.16.139.250",5440,10,1022,17351,0,0,10,1022,0,0,218.473015,0.0146519999999839,558012,0
"172.16.133.97",59552,"172.16.139.250",5440,10,1022,17352,0,0,10,1022,0,0,218.483901,0.014771999999993568,553479,0
"172.16.133.33",58061,"172.16.139.250",5440,12,1142,17353,0,0,12,1142,0,0,218.555653,0.006316999999995687,1446256,0
"172.16.133.68",60929,"172.16.139.250",5440,10,1022,17354,0,0,10,1022,0,0,218.590051,0.0055260000000032505,1479551,0
"172.16.133.12",59939,"172.16.139.250",5440,12,1142,17355,0,0,12,1142,0,0,218.604268,0.00610400000002187,1496723,0
"172.16.133.63",54099,"172.16.139.250",5440,10,1022,17356,0,0,10,1022,0,0,218.615403,0.005335999999999785,1532233,0
"172.16.133.66",54368,"172.16.139.250",5440,12,1142,17357,0,0,12,1142,0,0,218.626798,0.006073999999983926,1504115,0
"172.16.133.82",61607,"172.16.139.250",5440,10,1022,17358,0,0,10,1022,0,0,218.640967,0.005660000000005994,1444522,0
"172.16.133.37",60824,"172.16.139.250",5440,10,1022,17359,0,0,10,1022,0,0,218.656611,0.005425999999999931,1506819,0
"172.16.133.12",59940,"216.219.116.244",443,6,366,17360,0,0,4,246,2,120,218.741002,0.31046999999998093,6338,3092
"172.16.133.12",59941,"68.64.26.250",443,6,366,17361,0,0,4,246,2,120,218.741636,0.11335500000001275,17361,8468
"172.16.133.12",59942,"68.64.4.249",443,6,366,17362,0,0,4,246,2,120,218.741993,0.20076199999999744,9802,4781
"172.16.133.153",51625,"205.153.84.114",80,8,771,17363,0,0,4,403,4,368,218.744471,0.1811869999999942,17793,16248
"172.16.133.12",59943,"216.115.216.250",443,6,366,17364,0,0,4,246,2,120,218.744646,0.10877000000002113,18093,8825
"172.16.133.88",51243,"23.67.243.81",80,8,1202,17365,0,0,4,516,4,686,218.756947,0.2837210000000141,14549,19342
"172.16.133.78",59413,"172.16.139.250",5440,10,1022,17366,0,0,10,1022,0,0,218.810887,0.005535999999978003,1476878,0
"172.16.133.67",56171,"172.16.139.250",5440,10,1022,17367,0,0,10,1022,0,0,218.865705,0.014702999999997246,556076,0
"172.16.133.56",61598,"172.16.139.250",5440,12,1142,17368,0,0,12,1142,0,0,218.887944,0.005044999999995525,1810901,0
"172.16.133.85",52446,"157.56.244.217",443,6,374,17369,0,0,3,194,3,180,218.940977,1.1822549999999978,1312,1218
"172.16.133.41",53316,"172.16.139.250",5440,12,1142,17370,0,0,12,1142,0,0,218.944285,0.015882000000004837,575242,0
"172.16.133.43",57942,"172.16.139.250",5440,12,1142,17371,0,0,12,1142,0,0,219.013842,0.0062130000000024665,1470465,0
"172.16.133.42",57286,"172.16.139.250",5440,12,1142,17372,0,0,12,1142,0,0,219.030073,0.02023700000000872,451450,0
"172.16.133.13",53205,"172.16.139.250",5440,10,1022,17373,0,0,10,1022,0,0,219.03303,0.018740000000008195,436286,0
"172.16.133.85",52447,"172.16.139.250",5440,12,1142,17374,0,0,12,1142,0,0,219.038579,0.006301000000007662,1449928,0
"172.16.133.20",62572,"172.16.139.250",5440,10,1022,17375,0,0,10,1022,0,0,219.082601,0.004844999999988886,"",""
"172.16.133.28",49319,"172.16.139.250",5440,10,1022,17376,0,0,10,1022,0,0,219.111711,0.005294999999989614,1544098,0
"172.16.133.99",56227,"172.16.139.250",5440,10,1022,17377,0,0,10,1022,0,0,219.141759,0.0050959999999804495,1604395,0
"172.16.133.75",51140,"172.16.139.250",5440,10,1022,17378,0,0,10,1022,0,0,219.145246,0.0058450000000220825,1398802,0
"172.16.133.87",60421,"172.16.139.250",5440,10,1022,17379,0,0,10,1022,0,0,219.16466,0.005304999999992788,1541187,0
"172.16.133.35",50134,"172.16.139.250",5440,12,1142,17380,0,0,12,1142,0,0,219.170278,0.014729000000016867,620272,0
"172.16.133.116",53893,"172.16.139.250",5440,10,1022,17381,0,0,10,1022,0,0,219.17654,0.007399000000020806,1105014,0
"172.16.133.116",53894,"172.16.139.250",5440,10,1022,17382,0,0,10,1022,0,0,219.184709,0.005302000000000362,1542059,0
"172.16.133.116",53895,"172.16.139.250",5440,10,1022,17383,0,0,10,1022,0,0,219.190939,0.005664000000024316,1443502,0
"172.16.133.39",64331,"206.190.57.60",80,17,7847,17384,0,0,8,2729,9,5118,219.193455,45.29016299999998,482,904
"172.16.133.84",58969,"172.16.139.250",5440,10,1022,17385,0,0,10,1022,0,0,219.199046,0.005381999999997333,1519137,0
"172.16.133.49",55955,"172.16.139.250",5440,10,1022,17386,0,0,10,1022,0,0,219.274853,0.005538000000001375,1476345,0
"172.16.133.95",57128,"172.16.139.250",5440,10,1022,17387,0,0,10,1022,0,0,219.317748,0.04369800000000623,187102,0
"172.16.133.113",55700,"74.125.228.113",80,10,1945,17388,0,0,6,1231,4,714,219.320639,0.6909220000000005,14253,8267
"172.16.133.113",55701,"74.125.228.113",80,6,372,17389,0,0,4,246,2,126,219.322191,0.14752699999999663,13339,6832
"172.16.133.92",57840,"172.16.139.250",5440,10,1022,17390,0,0,10,1022,0,0,219.342682,0.08868799999999055,92188,0
"172.16.133.29",61177,"172.16.139.250",5440,10,1022,17391,0,0,10,1022,0,0,219.360429,0.06253099999997858,130751,0
"172.16.133.44",65003,"172.16.139.250",5440,10,1022,17392,0,0,10,1022,0,0,219.366743,0.059705999999977166,136937,0
"172.16.133.24",57495,"91.190.216.62",12350,2,120,17393,0,0,1,60,1,60,219.375244,0.00011299999999891952,"",""
"172.16.133.207",56111,"172.16.139.250",5440,10,1022,17394,0,0,10,1022,0,0,219.39403,0.03588400000001002,227845,0
"172.16.133.83",57249,"172.16.139.250",5440,12,1142,17395,0,0,12,1142,0,0,219.40171,0.03449999999997999,264811,0
"172.16.133.93",60924,"172.16.139.250",5440,12,1142,17396,0,0,12,1142,0,0,219.417251,0.022937000000013086,398308,0
"172.16.133.11",55338,"172.16.139.250",5440,10,1022,17397,0,0,10,1022,0,0,219.435807,0.008325999999982514,981984,0
"172.16.133.39",64332,"98.139.240.22",80,12,3332,17398,0,0,6,2594,6,738,219.43799,0.10503199999999424,197577,56211
"172.16.133.113",55702,"74.125.228.113",443,167,133565,17399,0,0,66,21167,101,112398,219.438218,33.768992999999995,5014,26627
"172.16.133.39",64333,"98.138.47.199",80,12,3155,17400,0,0,6,2335,6,820,219.438219,0.18706000000000245,99861,35068
"172.16.133.55",57793,"172.16.139.250",5440,10,1022,17401,0,0,10,1022,0,0,219.439651,0.00846599999999853,965745,0
"172.16.133.73",60849,"172.16.139.250",5440,10,1022,17402,0,0,10,1022,0,0,219.460981,0.016152000000005273,506191,0
"172.16.133.53",54277,"172.16.139.250",5440,12,1142,17403,0,0,12,1142,0,0,219.46438,0.01726199999998812,529255,0
"172.16.133.21",53351,"172.16.139.250",5440,10,1022,17404,0,0,10,1022,0,0,219.467646,0.005681000000009817,1439183,0
"172.16.133.30",62845,"172.16.139.250",5440,10,1022,17405,0,0,10,1022,0,0,219.471348,0.018725999999986698,436612,0
"172.16.133.25",63652,"172.16.139.250",5440,12,1142,17406,0,0,12,1142,0,0,219.478596,0.006338999999996986,1441236,0
"172.16.133.34",50632,"172.16.139.250",5440,12,1142,17407,0,0,12,1142,0,0,219.487093,0.005877000000026555,1554534,0
"172.16.133.97",59553,"172.16.139.250",5440,10,1022,17408,0,0,10,1022,0,0,219.49844,0.01518000000001507,538603,0
"172.16.133.39",64334,"74.201.120.8",80,16,9521,17409,0,0,7,1708,9,7813,219.525657,0.3764099999999928,36300,166052
"172.16.133.39",64335,"74.201.120.8",80,13,8081,17410,0,0,6,1843,7,6238,219.525905,0.5508890000000122,26764,90588
"172.16.133.39",64336,"74.201.120.8",80,10,2144,17411,0,0,5,1647,5,497,219.526087,0.4750180000000057,27737,8370
"172.16.133.33",58062,"172.16.139.250",5440,12,1142,17412,0,0,12,1142,0,0,219.570433,0.00625999999999749,1459424,0
"172.16.133.68",60930,"172.16.139.250",5440,12,1142,17413,0,0,12,1142,0,0,219.603929,0.015691000000003896,582244,0
"172.16.133.12",59944,"172.16.139.250",5440,12,1142,17414,0,0,12,1142,0,0,219.618473,0.01618300000001227,564543,0
"172.16.133.63",54100,"172.16.139.250",5440,12,1142,17415,0,0,12,1142,0,0,219.629189,0.009206000000006043,992396,0
"172.16.133.66",54369,"172.16.139.250",5440,12,1142,17416,0,0,12,1142,0,0,219.641514,0.0055069999999943775,1658979,0
"172.16.133.82",61608,"172.16.139.250",5440,12,1142,17417,0,0,12,1142,0,0,219.655273,0.0063140000000032614,1446943,0
"172.16.133.37",60825,"172.16.139.250",5440,12,1142,17418,0,0,12,1142,0,0,219.668621,0.007935000000003356,1151354,0
"172.16.133.78",59414,"172.16.139.250",5440,10,1022,17419,0,0,10,1022,0,0,219.825925,0.00588399999998046,1389530,0
"172.16.133.67",56172,"172.16.139.250",5440,10,1022,17420,0,0,10,1022,0,0,219.880663,0.005632999999988897,1451446,0
"172.16.133.56",61599,"172.16.139.250",5440,12,1142,17421,0,0,12,1142,0,0,219.902318,0.015286000000003241,597671,0
"172.16.133.113",55703,"74.125.228.113",443,79,47896,17422,0,0,35,15680,44,32216,219.948539,33.01866899999999,3799,7805
"172.16.133.41",53317,"172.16.139.250",5440,12,1142,17423,0,0,12,1142,0,0,219.958029,0.006255999999979167,1460358,0
"172.16.133.43",57943,"172.16.139.250",5440,10,1022,17424,0,0,10,1022,0,0,220.027568,0.0053039999999953125,1541478,0
"172.16.133.42",57287,"172.16.139.250",5440,12,1142,17425,0,0,12,1142,0,0,220.044739,0.014044000000012602,650526,0
"172.16.133.92",57841,"172.16.139.250",5440,12,1142,17426,0,0,12,1142,0,0,220.045409,0.02370500000000675,385403,0
"172.16.133.13",53207,"172.16.139.250",5440,12,1142,17427,0,0,12,1142,0,0,220.047174,0.014454000000000633,632074,0
"172.16.133.85",52448,"172.16.139.250",5440,12,1142,17428,0,0,12,1142,0,0,220.052715,0.012885999999980413,708986,0
"172.16.133.20",62573,"172.16.139.250",5440,12,1142,17429,0,0,12,1142,0,0,220.096576,0.004972000000009302,"",""
"172.16.133.85",52449,"157.56.234.137",443,6,374,17430,0,0,3,194,3,180,220.123688,1.2398310000000095,1251,1161
"172.16.133.28",49320,"172.16.139.250",5440,10,1022,17431,0,0,10,1022,0,0,220.125884,0.005639999999999645,1449645,0
"172.16.133.99",56228,"172.16.139.250",5440,12,1142,17432,0,0,12,1142,0,0,220.154608,0.014822000000009439,616381,0
"172.16.133.75",51141,"172.16.139.250",5440,12,1142,17433,0,0,12,1142,0,0,220.159402,0.0061289999999871725,1490618,0
"172.16.133.132",56379,"199.27.208.55",80,93,54675,17434,0,0,45,6943,48,47732,220.164025,19.974069999999983,2780,19117
"172.16.133.87",60422,"172.16.139.250",5440,12,1142,17435,0,0,12,1142,0,0,220.178631,0.005596999999994523,1632303,0
"172.16.133.35",50135,"172.16.139.250",5440,12,1142,17436,0,0,12,1142,0,0,220.182446,0.01798300000001518,508035,0
"172.16.133.116",53896,"172.16.139.250",5440,12,1142,17437,0,0,12,1142,0,0,220.190341,0.008605000000017071,1061708,0
"172.16.133.116",53897,"172.16.139.250",5440,10,1022,17438,0,0,10,1022,0,0,220.199955,0.005425999999999931,1506819,0
"172.16.133.116",53898,"172.16.139.250",5440,10,1022,17439,0,0,10,1022,0,0,220.206969,0.004736000000008289,"",""
"172.16.133.84",58970,"172.16.139.250",5440,10,1022,17440,0,0,10,1022,0,0,220.213771,0.015394999999983838,531081,0
"172.16.133.132",53896,"199.27.208.55",443,40,16748,17441,0,0,20,3552,20,13196,220.266978,19.86756600000001,1430,5313
"172.16.133.87",60423,"216.115.216.250",443,6,366,17442,0,0,4,246,2,120,220.278036,0.12836500000000228,15331,7478
"172.16.133.49",55956,"172.16.139.250",5440,12,1142,17443,0,0,12,1142,0,0,220.28908,0.006429999999994607,1420839,0
"172.16.133.87",60424,"68.64.26.250",443,6,366,17444,0,0,4,246,2,120,220.320914,0.15642000000002554,12581,6137
"172.16.133.95",57129,"172.16.139.250",5440,12,1142,17445,0,0,12,1142,0,0,220.330786,0.015362000000010312,594714,0
"172.16.133.87",60425,"68.64.4.249",443,7,432,17446,0,0,5,312,2,120,220.331793,3.1208680000000015,799,307
"172.16.133.92",57842,"172.16.139.250",5440,10,1022,17447,0,0,10,1022,0,0,220.356889,0.014762000000018816,553854,0
"172.16.133.29",61178,"172.16.139.250",5440,10,1022,17448,0,0,10,1022,0,0,220.374653,0.005224999999995816,1564784,0
"172.16.133.44",65004,"172.16.139.250",5440,10,1022,17449,0,0,10,1022,0,0,220.381115,0.015227000000010094,536940,0
"172.16.133.207",56112,"172.16.139.250",5440,12,1142,17450,0,0,12,1142,0,0,220.407277,0.005723000000017464,1596365,0
"172.16.133.83",57250,"172.16.139.250",5440,12,1142,17451,0,0,12,1142,0,0,220.415757,0.004714999999976044,"",""
"172.16.133.93",60925,"172.16.139.250",5440,12,1142,17452,0,0,12,1142,0,0,220.430301,0.00513300000000072,1779855,0
"172.16.133.11",55339,"172.16.139.250",5440,10,1022,17453,0,0,10,1022,0,0,220.449232,0.005673999999999069,1440958,0
"172.16.133.55",57794,"172.16.139.250",5440,10,1022,17454,0,0,10,1022,0,0,220.452952,0.015414999999990187,530392,0
"172.16.133.73",60850,"172.16.139.250",5440,12,1142,17455,0,0,12,1142,0,0,220.475279,0.006407999999993308,1425717,0
"172.16.133.53",54278,"172.16.139.250",5440,12,1142,17456,0,0,12,1142,0,0,220.478314,0.007294999999999163,1252364,0
"172.16.133.21",53352,"172.16.139.250",5440,10,1022,17457,0,0,10,1022,0,0,220.48199,0.006988000000006878,1170005,0
"172.16.133.68",60931,"173.194.74.121",80,7,1297,17458,0,0,4,496,3,801,220.483965,0.354108999999994,11205,18096
"172.16.133.30",62846,"172.16.139.250",5440,10,1022,17459,0,0,10,1022,0,0,220.485418,0.007362000000000535,1110567,0
"172.16.133.25",63653,"172.16.139.250",5440,12,1142,17460,0,0,12,1142,0,0,220.492478,0.004809999999991987,"",""
"172.16.133.34",50633,"172.16.139.250",5440,10,1022,17461,0,0,10,1022,0,0,220.501354,0.004703000000006341,"",""
"172.16.133.97",59554,"172.16.139.250",5440,10,1022,17462,0,0,10,1022,0,0,220.513097,0.01459800000000655,560076,0
"172.16.133.87",60426,"216.219.116.244",443,6,366,17463,0,0,4,246,2,120,220.562988,0.23756300000002284,8284,4041
"172.16.133.33",58063,"172.16.139.250",5440,10,1022,17464,0,0,10,1022,0,0,220.584289,0.005568999999979951,1468127,0
"172.16.133.68",60932,"172.16.139.250",5440,10,1022,17465,0,0,10,1022,0,0,220.618203,0.005550999999996975,1472887,0
"172.16.133.12",59945,"172.16.139.250",5440,12,1142,17466,0,0,12,1142,0,0,220.632232,0.005680000000012342,1608450,0
"172.16.133.63",54101,"172.16.139.250",5440,10,1022,17467,0,0,10,1022,0,0,220.643635,0.005418000000020129,1509043,0
"172.16.133.66",54370,"172.16.139.250",5440,12,1142,17468,0,0,12,1142,0,0,220.654791,0.006151000000016893,1485286,0
"172.16.133.68",60933,"173.194.43.34",443,21,8507,17469,0,0,9,1365,12,7142,220.667571,0.48146299999999087,22680,118671
"172.16.133.82",61609,"172.16.139.250",5440,10,1022,17470,0,0,10,1022,0,0,220.669114,0.015840999999994665,516129,0
"172.16.133.37",60826,"172.16.139.250",5440,12,1142,17471,0,0,12,1142,0,0,220.682183,0.0073919999999816355,1235930,0
"172.16.133.132",45049,"23.33.83.243",443,347,395295,17472,0,0,83,7136,264,388159,220.69233,19.422723999999988,2939,159878
"172.16.133.132",45050,"23.33.83.243",443,28,9347,17473,0,0,17,2768,11,6579,220.692849,19.421280999999993,1140,2710
"172.16.133.132",45051,"23.33.83.243",443,63,46979,17474,0,0,26,3362,37,43617,220.693309,19.420581,1384,17967
"172.16.133.132",45052,"23.33.83.243",443,63,52019,17475,0,0,23,2727,40,49292,220.69375,19.423595000000006,1123,20301
"172.16.133.132",45053,"23.33.83.243",443,26,9231,17476,0,0,15,2620,11,6611,220.69419,19.42352600000001,1079,2722
"172.16.133.132",45054,"23.33.83.243",443,125,101485,17477,0,0,55,4446,70,97039,220.694626,19.42344,1831,39967
"172.16.133.12",59946,"216.115.216.250",443,6,366,17478,0,0,4,246,2,120,220.773692,0.047010999999997694,41862,20420
"172.16.133.12",59947,"68.64.26.250",443,6,366,17479,0,0,4,246,2,120,220.786611,0.10029099999999858,19622,9572
"172.16.133.12",59948,"68.64.4.249",443,6,366,17480,0,0,4,246,2,120,220.79654,0.1120339999999942,17566,8568
"172.16.133.78",59415,"172.16.139.250",5440,12,1142,17481,0,0,12,1142,0,0,220.839047,0.016545000000007803,552190,0
"172.16.133.67",56173,"172.16.139.250",5440,12,1142,17482,0,0,12,1142,0,0,220.893771,0.0063100000000133605,1447860,0
"172.16.133.56",61600,"172.16.139.250",5440,10,1022,17483,0,0,10,1022,0,0,220.91658,0.014848999999998114,550609,0
"172.16.133.12",59949,"216.219.116.244",443,6,366,17484,0,0,4,246,2,120,220.930643,0.24801800000000185,7934,3870
"172.16.133.41",53318,"172.16.139.250",5440,12,1142,17485,0,0,12,1142,0,0,220.970967,0.014511999999996306,629547,0
"172.16.133.43",57944,"172.16.139.250",5440,12,1142,17486,0,0,12,1142,0,0,221.0411,0.05013199999999074,182238,0
"172.16.133.42",57288,"172.16.139.250",5440,12,1142,17487,0,0,12,1142,0,0,221.057161,0.06843799999998623,133493,0
"172.16.133.13",53208,"172.16.139.250",5440,12,1142,17488,0,0,12,1142,0,0,221.061176,0.03487200000000712,261986,0
"172.16.133.85",52450,"172.16.139.250",5440,10,1022,17489,0,0,10,1022,0,0,221.068017,0.030699999999995953,266319,0
"172.16.133.20",62574,"172.16.139.250",5440,12,1142,17490,0,0,12,1142,0,0,221.110694,0.004919999999998481,"",""
"172.16.133.28",49322,"172.16.139.250",5440,12,1142,17491,0,0,12,1142,0,0,221.14042,0.016719999999992297,546411,0
"172.16.133.99",56229,"172.16.139.250",5440,12,1142,17492,0,0,12,1142,0,0,221.168946,0.014497000000005755,630199,0
"172.16.133.75",51142,"172.16.139.250",5440,12,1142,17493,0,0,12,1142,0,0,221.173499,0.0061670000000049185,1481433,0
"172.16.133.87",60427,"172.16.139.250",5440,12,1142,17494,0,0,12,1142,0,0,221.192615,0.00614500000000362,1486737,0
"172.16.133.35",50136,"172.16.139.250",5440,12,1142,17495,0,0,12,1142,0,0,221.197582,0.008078999999980851,1130833,0
"172.16.133.116",53899,"172.16.139.250",5440,12,1142,17496,0,0,12,1142,0,0,221.206555,0.00633600000000456,1441919,0
"172.16.133.116",53900,"172.16.139.250",5440,12,1142,17497,0,0,12,1142,0,0,221.213824,0.005817000000007511,1570569,0
"172.16.133.116",53901,"172.16.139.250",5440,10,1022,17498,0,0,10,1022,0,0,221.220622,0.005311000000006061,1539446,0
"172.16.133.84",58971,"172.16.139.250",5440,12,1142,17499,0,0,12,1142,0,0,221.227913,0.006297999999986814,1450619,0
"172.16.133.49",55957,"172.16.139.250",5440,12,1142,17500,0,0,12,1142,0,0,221.302797,0.006228999999990492,1466688,0
"172.16.133.95",57130,"172.16.139.250",5440,12,1142,17501,0,0,12,1142,0,0,221.344919,0.006358000000005859,1436929,0
"172.16.133.85",52451,"157.56.236.89",443,6,374,17502,0,0,3,194,3,180,221.364075,1.3387469999999837,1159,1075
"172.16.133.92",57843,"172.16.139.250",5440,12,1142,17503,0,0,12,1142,0,0,221.374527,0.027746000000007598,329272,0
"172.16.133.29",61179,"172.16.139.250",5440,12,1142,17504,0,0,12,1142,0,0,221.389085,0.01668900000001372,547426,0
"172.16.133.44",65005,"172.16.139.250",5440,10,1022,17505,0,0,10,1022,0,0,221.395039,0.01351900000000228,604778,0
"172.16.133.97",59555,"96.43.146.176",443,21,6444,17506,0,0,13,4311,8,2133,221.411682,12.362936999999988,2789,1380
"172.16.133.207",56113,"172.16.139.250",5440,12,1142,17507,0,0,12,1142,0,0,221.420084,0.016404999999991787,556903,0
"172.16.133.83",57251,"172.16.139.250",5440,12,1142,17508,0,0,12,1142,0,0,221.429831,0.01923600000000647,474942,0
"172.16.133.93",60926,"172.16.139.250",5440,10,1022,17509,0,0,10,1022,0,0,221.444571,0.006062000000014223,1348729,0
"172.16.133.93",60927,"202.173.25.200",443,6,366,17510,0,0,4,246,2,120,221.461141,0.516303999999991,3811,1859
"172.16.133.93",60928,"216.219.117.244",443,6,366,17511,0,0,4,246,2,120,221.462173,0.22476499999999078,8755,4271
"172.16.133.93",60929,"78.108.117.250",443,6,366,17512,0,0,4,246,2,120,221.462176,0.22509999999999764,8742,4264
"172.16.133.11",55340,"172.16.139.250",5440,10,1022,17513,0,0,10,1022,0,0,221.463037,0.01917499999998995,426388,0
"172.16.133.93",60930,"67.217.95.254",443,7,426,17514,0,0,5,306,2,120,221.464357,0.36746299999998655,6661,2612
"172.16.133.55",57795,"172.16.139.250",5440,12,1142,17515,0,0,12,1142,0,0,221.467807,0.017820999999997866,512653,0
"172.16.133.73",60851,"172.16.139.250",5440,12,1142,17516,0,0,12,1142,0,0,221.489305,0.019404000000008637,470830,0
"172.16.133.53",54279,"172.16.139.250",5440,12,1142,17517,0,0,12,1142,0,0,221.494565,0.0072000000000116415,1268888,0
"172.16.133.21",53353,"172.16.139.250",5440,12,1142,17518,0,0,12,1142,0,0,221.495806,0.008269000000012738,1104849,0
"172.16.133.30",62847,"172.16.139.250",5440,10,1022,17519,0,0,10,1022,0,0,221.499856,0.016848000000010188,485280,0
"172.16.133.25",63654,"172.16.139.250",5440,12,1142,17520,0,0,12,1142,0,0,221.506508,0.005616000000003396,1626780,0
"172.16.133.34",50634,"172.16.139.250",5440,12,1142,17521,0,0,12,1142,0,0,221.515502,0.005210000000005266,1753550,0
"172.16.133.97",59556,"172.16.139.250",5440,10,1022,17522,0,0,10,1022,0,0,221.527171,0.009107000000000198,897770,0
"172.16.133.33",58064,"172.16.139.250",5440,12,1142,17523,0,0,12,1142,0,0,221.597527,0.01635699999999929,558537,0
"172.16.133.60",62182,"68.64.5.249",443,6,366,17524,0,0,4,246,2,120,221.602969,0.12447499999998968,15810,7712
"172.16.133.60",62183,"216.115.209.254",443,6,366,17525,0,0,4,246,2,120,221.603677,0.23899000000000115,8234,4016
"172.16.133.113",55704,"172.16.139.250",135,8,492,17526,0,0,8,492,0,0,221.619755,0.013082999999994627,300848,0
"172.16.133.68",60934,"172.16.139.250",5440,10,1022,17527,0,0,10,1022,0,0,221.63237,0.0156859999999881,521229,0
"172.16.133.113",55705,"172.16.139.250",5462,12,816,17528,0,0,12,816,0,0,221.634666,0.533929999999998,12226,0
"172.16.133.60",62184,"78.108.119.250",443,6,366,17529,0,0,4,246,2,120,221.639745,0.2723829999999907,7225,3524
"172.16.133.12",59950,"172.16.139.250",5440,12,1142,17530,0,0,12,1142,0,0,221.646421,0.009051999999996951,1009279,0
"172.16.133.60",62185,"68.64.25.250",443,6,366,17531,0,0,4,246,2,120,221.655743,0.1323069999999973,14874,7255
"172.16.133.63",54102,"172.16.139.250",5440,12,1142,17532,0,0,12,1142,0,0,221.656557,0.015793000000002166,578484,0
"172.16.133.66",54371,"172.16.139.250",5440,12,1142,17533,0,0,12,1142,0,0,221.669075,0.007560000000012224,1208465,0
"172.16.133.82",61610,"172.16.139.250",5440,12,1142,17534,0,0,12,1142,0,0,221.683128,0.00618599999998537,1476883,0
"172.16.133.37",60827,"172.16.139.250",5440,10,1022,17535,0,0,10,1022,0,0,221.695888,0.006191000000001168,1320626,0
"172.16.133.132",53903,"199.27.208.55",443,16,5148,17536,0,0,9,945,7,4203,221.77192,0.17689799999999423,42736,190075
"172.16.133.78",59416,"172.16.139.250",5440,12,1142,17537,0,0,12,1142,0,0,221.852922,0.006408999999990783,1425495,0
"172.16.133.67",56174,"172.16.139.250",5440,10,1022,17538,0,0,10,1022,0,0,221.907571,0.014882999999997537,549351,0
"172.16.133.56",61601,"172.16.139.250",5440,10,1022,17539,0,0,10,1022,0,0,221.930607,0.004760000000004538,"",""
"172.16.133.41",53319,"172.16.139.250",5440,12,1142,17540,0,0,12,1142,0,0,221.985056,0.005510000000015225,1658076,0
"172.16.133.43",57945,"172.16.139.250",5440,10,1022,17541,0,0,10,1022,0,0,222.055816,0.015437000000019907,529636,0
"172.16.133.13",53209,"172.16.139.250",5440,10,1022,17542,0,0,10,1022,0,0,222.075234,0.005369999999999209,1522532,0
"172.16.133.85",52452,"172.16.139.250",5440,12,1142,17543,0,0,12,1142,0,0,222.080702,0.0061670000000049185,1481433,0
"172.16.133.42",57289,"172.16.139.250",5440,12,1142,17544,0,0,12,1142,0,0,222.091905,0.00878099999999904,1040428,0
"172.16.133.20",62575,"172.16.139.250",5440,12,1142,17545,0,0,12,1142,0,0,222.124752,0.014251000000001568,641077,0
"172.16.133.28",49323,"172.16.139.250",5440,10,1022,17546,0,0,10,1022,0,0,222.154914,0.005402000000003682,1513513,0
"172.16.133.99",56230,"172.16.139.250",5440,12,1142,17547,0,0,12,1142,0,0,222.182964,0.004880000000014206,"",""
"172.16.133.75",51143,"172.16.139.250",5440,10,1022,17548,0,0,10,1022,0,0,222.187657,0.005504000000001952,1485465,0
"172.16.133.87",60428,"172.16.139.250",5440,10,1022,17549,0,0,10,1022,0,0,222.207034,0.005412000000006856,1510716,0
"172.16.133.116",53902,"172.16.139.250",5440,10,1022,17550,0,0,10,1022,0,0,222.217533,0.004951000000005479,"",""
"172.16.133.35",50137,"172.16.139.250",5440,12,1142,17551,0,0,12,1142,0,0,222.221144,0.02544999999997799,358978,0
"172.16.133.116",53903,"172.16.139.250",5440,10,1022,17552,0,0,10,1022,0,0,222.223371,0.015370000000018536,531945,0
"172.16.133.116",53904,"172.16.139.250",5440,10,1022,17553,0,0,10,1022,0,0,222.23957,0.015274000000005117,535288,0
"172.16.133.84",58972,"172.16.139.250",5440,10,1022,17554,0,0,10,1022,0,0,222.24173,0.016914000000014084,483386,0
"172.16.133.34",50635,"173.194.43.44",443,14,3918,17555,0,0,8,968,6,2950,222.257404,3.9930789999999945,1939,5910
"172.16.133.49",55958,"172.16.139.250",5440,12,1142,17556,0,0,12,1142,0,0,222.316848,0.0063370000000020354,1441691,0
"172.16.133.87",60429,"216.115.216.250",443,6,366,17557,0,0,4,246,2,120,222.319065,0.05128500000000713,38373,18718
"172.16.133.95",57131,"172.16.139.250",5440,10,1022,17558,0,0,10,1022,0,0,222.360237,0.005383999999992284,1518573,0
"172.16.133.92",57844,"172.16.139.250",5440,10,1022,17559,0,0,10,1022,0,0,222.384606,0.0058530000000018845,1396890,0
"172.16.133.29",61180,"172.16.139.250",5440,10,1022,17560,0,0,10,1022,0,0,222.402566,0.005356000000006134,1526512,0
"172.16.133.44",65006,"172.16.139.250",5440,12,1142,17561,0,0,12,1142,0,0,222.409027,0.00615799999999922,1483598,0
"172.16.133.87",60430,"68.64.26.250",443,6,366,17562,0,0,4,246,2,120,222.430082,0.10082299999999123,19519,9521
"172.16.133.207",56114,"172.16.139.250",5440,12,1142,17563,0,0,12,1142,0,0,222.434429,0.014799000000010665,617339,0
"172.16.133.83",57252,"172.16.139.250",5440,12,1142,17564,0,0,12,1142,0,0,222.443969,0.014680999999995947,622300,0
"172.16.133.93",60931,"172.16.139.250",5440,10,1022,17565,0,0,10,1022,0,0,222.458256,0.0046820000000025175,"",""
"172.16.133.11",55341,"172.16.139.250",5440,12,1142,17566,0,0,12,1142,0,0,222.476274,0.006243000000011989,1463399,0
"172.16.133.55",57796,"172.16.139.250",5440,12,1142,17567,0,0,12,1142,0,0,222.481777,0.006154000000009319,1484562,0
"172.16.133.113",55706,"74.125.228.113",443,15,4749,17568,0,0,9,3422,6,1327,222.495474,9.116595999999987,3002,1164
"172.16.133.73",60852,"172.16.139.250",5440,10,1022,17569,0,0,10,1022,0,0,222.503137,0.005585999999993874,1463659,0
"172.16.133.53",54280,"172.16.139.250",5440,10,1022,17570,0,0,10,1022,0,0,222.506406,0.006200000000006867,1318709,0
"172.16.133.21",53354,"172.16.139.250",5440,10,1022,17571,0,0,10,1022,0,0,222.509788,0.006776000000002114,1206611,0
"172.16.133.30",62848,"172.16.139.250",5440,12,1142,17572,0,0,12,1142,0,0,222.513935,0.00723500000000854,1262750,0
"172.16.133.34",50636,"216.27.91.218",80,10,1169,17573,0,0,6,777,4,392,222.519831,8.227188999999981,755,381
"172.16.133.25",63655,"172.16.139.250",5440,12,1142,17574,0,0,12,1142,0,0,222.520924,0.004914999999982683,"",""
"172.16.133.34",50637,"172.16.139.250",5440,10,1022,17575,0,0,10,1022,0,0,222.529728,0.005336999999997261,1531946,0
"172.16.133.97",59557,"172.16.139.250",5440,10,1022,17576,0,0,10,1022,0,0,222.541211,0.00565199999999777,1446567,0
"172.16.133.33",58065,"172.16.139.250",5440,10,1022,17577,0,0,10,1022,0,0,222.610431,0.005566999999985001,1468654,0
"172.16.133.34",50638,"216.27.91.218",443,27,14149,17578,0,0,12,1592,15,12557,222.636285,0.6487390000000062,19631,154848
"172.16.133.68",60935,"172.16.139.250",5440,10,1022,17579,0,0,10,1022,0,0,222.64626,0.01584799999997699,515901,0
"172.16.133.92",57845,"96.43.146.176",443,12,2271,17580,0,0,7,1478,5,793,222.6484,0.7098279999999875,16657,8937
"172.16.133.12",59951,"172.16.139.250",5440,12,1142,17581,0,0,12,1142,0,0,222.659247,0.007256000000012364,1259095,0
"172.16.133.63",54103,"172.16.139.250",5440,12,1142,17582,0,0,12,1142,0,0,222.671582,0.0983359999999891,92905,0
"172.16.133.87",60431,"216.219.116.244",443,6,366,17583,0,0,4,246,2,120,222.679081,0.26527600000000007,7418,3618
"172.16.133.66",54372,"172.16.139.250",5440,12,1142,17584,0,0,12,1142,0,0,222.682064,0.08439300000000571,108255,0
"172.16.133.18",50307,"174.129.20.55",443,26,9590,17585,0,0,13,2336,13,7254,222.689429,10.32780600000001,1809,5619
"172.16.133.82",61611,"172.16.139.250",5440,10,1022,17586,0,0,10,1022,0,0,222.696572,0.07889299999999366,103634,0
"172.16.133.85",52453,"157.56.240.137",80,8,884,17587,0,0,5,532,3,352,222.706428,0.08848800000001233,48096,31823
"172.16.133.37",60828,"172.16.139.250",5440,10,1022,17588,0,0,10,1022,0,0,222.711442,0.06826499999999669,119768,0
"172.16.133.16",59364,"23.21.132.234",80,8,1578,17589,0,0,5,985,3,593,222.743497,0.08666100000002075,90929,54742
"172.16.133.16",59365,"208.92.52.90",80,11,1835,17590,0,0,6,1025,5,810,222.775332,1.0037960000000226,8168,6455
"172.16.133.85",52454,"132.245.1.134",443,24,9479,17591,0,0,11,2731,13,6748,222.786177,1.1647769999999866,18757,46347
"172.16.133.12",59952,"216.115.216.250",443,6,366,17592,0,0,4,246,2,120,222.804785,0.056383999999980006,34903,17026
"172.16.133.12",59953,"68.64.26.250",443,6,366,17593,0,0,4,246,2,120,222.839733,0.0871710000000121,22576,11012
"172.16.133.12",59954,"68.64.4.249",443,6,366,17594,0,0,4,246,2,120,222.846646,0.09270600000002105,21228,10355
"172.16.133.78",59417,"172.16.139.250",5440,12,1142,17595,0,0,12,1142,0,0,222.867583,0.0062360000000012406,1465041,0
"172.16.133.67",56175,"172.16.139.250",5440,10,1022,17596,0,0,10,1022,0,0,222.923185,0.015815000000003465,516977,0
"172.16.133.56",61602,"172.16.139.250",5440,12,1142,17597,0,0,12,1142,0,0,222.943875,0.005464000000017677,1672035,0
"172.16.133.41",53320,"172.16.139.250",5440,12,1142,17598,0,0,12,1142,0,0,222.999046,0.015430000000009159,592093,0
"172.16.133.12",59955,"216.219.116.244",443,6,366,17599,0,0,4,246,2,120,223.061789,0.2731980000000078,7203,3513
"172.16.133.43",57946,"172.16.139.250",5440,12,1142,17600,0,0,12,1142,0,0,223.069367,0.00634700000000521,1439420,0
"172.16.133.42",57290,"172.16.139.250",5440,12,1142,17601,0,0,12,1142,0,0,223.085812,0.01928799999998887,473662,0
"172.16.133.13",53210,"172.16.139.250",5440,10,1022,17602,0,0,10,1022,0,0,223.089773,0.014937000000003309,547365,0
"172.16.133.85",52455,"172.16.139.250",5440,10,1022,17603,0,0,10,1022,0,0,223.096093,0.01500599999999963,544848,0
"172.16.133.20",62576,"172.16.139.250",5440,12,1142,17604,0,0,12,1142,0,0,223.138527,0.005028999999979078,1816663,0
"172.16.133.28",49324,"172.16.139.250",5440,10,1022,17605,0,0,10,1022,0,0,223.167958,0.005315999999993437,1537998,0
"172.16.133.99",56231,"172.16.139.250",5440,10,1022,17606,0,0,10,1022,0,0,223.196447,0.01490400000000136,548577,0
"172.16.133.75",51144,"172.16.139.250",5440,10,1022,17607,0,0,10,1022,0,0,223.201501,0.005554999999986876,1471827,0
"172.16.133.87",60432,"172.16.139.250",5440,12,1142,17608,0,0,12,1142,0,0,223.220613,0.016312000000027638,560078,0
"172.16.133.116",53905,"172.16.139.250",5440,10,1022,17609,0,0,10,1022,0,0,223.231645,0.008317000000005237,983046,0
"172.16.133.116",53906,"172.16.139.250",5440,10,1022,17610,0,0,10,1022,0,0,223.240978,0.005356999999975187,1526227,0
"172.16.133.34",50639,"216.27.91.218",443,263,217145,17611,0,0,106,10841,157,206304,223.242886,50.80116800000002,1707,32488
"172.16.133.34",50640,"216.27.91.218",443,147,123203,17612,0,0,54,6389,93,116814,223.244138,50.823679999999996,1005,18387
"172.16.133.116",53907,"172.16.139.250",5440,12,1142,17613,0,0,12,1142,0,0,223.247123,0.006376000000017257,1432873,0
"172.16.133.84",58973,"172.16.139.250",5440,10,1022,17614,0,0,10,1022,0,0,223.255679,0.0054160000000251785,1509601,0
"172.16.133.34",50641,"199.7.51.231",443,18,6293,17615,0,0,8,1364,10,4929,223.276919,30.19558600000002,361,1305
"172.16.133.35",50138,"172.16.139.250",5440,12,1142,17616,0,0,12,1142,0,0,223.327282,0.018450999999998885,495149,0
"172.16.133.49",55959,"172.16.139.250",5440,12,1142,17617,0,0,12,1142,0,0,223.330536,0.005703000000011116,1601963,0
"172.16.133.25",63656,"172.16.139.250",5440,12,1142,17618,0,0,12,1142,0,0,223.354371,0.006007000000010976,1520892,0
"172.16.133.95",57132,"172.16.139.250",5440,10,1022,17619,0,0,10,1022,0,0,223.373038,0.015533000000004904,526363,0
"172.16.133.92",57846,"172.16.139.250",5440,10,1022,17620,0,0,10,1022,0,0,223.399308,0.015627000000023372,523197,0
"172.16.133.29",61181,"172.16.139.250",5440,10,1022,17621,0,0,10,1022,0,0,223.416444,0.015740999999991345,519407,0
"172.16.133.44",65007,"172.16.139.250",5440,12,1142,17622,0,0,12,1142,0,0,223.423119,0.00617299999998977,1479993,0
"172.16.133.207",56115,"172.16.139.250",5440,10,1022,17623,0,0,10,1022,0,0,223.449841,0.014067000000011376,581218,0
"172.16.133.83",57253,"172.16.139.250",5440,12,1142,17624,0,0,12,1142,0,0,223.457857,0.014356000000020686,636388,0
"172.16.133.93",60932,"172.16.139.250",5440,12,1142,17625,0,0,12,1142,0,0,223.472268,0.004971999999980881,"",""
"172.16.133.95",57133,"216.52.242.80",80,61,51239,17626,0,0,26,16650,35,34589,223.478863,73.58302700000002,1810,3760
"172.16.133.11",55342,"172.16.139.250",5440,10,1022,17627,0,0,10,1022,0,0,223.49143,0.0055720000000007985,1467336,0
"172.16.133.55",57797,"172.16.139.250",5440,12,1142,17628,0,0,12,1142,0,0,223.495824,0.015502999999995382,589305,0
"172.16.133.93",60933,"67.217.95.254",443,6,366,17629,0,0,4,246,2,120,223.511989,0.08970400000001177,21938,10701
"172.16.133.73",60853,"172.16.139.250",5440,12,1142,17630,0,0,12,1142,0,0,223.516978,0.016359999999991715,558435,0
"172.16.133.95",57134,"23.0.49.244",80,7,432,17631,0,0,4,246,3,186,223.518793,16.345995000000016,120,91
"172.16.133.53",54281,"172.16.139.250",5440,10,1022,17632,0,0,10,1022,0,0,223.520365,0.016010999999991782,510648,0
"172.16.133.21",53355,"172.16.139.250",5440,10,1022,17633,0,0,10,1022,0,0,223.52308,0.005689000000018041,1437159,0
"172.16.133.30",62849,"172.16.139.250",5440,10,1022,17634,0,0,10,1022,0,0,223.527705,0.01675199999999677,488061,0
"172.16.133.25",63657,"172.16.139.250",5440,12,1142,17635,0,0,12,1142,0,0,223.534539,0.005861000000010108,1558778,0
"172.16.133.34",50642,"172.16.139.250",5440,10,1022,17636,0,0,10,1022,0,0,223.54327,0.014726999999993495,555170,0
"172.16.133.97",59558,"172.16.139.250",5440,10,1022,17637,0,0,10,1022,0,0,223.554358,0.007350999999999885,1112229,0
"172.16.133.93",60934,"216.219.117.244",443,6,366,17638,0,0,4,246,2,120,223.5879,0.1974920000000111,9964,4860
"172.16.133.93",60935,"78.108.117.250",443,6,366,17639,0,0,4,246,2,120,223.588767,0.19562100000001692,10060,4907
"172.16.133.95",57135,"216.52.242.80",80,98,81656,17640,0,0,38,22655,60,59001,223.596788,73.46619099999998,2466,6424
"172.16.133.95",57136,"173.194.43.59",80,23,12112,17641,0,0,12,6964,11,5148,223.59749,73.46376200000003,758,560
"172.16.133.95",57137,"173.194.43.59",80,23,11296,17642,0,0,12,6966,11,4330,223.609272,73.44202900000002,758,471
"172.16.133.33",58066,"172.16.139.250",5440,10,1022,17643,0,0,10,1022,0,0,223.625569,0.01577899999998067,518157,0
"172.16.133.68",60937,"172.16.139.250",5440,10,1022,17644,0,0,10,1022,0,0,223.659868,0.016186000000004697,505127,0
"172.16.133.60",62186,"68.64.5.249",443,6,366,17645,0,0,4,246,2,120,223.660073,0.11027899999999136,17845,8705
"172.16.133.12",59956,"172.16.139.250",5440,12,1142,17646,0,0,12,1142,0,0,223.673324,0.0064889999999877546,1407921,0
"172.16.133.63",54104,"172.16.139.250",5440,12,1142,17647,0,0,12,1142,0,0,223.684577,0.015504000000021279,589267,0
"172.16.133.66",54373,"172.16.139.250",5440,12,1142,17648,0,0,12,1142,0,0,223.69588,0.00795800000000213,1148027,0
"172.16.133.82",61612,"172.16.139.250",5440,10,1022,17649,0,0,10,1022,0,0,223.710041,0.005505999999996902,1484925,0
"172.16.133.93",60936,"202.173.25.200",443,6,366,17650,0,0,4,246,2,120,223.717897,0.5615160000000117,3504,1709
"172.16.133.37",60829,"172.16.139.250",5440,10,1022,17651,0,0,10,1022,0,0,223.724369,0.005665999999990845,1442993,0
"172.16.133.60",62187,"216.115.209.254",443,6,366,17652,0,0,4,246,2,120,223.727953,0.2075749999999914,9480,4624
"172.16.133.60",62188,"68.64.25.250",443,6,366,17653,0,0,4,246,2,120,223.736846,0.11574599999997304,17002,8294
"172.16.133.60",62189,"78.108.119.250",443,6,366,17654,0,0,4,246,2,120,223.792918,0.2546379999999999,7728,3770
"172.16.133.95",57138,"216.52.242.80",80,25,12462,17655,0,0,12,4277,13,8185,223.80713,14.199220999999994,2409,4611
"172.16.133.78",59418,"172.16.139.250",5440,10,1022,17656,0,0,10,1022,0,0,223.880186,0.13897799999998028,58829,0
"172.16.133.34",50643,"216.27.91.218",443,36,21497,17657,0,0,18,4181,18,17316,223.896695,50.28465700000001,665,2754
"172.16.133.34",50644,"216.27.91.218",443,46,26219,17658,0,0,21,4457,25,21762,223.896892,4.961376999999999,7186,35090
"172.16.133.34",50645,"216.27.91.218",443,46,27849,17659,0,0,22,5661,24,22188,223.897066,50.125463000000025,903,3541
"172.16.133.34",50646,"216.27.91.218",443,17,6134,17660,0,0,9,1981,8,4153,223.897254,45.49252499999997,348,730
"172.16.133.67",56176,"172.16.139.250",5440,12,1142,17661,0,0,12,1142,0,0,223.935857,0.08762400000000525,104263,0
"172.16.133.85",52456,"132.245.1.150",443,25,15509,17662,0,0,10,1874,15,13635,223.957556,1.3932909999999765,10760,78289
"172.16.133.56",61603,"172.16.139.250",5440,12,1142,17663,0,0,12,1142,0,0,223.957998,0.06845500000000015,133459,0
"172.16.128.233",50937,"172.16.133.233",22,166,19648,17664,0,0,47,4062,119,15586,223.97646,11.270651999999984,2883,11063
"172.16.133.95",57139,"138.108.6.20",80,8,2256,17665,0,0,4,1598,4,658,224.00863,11.124666999999988,1149,473
"172.16.133.41",53321,"172.16.139.250",5440,12,1142,17666,0,0,12,1142,0,0,224.014198,0.015848000000005413,576476,0
"172.16.133.95",57140,"64.94.107.18",80,10,2352,17667,0,0,6,1829,4,523,224.017181,0.06726600000001781,217524,62200
"172.16.133.95",57141,"208.47.254.81",80,26,12700,17668,0,0,17,10460,9,2240,224.020685,73.89163800000003,1132,242
"172.16.133.43",57947,"172.16.139.250",5440,12,1142,17669,0,0,12,1142,0,0,224.08322,0.015354999999999563,594985,0
"172.16.133.42",57291,"172.16.139.250",5440,12,1142,17670,0,0,12,1142,0,0,224.102546,0.011349000000024034,805004,0
"172.16.133.13",53214,"172.16.139.250",5440,10,1022,17671,0,0,10,1022,0,0,224.10306,0.015163000000001148,539207,0
"172.16.133.85",52457,"172.16.139.250",5440,12,1142,17672,0,0,12,1142,0,0,224.108802,0.0063049999999975626,1449008,0
"172.16.133.20",62577,"172.16.139.250",5440,12,1142,17673,0,0,12,1142,0,0,224.152622,0.005328999999989037,1714392,0
"172.16.133.28",49325,"172.16.139.250",5440,12,1142,17674,0,0,12,1142,0,0,224.181945,0.015305999999981168,596890,0
"172.16.133.99",56232,"172.16.139.250",5440,12,1142,17675,0,0,12,1142,0,0,224.210695,0.014972000000000207,610205,0
"172.16.133.75",51145,"172.16.139.250",5440,12,1142,17676,0,0,12,1142,0,0,224.215315,0.00618599999998537,1476883,0
"172.16.133.87",60433,"172.16.139.250",5440,10,1022,17677,0,0,10,1022,0,0,224.234753,0.005397999999985359,1514635,0
"172.16.133.35",50139,"172.16.139.250",5440,12,1142,17678,0,0,12,1142,0,0,224.24553,0.008084999999994125,1129993,0
"172.16.133.116",53908,"172.16.139.250",5440,12,1142,17679,0,0,12,1142,0,0,224.245975,0.015772000000026765,579254,0
"172.16.133.116",53909,"172.16.139.250",5440,10,1022,17680,0,0,10,1022,0,0,224.263505,0.005572999999998274,1467073,0
"172.16.133.84",58974,"172.16.139.250",5440,10,1022,17681,0,0,10,1022,0,0,224.269003,0.005432000000013204,1505154,0
"172.16.133.116",53910,"172.16.139.250",5440,10,1022,17682,0,0,10,1022,0,0,224.270212,0.007998000000014827,1022255,0
"172.16.133.49",55960,"172.16.139.250",5440,12,1142,17683,0,0,12,1142,0,0,224.344674,0.01657199999999648,551291,0
"172.16.133.95",57142,"172.16.139.250",5440,12,1142,17684,0,0,12,1142,0,0,224.386966,0.01532299999999509,596227,0
"172.16.133.92",57847,"172.16.139.250",5440,10,1022,17685,0,0,10,1022,0,0,224.412866,0.0058019999999885385,1409169,0
"172.16.133.26",53105,"91.190.216.53",12350,21,2558,17686,0,0,10,1354,11,1204,224.414648,0.9888809999999921,10953,9740
"172.16.133.29",61182,"172.16.139.250",5440,10,1022,17687,0,0,10,1022,0,0,224.430852,0.00539600000001883,1515196,0
"172.16.133.44",65008,"172.16.139.250",5440,12,1142,17688,0,0,12,1142,0,0,224.440599,0.006169999999997344,1480713,0
"172.16.133.207",56116,"172.16.139.250",5440,10,1022,17689,0,0,10,1022,0,0,224.462304,0.004842000000024882,"",""
"172.16.133.83",57254,"172.16.139.250",5440,10,1022,17690,0,0,10,1022,0,0,224.47188,0.0047280000000000655,"",""
"172.16.133.93",60937,"172.16.139.250",5440,10,1022,17691,0,0,10,1022,0,0,224.486451,0.014262000000002217,573271,0
"172.16.133.11",55343,"172.16.139.250",5440,10,1022,17692,0,0,10,1022,0,0,224.504066,0.005393999999995458,1515758,0
"172.16.133.55",57798,"172.16.139.250",5440,10,1022,17693,0,0,10,1022,0,0,224.510117,0.005705000000006066,1433128,0
"172.16.133.73",60854,"172.16.139.250",5440,10,1022,17694,0,0,10,1022,0,0,224.531143,0.015257000000019616,535885,0
"172.16.133.53",54282,"172.16.139.250",5440,10,1022,17695,0,0,10,1022,0,0,224.534627,0.05267499999999359,155215,0
"172.16.133.21",53356,"172.16.139.250",5440,12,1142,17696,0,0,12,1142,0,0,224.5369,0.05474599999999441,166879,0
"172.16.133.30",62850,"172.16.139.250",5440,10,1022,17697,0,0,10,1022,0,0,224.54195,0.008783999999991465,930783,0
"172.16.133.25",63658,"172.16.139.250",5440,10,1022,17698,0,0,10,1022,0,0,224.548953,0.04700499999998442,173938,0
"172.16.133.34",50647,"172.16.139.250",5440,10,1022,17699,0,0,10,1022,0,0,224.557679,0.04532499999999118,180386,0
"172.16.133.97",59559,"172.16.139.250",5440,12,1142,17700,0,0,12,1142,0,0,224.568256,0.03174699999999575,287775,0
"172.16.133.233",46788,"184.73.225.104",80,73,19782,17701,0,0,40,2412,33,17370,224.58052,0.20290299999999206,95099,684859
"172.16.133.233",48691,"172.16.125.220",80,7,420,17702,0,0,4,240,3,180,224.581694,0.21240599999998722,9039,6779
"172.16.133.33",58067,"172.16.139.250",5440,10,1022,17703,0,0,10,1022,0,0,224.639428,0.005659999999977572,1444522,0
"172.16.133.68",60938,"172.16.139.250",5440,10,1022,17704,0,0,10,1022,0,0,224.674168,0.01556399999998348,525314,0
"172.16.133.12",59957,"172.16.139.250",5440,10,1022,17705,0,0,10,1022,0,0,224.687536,0.006166000000007443,1325981,0
"172.16.133.63",54105,"172.16.139.250",5440,10,1022,17706,0,0,10,1022,0,0,224.699654,0.0146349999999984,558660,0
"172.16.133.66",54374,"172.16.139.250",5440,12,1142,17707,0,0,12,1142,0,0,224.711229,0.007564000000002125,1207826,0
"172.16.133.82",61613,"172.16.139.250",5440,12,1142,17708,0,0,12,1142,0,0,224.724367,0.01633300000000304,559358,0
"172.16.133.37",60830,"172.16.139.250",5440,12,1142,17709,0,0,12,1142,0,0,224.738849,0.0057189999999991414,1597482,0
"172.16.133.12",59958,"216.115.216.250",443,7,426,17710,0,0,4,246,3,180,224.840897,0.04556099999999219,43194,31605
"172.16.133.132",32904,"199.27.208.32",80,26,12497,17711,0,0,14,2091,12,10406,224.841851,15.301255999999995,1093,5440
"172.16.133.93",60938,"74.63.51.79",80,445,462948,17712,0,0,141,10598,304,452350,224.872022,12.643702000000019,6705,286213
"172.16.133.93",60939,"74.63.51.79",80,10,636,17713,0,0,6,378,4,258,224.876345,12.639764000000014,239,163
"172.16.133.93",60940,"74.63.51.79",80,10,636,17714,0,0,6,378,4,258,224.876511,12.64022,239,163
"172.16.133.93",60941,"74.63.51.79",80,10,636,17715,0,0,6,378,4,258,224.876649,12.639801000000006,239,163
"172.16.133.93",60942,"74.125.226.4",80,6,372,17716,0,0,4,246,2,126,224.877302,12.651873000000023,155,79
"172.16.133.93",60943,"74.125.226.4",80,6,372,17717,0,0,4,246,2,126,224.877464,12.65072699999999,155,79
"172.16.133.12",59959,"68.64.26.250",443,6,366,17718,0,0,4,246,2,120,224.883586,0.0901309999999853,21834,10651
"172.16.133.78",59419,"172.16.139.250",5440,12,1142,17719,0,0,12,1142,0,0,224.895032,0.006298000000015236,1450619,0
"172.16.133.12",59960,"68.64.4.249",443,6,366,17720,0,0,4,246,2,120,224.898636,0.09184199999998555,21428,10452
"172.16.133.93",60944,"173.252.110.27",80,7,432,17721,0,0,4,246,3,186,224.898746,12.626040000000017,155,117
"172.16.133.93",60945,"173.252.110.27",80,7,432,17722,0,0,4,246,3,186,224.898854,12.626925,155,117
"172.16.133.93",60946,"173.252.110.27",443,44,10907,17723,0,0,22,4254,22,6653,224.89895,60.47193299999998,562,880
"172.16.133.93",60947,"23.67.243.50",80,6,372,17724,0,0,4,246,2,126,224.900098,12.61699299999998,155,79
"172.16.133.93",60948,"23.67.243.50",80,6,372,17725,0,0,4,246,2,126,224.900212,12.617190999999991,155,79
"172.16.133.93",60949,"23.67.243.50",80,6,372,17726,0,0,4,246,2,126,224.900281,12.616860000000003,155,79
"172.16.133.93",60950,"23.67.243.50",80,6,372,17727,0,0,4,246,2,126,224.900417,12.616419000000008,155,79
"172.16.133.93",60951,"23.67.243.50",80,6,372,17728,0,0,4,246,2,126,224.900508,12.616584999999986,155,79
"172.16.133.93",60952,"23.6.17.224",80,6,372,17729,0,0,4,246,2,126,224.900615,12.617297000000008,155,79
"172.16.133.93",60953,"23.6.17.224",80,7,432,17730,0,0,4,246,3,186,224.900705,12.642296000000016,155,117
"172.16.133.93",60954,"23.6.17.224",80,6,372,17731,0,0,4,246,2,126,224.90079,12.61737500000001,155,79
"172.16.133.93",60955,"23.6.17.224",443,17,5459,17732,0,0,8,1011,9,4448,224.900879,26.036641000000003,310,1366
"172.16.133.93",60956,"23.6.17.224",443,13,1871,17733,0,0,7,627,6,1244,224.900964,75.05540000000002,66,132
"172.16.133.93",60957,"23.6.17.224",443,18,6959,17734,0,0,9,2052,9,4907,224.901049,61.31174600000003,267,640
"172.16.133.93",60958,"23.33.82.110",443,16,3255,17735,0,0,8,891,8,2364,224.905523,26.026206000000002,273,726
"172.16.133.93",60959,"23.33.82.110",443,16,3255,17736,0,0,8,891,8,2364,224.905667,26.027281000000016,273,726
"172.16.133.93",60960,"23.33.82.110",443,16,3255,17737,0,0,8,891,8,2364,224.905774,26.02698699999999,273,726
"172.16.133.93",60961,"23.33.82.110",443,16,3255,17738,0,0,8,891,8,2364,224.905873,26.027183999999977,273,726
"172.16.133.93",60962,"173.194.43.36",80,12,5793,17739,0,0,5,732,7,5061,224.906007,0.5066410000000019,11558,79914
"172.16.133.93",60963,"173.194.43.36",80,15,10489,17740,0,0,5,682,10,9807,224.906118,0.5032180000000039,10842,155908
"172.16.133.93",60964,"173.194.43.36",80,15,10552,17741,0,0,5,682,10,9870,224.906225,0.5031119999999873,10844,156943
"172.16.133.93",60965,"74.63.52.167",80,60,59525,17742,0,0,18,2537,42,56988,224.906338,0.5037649999999871,40288,904993
"172.16.133.93",60966,"74.63.52.167",80,51,44500,17743,0,0,18,2537,33,41963,224.906473,0.5008499999999856,40523,670268
"172.16.133.93",60967,"74.63.52.167",80,60,57833,17744,0,0,20,2047,40,55786,224.906597,0.5109960000000058,32047,873368
"172.16.133.93",60968,"74.63.52.167",80,68,66297,17745,0,0,21,2717,47,63580,224.906712,0.5012560000000121,43363,1014730
"172.16.133.93",60969,"74.63.52.167",80,81,86385,17746,0,0,23,2648,58,83737,224.906818,0.511099999999999,41447,1310694
"172.16.133.93",60970,"74.63.52.167",80,65,63641,17747,0,0,21,3138,44,60503,224.906909,0.5077949999999873,49437,953187
"172.16.133.27",60923,"76.96.40.158",110,94,66630,17748,0,0,39,2638,55,63992,224.914894,2.3906479999999988,8827,214141
"172.16.133.67",56177,"172.16.139.250",5440,12,1142,17749,0,0,12,1142,0,0,224.949907,0.006408999999990783,1425495,0
"172.16.133.56",61604,"172.16.139.250",5440,12,1142,17750,0,0,12,1142,0,0,224.972664,0.00496799999999098,"",""
"172.16.133.41",53322,"172.16.139.250",5440,10,1022,17751,0,0,10,1022,0,0,225.028059,0.005409999999983484,1511275,0
"172.16.133.93",60971,"173.194.43.57",80,9,1123,17752,0,0,5,717,4,406,225.041726,45.097980999999976,127,72
"172.16.133.93",60972,"23.33.95.139",80,14,1798,17753,0,0,7,852,7,946,225.065602,72.450222,94,104
"172.16.133.43",57948,"172.16.139.250",5440,10,1022,17754,0,0,10,1022,0,0,225.097036,0.005428999999992357,1505986,0
"172.16.133.132",50903,"23.33.83.243",80,118,87841,17755,0,0,58,7207,60,80634,225.100298,15.025924000000003,3837,42930
"172.16.133.93",60973,"173.194.43.57",80,9,1139,17756,0,0,5,732,4,407,225.102772,45.06687600000001,129,72
"172.16.133.132",50904,"23.33.83.243",80,88,66841,17757,0,0,43,5541,45,61300,225.105224,15.025315000000006,2950,32638
"172.16.133.132",50905,"23.33.83.243",80,79,57219,17758,0,0,39,3847,40,53372,225.11035,15.017440999999991,2049,28432
"172.16.133.13",53215,"172.16.139.250",5440,10,1022,17759,0,0,10,1022,0,0,225.117463,0.015412000000026183,530495,0
"172.16.133.42",57292,"172.16.139.250",5440,12,1142,17760,0,0,12,1142,0,0,225.119495,0.021836000000007516,418391,0
"172.16.133.85",52458,"172.16.139.250",5440,10,1022,17761,0,0,10,1022,0,0,225.123054,0.005566000000015947,1468918,0
"172.16.133.20",62578,"172.16.139.250",5440,10,1022,17762,0,0,10,1022,0,0,225.166838,0.014176999999989448,576708,0
"172.16.133.28",49326,"172.16.139.250",5440,12,1142,17763,0,0,12,1142,0,0,225.195882,0.005538000000001375,1649693,0
"172.16.133.99",56233,"172.16.139.250",5440,12,1142,17764,0,0,12,1142,0,0,225.224894,0.014606999999983827,625453,0
"172.16.133.12",59961,"216.219.116.244",443,6,366,17765,0,0,4,246,2,120,225.226846,0.2902880000000039,6779,3307
"172.16.133.75",51146,"172.16.139.250",5440,10,1022,17766,0,0,10,1022,0,0,225.229383,0.005387999999982185,1517446,0
"172.16.133.87",60434,"172.16.139.250",5440,10,1022,17767,0,0,10,1022,0,0,225.248787,0.015772999999995818,518354,0
"172.16.133.35",50140,"172.16.139.250",5440,12,1142,17768,0,0,12,1142,0,0,225.254919,0.04290100000000052,212955,0
"172.16.133.116",53911,"172.16.139.250",5440,10,1022,17769,0,0,10,1022,0,0,225.259919,0.008397999999999683,973565,0
"172.16.133.116",53912,"172.16.139.250",5440,10,1022,17770,0,0,10,1022,0,0,225.26931,0.015802000000007865,517402,0
"172.16.133.93",60974,"173.194.43.45",80,33,24461,17771,0,0,15,6904,18,17557,225.275581,59.34835400000003,930,2366
"172.16.133.84",58975,"172.16.139.250",5440,10,1022,17772,0,0,10,1022,0,0,225.28399,0.01530400000001464,534239,0
"172.16.133.116",53913,"172.16.139.250",5440,10,1022,17773,0,0,10,1022,0,0,225.285997,0.005427999999994881,1506263,0
"172.16.133.93",60975,"173.194.43.36",80,49,38638,17774,0,0,19,2682,30,35956,225.321972,59.809905999999984,358,4809
"172.16.133.93",60976,"173.194.43.36",80,20,12591,17775,0,0,9,1298,11,11293,225.322174,45.422931000000034,228,1988
"172.16.133.93",60977,"173.194.43.36",80,24,15838,17776,0,0,10,1358,14,14480,225.322345,45.410334000000006,239,2550
"172.16.133.28",49327,"96.43.146.22",443,19,6423,17777,0,0,12,5576,7,847,225.334184,65.66388899999998,679,103
"172.16.133.93",60978,"23.33.95.139",80,6,372,17778,0,0,4,246,2,126,225.339689,12.17590100000001,161,82
"172.16.133.93",60979,"23.33.95.139",80,6,372,17779,0,0,4,246,2,126,225.339819,12.176035999999982,161,82
"172.16.133.93",60980,"173.194.43.57",80,6,372,17780,0,0,4,246,2,126,225.34,12.176060000000007,161,82
"172.16.133.93",60981,"173.194.43.57",80,6,372,17781,0,0,4,246,2,126,225.340111,12.176263000000006,161,82
"172.16.133.93",60982,"173.194.43.57",80,6,372,17782,0,0,4,246,2,126,225.340316,12.176416999999987,161,82
"172.16.133.93",60983,"173.194.43.57",80,6,372,17783,0,0,4,246,2,126,225.340425,12.176355999999998,161,82
"172.16.133.93",60984,"74.63.52.167",80,441,441691,17784,0,0,148,15072,293,426619,225.357387,12.156921000000011,9918,280741
"172.16.133.93",60985,"74.63.52.167",80,423,420703,17785,0,0,146,14109,277,406594,225.358543,12.155552999999998,9285,267593
"172.16.133.93",60986,"74.63.52.167",80,364,360601,17786,0,0,124,12693,240,347908,225.3588,12.155833999999999,8353,228965
"172.16.133.93",60987,"74.63.52.167",80,505,506620,17787,0,0,170,16392,335,490228,225.359018,12.155731000000003,10787,322631
"172.16.133.93",60988,"74.63.52.167",80,429,431248,17788,0,0,144,14344,285,416904,225.359233,12.155201000000005,9440,274387
"172.16.133.49",55961,"172.16.139.250",5440,10,1022,17789,0,0,10,1022,0,0,225.359295,0.015095000000002301,541636,0
"172.16.133.93",60989,"74.63.52.167",80,501,494158,17790,0,0,176,15932,325,478226,225.35951,12.155350999999996,10485,314742
"172.16.133.93",60990,"173.194.43.36",80,31,22925,17791,0,0,12,1478,19,21447,225.362243,45.361571,260,3782
"172.16.133.93",60991,"173.194.43.36",80,28,20839,17792,0,0,11,1418,17,19421,225.362473,45.37009600000002,250,3424
"172.16.133.93",60992,"173.194.43.36",80,22,15550,17793,0,0,9,1298,13,14252,225.362673,45.36886200000001,228,2513
"172.16.133.93",60993,"208.47.254.83",80,6,372,17794,0,0,4,246,2,126,225.371777,12.131236000000001,162,83
"172.16.133.93",60994,"208.47.254.83",80,6,372,17795,0,0,4,246,2,126,225.371953,12.132094000000023,162,83
"172.16.133.93",60995,"208.47.254.83",80,16,4873,17796,0,0,10,3539,6,1334,225.372106,59.86275199999997,472,178
"172.16.133.87",60435,"68.64.4.249",443,6,366,17797,0,0,4,246,2,120,225.391232,0.11372099999999818,17305,8441
"172.16.133.95",57143,"172.16.139.250",5440,12,1142,17798,0,0,12,1142,0,0,225.402154,0.016314999999991642,559975,0
"172.16.133.92",57848,"172.16.139.250",5440,10,1022,17799,0,0,10,1022,0,0,225.427623,0.005615999999974974,1455840,0
"172.16.133.29",61183,"172.16.139.250",5440,10,1022,17800,0,0,10,1022,0,0,225.444481,0.005450999999993655,1499908,0
"172.16.133.44",65009,"172.16.139.250",5440,10,1022,17801,0,0,10,1022,0,0,225.451862,0.005387999999982185,1517446,0
"172.16.133.66",54375,"173.194.43.53",443,17,3919,17802,0,0,9,2879,8,1040,225.455559,27.658984000000004,832,300
"172.16.133.207",56117,"172.16.139.250",5440,10,1022,17803,0,0,10,1022,0,0,225.475706,0.00495699999999033,"",""
"172.16.133.83",57255,"172.16.139.250",5440,12,1142,17804,0,0,12,1142,0,0,225.485885,0.013796000000013464,662220,0
"172.16.133.132",56392,"199.27.208.55",80,121,83374,17805,0,0,61,5531,60,77843,225.494548,14.638818999999984,3022,42540
"172.16.133.132",56393,"199.27.208.55",80,19,7547,17806,0,0,11,1694,8,5853,225.497679,14.639276999999993,925,3198
"172.16.133.93",60996,"172.16.139.250",5440,12,1142,17807,0,0,12,1142,0,0,225.500318,0.0053460000000029595,1708941,0
"172.16.133.132",56394,"199.27.208.55",80,9,1656,17808,0,0,6,972,3,684,225.50065,14.637326000000002,531,373
"172.16.133.132",56395,"199.27.208.55",80,10,1718,17809,0,0,6,969,4,749,225.503627,14.630740000000003,529,409
"172.16.133.11",55344,"172.16.139.250",5440,10,1022,17810,0,0,10,1022,0,0,225.519424,0.015461000000016156,528814,0
"172.16.133.55",57799,"172.16.139.250",5440,12,1142,17811,0,0,12,1142,0,0,225.522922,0.006426000000004706,1421724,0
"172.16.133.73",60855,"172.16.139.250",5440,10,1022,17812,0,0,10,1022,0,0,225.545062,0.005869999999987385,1392844,0
"172.16.133.53",54283,"172.16.139.250",5440,10,1022,17813,0,0,10,1022,0,0,225.548443,0.0062130000000024665,1315950,0
"172.16.133.21",53357,"172.16.139.250",5440,10,1022,17814,0,0,10,1022,0,0,225.550813,0.015183000000007496,538497,0
"172.16.133.30",62851,"172.16.139.250",5440,10,1022,17815,0,0,10,1022,0,0,225.557204,0.016335999999995465,500489,0
"172.16.133.25",63659,"172.16.139.250",5440,10,1022,17816,0,0,10,1022,0,0,225.562846,0.006791999999990139,1203769,0
"172.16.133.34",50648,"172.16.139.250",5440,12,1142,17817,0,0,12,1142,0,0,225.571583,0.006155000000006794,1484321,0
"172.16.133.93",60997,"67.217.95.254",443,6,366,17818,0,0,4,246,2,120,225.580799,0.047081999999988966,41799,20389
"172.16.133.97",59560,"172.16.139.250",5440,10,1022,17819,0,0,10,1022,0,0,225.583137,0.01471300000000042,555699,0
"172.16.133.33",58068,"172.16.139.250",5440,10,1022,17820,0,0,10,1022,0,0,225.652562,0.011031000000002678,741183,0
"172.16.133.93",60998,"78.108.117.250",443,6,366,17821,0,0,4,246,2,120,225.682781,0.21460199999998508,9170,4473
"172.16.133.93",60999,"216.219.117.244",443,6,366,17822,0,0,4,246,2,120,225.683733,0.2242559999999969,8775,4280
"172.16.133.68",60939,"172.16.139.250",5440,10,1022,17823,0,0,10,1022,0,0,225.688231,0.005603000000007796,1459218,0
"172.16.133.12",59962,"172.16.139.250",5440,10,1022,17824,0,0,10,1022,0,0,225.701465,0.0056489999999769225,1447335,0
"172.16.133.63",54106,"172.16.139.250",5440,10,1022,17825,0,0,10,1022,0,0,225.713007,0.015269999999986794,535428,0
"172.16.133.60",62190,"68.64.5.249",443,6,366,17826,0,0,4,246,2,120,225.720065,0.11818600000000856,16651,8122
"172.16.133.66",54376,"172.16.139.250",5440,10,1022,17827,0,0,10,1022,0,0,225.723611,0.008713999999997668,938260,0
"172.16.133.82",61614,"172.16.139.250",5440,10,1022,17828,0,0,10,1022,0,0,225.738675,0.0055629999999951,1469710,0
"172.16.133.37",60831,"172.16.139.250",5440,10,1022,17829,0,0,10,1022,0,0,225.752163,0.00695899999999483,1174881,0
"172.16.133.60",62191,"68.64.25.250",443,6,366,17830,0,0,4,246,2,120,225.796957,0.13022800000001666,15111,7371
"172.16.133.60",62192,"216.115.209.254",443,6,366,17831,0,0,4,246,2,120,225.830991,0.20692799999997646,9510,4639
"172.16.133.66",54377,"173.194.43.53",443,15,4421,17832,0,0,9,3565,6,856,225.844072,0.556841999999989,51217,12297
"172.16.133.66",54378,"173.194.43.53",443,93,57180,17833,0,0,45,25327,48,31853,225.844212,50.45100799999997,4016,5050
"172.16.133.78",59420,"172.16.139.250",5440,12,1142,17834,0,0,12,1142,0,0,225.909129,0.006326000000001386,1444198,0
"172.16.133.60",62193,"78.108.119.250",443,6,366,17835,0,0,4,246,2,120,225.929105,0.2736969999999985,7190,3507
"172.16.133.67",56178,"172.16.139.250",5440,12,1142,17836,0,0,12,1142,0,0,225.964213,0.006351999999992586,1438287,0
"172.16.133.93",61000,"202.173.25.200",443,6,366,17837,0,0,4,246,2,120,225.97671,0.5507179999999892,3573,1743
"172.16.133.56",61605,"172.16.139.250",5440,10,1022,17838,0,0,10,1022,0,0,225.986049,0.00489399999997886,"",""
"172.16.133.41",53323,"172.16.139.250",5440,10,1022,17839,0,0,10,1022,0,0,226.042176,0.021887999999989916,373538,0
"172.16.133.93",61001,"63.241.108.124",80,15,9566,17840,0,0,8,4148,7,5418,226.051159,0.16241199999998912,204319,266876
"172.16.133.93",61002,"63.241.108.124",80,15,9582,17841,0,0,8,4159,7,5423,226.053581,0.1843020000000024,180529,235396
"172.16.133.93",61003,"63.241.108.124",80,12,6395,17842,0,0,7,3697,5,2698,226.055135,0.1361880000000042,217170,158486
"172.16.133.43",57949,"172.16.139.250",5440,12,1142,17843,0,0,12,1142,0,0,226.111938,0.006547999999980902,1395235,0
"172.16.133.13",53216,"172.16.139.250",5440,10,1022,17844,0,0,10,1022,0,0,226.131387,0.005440000000021428,1502941,0
"172.16.133.85",52459,"172.16.139.250",5440,10,1022,17845,0,0,10,1022,0,0,226.138045,0.015476000000006707,528301,0
"172.16.133.93",61004,"138.108.6.20",80,8,1428,17846,0,0,4,770,4,658,226.159678,10.800188999999989,570,487
"172.16.133.93",61005,"138.108.6.20",80,8,1422,17847,0,0,4,764,4,658,226.159792,11.649985999999984,524,451
"172.16.133.93",61006,"138.108.6.20",80,4,252,17848,0,0,2,126,2,126,226.159884,10.997292999999985,91,91
"172.16.133.93",61007,"138.108.6.20",80,8,1427,17849,0,0,4,769,4,658,226.160002,10.294139000000001,597,511
"172.16.133.113",55707,"172.16.139.250",135,8,492,17850,0,0,8,492,0,0,226.179591,0.03162400000002208,124462,0
"172.16.133.20",62579,"172.16.139.250",5440,10,1022,17851,0,0,10,1022,0,0,226.180711,0.014240000000000919,574157,0
"172.16.133.42",57293,"172.16.139.250",5440,12,1142,17852,0,0,12,1142,0,0,226.202013,0.048943000000008396,186666,0
"172.16.133.28",49328,"172.16.139.250",5440,12,1142,17853,0,0,12,1142,0,0,226.209781,0.015224000000017668,600105,0
"172.16.133.113",55708,"172.16.139.250",5462,10,696,17854,0,0,10,696,0,0,226.211678,0.5151869999999974,10807,0
"172.16.133.99",56234,"172.16.139.250",5440,12,1142,17855,0,0,12,1142,0,0,226.238529,0.01677799999998797,544522,0
"172.16.133.75",51147,"172.16.139.250",5440,10,1022,17856,0,0,10,1022,0,0,226.243722,0.007617000000010421,1073388,0
"172.16.133.87",60436,"172.16.139.250",5440,10,1022,17857,0,0,10,1022,0,0,226.262895,0.005659000000008518,1444778,0
"172.16.133.35",50141,"172.16.139.250",5440,12,1142,17858,0,0,12,1142,0,0,226.27027,0.02261199999998098,404033,0
"172.16.133.116",53914,"172.16.139.250",5440,10,1022,17859,0,0,10,1022,0,0,226.273488,0.005345000000005484,1529653,0
"172.16.133.116",53915,"172.16.139.250",5440,10,1022,17860,0,0,10,1022,0,0,226.279739,0.006518999999997277,1254180,0
"172.16.133.116",53916,"172.16.139.250",5440,10,1022,17861,0,0,10,1022,0,0,226.287147,0.017657999999983076,463019,0
"172.16.133.84",58976,"172.16.139.250",5440,10,1022,17862,0,0,10,1022,0,0,226.295773,0.005427999999994881,1506263,0
"172.16.133.49",55962,"172.16.139.250",5440,10,1022,17863,0,0,10,1022,0,0,226.372895,0.005012999999991052,1630959,0
"172.16.133.95",57144,"172.16.139.250",5440,12,1142,17864,0,0,12,1142,0,0,226.415088,0.015203000000013844,600934,0
"172.16.133.92",57849,"172.16.139.250",5440,10,1022,17865,0,0,10,1022,0,0,226.440659,0.006176999999979671,1323619,0
"172.16.133.29",61184,"172.16.139.250",5440,10,1022,17866,0,0,10,1022,0,0,226.45863,0.009229000000004817,885903,0
"172.16.133.44",65010,"172.16.139.250",5440,10,1022,17867,0,0,10,1022,0,0,226.466036,0.018497999999993908,441993,0
"172.16.133.207",56118,"172.16.139.250",5440,10,1022,17868,0,0,10,1022,0,0,226.490609,0.004692000000005692,"",""
"172.16.133.83",57256,"172.16.139.250",5440,12,1142,17869,0,0,12,1142,0,0,226.499875,0.004776999999990039,"",""
"172.16.133.93",61008,"172.16.139.250",5440,10,1022,17870,0,0,10,1022,0,0,226.514112,0.004577999999980875,"",""
"172.16.133.11",55345,"172.16.139.250",5440,10,1022,17871,0,0,10,1022,0,0,226.532333,0.005648000000007869,1447592,0
"172.16.133.55",57800,"172.16.139.250",5440,10,1022,17872,0,0,10,1022,0,0,226.53792,0.015084999999999127,541995,0
"172.16.133.73",60856,"172.16.139.250",5440,12,1142,17873,0,0,12,1142,0,0,226.559677,0.015292000000016515,597436,0
"172.16.133.53",54284,"172.16.139.250",5440,10,1022,17874,0,0,10,1022,0,0,226.562602,0.022032999999993308,371079,0
"172.16.133.21",53358,"172.16.139.250",5440,10,1022,17875,0,0,10,1022,0,0,226.56497,0.005679000000014867,1439690,0
"172.16.133.30",62852,"172.16.139.250",5440,10,1022,17876,0,0,10,1022,0,0,226.570261,0.008712000000002718,938475,0
"172.16.133.20",62580,"116.90.133.49",80,30,34109,17877,0,0,6,692,24,33417,226.574701,1.4642020000000002,3780,182581
"172.16.133.25",63660,"172.16.139.250",5440,10,1022,17878,0,0,10,1022,0,0,226.576591,0.012006999999982781,680936,0
"172.16.133.34",50649,"172.16.139.250",5440,12,1142,17879,0,0,12,1142,0,0,226.585633,0.008192000000008193,1115234,0
"172.16.133.97",59561,"172.16.139.250",5440,12,1142,17880,0,0,12,1142,0,0,226.595351,0.006236999999998716,1464806,0
"172.16.133.33",58069,"172.16.139.250",5440,12,1142,17881,0,0,12,1142,0,0,226.667656,0.008358000000015409,1093084,0
"172.16.133.68",60940,"172.16.139.250",5440,10,1022,17882,0,0,10,1022,0,0,226.702379,0.005452999999988606,1499358,0
"172.16.133.12",59963,"172.16.139.250",5440,12,1142,17883,0,0,12,1142,0,0,226.71555,0.006968000000000529,1311136,0
"172.16.133.63",54107,"172.16.139.250",5440,10,1022,17884,0,0,10,1022,0,0,226.727751,0.005335999999999785,1532233,0
"172.16.133.66",54379,"172.16.139.250",5440,10,1022,17885,0,0,10,1022,0,0,226.739573,0.005540999999993801,1475545,0
"172.16.133.82",61615,"172.16.139.250",5440,12,1142,17886,0,0,12,1142,0,0,226.752276,0.006303000000002612,1449468,0
"172.16.133.37",60832,"172.16.139.250",5440,10,1022,17887,0,0,10,1022,0,0,226.766209,0.005683000000004768,1438676,0
"172.16.133.12",59964,"216.115.216.250",443,6,366,17888,0,0,4,246,2,120,226.863866,0.06281100000001061,31332,15283
"172.16.133.93",61009,"63.116.244.154",80,9,1310,17889,0,0,5,778,4,532,226.873849,45.06809900000002,138,94
"172.16.133.78",59421,"172.16.139.250",5440,10,1022,17890,0,0,10,1022,0,0,226.923412,0.005523999999979878,1480086,0
"172.16.133.12",59965,"68.64.26.250",443,6,366,17891,0,0,4,246,2,120,226.93279,0.0986859999999865,19942,9727
"172.16.133.12",59966,"68.64.4.249",443,6,366,17892,0,0,4,246,2,120,226.949792,0.09648300000000631,20397,9949
"172.16.133.67",56179,"172.16.139.250",5440,12,1142,17893,0,0,12,1142,0,0,226.977669,0.01550800000001118,589115,0
"172.16.133.56",61606,"172.16.139.250",5440,10,1022,17894,0,0,10,1022,0,0,227.000689,0.004778000000015936,"",""
"172.16.133.41",53324,"172.16.139.250",5440,12,1142,17895,0,0,12,1142,0,0,227.056035,0.015405999999984488,593015,0
"172.16.133.43",57950,"172.16.139.250",5440,12,1142,17896,0,0,12,1142,0,0,227.126459,0.015085999999996602,605594,0
"172.16.133.13",53217,"172.16.139.250",5440,12,1142,17897,0,0,12,1142,0,0,227.145215,0.019621999999998252,465599,0
"172.16.133.42",57294,"172.16.139.250",5440,12,1142,17898,0,0,12,1142,0,0,227.147817,0.010990999999989981,831225,0
"172.16.133.85",52460,"172.16.139.250",5440,10,1022,17899,0,0,10,1022,0,0,227.150981,0.00936300000000756,873224,0
"172.16.133.20",62581,"172.16.139.250",5440,10,1022,17900,0,0,10,1022,0,0,227.194744,0.004783000000003312,"",""
"172.16.133.28",49329,"172.16.139.250",5440,10,1022,17901,0,0,10,1022,0,0,227.223979,0.005359999999996035,1525373,0
"172.16.133.99",56235,"172.16.139.250",5440,12,1142,17902,0,0,12,1142,0,0,227.252469,0.005099000000001297,1791723,0
"172.16.133.75",51148,"172.16.139.250",5440,10,1022,17903,0,0,10,1022,0,0,227.25722,0.005187000000006492,1576248,0
"172.16.133.87",60437,"172.16.139.250",5440,10,1022,17904,0,0,10,1022,0,0,227.277049,0.015352000000007138,532569,0
"172.16.133.35",50142,"172.16.139.250",5440,12,1142,17905,0,0,12,1142,0,0,227.280835,0.009499000000005253,961785,0
"172.16.133.116",53917,"172.16.139.250",5440,10,1022,17906,0,0,10,1022,0,0,227.28812,0.00814500000001317,1003806,0
"172.16.133.116",53918,"172.16.139.250",5440,10,1022,17907,0,0,10,1022,0,0,227.297247,0.014835000000005039,551129,0
"172.16.133.84",58977,"172.16.139.250",5440,10,1022,17908,0,0,10,1022,0,0,227.311064,0.015353000000004613,532534,0
"172.16.133.116",53919,"172.16.139.250",5440,10,1022,17909,0,0,10,1022,0,0,227.312991,0.0171489999999892,476762,0
"172.16.133.16",59366,"23.67.243.64",80,8,959,17910,0,0,5,509,3,450,227.352586,25.76267100000001,158,139
"172.16.133.12",59967,"216.219.116.244",443,6,366,17911,0,0,4,246,2,120,227.381929,0.3039679999999976,6474,3158
"172.16.133.49",55963,"172.16.139.250",5440,12,1142,17912,0,0,12,1142,0,0,227.386937,0.0061990000000093914,1473786,0
"172.16.133.95",57145,"172.16.139.250",5440,10,1022,17913,0,0,10,1022,0,0,227.430367,0.005959000000018477,1372042,0
"172.16.133.92",57850,"172.16.139.250",5440,10,1022,17914,0,0,10,1022,0,0,227.4541,0.01518399999997655,538461,0
"172.16.133.29",61185,"172.16.139.250",5440,12,1142,17915,0,0,12,1142,0,0,227.473071,0.006224000000003116,1467866,0
"172.16.133.44",65011,"172.16.139.250",5440,10,1022,17916,0,0,10,1022,0,0,227.479148,0.005380999999999858,1519420,0
"172.16.133.207",56119,"172.16.139.250",5440,12,1142,17917,0,0,12,1142,0,0,227.504565,0.018028999999984308,506739,0
"172.16.133.83",57257,"172.16.139.250",5440,12,1142,17918,0,0,12,1142,0,0,227.513965,0.004705999999998767,"",""
"172.16.133.93",61010,"172.16.139.250",5440,12,1142,17919,0,0,12,1142,0,0,227.528974,0.005128999999982398,1781243,0
"172.16.133.11",55346,"172.16.139.250",5440,10,1022,17920,0,0,10,1022,0,0,227.547488,0.005678000000017391,1439943,0
"172.16.133.55",57801,"172.16.139.250",5440,12,1142,17921,0,0,12,1142,0,0,227.551885,0.005740000000002965,1591637,0
"172.16.133.73",60857,"172.16.139.250",5440,12,1142,17922,0,0,12,1142,0,0,227.573394,0.01812400000000025,504082,0
"172.16.133.53",54285,"172.16.139.250",5440,10,1022,17923,0,0,10,1022,0,0,227.576832,0.0056460000000129185,1448104,0
"172.16.133.21",53359,"172.16.139.250",5440,12,1142,17924,0,0,12,1142,0,0,227.579207,0.008012000000007902,1140289,0
"172.16.133.30",62853,"172.16.139.250",5440,10,1022,17925,0,0,10,1022,0,0,227.584025,0.010131999999998698,806948,0
"172.16.133.25",63661,"172.16.139.250",5440,10,1022,17926,0,0,10,1022,0,0,227.589961,0.007957000000004655,1027522,0
"172.16.133.34",50650,"172.16.139.250",5440,10,1022,17927,0,0,10,1022,0,0,227.599518,0.004902000000015505,"",""
"172.16.133.97",59562,"172.16.139.250",5440,10,1022,17928,0,0,10,1022,0,0,227.610133,0.01468700000000922,556682,0
"172.16.133.93",61011,"67.217.95.254",443,6,366,17929,0,0,4,246,2,120,227.611988,0.041220000000009804,47743,23289
"172.16.133.33",58070,"172.16.139.250",5440,10,1022,17930,0,0,10,1022,0,0,227.681583,0.005672000000004118,1441466,0
"172.16.133.68",60942,"172.16.139.250",5440,10,1022,17931,0,0,10,1022,0,0,227.716416,0.005500999999981104,1486275,0
"172.16.133.12",59968,"172.16.139.250",5440,10,1022,17932,0,0,10,1022,0,0,227.729678,0.0056219999999882475,1454286,0
"172.16.133.63",54108,"172.16.139.250",5440,12,1142,17933,0,0,12,1142,0,0,227.740819,0.00610400000002187,1496723,0
"172.16.133.66",54380,"172.16.139.250",5440,12,1142,17934,0,0,12,1142,0,0,227.752797,0.015477000000004182,590295,0
"172.16.133.82",61616,"172.16.139.250",5440,10,1022,17935,0,0,10,1022,0,0,227.766594,0.015527999999989106,526532,0
"172.16.133.28",49330,"8.27.243.253",80,6,372,17936,0,0,4,246,2,126,227.776182,11.852304000000004,166,85
"172.16.133.28",49331,"8.27.243.253",80,7,432,17937,0,0,4,246,3,186,227.776331,11.853790000000004,166,125
"172.16.133.28",49332,"216.52.242.80",80,6,372,17938,0,0,4,246,2,126,227.776514,11.924272000000002,165,84
"172.16.133.37",60833,"172.16.139.250",5440,10,1022,17939,0,0,10,1022,0,0,227.779143,0.006646999999986747,1230028,0
"172.16.133.60",62194,"68.64.5.249",443,6,366,17940,0,0,4,246,2,120,227.78013,0.1075389999999743,18300,8926
"172.16.133.93",61012,"78.108.117.250",443,6,366,17941,0,0,4,246,2,120,227.798028,0.19983000000001994,9848,4804
"172.16.133.26",53106,"216.52.242.80",80,17,5400,17942,0,0,11,4156,6,1244,227.799175,47.06727999999998,706,211
"172.16.133.93",61013,"216.219.117.244",443,6,366,17943,0,0,4,246,2,120,227.800892,0.20507299999999873,9596,4681
"172.16.133.60",62195,"68.64.25.250",443,6,366,17944,0,0,4,246,2,120,227.865067,0.10979799999998363,17923,8743
"172.16.133.26",53107,"216.52.242.80",80,34,22726,17945,0,0,14,6261,20,16465,227.902769,48.078686999999974,1041,2739
"172.16.133.78",59422,"172.16.139.250",5440,10,1022,17946,0,0,10,1022,0,0,227.936177,0.005527000000000726,1479283,0
"172.16.133.60",62196,"216.115.209.254",443,6,366,17947,0,0,4,246,2,120,227.942909,0.2131000000000256,9235,4504
"172.16.133.67",56180,"172.16.139.250",5440,10,1022,17948,0,0,10,1022,0,0,227.99184,0.005735000000015589,1425632,0
"172.16.133.56",61607,"172.16.139.250",5440,10,1022,17949,0,0,10,1022,0,0,228.015167,0.005677000000019916,1440197,0
"172.16.133.41",53325,"172.16.139.250",5440,10,1022,17950,0,0,10,1022,0,0,228.06915,0.01504099999999653,543580,0
"172.16.133.60",62197,"78.108.119.250",443,6,366,17951,0,0,4,246,2,120,228.071122,0.25262200000000234,7790,3800
"172.16.133.132",50910,"23.33.83.243",80,15,4903,17952,0,0,9,1325,6,3578,228.09897,12.028892999999982,881,2379
"172.16.133.132",50911,"23.33.83.243",80,113,97009,17953,0,0,48,3895,65,93114,228.105935,12.02361400000001,2591,61954
"172.16.133.43",57951,"172.16.139.250",5440,12,1142,17954,0,0,12,1142,0,0,228.139345,0.006141000000013719,1487705,0
"172.16.133.20",62582,"173.194.43.43",80,6,372,17955,0,0,4,246,2,126,228.159158,17.919343999999995,109,56
"172.16.133.20",62583,"173.194.43.43",80,50,44266,17956,0,0,18,1528,32,42738,228.159325,60.75099100000003,201,5627
"172.16.133.13",53218,"172.16.139.250",5440,10,1022,17957,0,0,10,1022,0,0,228.159327,0.005351000000018757,1527938,0
"172.16.133.20",62584,"173.194.43.43",80,49,44274,17958,0,0,17,1468,32,42806,228.159431,60.75099900000001,193,5636
"172.16.133.20",62585,"173.194.43.46",80,7,432,17959,0,0,4,246,3,186,228.16268,17.91610700000001,109,83
"172.16.133.20",62586,"173.194.43.46",80,6,372,17960,0,0,4,246,2,126,228.163324,17.91568700000002,109,56
"172.16.133.42",57295,"172.16.139.250",5440,12,1142,17961,0,0,12,1142,0,0,228.164293,0.025575000000003456,357223,0
"172.16.133.85",52461,"172.16.139.250",5440,10,1022,17962,0,0,10,1022,0,0,228.164895,0.005410000000011905,1511275,0
"172.16.133.20",62587,"116.90.133.49",80,14,2326,17963,0,0,7,1147,7,1179,228.166071,8.156808000000012,1124,1156
"172.16.133.20",62588,"116.90.133.49",80,18,6230,17964,0,0,9,1589,9,4641,228.166469,8.161307999999991,1557,4549
"172.16.133.20",62589,"116.90.133.49",80,42,35059,17965,0,0,16,1637,26,33422,228.166586,8.156194,1605,32781
"172.16.133.20",62590,"116.90.133.49",80,16,3661,17966,0,0,8,1978,8,1683,228.166839,8.161837999999989,1938,1649
"172.16.133.20",62591,"116.90.133.49",80,53,33440,17967,0,0,21,3906,32,29534,228.16708,28.114603999999986,1111,8403
"172.16.133.20",62592,"116.90.133.49",80,18,5758,17968,0,0,9,1311,9,4447,228.167225,18.518736999999987,566,1921
"172.16.133.20",62593,"66.175.215.85",80,18,4282,17969,0,0,9,1797,9,2485,228.167415,7.935444999999987,1811,2505
"172.16.133.20",62594,"66.175.215.85",80,8,504,17970,0,0,5,312,3,192,228.167557,17.911453000000023,139,85
"172.16.133.20",62595,"66.175.215.85",80,17,4262,17971,0,0,9,1837,8,2425,228.167701,27.890862,526,695
"172.16.133.20",62596,"173.194.68.95",80,6,372,17972,0,0,4,246,2,126,228.168912,17.914776999999987,109,56
"172.16.133.20",62597,"173.194.68.95",80,6,372,17973,0,0,4,246,2,126,228.169061,17.915819999999997,109,56
"172.16.133.20",62598,"173.194.68.95",80,6,372,17974,0,0,4,246,2,126,228.169166,17.91548400000002,109,56
"172.16.133.20",62599,"172.16.139.250",5440,12,1142,17975,0,0,12,1142,0,0,228.20951,0.0145870000000059,626311,0
"172.16.133.28",49333,"167.8.226.9",80,14,2912,17976,0,0,7,1912,7,1000,228.227866,0.2089509999999848,73203,38286
"172.16.133.28",49334,"172.16.139.250",5440,10,1022,17977,0,0,10,1022,0,0,228.237565,0.017060000000014952,479249,0
"172.16.133.93",61014,"202.173.25.200",443,6,366,17978,0,0,4,246,2,120,228.256992,0.5523939999999925,3562,1737
"172.16.133.99",56236,"172.16.139.250",5440,10,1022,17979,0,0,10,1022,0,0,228.26663,0.016146000000020422,506379,0
"172.16.133.75",51149,"172.16.139.250",5440,10,1022,17980,0,0,10,1022,0,0,228.27136,0.00710500000002412,1150738,0
"172.16.133.26",53108,"173.194.43.59",80,14,5575,17981,0,0,8,3720,6,1855,228.286843,46.446291,640,319
"172.16.133.87",60438,"172.16.139.250",5440,10,1022,17982,0,0,10,1022,0,0,228.290952,0.008442000000002281,968490,0
"172.16.133.35",50143,"172.16.139.250",5440,12,1142,17983,0,0,12,1142,0,0,228.294439,0.016523999999975558,552892,0
"172.16.133.116",53920,"172.16.139.250",5440,10,1022,17984,0,0,10,1022,0,0,228.302,0.008965000000017653,911991,0
"172.16.133.28",49335,"23.0.49.244",80,7,438,17985,0,0,5,312,2,126,228.308986,21.323687000000007,117,47
"172.16.133.28",49336,"23.0.49.244",80,7,438,17986,0,0,5,312,2,126,228.309318,21.324253,117,47
"172.16.133.116",53921,"172.16.139.250",5440,10,1022,17987,0,0,10,1022,0,0,228.309604,0.01676299999999742,487740,0
"172.16.133.28",49337,"138.108.6.20",80,5,318,17988,0,0,3,192,2,126,228.311883,13.234438000000011,116,76
"172.16.133.28",49338,"64.94.107.62",80,8,494,17989,0,0,5,312,3,182,228.319605,21.30830800000001,117,68
"172.16.133.84",58978,"172.16.139.250",5440,10,1022,17990,0,0,10,1022,0,0,228.325008,0.015442000000007283,529465,0
"172.16.133.116",53922,"172.16.139.250",5440,10,1022,17991,0,0,10,1022,0,0,228.327253,0.016854999999992515,485078,0
"172.16.133.49",55964,"172.16.139.250",5440,10,1022,17992,0,0,10,1022,0,0,228.40113,0.005364000000014357,1524235,0
"172.16.133.95",57146,"172.16.139.250",5440,10,1022,17993,0,0,10,1022,0,0,228.44442,0.015443000000004758,529430,0
"172.16.133.92",57851,"172.16.139.250",5440,10,1022,17994,0,0,10,1022,0,0,228.4698,0.00594300000000203,1375736,0
"172.16.133.29",61186,"172.16.139.250",5440,10,1022,17995,0,0,10,1022,0,0,228.485699,0.01644999999999186,497021,0
"172.16.133.44",65012,"172.16.139.250",5440,10,1022,17996,0,0,10,1022,0,0,228.49304,0.005512999999979229,1483040,0
"172.16.133.207",56120,"172.16.139.250",5440,10,1022,17997,0,0,10,1022,0,0,228.517774,0.00780799999998294,1047131,0
"172.16.133.83",57258,"172.16.139.250",5440,12,1142,17998,0,0,12,1142,0,0,228.528061,0.01411999999999125,647025,0
"172.16.133.93",61015,"172.16.139.250",5440,12,1142,17999,0,0,12,1142,0,0,228.542547,0.005116999999984273,1785421,0
"172.16.133.11",55347,"172.16.139.250",5440,10,1022,18000,0,0,10,1022,0,0,228.560468,0.00543500000000563,1504323,0
"172.16.133.28",49339,"138.108.6.20",80,8,2055,18001,0,0,4,1397,4,658,228.562329,9.904876999999999,1128,531
"172.16.133.55",57802,"172.16.139.250",5440,10,1022,18002,0,0,10,1022,0,0,228.565147,0.005584999999996398,1463921,0
"172.16.133.28",49340,"64.94.107.62",80,8,2040,18003,0,0,5,1577,3,463,228.569192,0.10139200000000415,124427,36531
"172.16.133.73",60858,"172.16.139.250",5440,10,1022,18004,0,0,10,1022,0,0,228.587156,0.0065400000000011005,1250152,0
"172.16.133.53",54286,"172.16.139.250",5440,10,1022,18005,0,0,10,1022,0,0,228.590505,0.006416999999999007,1274115,0
"172.16.133.21",53360,"172.16.139.250",5440,10,1022,18006,0,0,10,1022,0,0,228.593039,0.008065999999985252,1013637,0
"172.16.133.30",62854,"172.16.139.250",5440,10,1022,18007,0,0,10,1022,0,0,228.597885,0.006841000000008535,1195146,0
"172.16.133.25",63662,"172.16.139.250",5440,10,1022,18008,0,0,10,1022,0,0,228.603799,0.017397999999985814,469939,0
"172.16.133.34",50651,"172.16.139.250",5440,10,1022,18009,0,0,10,1022,0,0,228.613663,0.01059799999998745,771466,0
"172.16.133.97",59563,"172.16.139.250",5440,10,1022,18010,0,0,10,1022,0,0,228.624557,0.015527999999989106,526532,0
"172.16.133.33",58071,"172.16.139.250",5440,10,1022,18011,0,0,10,1022,0,0,228.696775,0.01546199999998521,528780,0
"172.16.133.26",53109,"208.111.161.254",80,13,3462,18012,0,0,6,787,7,2675,228.716482,39.345718000000005,160,543
"172.16.133.26",53110,"208.111.161.254",80,13,3364,18013,0,0,6,788,7,2576,228.716704,39.34646100000003,160,523
"172.16.133.26",53111,"208.111.161.254",80,13,3536,18014,0,0,6,788,7,2748,228.716806,39.352001,160,558
"172.16.133.68",60943,"172.16.139.250",5440,10,1022,18015,0,0,10,1022,0,0,228.72927,0.015546999999997979,525889,0
"172.16.133.12",59969,"172.16.139.250",5440,10,1022,18016,0,0,10,1022,0,0,228.743664,0.0053880000000106065,1517446,0
"172.16.133.132",50912,"23.33.83.243",80,6,412,18017,0,0,4,272,2,140,228.745689,11.381719000000004,191,98
"172.16.133.63",54110,"172.16.139.250",5440,12,1142,18018,0,0,12,1142,0,0,228.75502,0.006180999999997994,1478077,0
"172.16.133.66",54381,"172.16.139.250",5440,10,1022,18019,0,0,10,1022,0,0,228.766993,0.005380999999999858,1519420,0
"172.16.133.82",61617,"172.16.139.250",5440,10,1022,18020,0,0,10,1022,0,0,228.780676,0.005461999999994305,1496887,0
"172.16.133.37",60834,"172.16.139.250",5440,10,1022,18021,0,0,10,1022,0,0,228.793061,0.00533500000000231,1532521,0
"172.16.133.78",59423,"172.16.139.250",5440,12,1142,18022,0,0,12,1142,0,0,228.950147,0.006316000000026634,1446485,0
"172.16.133.67",56181,"172.16.139.250",5440,12,1142,18023,0,0,12,1142,0,0,229.006505,0.006870999999989635,1329646,0
"172.16.133.56",61608,"172.16.139.250",5440,10,1022,18024,0,0,10,1022,0,0,229.02803,0.014540000000010878,562310,0
"172.16.133.28",49341,"167.8.226.9",80,27,18309,18025,0,0,11,2080,16,16229,229.059283,0.15348800000001006,108412,845877
"172.16.133.41",53326,"172.16.139.250",5440,12,1142,18026,0,0,12,1142,0,0,229.083471,0.01590699999999856,574338,0
"172.16.133.13",53219,"202.173.25.200",443,6,366,18027,0,0,4,246,2,120,229.137183,0.5331099999999935,3691,1800
"172.16.133.13",53220,"78.108.117.250",443,6,366,18028,0,0,4,246,2,120,229.137277,0.1972769999999855,9975,4866
"172.16.133.13",53221,"216.219.117.244",443,6,366,18029,0,0,4,246,2,120,229.138889,0.2008510000000001,9798,4779
"172.16.133.13",53222,"67.217.95.254",443,6,366,18030,0,0,4,246,2,120,229.139711,0.05681300000000533,34639,16897
"172.16.133.43",57952,"172.16.139.250",5440,12,1142,18031,0,0,12,1142,0,0,229.152972,0.015374000000008436,594250,0
"172.16.133.13",53223,"172.16.139.250",5440,10,1022,18032,0,0,10,1022,0,0,229.173521,0.0053690000000017335,1522816,0
"172.16.133.85",52462,"172.16.139.250",5440,12,1142,18033,0,0,12,1142,0,0,229.177958,0.015318000000007714,596422,0
"172.16.133.42",57296,"172.16.139.250",5440,12,1142,18034,0,0,12,1142,0,0,229.180382,0.022532999999981485,405449,0
"172.16.133.20",62600,"172.16.139.250",5440,12,1142,18035,0,0,12,1142,0,0,229.222749,0.004986000000002377,"",""
"172.16.133.28",49342,"23.45.65.67",80,9,1416,18036,0,0,5,981,4,435,229.239568,45.158435000000026,173,77
"172.16.133.28",49343,"23.45.65.67",80,39,36845,18037,0,0,12,1473,27,35372,229.239724,45.37929599999998,259,6235
"172.16.133.28",49344,"172.16.139.250",5440,10,1022,18038,0,0,10,1022,0,0,229.25074,0.014382999999980939,568448,0
"172.16.133.99",56237,"172.16.139.250",5440,12,1142,18039,0,0,12,1142,0,0,229.280645,0.015705999999994447,581688,0
"172.16.133.75",51150,"172.16.139.250",5440,10,1022,18040,0,0,10,1022,0,0,229.28557,0.005498999999986154,1486815,0
"172.16.133.87",60439,"172.16.139.250",5440,10,1022,18041,0,0,10,1022,0,0,229.304933,0.005381999999997333,1519137,0
"172.16.133.35",50144,"172.16.139.250",5440,12,1142,18042,0,0,12,1142,0,0,229.309067,0.014213000000012244,642791,0
"172.16.133.116",53923,"172.16.139.250",5440,10,1022,18043,0,0,10,1022,0,0,229.315819,0.007298999999989064,1120153,0
"172.16.133.116",53924,"172.16.139.250",5440,10,1022,18044,0,0,10,1022,0,0,229.324023,0.0051609999999868705,1584189,0
"172.16.133.116",53925,"172.16.139.250",5440,10,1022,18045,0,0,10,1022,0,0,229.330387,0.005507999999991853,1484386,0
"172.16.133.84",58979,"172.16.139.250",5440,10,1022,18046,0,0,10,1022,0,0,229.338307,0.015202000000016369,537823,0
"172.16.133.49",55965,"172.16.139.250",5440,10,1022,18047,0,0,10,1022,0,0,229.414648,0.005433000000010679,1504877,0
"172.16.133.95",57147,"172.16.139.250",5440,12,1142,18048,0,0,12,1142,0,0,229.458604,0.016010999999991782,570607,0
"172.16.133.92",57852,"172.16.139.250",5440,10,1022,18049,0,0,10,1022,0,0,229.482682,0.0056489999999769225,1447335,0
"172.16.133.29",61187,"172.16.139.250",5440,10,1022,18050,0,0,10,1022,0,0,229.499934,0.0052809999999965385,1548191,0
"172.16.133.44",65013,"172.16.139.250",5440,12,1142,18051,0,0,12,1142,0,0,229.507271,0.015298999999998841,597163,0
"172.16.133.207",56121,"172.16.139.250",5440,12,1142,18052,0,0,12,1142,0,0,229.532555,0.018753000000003794,487175,0
"172.16.133.83",57259,"172.16.139.250",5440,12,1142,18053,0,0,12,1142,0,0,229.54214,0.0049130000000161544,"",""
"172.16.133.93",61016,"172.16.139.250",5440,12,1142,18054,0,0,12,1142,0,0,229.55682,0.005023000000022648,1818833,0
"172.16.133.11",55348,"172.16.139.250",5440,10,1022,18055,0,0,10,1022,0,0,229.575618,0.005636000000009744,1450674,0
"172.16.133.55",57803,"172.16.139.250",5440,12,1142,18056,0,0,12,1142,0,0,229.58042,0.015396000000009735,593400,0
"172.16.133.73",60859,"172.16.139.250",5440,10,1022,18057,0,0,10,1022,0,0,229.601168,0.005493999999998778,1488168,0
"172.16.133.53",54287,"172.16.139.250",5440,10,1022,18058,0,0,10,1022,0,0,229.604536,0.0060060000000135005,1361305,0
"172.16.133.21",53361,"172.16.139.250",5440,10,1022,18059,0,0,10,1022,0,0,229.607117,0.01478900000000749,552843,0
"172.16.133.30",62855,"172.16.139.250",5440,10,1022,18060,0,0,10,1022,0,0,229.612185,0.01730999999998062,472328,0
"172.16.133.25",63663,"172.16.139.250",5440,12,1142,18061,0,0,12,1142,0,0,229.617565,0.008227999999974145,1110354,0
"172.16.133.34",50652,"172.16.139.250",5440,10,1022,18062,0,0,10,1022,0,0,229.627905,0.005559000000005199,1470768,0
"172.16.133.93",61017,"67.217.95.254",443,6,366,18063,0,0,4,246,2,120,229.638058,0.054595000000006166,36047,17584
"172.16.133.97",59564,"172.16.139.250",5440,12,1142,18064,0,0,12,1142,0,0,229.63876,0.01530999999999949,596734,0
"172.16.133.24",57705,"193.120.199.14",12350,22,2645,18065,0,0,11,1438,11,1207,229.652706,1.1084330000000193,10378,8711
"172.16.133.28",49345,"63.97.94.126",80,9,2002,18066,0,0,6,1286,3,716,229.678528,45.255288999999976,227,126
"172.16.133.33",58072,"172.16.139.250",5440,10,1022,18067,0,0,10,1022,0,0,229.708803,0.005423000000007505,1507652,0
"172.16.133.26",53112,"173.194.43.59",80,6,372,18068,0,0,4,246,2,126,229.713473,18.350959000000017,107,54
"172.16.133.26",53113,"173.194.43.59",80,6,372,18069,0,0,4,246,2,126,229.713647,18.351675,107,54
"172.16.133.68",60944,"172.16.139.250",5440,10,1022,18070,0,0,10,1022,0,0,229.743483,0.005501000000009526,1486275,0
"172.16.133.12",59970,"172.16.139.250",5440,10,1022,18071,0,0,10,1022,0,0,229.757575,0.005329999999986512,1533958,0
"172.16.133.63",54111,"172.16.139.250",5440,10,1022,18072,0,0,10,1022,0,0,229.76898,0.01562300000000505,523330,0
"172.16.133.66",54382,"172.16.139.250",5440,10,1022,18073,0,0,10,1022,0,0,229.781424,0.00703300000000695,1162519,0
"172.16.133.82",61618,"172.16.139.250",5440,10,1022,18074,0,0,10,1022,0,0,229.794604,0.005431000000015729,1505431,0
"172.16.133.26",53114,"208.111.161.254",80,17,6893,18075,0,0,8,919,9,5974,229.807142,38.26154300000002,192,1249
"172.16.133.26",53115,"208.111.161.254",80,13,3396,18076,0,0,6,787,7,2609,229.807346,38.261662,164,545
"172.16.133.26",53116,"208.111.161.254",80,13,3259,18077,0,0,6,787,7,2472,229.807526,38.261386000000016,164,516
"172.16.133.37",60835,"172.16.139.250",5440,12,1142,18078,0,0,12,1142,0,0,229.809059,0.006366000000014083,1435124,0
"172.16.133.60",62198,"68.64.5.249",443,6,366,18079,0,0,4,246,2,120,229.837123,0.10751500000000647,18304,8928
"172.16.133.93",61018,"78.108.117.250",443,6,366,18080,0,0,4,246,2,120,229.905996,0.22054900000000544,8923,4352
"172.16.133.93",61019,"216.219.117.244",443,6,366,18081,0,0,4,246,2,120,229.909899,0.2189610000000073,8987,4384
"172.16.133.60",62199,"68.64.25.250",443,6,366,18082,0,0,4,246,2,120,229.924256,0.10458499999998594,18817,9179
"172.16.133.28",49346,"63.97.94.126",1935,39,20457,18083,0,0,18,5013,21,15444,229.939648,21.150552000000005,1896,5841
"172.16.133.28",49347,"63.97.94.126",80,1123,1267554,18084,0,0,275,20741,848,1246813,229.94001,21.119263999999987,7856,472294
"172.16.133.28",49348,"63.97.94.126",80,127,45412,18085,0,0,64,22902,63,22510,229.954667,21.12655799999999,8672,8523
"172.16.133.78",59424,"172.16.139.250",5440,10,1022,18086,0,0,10,1022,0,0,229.964682,0.005561999999997624,1469974,0
"172.16.133.67",56182,"172.16.139.250",5440,12,1142,18087,0,0,12,1142,0,0,230.019932,0.006365999999985661,1435124,0
"172.16.133.56",61609,"172.16.139.250",5440,12,1142,18088,0,0,12,1142,0,0,230.041124,0.0049960000000055516,"",""
"172.16.133.60",62200,"216.115.209.254",443,6,366,18089,0,0,4,246,2,120,230.049176,0.208689000000021,9430,4600
"172.16.133.41",53327,"172.16.139.250",5440,12,1142,18090,0,0,12,1142,0,0,230.097109,0.015284000000008291,597749,0
"172.16.133.43",57953,"172.16.139.250",5440,10,1022,18091,0,0,10,1022,0,0,230.1666,0.015038000000004104,543689,0
"172.16.133.13",53224,"172.16.139.250",5440,10,1022,18092,0,0,10,1022,0,0,230.186298,0.01529500000000894,534553,0
"172.16.133.85",52463,"172.16.139.250",5440,10,1022,18093,0,0,10,1022,0,0,230.192301,0.0056420000000230175,1449131,0
"172.16.133.42",57297,"172.16.139.250",5440,12,1142,18094,0,0,12,1142,0,0,230.194505,0.020915999999999713,436794,0
"172.16.133.60",62201,"78.108.119.250",443,6,366,18095,0,0,4,246,2,120,230.202091,0.24647500000000377,7984,3894
"172.16.133.20",62601,"172.16.139.250",5440,12,1142,18096,0,0,12,1142,0,0,230.23725,0.005061000000011973,1805176,0
"172.16.133.28",49349,"172.16.139.250",5440,10,1022,18097,0,0,10,1022,0,0,230.265107,0.006183999999990419,1322121,0
"172.16.133.99",56238,"172.16.139.250",5440,10,1022,18098,0,0,10,1022,0,0,230.295031,0.005079999999992424,1609448,0
"172.16.133.75",51151,"172.16.139.250",5440,10,1022,18099,0,0,10,1022,0,0,230.299644,0.005370999999996684,1522249,0
"172.16.133.87",60440,"172.16.139.250",5440,10,1022,18100,0,0,10,1022,0,0,230.318879,0.01786099999998214,457757,0
"172.16.133.35",50145,"172.16.139.250",5440,12,1142,18101,0,0,12,1142,0,0,230.32296,0.015032000000019252,607770,0
"172.16.133.116",53926,"172.16.139.250",5440,10,1022,18102,0,0,10,1022,0,0,230.330339,0.0105959999999925,771611,0
"172.16.133.116",53927,"172.16.139.250",5440,10,1022,18103,0,0,10,1022,0,0,230.34163,0.006688999999994394,1222305,0
"172.16.133.116",53928,"172.16.139.250",5440,10,1022,18104,0,0,10,1022,0,0,230.348963,0.004762999999996964,"",""
"172.16.133.84",58980,"172.16.139.250",5440,10,1022,18105,0,0,10,1022,0,0,230.352634,0.005516000000000076,1482233,0
"172.16.133.28",49350,"167.8.226.13",80,8,1361,18106,0,0,5,897,3,464,230.359245,0.07726500000001124,92875,48042
"172.16.133.49",55966,"172.16.139.250",5440,10,1022,18107,0,0,10,1022,0,0,230.428791,0.015800000000012915,517468,0
"172.16.133.95",57148,"172.16.139.250",5440,12,1142,18108,0,0,12,1142,0,0,230.471274,0.006294999999994388,1451310,0
"172.16.133.92",57853,"172.16.139.250",5440,10,1022,18109,0,0,10,1022,0,0,230.497756,0.005632999999988897,1451446,0
"172.16.133.29",61188,"172.16.139.250",5440,10,1022,18110,0,0,10,1022,0,0,230.515073,0.005290000000002237,1545557,0
"172.16.133.44",65014,"172.16.139.250",5440,12,1142,18111,0,0,12,1142,0,0,230.522178,0.006168000000002394,1481193,0
"172.16.133.93",61020,"202.173.25.200",443,6,366,18112,0,0,4,246,2,120,230.533057,0.5167969999999968,3808,1857
"172.16.133.207",56122,"172.16.139.250",5440,12,1142,18113,0,0,12,1142,0,0,230.546654,0.018175000000013597,502668,0
"172.16.133.83",57260,"172.16.139.250",5440,12,1142,18114,0,0,12,1142,0,0,230.556073,0.005327999999991562,1714714,0
"172.16.133.93",61021,"172.16.139.250",5440,12,1142,18115,0,0,12,1142,0,0,230.570619,0.01435700000001816,636344,0
"172.16.133.11",55349,"172.16.139.250",5440,10,1022,18116,0,0,10,1022,0,0,230.589914,0.006293999999996913,1299014,0
"172.16.133.55",57804,"172.16.139.250",5440,12,1142,18117,0,0,12,1142,0,0,230.593113,0.015438000000017382,591786,0
"172.16.133.73",60860,"172.16.139.250",5440,10,1022,18118,0,0,10,1022,0,0,230.615337,0.005381999999997333,1519137,0
"172.16.133.53",54288,"172.16.139.250",5440,12,1142,18119,0,0,12,1142,0,0,230.619069,0.017404999999996562,524906,0
"172.16.133.21",53362,"172.16.139.250",5440,10,1022,18120,0,0,10,1022,0,0,230.621231,0.005667000000016742,1442738,0
"172.16.133.30",62856,"172.16.139.250",5440,10,1022,18121,0,0,10,1022,0,0,230.626321,0.005380000000002383,1519702,0
"172.16.133.25",63664,"172.16.139.250",5440,12,1142,18122,0,0,12,1142,0,0,230.632078,0.007689999999996644,1188036,0
"172.16.133.34",50653,"172.16.139.250",5440,10,1022,18123,0,0,10,1022,0,0,230.641556,0.014478999999994357,564679,0
"172.16.133.97",59565,"172.16.139.250",5440,10,1022,18124,0,0,10,1022,0,0,230.652279,0.015037000000006628,543725,0
"172.16.133.33",58073,"172.16.139.250",5440,10,1022,18125,0,0,10,1022,0,0,230.723547,0.005618999999995822,1455063,0
"172.16.133.113",55709,"172.16.139.250",135,8,492,18126,0,0,8,492,0,0,230.745126,0.023130000000008977,170168,0
"172.16.133.68",60945,"172.16.139.250",5440,10,1022,18127,0,0,10,1022,0,0,230.757421,0.0055949999999995725,1461304,0
"172.16.133.12",59971,"172.16.139.250",5440,10,1022,18128,0,0,10,1022,0,0,230.771582,0.005381999999997333,1519137,0
"172.16.133.113",55710,"172.16.139.250",5462,12,816,18129,0,0,12,816,0,0,230.77917,0.5284269999999935,12353,0
"172.16.133.63",54112,"172.16.139.250",5440,10,1022,18130,0,0,10,1022,0,0,230.783241,0.005401000000006206,1513793,0
"172.16.133.66",54383,"172.16.139.250",5440,10,1022,18131,0,0,10,1022,0,0,230.793858,0.0059410000000070795,1376199,0
"172.16.133.82",61619,"172.16.139.250",5440,10,1022,18132,0,0,10,1022,0,0,230.808412,0.016417999999987387,497990,0
"172.16.133.37",60836,"172.16.139.250",5440,10,1022,18133,0,0,10,1022,0,0,230.821273,0.006773000000009688,1207146,0
"172.16.133.78",59425,"172.16.139.250",5440,10,1022,18134,0,0,10,1022,0,0,230.978289,0.007806000000016411,1047399,0
"172.16.133.28",49351,"63.97.94.126",80,7,428,18135,0,0,4,246,3,182,230.996269,18.679842999999977,105,77
"172.16.133.67",56183,"172.16.139.250",5440,12,1142,18136,0,0,12,1142,0,0,231.034199,0.006288000000012062,1452926,0
"172.16.133.56",61610,"172.16.139.250",5440,10,1022,18137,0,0,10,1022,0,0,231.055684,0.004812999999984413,"",""
"172.16.133.41",53328,"172.16.139.250",5440,10,1022,18138,0,0,10,1022,0,0,231.111179,0.015035000000011678,543797,0
"172.16.133.13",53225,"67.217.95.254",443,6,366,18139,0,0,4,246,2,120,231.169001,0.04958899999999744,39686,19359
"172.16.133.43",57954,"172.16.139.250",5440,12,1142,18140,0,0,12,1142,0,0,231.179997,0.006168999999999869,1480953,0
"172.16.133.13",53226,"172.16.139.250",5440,10,1022,18141,0,0,10,1022,0,0,231.200827,0.01574399999998377,519308,0
"172.16.133.85",52464,"172.16.139.250",5440,10,1022,18142,0,0,10,1022,0,0,231.207273,0.005401000000006206,1513793,0
"172.16.133.42",57298,"172.16.139.250",5440,12,1142,18143,0,0,12,1142,0,0,231.212271,0.009801000000010163,932149,0
"172.16.133.13",53227,"78.108.117.250",443,6,366,18144,0,0,4,246,2,120,231.243961,0.20309199999999805,9690,4726
"172.16.133.13",53228,"216.219.117.244",443,6,366,18145,0,0,4,246,2,120,231.246819,0.20420000000001437,9637,4701
"172.16.133.20",62602,"172.16.139.250",5440,10,1022,18146,0,0,10,1022,0,0,231.251082,0.014164999999991323,577197,0
"172.16.133.28",49352,"172.16.139.250",5440,10,1022,18147,0,0,10,1022,0,0,231.278693,0.0052349999999989905,1561795,0
"172.16.133.99",56239,"172.16.139.250",5440,12,1142,18148,0,0,12,1142,0,0,231.307845,0.01572500000000332,580985,0
"172.16.133.75",51152,"172.16.139.250",5440,12,1142,18149,0,0,12,1142,0,0,231.313966,0.00622100000001069,1468574,0
"172.16.133.87",60441,"172.16.139.250",5440,10,1022,18150,0,0,10,1022,0,0,231.332634,0.00534799999999791,1528795,0
"172.16.133.35",50146,"172.16.139.250",5440,12,1142,18151,0,0,12,1142,0,0,231.336353,0.010121999999995523,902588,0
"172.16.128.169",3323,"172.16.139.250",21,8,505,18152,0,0,4,242,4,263,231.342904,0.30389399999998545,6370,6923
"172.16.133.116",53929,"172.16.139.250",5440,10,1022,18153,0,0,10,1022,0,0,231.34392,0.015956000000016957,512409,0
"172.16.133.116",53930,"172.16.139.250",5440,10,1022,18154,0,0,10,1022,0,0,231.360482,0.005385000000018181,1518291,0
"172.16.133.116",53931,"172.16.139.250",5440,10,1022,18155,0,0,10,1022,0,0,231.366549,0.006653999999997495,1228734,0
"172.16.133.84",58981,"172.16.139.250",5440,12,1142,18156,0,0,12,1142,0,0,231.367639,0.015574000000015076,586618,0
"172.16.133.13",53229,"202.173.25.200",443,6,366,18157,0,0,4,246,2,120,231.403023,0.5228170000000034,3764,1836
"172.16.133.49",55967,"172.16.139.250",5440,12,1142,18158,0,0,12,1142,0,0,231.443054,0.0066330000000220934,1377355,0
"172.16.133.95",57149,"172.16.139.250",5440,10,1022,18159,0,0,10,1022,0,0,231.485425,0.015543000000008078,526024,0
"172.16.133.92",57854,"172.16.139.250",5440,10,1022,18160,0,0,10,1022,0,0,231.51095,0.005580999999978076,1464970,0
"172.16.133.29",61189,"172.16.139.250",5440,10,1022,18161,0,0,10,1022,0,0,231.527737,0.005516999999997552,1481964,0
"172.16.133.44",65015,"172.16.139.250",5440,10,1022,18162,0,0,10,1022,0,0,231.536088,0.005423000000007505,1507652,0
"172.16.133.28",49353,"167.8.226.13",80,8,1361,18163,0,0,5,897,3,464,231.541001,0.08796000000000959,81582,42201
"172.16.133.207",56123,"172.16.139.250",5440,12,1142,18164,0,0,12,1142,0,0,231.560787,0.004856999999987011,"",""
"172.16.133.83",57261,"172.16.139.250",5440,12,1142,18165,0,0,12,1142,0,0,231.570239,0.014842000000015787,615550,0
"172.16.133.93",61022,"172.16.139.250",5440,12,1142,18166,0,0,12,1142,0,0,231.584555,0.004878000000019256,"",""
"172.16.133.11",55350,"172.16.139.250",5440,10,1022,18167,0,0,10,1022,0,0,231.603098,0.015212000000019543,537470,0
"172.16.133.55",57805,"172.16.139.250",5440,12,1142,18168,0,0,12,1142,0,0,231.608573,0.006240999999988617,1463867,0
"172.16.133.73",60861,"172.16.139.250",5440,10,1022,18169,0,0,10,1022,0,0,231.629444,0.015311999999994441,533960,0
"172.16.133.53",54289,"172.16.139.250",5440,12,1142,18170,0,0,12,1142,0,0,231.63206,0.021253999999998996,429848,0
"172.16.133.21",53363,"172.16.139.250",5440,10,1022,18171,0,0,10,1022,0,0,231.635213,0.005684000000002243,1438423,0
"172.16.133.30",62857,"172.16.139.250",5440,10,1022,18172,0,0,10,1022,0,0,231.639423,0.009576000000009799,853801,0
"172.16.133.25",63665,"172.16.139.250",5440,10,1022,18173,0,0,10,1022,0,0,231.645718,0.010524000000003753,776890,0
"172.16.133.34",50654,"172.16.139.250",5440,12,1142,18174,0,0,12,1142,0,0,231.655676,0.005244000000004689,1742181,0
"172.16.133.97",59566,"172.16.139.250",5440,12,1142,18175,0,0,12,1142,0,0,231.666398,0.015370000000018536,594404,0
"172.16.133.33",58074,"172.16.139.250",5440,12,1142,18176,0,0,12,1142,0,0,231.737516,0.006371000000001459,1433997,0
"172.16.133.68",60946,"172.16.139.250",5440,10,1022,18177,0,0,10,1022,0,0,231.771257,0.005557000000010248,1471297,0
"172.16.133.12",59972,"172.16.139.250",5440,10,1022,18178,0,0,10,1022,0,0,231.786268,0.005415999999996757,1509601,0
"172.16.133.63",54113,"172.16.139.250",5440,10,1022,18179,0,0,10,1022,0,0,231.797913,0.014679999999998472,556948,0
"172.16.133.66",54384,"172.16.139.250",5440,12,1142,18180,0,0,12,1142,0,0,231.80955,0.007420999999993683,1231100,0
"172.16.133.82",61620,"172.16.139.250",5440,10,1022,18181,0,0,10,1022,0,0,231.822664,0.005516999999997552,1481964,0
"172.16.133.37",60837,"172.16.139.250",5440,10,1022,18182,0,0,10,1022,0,0,231.835392,0.015373999999980015,531806,0
"172.16.133.78",59426,"172.16.139.250",5440,10,1022,18183,0,0,10,1022,0,0,231.993181,0.0050190000000043256,1629009,0
"172.16.133.67",56184,"172.16.139.250",5440,10,1022,18184,0,0,10,1022,0,0,232.04754,0.012616000000008398,648065,0
"172.16.133.56",61611,"172.16.139.250",5440,12,1142,18185,0,0,12,1142,0,0,232.06966,0.004953000000000429,"",""
"172.16.133.41",53329,"172.16.139.250",5440,12,1142,18186,0,0,12,1142,0,0,232.125207,0.015244000000024016,599317,0
"172.16.133.43",57955,"172.16.139.250",5440,10,1022,18187,0,0,10,1022,0,0,232.193993,0.014716999999990321,555548,0
"172.16.133.13",53230,"172.16.139.250",5440,10,1022,18188,0,0,10,1022,0,0,232.214535,0.005521999999984928,1480622,0
"172.16.133.85",52465,"172.16.139.250",5440,10,1022,18189,0,0,10,1022,0,0,232.22095,0.014551000000011527,561885,0
"172.16.133.42",57299,"172.16.139.250",5440,12,1142,18190,0,0,12,1142,0,0,232.254124,0.022160000000013724,412274,0
"172.16.133.20",62603,"172.16.139.250",5440,10,1022,18191,0,0,10,1022,0,0,232.264875,0.004838000000006559,"",""
"172.16.133.28",49354,"172.16.139.250",5440,10,1022,18192,0,0,10,1022,0,0,232.293013,0.005493999999998778,1488168,0
"172.16.133.99",56240,"172.16.139.250",5440,10,1022,18193,0,0,10,1022,0,0,232.321855,0.015185999999999922,538390,0
"172.16.133.75",51153,"172.16.139.250",5440,10,1022,18194,0,0,10,1022,0,0,232.327756,0.005354000000011183,1527082,0
"172.16.133.87",60442,"172.16.139.250",5440,10,1022,18195,0,0,10,1022,0,0,232.346935,0.01480200000000309,552357,0
"172.16.133.35",50147,"172.16.139.250",5440,12,1142,18196,0,0,12,1142,0,0,232.351747,0.007902999999998883,1156016,0
"172.16.133.116",53932,"172.16.139.250",5440,10,1022,18197,0,0,10,1022,0,0,232.358156,0.00719999999998322,1135555,0
"172.16.133.116",53933,"172.16.139.250",5440,10,1022,18198,0,0,10,1022,0,0,232.365828,0.0050160000000119,1629984,0
"172.16.133.116",53934,"172.16.139.250",5440,10,1022,18199,0,0,10,1022,0,0,232.371304,0.004559000000000424,"",""
"172.16.133.84",58982,"172.16.139.250",5440,10,1022,18200,0,0,10,1022,0,0,232.379883,0.005334000000004835,1532808,0
"172.16.133.49",55968,"172.16.139.250",5440,10,1022,18201,0,0,10,1022,0,0,232.455903,0.005516000000000076,1482233,0
"172.16.133.95",57150,"172.16.139.250",5440,10,1022,18202,0,0,10,1022,0,0,232.500305,0.005814000000015085,1406260,0
"172.16.133.92",57855,"172.16.139.250",5440,10,1022,18203,0,0,10,1022,0,0,232.524889,0.0056730000000015934,1441212,0
"172.16.133.29",61190,"172.16.139.250",5440,10,1022,18204,0,0,10,1022,0,0,232.541747,0.014476999999999407,564757,0
"172.16.133.44",65016,"172.16.139.250",5440,10,1022,18205,0,0,10,1022,0,0,232.55012,0.015516000000019403,526939,0
"172.16.133.207",56124,"172.16.139.250",5440,10,1022,18206,0,0,10,1022,0,0,232.573724,0.014675000000011096,557137,0
"172.16.133.83",57262,"172.16.139.250",5440,12,1142,18207,0,0,12,1142,0,0,232.58421,0.007902999999998883,1156016,0
"172.16.133.93",61023,"172.16.139.250",5440,10,1022,18208,0,0,10,1022,0,0,232.599747,0.014377999999993563,568646,0
"172.16.133.11",55351,"172.16.139.250",5440,10,1022,18209,0,0,10,1022,0,0,232.617844,0.005591000000009672,1462350,0
"172.16.133.55",57806,"172.16.139.250",5440,10,1022,18210,0,0,10,1022,0,0,232.621101,0.014791000000002441,552768,0
"172.16.133.73",60862,"172.16.139.250",5440,10,1022,18211,0,0,10,1022,0,0,232.643789,0.006073000000014872,1346286,0
"172.16.133.53",54290,"172.16.139.250",5440,12,1142,18212,0,0,12,1142,0,0,232.645722,0.04540499999998815,201211,0
"172.16.133.21",53364,"172.16.139.250",5440,12,1142,18213,0,0,12,1142,0,0,232.649498,0.10153300000001764,89980,0
"172.16.133.30",62858,"172.16.139.250",5440,12,1142,18214,0,0,12,1142,0,0,232.653953,0.10602299999999332,86169,0
"172.16.133.25",63666,"172.16.139.250",5440,10,1022,18215,0,0,10,1022,0,0,232.659862,0.09598900000000299,85176,0
"172.16.133.34",50655,"172.16.139.250",5440,12,1142,18216,0,0,12,1142,0,0,232.669802,0.09400899999999979,97182,0
"172.16.133.97",59567,"172.16.139.250",5440,10,1022,18217,0,0,10,1022,0,0,232.680753,0.08739499999998657,93552,0
"172.16.133.33",58075,"172.16.139.250",5440,12,1142,18218,0,0,12,1142,0,0,232.751652,0.021556000000003905,423826,0
"172.16.133.68",60947,"172.16.139.250",5440,12,1142,18219,0,0,12,1142,0,0,232.784915,0.015779999999978145,578960,0
"172.16.133.12",59973,"172.16.139.250",5440,12,1142,18220,0,0,12,1142,0,0,232.799696,0.016608999999988328,550063,0
"172.16.133.63",54114,"172.16.139.250",5440,12,1142,18221,0,0,12,1142,0,0,232.811943,0.008004999999997153,1141286,0
"172.16.133.66",54385,"172.16.139.250",5440,10,1022,18222,0,0,10,1022,0,0,232.822045,0.005343000000010534,1530226,0
"172.16.133.82",61621,"172.16.139.250",5440,12,1142,18223,0,0,12,1142,0,0,232.836769,0.005561000000000149,1642869,0
"172.16.133.67",56185,"173.194.43.46",443,59,24135,18224,0,0,27,4114,32,20021,232.84401,67.02566299999998,491,2389
"172.16.133.37",60838,"172.16.139.250",5440,10,1022,18225,0,0,10,1022,0,0,232.849371,0.005086000000005697,1607550,0
"172.16.133.96",53375,"173.194.43.41",443,20,4607,18226,0,0,12,3306,8,1301,232.963457,0.13754599999998618,192284,75669
"172.16.133.78",59427,"172.16.139.250",5440,10,1022,18227,0,0,10,1022,0,0,233.007489,0.005519000000020924,1481427,0
"172.16.133.67",56186,"172.16.139.250",5440,10,1022,18228,0,0,10,1022,0,0,233.061812,0.014995999999996457,545212,0
"172.16.133.56",61612,"172.16.139.250",5440,12,1142,18229,0,0,12,1142,0,0,233.083301,0.014645000000001573,623830,0
"172.16.133.41",53330,"172.16.139.250",5440,12,1142,18230,0,0,12,1142,0,0,233.138107,0.015365000000002738,594598,0
"172.16.133.13",53231,"67.217.95.254",443,6,366,18231,0,0,4,246,2,120,233.203065,0.04397199999999657,44755,21832
"172.16.133.43",57956,"172.16.139.250",5440,10,1022,18232,0,0,10,1022,0,0,233.208615,0.005476999999984855,1492788,0
"172.16.133.13",53232,"172.16.139.250",5440,12,1142,18233,0,0,12,1142,0,0,233.228599,0.00622100000001069,1468574,0
"172.16.133.85",52466,"172.16.139.250",5440,10,1022,18234,0,0,10,1022,0,0,233.235184,0.005417999999991707,1509043,0
"172.16.133.42",57300,"172.16.139.250",5440,12,1142,18235,0,0,12,1142,0,0,233.239617,0.017783999999977596,513720,0
"172.16.133.97",59568,"172.16.139.250",5440,10,1022,18236,0,0,10,1022,0,0,233.275554,0.005535000000008949,1477145,0
"172.16.133.20",62604,"172.16.139.250",5440,10,1022,18237,0,0,10,1022,0,0,233.278704,0.016177999999996473,505377,0
"172.16.133.28",49355,"172.16.139.250",5440,12,1142,18238,0,0,12,1142,0,0,233.307322,0.006283999999993739,1453851,0
"172.16.133.99",56241,"172.16.139.250",5440,10,1022,18239,0,0,10,1022,0,0,233.337046,0.014715000000023792,555623,0
"172.16.133.75",51154,"172.16.139.250",5440,10,1022,18240,0,0,10,1022,0,0,233.341612,0.006068999999996549,1347174,0
"172.16.133.13",53233,"78.108.117.250",443,6,366,18241,0,0,4,246,2,120,233.345855,0.2047420000000102,9612,4688
"172.16.133.87",60443,"172.16.139.250",5440,10,1022,18242,0,0,10,1022,0,0,233.360792,0.016680000000008022,490167,0
"172.16.133.35",50148,"172.16.139.250",5440,12,1142,18243,0,0,12,1142,0,0,233.364634,0.01973800000001802,462863,0
"172.16.133.116",53935,"172.16.139.250",5440,10,1022,18244,0,0,10,1022,0,0,233.371898,0.009308000000004313,878384,0
"172.16.133.13",53234,"216.219.117.244",443,6,366,18245,0,0,4,246,2,120,233.374639,0.2041189999999915,9641,4703
"172.16.133.116",53936,"172.16.139.250",5440,10,1022,18246,0,0,10,1022,0,0,233.382167,0.0054689999999766314,1494971,0
"172.16.133.116",53937,"172.16.139.250",5440,10,1022,18247,0,0,10,1022,0,0,233.389192,0.005628999999998996,1452478,0
"172.16.133.84",58983,"172.16.139.250",5440,12,1142,18248,0,0,12,1142,0,0,233.394038,0.0060709999999915,1504859,0
"172.16.133.49",55969,"172.16.139.250",5440,10,1022,18249,0,0,10,1022,0,0,233.469881,0.015719000000018468,520134,0
"172.16.133.16",59367,"208.85.44.22",80,1663,1752993,18250,0,0,524,33144,1139,1719849,233.479855,1.0176500000000033,260553,13520161
"172.16.133.95",57151,"172.16.139.250",5440,12,1142,18251,0,0,12,1142,0,0,233.512365,0.01545800000002373,591020,0
"172.16.133.92",57856,"172.16.139.250",5440,10,1022,18252,0,0,10,1022,0,0,233.537763,0.005561000000000149,1470239,0
"172.16.133.29",61191,"172.16.139.250",5440,12,1142,18253,0,0,12,1142,0,0,233.556073,0.006192999999996118,1475213,0
"172.16.133.44",65017,"172.16.139.250",5440,12,1142,18254,0,0,12,1142,0,0,233.563318,0.0161549999999977,565521,0
"172.16.133.207",56125,"172.16.139.250",5440,10,1022,18255,0,0,10,1022,0,0,233.587987,0.014397000000002436,567896,0
"172.16.133.83",57263,"172.16.139.250",5440,12,1142,18256,0,0,12,1142,0,0,233.598201,0.014042000000017651,650619,0
"172.16.133.93",61024,"172.16.139.250",5440,10,1022,18257,0,0,10,1022,0,0,233.612822,0.014320999999995365,570909,0
"172.16.133.11",55352,"172.16.139.250",5440,10,1022,18258,0,0,10,1022,0,0,233.630413,0.014823000000006914,551575,0
"172.16.133.55",57807,"172.16.139.250",5440,12,1142,18259,0,0,12,1142,0,0,233.63507,0.006380999999976211,1431750,0
"172.16.133.73",60863,"172.16.139.250",5440,12,1142,18260,0,0,12,1142,0,0,233.657184,0.006357000000008384,1437155,0
"172.16.133.53",54291,"172.16.139.250",5440,12,1142,18261,0,0,12,1142,0,0,233.659984,0.006781999999986965,1347095,0
"172.16.133.21",53365,"172.16.139.250",5440,12,1142,18262,0,0,12,1142,0,0,233.663184,0.01670599999999922,546869,0
"172.16.133.13",53235,"202.173.25.200",443,6,366,18263,0,0,4,246,2,120,233.66807,0.6039470000000051,3258,1589
"172.16.133.30",62860,"172.16.139.250",5440,12,1142,18264,0,0,12,1142,0,0,233.668785,0.0071159999999963475,1283867,0
"172.16.133.25",63667,"172.16.139.250",5440,12,1142,18265,0,0,12,1142,0,0,233.674325,0.00872199999997747,1047466,0
"172.16.133.34",50656,"172.16.139.250",5440,12,1142,18266,0,0,12,1142,0,0,233.682544,0.005306999999987738,1721499,0
"172.16.133.97",59569,"172.16.139.250",5440,10,1022,18267,0,0,10,1022,0,0,233.694466,0.005403000000001157,1513233,0
"172.16.133.33",58076,"172.16.139.250",5440,10,1022,18268,0,0,10,1022,0,0,233.765835,0.017036999999987756,479896,0
"172.16.133.68",60948,"172.16.139.250",5440,12,1142,18269,0,0,12,1142,0,0,233.799365,0.00627299999999309,1456400,0
"172.16.133.12",59974,"172.16.139.250",5440,12,1142,18270,0,0,12,1142,0,0,233.813814,0.0062669999999798165,1457794,0
"172.16.133.63",54115,"172.16.139.250",5440,12,1142,18271,0,0,12,1142,0,0,233.82502,0.006163000000015018,1482394,0
"172.16.133.66",54386,"172.16.139.250",5440,10,1022,18272,0,0,10,1022,0,0,233.836991,0.005823999999989837,1403846,0
"172.16.133.82",61622,"172.16.139.250",5440,10,1022,18273,0,0,10,1022,0,0,233.850435,0.00565399999999272,1446055,0
"172.16.133.37",60840,"172.16.139.250",5440,10,1022,18274,0,0,10,1022,0,0,233.863098,0.005486999999988029,1490067,0
"172.16.133.78",59428,"172.16.139.250",5440,10,1022,18275,0,0,10,1022,0,0,234.020153,0.012930000000011432,632327,0
"172.16.133.67",56187,"172.16.139.250",5440,10,1022,18276,0,0,10,1022,0,0,234.076384,0.015272000000010166,535358,0
"172.16.133.56",61613,"172.16.139.250",5440,12,1142,18277,0,0,12,1142,0,0,234.098354,0.005047999999987951,1809825,0
"172.16.133.41",53331,"172.16.139.250",5440,12,1142,18278,0,0,12,1142,0,0,234.156186,0.015575000000012551,586581,0
"172.16.133.43",57957,"172.16.139.250",5440,12,1142,18279,0,0,12,1142,0,0,234.221935,0.01645700000000261,555143,0
"172.16.133.13",53236,"172.16.139.250",5440,10,1022,18280,0,0,10,1022,0,0,234.242586,0.005403000000001157,1513233,0
"172.16.133.85",52467,"172.16.139.250",5440,10,1022,18281,0,0,10,1022,0,0,234.249023,0.005752999999998565,1421171,0
"172.16.133.42",57301,"172.16.139.250",5440,12,1142,18282,0,0,12,1142,0,0,234.251728,0.026680999999996402,342415,0
"172.16.133.20",62605,"172.16.139.250",5440,10,1022,18283,0,0,10,1022,0,0,234.292951,0.01468700000000922,556682,0
"172.16.133.28",49356,"172.16.139.250",5440,10,1022,18284,0,0,10,1022,0,0,234.321015,0.005492000000003827,1488710,0
"172.16.133.99",56242,"172.16.139.250",5440,12,1142,18285,0,0,12,1142,0,0,234.350308,0.0051379999999880965,1778123,0
"172.16.133.75",51155,"172.16.139.250",5440,10,1022,18286,0,0,10,1022,0,0,234.355635,0.005438999999995531,1503217,0
"172.16.133.55",57808,"72.32.20.63",80,9,1614,18287,0,0,5,1082,4,532,234.356643,0.2374420000000157,36455,17924
"172.16.133.87",60444,"172.16.139.250",5440,10,1022,18288,0,0,10,1022,0,0,234.373992,0.01691500000001156,483357,0
"172.16.133.35",50149,"172.16.139.250",5440,12,1142,18289,0,0,12,1142,0,0,234.378823,0.02350500000000011,388683,0
"172.16.133.116",53938,"172.16.139.250",5440,10,1022,18290,0,0,10,1022,0,0,234.385931,0.008501999999992904,961656,0
"172.16.133.116",53939,"172.16.139.250",5440,10,1022,18291,0,0,10,1022,0,0,234.395721,0.005474999999989905,1493333,0
"172.16.133.116",53940,"172.16.139.250",5440,10,1022,18292,0,0,10,1022,0,0,234.402164,0.005084000000010747,1608182,0
"172.16.133.84",58984,"172.16.139.250",5440,12,1142,18293,0,0,12,1142,0,0,234.409176,0.006544999999988477,1395874,0
"172.16.133.49",55970,"172.16.139.250",5440,10,1022,18294,0,0,10,1022,0,0,234.483995,0.01588100000000736,514829,0
"172.16.133.95",57152,"172.16.139.250",5440,10,1022,18295,0,0,10,1022,0,0,234.527577,0.00538699999998471,1517727,0
"172.16.133.92",57857,"172.16.139.250",5440,10,1022,18296,0,0,10,1022,0,0,234.551973,0.005652999999995245,1446311,0
"172.16.133.29",61192,"172.16.139.250",5440,10,1022,18297,0,0,10,1022,0,0,234.569599,0.006014999999990778,1359268,0
"172.16.133.44",65018,"172.16.139.250",5440,12,1142,18298,0,0,12,1142,0,0,234.578633,0.0060709999999915,1504859,0
"172.16.133.207",56126,"172.16.139.250",5440,12,1142,18299,0,0,12,1142,0,0,234.602848,0.014688000000006696,622004,0
"172.16.133.83",57264,"172.16.139.250",5440,12,1142,18300,0,0,12,1142,0,0,234.612237,0.01387700000000791,658355,0
"172.16.133.93",61025,"172.16.139.250",5440,12,1142,18301,0,0,12,1142,0,0,234.626478,0.004846000000014783,"",""
"172.16.133.11",55353,"172.16.139.250",5440,10,1022,18302,0,0,10,1022,0,0,234.645564,0.015593999999993002,524304,0
"172.16.133.55",57809,"172.16.139.250",5440,10,1022,18303,0,0,10,1022,0,0,234.649201,0.005574999999993224,1466547,0
"172.16.133.73",60864,"172.16.139.250",5440,10,1022,18304,0,0,10,1022,0,0,234.671354,0.005546999999978652,1473949,0
"172.16.133.53",54292,"172.16.139.250",5440,12,1142,18305,0,0,12,1142,0,0,234.673685,0.007735999999994192,1180972,0
"172.16.133.21",53366,"172.16.139.250",5440,12,1142,18306,0,0,12,1142,0,0,234.677131,0.016057999999986805,568937,0
"172.16.133.30",62861,"172.16.139.250",5440,10,1022,18307,0,0,10,1022,0,0,234.681252,0.005439999999993006,1502941,0
"172.16.133.25",63668,"172.16.139.250",5440,10,1022,18308,0,0,10,1022,0,0,234.687938,0.008513999999991029,960300,0
"172.16.133.34",50657,"172.16.139.250",5440,10,1022,18309,0,0,10,1022,0,0,234.6967,0.005041000000005624,1621900,0
"172.16.133.97",59570,"172.16.139.250",5440,12,1142,18310,0,0,12,1142,0,0,234.708662,0.016089999999991278,567806,0
"172.16.133.33",58077,"172.16.139.250",5440,12,1142,18311,0,0,12,1142,0,0,234.779569,0.015381999999988238,593940,0
"172.16.133.68",60949,"172.16.139.250",5440,10,1022,18312,0,0,10,1022,0,0,234.81337,0.015667000000007647,521861,0
"172.16.133.12",59975,"172.16.139.250",5440,12,1142,18313,0,0,12,1142,0,0,234.827779,0.006285000000019636,1453619,0
"172.16.133.63",54116,"172.16.139.250",5440,10,1022,18314,0,0,10,1022,0,0,234.840128,0.005459999999999354,1497435,0
"172.16.133.66",54387,"172.16.139.250",5440,10,1022,18315,0,0,10,1022,0,0,234.850188,0.00544999999999618,1500183,0
"172.16.133.82",61623,"172.16.139.250",5440,10,1022,18316,0,0,10,1022,0,0,234.864814,0.00686799999999721,1190448,0
"172.16.133.44",65019,"172.16.139.250",5440,10,1016,18317,0,0,10,1016,0,0,234.87438,0.01430899999999724,568034,0
"172.16.133.37",60841,"172.16.139.250",5440,10,1022,18318,0,0,10,1022,0,0,234.877197,0.015658999999999423,522127,0
"172.16.133.18",50308,"173.194.75.105",80,7,2167,18319,0,0,4,1419,3,748,234.927801,0.15021300000000792,75572,39836
"172.16.133.78",59429,"172.16.139.250",5440,10,1022,18320,0,0,10,1022,0,0,235.035388,0.022452999999984513,364138,0
"172.16.133.67",56188,"172.16.139.250",5440,10,1022,18321,0,0,10,1022,0,0,235.089872,0.005310999999977639,1539446,0
"172.16.133.56",61614,"172.16.139.250",5440,12,1142,18322,0,0,12,1142,0,0,235.112452,0.005122000000000071,1783678,0
"172.16.133.41",53332,"172.16.139.250",5440,12,1142,18323,0,0,12,1142,0,0,235.167545,0.016064000000000078,568725,0
"172.16.133.68",60950,"66.151.183.41",80,7,1045,18324,0,0,4,732,3,313,235.226949,16.113377000000014,363,155
"172.16.133.13",53237,"67.217.95.254",443,6,366,18325,0,0,4,246,2,120,235.232198,0.053111999999998716,37053,18075
"172.16.133.43",57958,"172.16.139.250",5440,12,1142,18326,0,0,12,1142,0,0,235.236159,0.005542000000019698,1648502,0
"172.16.133.18",50309,"128.177.36.73",80,286,265352,18327,0,0,100,8506,186,256846,235.24711,7.149392000000006,9518,287404
"172.16.133.13",53238,"172.16.139.250",5440,12,1142,18328,0,0,12,1142,0,0,235.256684,0.006150999999988471,1485286,0
"172.16.133.85",52468,"172.16.139.250",5440,10,1022,18329,0,0,10,1022,0,0,235.262168,0.005324999999999136,1535399,0
"172.16.133.42",57302,"172.16.139.250",5440,12,1142,18330,0,0,12,1142,0,0,235.270519,0.03687600000000657,247749,0
"172.16.133.20",62606,"172.16.139.250",5440,10,1022,18331,0,0,10,1022,0,0,235.306862,0.0047890000000165855,"",""
"172.16.133.113",55711,"172.16.139.250",135,8,492,18332,0,0,8,492,0,0,235.312628,0.011142000000006647,353257,0
"172.16.133.25",63669,"74.125.170.42",80,1732,1880604,18333,0,0,504,32173,1228,1848431,235.323642,32.534249999999986,7911,454519
"172.16.133.68",60951,"54.234.89.21",80,16,9850,18334,0,0,6,868,10,8982,235.324782,0.13598799999999756,51063,528399
"172.16.133.113",55712,"172.16.139.250",5462,10,696,18335,0,0,10,696,0,0,235.327987,0.5252469999999789,10600,0
"172.16.133.28",49357,"172.16.139.250",5440,12,1142,18336,0,0,12,1142,0,0,235.335104,0.006113999999996622,1494275,0
"172.16.133.99",56243,"172.16.139.250",5440,12,1142,18337,0,0,12,1142,0,0,235.363966,0.015174000000001797,602082,0
"172.16.133.75",51156,"172.16.139.250",5440,12,1142,18338,0,0,12,1142,0,0,235.369831,0.006054000000005999,1509084,0
"172.16.133.87",60445,"172.16.139.250",5440,10,1022,18339,0,0,10,1022,0,0,235.388132,0.005207999999981894,1569892,0
"172.16.133.35",50150,"172.16.139.250",5440,12,1142,18340,0,0,12,1142,0,0,235.39577,0.024255000000010796,376664,0
"172.16.133.116",53941,"172.16.139.250",5440,10,1022,18341,0,0,10,1022,0,0,235.399685,0.005154000000004544,1586340,0
"172.16.133.113",55713,"74.125.228.113",80,11,4472,18342,0,0,6,2554,5,1918,235.402216,19.19390999999999,1064,799
"172.16.133.116",53942,"172.16.139.250",5440,10,1022,18343,0,0,10,1022,0,0,235.405704,0.01577300000002424,518354,0
"172.16.133.18",50310,"128.177.36.73",80,293,228377,18344,0,0,137,10669,156,217708,235.406687,13.285401000000007,6424,131096
"172.16.133.18",50311,"128.177.36.73",80,27,10849,18345,0,0,13,1503,14,9346,235.407042,9.498838000000006,1265,7871
"172.16.133.96",53376,"173.194.43.53",443,36,12331,18346,0,0,19,7860,17,4471,235.407446,6.39224200000001,9836,5595
"172.16.133.18",50312,"128.177.36.73",80,24,7356,18347,0,0,12,2109,12,5247,235.409276,5.823634999999996,2897,7207
"172.16.133.116",53943,"172.16.139.250",5440,10,1022,18348,0,0,10,1022,0,0,235.422394,0.005597999999991998,1460521,0
"172.16.133.84",58985,"172.16.139.250",5440,10,1022,18349,0,0,10,1022,0,0,235.423098,0.015625999999997475,523230,0
"172.16.133.13",53239,"78.108.117.250",443,8,486,18350,0,0,5,306,3,180,235.458145,0.5016080000000045,4880,2870
"172.16.133.18",50313,"128.177.36.73",80,30,12029,18351,0,0,16,2065,14,9964,235.46449,12.968513999999999,1273,6146
"172.16.133.18",50314,"128.177.36.73",80,28,13773,18352,0,0,13,1858,15,11915,235.469252,9.435096999999985,1575,10102
"172.16.133.13",53240,"216.219.117.244",443,7,426,18353,0,0,5,306,2,120,235.480116,0.5138699999999972,4763,1868
"172.16.133.113",55714,"132.245.2.22",443,28,16632,18354,0,0,13,2170,15,14462,235.482792,0.7534640000000081,23040,153552
"172.16.133.49",55971,"172.16.139.250",5440,12,1142,18355,0,0,12,1142,0,0,235.497992,0.006251999999989266,1461292,0
"172.16.133.95",57153,"172.16.139.250",5440,10,1022,18356,0,0,10,1022,0,0,235.540451,0.006690000000020291,1222122,0
"172.16.133.92",57858,"172.16.139.250",5440,10,1022,18357,0,0,10,1022,0,0,235.565697,0.015504999999990332,527313,0
"172.16.133.29",61193,"172.16.139.250",5440,10,1022,18358,0,0,10,1022,0,0,235.584313,0.005454999999983556,1498808,0
"172.16.133.44",65020,"172.16.139.250",5440,12,1142,18359,0,0,12,1142,0,0,235.590373,0.00623400000000629,1465511,0
"172.16.133.207",56127,"172.16.139.250",5440,12,1142,18360,0,0,12,1142,0,0,235.61597,0.017830000000003565,512394,0
"172.16.133.83",57265,"172.16.139.250",5440,12,1142,18361,0,0,12,1142,0,0,235.625255,0.004758999999978641,"",""
"172.16.133.93",61026,"172.16.139.250",5440,12,1142,18362,0,0,12,1142,0,0,235.64055,0.005027000000012549,1817386,0
"172.16.133.11",55354,"172.16.139.250",5440,12,1142,18363,0,0,12,1142,0,0,235.659157,0.01603099999999813,569895,0
"172.16.133.55",57810,"172.16.139.250",5440,12,1142,18364,0,0,12,1142,0,0,235.66446,0.006400000000013506,1427499,0
"172.16.133.73",60865,"172.16.139.250",5440,10,1022,18365,0,0,10,1022,0,0,235.686338,0.005498999999986154,1486815,0
"172.16.133.53",54293,"172.16.139.250",5440,10,1022,18366,0,0,10,1022,0,0,235.687711,0.007974999999987631,1025203,0
"172.16.133.21",53367,"172.16.139.250",5440,10,1022,18367,0,0,10,1022,0,0,235.691097,0.00837699999999586,976005,0
"172.16.133.30",62862,"172.16.139.250",5440,10,1022,18368,0,0,10,1022,0,0,235.695164,0.017644999999987476,463360,0
"172.16.133.25",63670,"172.16.139.250",5440,10,1022,18369,0,0,10,1022,0,0,235.703796,0.005209999999976844,1569289,0
"172.16.133.34",50658,"172.16.139.250",5440,10,1022,18370,0,0,10,1022,0,0,235.710979,0.014397000000002436,567896,0
"172.16.133.97",59571,"172.16.139.250",5440,12,1142,18371,0,0,12,1142,0,0,235.721734,0.008010000000012951,1140574,0
"172.16.133.33",58078,"172.16.139.250",5440,12,1142,18372,0,0,12,1142,0,0,235.793904,0.016214999999988322,563428,0
"172.16.133.68",60952,"172.16.139.250",5440,10,1022,18373,0,0,10,1022,0,0,235.827457,0.0061749999999847205,1324048,0
"172.16.133.12",59976,"172.16.139.250",5440,12,1142,18374,0,0,12,1142,0,0,235.841658,0.005425000000002456,1684055,0
"172.16.133.37",60842,"157.56.234.118",443,23,9723,18375,0,0,10,1972,13,7751,235.841727,0.46695700000000784,33784,132791
"172.16.133.63",54117,"172.16.139.250",5440,10,1022,18376,0,0,10,1022,0,0,235.853236,0.015541999999982181,526058,0
"172.16.133.66",54388,"172.16.139.250",5440,10,1022,18377,0,0,10,1022,0,0,235.865172,0.007778000000001839,1051169,0
"172.16.133.82",61624,"172.16.139.250",5440,10,1022,18378,0,0,10,1022,0,0,235.878235,0.014880000000005111,549462,0
"172.16.133.37",60843,"172.16.139.250",5440,10,1022,18379,0,0,10,1022,0,0,235.892382,0.01590899999999351,513922,0
"172.16.133.78",59430,"172.16.128.169",8014,14,4870,18380,0,0,7,2050,7,2820,235.939097,37.421937000000014,438,602
"172.16.133.13",53241,"202.173.25.200",443,6,366,18381,0,0,4,246,2,120,235.992131,0.5345979999999884,3681,1795
"172.16.133.78",59431,"172.16.139.250",5440,12,1142,18382,0,0,12,1142,0,0,236.048679,0.013039000000020451,700667,0
"172.16.133.67",56189,"172.16.139.250",5440,10,1022,18383,0,0,10,1022,0,0,236.104304,0.005513999999976704,1482771,0
"172.16.133.56",61615,"172.16.139.250",5440,10,1022,18384,0,0,10,1022,0,0,236.126302,0.014592999999990752,560268,0
"172.16.133.41",53333,"172.16.139.250",5440,12,1142,18385,0,0,12,1142,0,0,236.181233,0.015360000000015361,594791,0
"172.16.133.43",57959,"172.16.139.250",5440,12,1142,18386,0,0,12,1142,0,0,236.25019,0.006223000000005641,1468102,0
"172.16.133.13",53242,"172.16.139.250",5440,12,1142,18387,0,0,12,1142,0,0,236.270323,0.005747000000013713,1589698,0
"172.16.133.85",52469,"172.16.139.250",5440,10,1022,18388,0,0,10,1022,0,0,236.277495,0.005581000000006497,1464970,0
"172.16.133.42",57303,"172.16.139.250",5440,12,1142,18389,0,0,12,1142,0,0,236.278681,0.02578900000000317,354259,0
"172.16.133.20",62607,"172.16.139.250",5440,12,1142,18390,0,0,12,1142,0,0,236.321152,0.014253999999993994,640942,0
"172.16.133.28",49358,"172.16.139.250",5440,10,1022,18391,0,0,10,1022,0,0,236.349666,0.00527399999998579,1550246,0
"172.16.133.99",56244,"172.16.139.250",5440,10,1022,18392,0,0,10,1022,0,0,236.379317,0.014321000000023787,570909,0
"172.16.133.75",51157,"172.16.139.250",5440,10,1022,18393,0,0,10,1022,0,0,236.383924,0.015291999999988093,534658,0
"172.16.133.87",60446,"172.16.139.250",5440,10,1022,18394,0,0,10,1022,0,0,236.402305,0.0056679999999857955,1442484,0
"172.16.133.35",50151,"172.16.139.250",5440,12,1142,18395,0,0,12,1142,0,0,236.406983,0.0328269999999975,278307,0
"172.16.133.116",53944,"172.16.139.250",5440,10,1022,18396,0,0,10,1022,0,0,236.415998,0.00508299999998485,1608498,0
"172.16.133.116",53945,"172.16.139.250",5440,10,1022,18397,0,0,10,1022,0,0,236.42256,0.006020000000006576,1358139,0
"172.16.133.116",53946,"172.16.139.250",5440,10,1022,18398,0,0,10,1022,0,0,236.429558,0.014668000000000347,557403,0
"172.16.133.84",58986,"172.16.139.250",5440,12,1142,18399,0,0,12,1142,0,0,236.436118,0.015198999999995522,601092,0
"172.16.133.96",53377,"74.125.226.193",80,51,50484,18400,0,0,15,1474,36,49010,236.511455,30.122731999999985,391,13016
"172.16.133.49",55972,"172.16.139.250",5440,12,1142,18401,0,0,12,1142,0,0,236.51198,0.005756000000019412,1587213,0
"172.16.133.96",53378,"66.151.183.41",80,7,1204,18402,0,0,4,866,3,338,236.512187,14.82709299999999,467,182
"172.16.133.96",53379,"23.67.242.211",80,10,1757,18403,0,0,6,903,4,854,236.540761,30.09764199999998,240,226
"172.16.133.96",53380,"23.67.243.33",80,13,5763,18404,0,0,7,1407,6,4356,236.541175,30.096047999999996,374,1157
"172.16.133.95",57154,"172.16.139.250",5440,10,1022,18405,0,0,10,1022,0,0,236.554577,0.005338999999992211,1531372,0
"172.16.133.92",57859,"172.16.139.250",5440,12,1142,18406,0,0,12,1142,0,0,236.581316,0.0064020000000084565,1427054,0
"172.16.133.29",61194,"172.16.139.250",5440,12,1142,18407,0,0,12,1142,0,0,236.598121,0.006141000000013719,1487705,0
"172.16.133.96",53381,"54.234.89.21",80,9,1325,18408,0,0,5,947,4,378,236.60055499999999,0.2756470000000206,27484,10970
"172.16.133.44",65021,"172.16.139.250",5440,10,1022,18409,0,0,10,1022,0,0,236.604349,0.005447999999972808,1500734,0
"172.16.133.207",56128,"172.16.139.250",5440,10,1022,18410,0,0,10,1022,0,0,236.630748,0.017139999999983502,477012,0
"172.16.133.83",57266,"172.16.139.250",5440,12,1142,18411,0,0,12,1142,0,0,236.639265,0.005038000000013199,1813418,0
"172.16.133.93",61027,"172.16.139.250",5440,12,1142,18412,0,0,12,1142,0,0,236.654927,0.00487500000002683,"",""
"172.16.133.11",55355,"172.16.139.250",5440,10,1022,18413,0,0,10,1022,0,0,236.672779,0.005621000000019194,1454545,0
"172.16.133.55",57811,"172.16.139.250",5440,10,1022,18414,0,0,10,1022,0,0,236.678886,0.015080999999980804,542139,0
"172.16.133.73",60866,"172.16.139.250",5440,10,1022,18415,0,0,10,1022,0,0,236.701419,0.005606000000000222,1458437,0
"172.16.133.53",54294,"172.16.139.250",5440,10,1022,18416,0,0,10,1022,0,0,236.702094,0.008700000000004593,939770,0
"172.16.133.21",53368,"172.16.139.250",5440,10,1022,18417,0,0,10,1022,0,0,236.705245,0.015771000000000868,518419,0
"172.16.133.30",62863,"172.16.139.250",5440,10,1022,18418,0,0,10,1022,0,0,236.709394,0.00547599999998738,1493060,0
"172.16.133.25",63671,"172.16.139.250",5440,12,1142,18419,0,0,12,1142,0,0,236.716135,0.008781999999996515,1040309,0
"172.16.133.34",50659,"172.16.139.250",5440,10,1022,18420,0,0,10,1022,0,0,236.724784,0.0053650000000118325,1523951,0
"172.16.133.97",59572,"172.16.139.250",5440,10,1022,18421,0,0,10,1022,0,0,236.735439,0.01476699999997777,553666,0
"172.16.133.113",55715,"184.75.210.3",80,9,2517,18422,0,0,5,763,4,1754,236.777264,0.172142000000008,35459,81514
"172.16.133.113",55716,"184.75.210.3",80,19,11456,18423,0,0,10,2335,9,9121,236.779769,62.343909999999994,299,1170
"172.16.133.33",58079,"172.16.139.250",5440,10,1022,18424,0,0,10,1022,0,0,236.807701,0.015583999999989828,524640,0
"172.16.133.96",53382,"173.194.74.121",80,19,9941,18425,0,0,9,1572,10,8369,236.809539,29.83751700000002,421,2243
"172.16.133.68",60953,"172.16.139.250",5440,12,1142,18426,0,0,12,1142,0,0,236.842154,0.014960999999999558,610654,0
"172.16.133.63",54118,"172.16.139.250",5440,10,1022,18427,0,0,10,1022,0,0,236.867227,0.005318999999985863,1537131,0
"172.16.133.12",59977,"172.16.139.250",5440,12,1142,18428,0,0,12,1142,0,0,236.876327,0.006129999999984648,1490375,0
"172.16.133.66",54389,"172.16.139.250",5440,10,1022,18429,0,0,10,1022,0,0,236.878003,0.008145999999982223,1003682,0
"172.16.133.82",61625,"172.16.139.250",5440,10,1022,18430,0,0,10,1022,0,0,236.892867,0.006332000000014659,1291219,0
"172.16.133.37",60844,"172.16.139.250",5440,10,1022,18431,0,0,10,1022,0,0,236.905428,0.005230000000011614,1563288,0
"172.16.133.113",55717,"184.75.210.3",80,5,320,18432,0,0,1,66,4,254,236.91621,21.072685000000007,25,96
"172.16.133.113",55718,"184.75.210.3",80,11,3550,18433,0,0,7,1381,4,2169,236.916217,62.207611000000014,177,278
"172.16.133.113",55719,"184.75.210.3",80,16,8556,18434,0,0,9,1527,7,7029,236.916327,62.207611000000014,196,903
"172.16.133.113",55720,"184.75.210.3",80,9,4168,18435,0,0,6,1367,3,2801,236.916376,62.207561999999996,175,360
"172.16.133.113",55721,"184.75.210.3",80,17,10962,18436,0,0,9,2192,8,8770,236.916378,17.811943999999983,984,3938
"172.16.133.113",55722,"184.75.210.3",80,9,3158,18437,0,0,6,1366,3,1792,236.916379,62.207389999999975,175,230
"172.16.133.113",55723,"74.125.226.77",80,16,8263,18438,0,0,8,1247,8,7016,237.050767,62.07279299999999,160,904
"172.16.133.113",55724,"74.125.226.77",80,82,72022,18439,0,0,31,2612,51,69410,237.050769,62.11155500000001,336,8940
"172.16.133.78",59432,"172.16.139.250",5440,12,1142,18440,0,0,12,1142,0,0,237.06219,0.006453000000021802,1415775,0
"172.16.133.67",56190,"172.16.139.250",5440,10,1022,18441,0,0,10,1022,0,0,237.117208,0.0064009999999825595,1277300,0
"172.16.133.56",61616,"172.16.139.250",5440,12,1142,18442,0,0,12,1142,0,0,237.140946,0.005079999999992424,1798425,0
"172.16.133.41",53334,"172.16.139.250",5440,12,1142,18443,0,0,12,1142,0,0,237.194212,0.006135000000000446,1489160,0
"172.16.133.13",53243,"67.217.95.254",443,7,426,18444,0,0,4,246,3,180,237.262121,0.05678000000000338,34660,25361
"172.16.133.43",57960,"172.16.139.250",5440,12,1142,18445,0,0,12,1142,0,0,237.264062,0.005432000000013204,1681885,0
"172.16.133.13",53244,"172.16.139.250",5440,10,1022,18446,0,0,10,1022,0,0,237.284614,0.005415999999996757,1509601,0
"172.16.133.85",52470,"172.16.139.250",5440,12,1142,18447,0,0,12,1142,0,0,237.28983,0.017839000000009264,512136,0
"172.16.133.42",57304,"172.16.139.250",5440,12,1142,18448,0,0,12,1142,0,0,237.29626,0.014633000000003449,624342,0
"172.16.133.113",55725,"31.13.74.7",80,8,492,18449,0,0,4,246,4,246,237.306172,7.296571,269,269
"172.16.133.113",55726,"31.13.74.7",80,19,10414,18450,0,0,8,1872,11,8542,237.306174,17.414557000000002,859,3924
"172.16.133.20",62608,"172.16.139.250",5440,10,1022,18451,0,0,10,1022,0,0,237.33514,0.014490999999992482,564212,0
"172.16.133.28",49359,"172.16.139.250",5440,10,1022,18452,0,0,10,1022,0,0,237.363149,0.006365000000016607,1284524,0
"172.16.133.99",56245,"172.16.139.250",5440,10,1022,18453,0,0,10,1022,0,0,237.393187,0.014307999999999765,571428,0
"172.16.133.75",51158,"172.16.139.250",5440,10,1022,18454,0,0,10,1022,0,0,237.397721,0.0054110000000093805,1510996,0
"172.16.133.87",60447,"172.16.139.250",5440,10,1022,18455,0,0,10,1022,0,0,237.417329,0.0155950000000189,524270,0
"172.16.133.35",50152,"172.16.139.250",5440,12,1142,18456,0,0,12,1142,0,0,237.42016,0.03367899999997803,271266,0
"172.16.133.116",53947,"172.16.139.250",5440,10,1022,18457,0,0,10,1022,0,0,237.427958,0.008722000000005892,937399,0
"172.16.133.116",53948,"172.16.139.250",5440,10,1022,18458,0,0,10,1022,0,0,237.437559,0.006473999999997204,1262897,0
"172.16.133.116",53949,"172.16.139.250",5440,10,1022,18459,0,0,10,1022,0,0,237.444834,0.005286000000012336,1546727,0
"172.16.133.84",58988,"172.16.139.250",5440,10,1022,18460,0,0,10,1022,0,0,237.450396,0.005568999999979951,1468127,0
"172.16.133.113",55728,"74.125.226.90",80,25,19700,18461,0,0,10,3274,15,16426,237.504965,17.552839000000006,1492,7486
"172.16.133.113",55727,"74.125.226.90",80,12,6283,18462,0,0,7,3215,5,3068,237.505977,18.100561,1420,1355
"172.16.133.113",55729,"31.13.74.7",443,44,23665,18463,0,0,17,3723,27,19942,237.506059,17.805086000000017,1672,8960
"172.16.133.49",55973,"172.16.139.250",5440,10,1022,18464,0,0,10,1022,0,0,237.526236,0.01571999999998752,520101,0
"172.16.133.13",53245,"78.108.117.250",443,6,366,18465,0,0,4,246,2,120,237.562162,0.18733599999998773,10505,5124
"172.16.133.95",57155,"172.16.139.250",5440,10,1022,18466,0,0,10,1022,0,0,237.569892,0.005295999999987089,1543806,0
"172.16.133.13",53246,"216.219.117.244",443,6,366,18467,0,0,4,246,2,120,237.592182,0.20160699999999565,9761,4761
"172.16.133.92",57860,"172.16.139.250",5440,10,1022,18468,0,0,10,1022,0,0,237.593837,0.015432000000004109,529808,0
"172.16.133.29",61195,"172.16.139.250",5440,10,1022,18469,0,0,10,1022,0,0,237.61199,0.005337999999994736,1531659,0
"172.16.133.44",65022,"172.16.139.250",5440,10,1022,18470,0,0,10,1022,0,0,237.618303,0.01577700000001414,518222,0
"172.16.133.207",56129,"172.16.139.250",5440,12,1142,18471,0,0,12,1142,0,0,237.643816,0.018829000000010865,485208,0
"172.16.133.83",57267,"172.16.139.250",5440,12,1142,18472,0,0,12,1142,0,0,237.653598,0.00510300000001962,1790319,0
"172.16.133.93",61028,"172.16.139.250",5440,12,1142,18473,0,0,12,1142,0,0,237.668672,0.014563000000009652,627343,0
"172.16.133.11",55356,"172.16.139.250",5440,10,1022,18474,0,0,10,1022,0,0,237.687425,0.005722000000019989,1428871,0
"172.16.133.55",57812,"172.16.139.250",5440,10,1022,18475,0,0,10,1022,0,0,237.691236,0.006133000000005495,1333115,0
"172.16.133.73",60867,"172.16.139.250",5440,10,1022,18476,0,0,10,1022,0,0,237.713123,0.014427000000011958,566715,0
"172.16.133.53",54295,"172.16.139.250",5440,12,1142,18477,0,0,12,1142,0,0,237.715846,0.016334000000000515,559324,0
"172.16.133.21",53369,"172.16.139.250",5440,10,1022,18478,0,0,10,1022,0,0,237.719298,0.016678999999982125,490197,0
"172.16.133.30",62864,"172.16.139.250",5440,10,1022,18479,0,0,10,1022,0,0,237.722415,0.021236999999985073,384988,0
"172.16.133.25",63672,"172.16.139.250",5440,10,1022,18480,0,0,10,1022,0,0,237.73008,0.009926000000007207,823695,0
"172.16.133.34",50660,"172.16.139.250",5440,10,1022,18481,0,0,10,1022,0,0,237.738961,0.008477999999996655,964378,0
"172.16.133.97",59573,"172.16.139.250",5440,10,1022,18482,0,0,10,1022,0,0,237.74956,0.014563000000009652,561422,0
"172.16.133.33",58080,"172.16.139.250",5440,10,1022,18483,0,0,10,1022,0,0,237.821127,0.015347000000019762,532742,0
"172.16.133.68",60954,"172.16.139.250",5440,10,1022,18484,0,0,10,1022,0,0,237.855469,0.005576999999988175,1466021,0
"172.16.133.12",59978,"172.16.139.250",5440,10,1022,18485,0,0,10,1022,0,0,237.869774,0.01544699999999466,529293,0
"172.16.133.63",54119,"172.16.139.250",5440,10,1022,18486,0,0,10,1022,0,0,237.88104,0.014958999999976186,546560,0
"172.16.133.66",54390,"172.16.139.250",5440,10,1022,18487,0,0,10,1022,0,0,237.893391,0.006365999999985661,1284322,0
"172.16.133.82",61627,"172.16.139.250",5440,10,1022,18488,0,0,10,1022,0,0,237.90687,0.005791000000016311,1411845,0
"172.16.133.37",60845,"172.16.139.250",5440,10,1022,18489,0,0,10,1022,0,0,237.919538,0.005015000000014425,1630309,0
"172.16.133.55",57813,"172.16.128.169",8014,9,1412,18490,0,0,6,1050,3,362,238.04233,10.208522000000016,822,283
"172.16.133.78",59433,"172.16.139.250",5440,12,1142,18491,0,0,12,1142,0,0,238.076374,0.01640199999999936,557005,0
"172.16.133.113",55731,"67.69.196.176",443,13,3081,18492,0,0,7,1381,6,1700,238.117591,61.005908999999974,181,222
"172.16.133.113",55730,"67.69.196.176",443,13,2197,18493,0,0,7,753,6,1444,238.131463,22.53171500000002,267,512
"172.16.133.113",55733,"67.69.174.114",443,13,2192,18494,0,0,7,748,6,1444,238.131596,22.53062699999998,265,512
"172.16.133.113",55732,"67.69.174.114",443,52,44485,18495,0,0,20,2060,32,42425,238.131693,60.99180599999997,270,5564
"172.16.133.67",56191,"172.16.139.250",5440,10,1022,18496,0,0,10,1022,0,0,238.132168,0.005512999999979229,1483040,0
"172.16.133.56",61617,"172.16.139.250",5440,12,1142,18497,0,0,12,1142,0,0,238.154545,0.00496999999998593,"",""
"172.16.133.41",53335,"172.16.139.250",5440,12,1142,18498,0,0,12,1142,0,0,238.209353,0.015237000000013268,599593,0
"172.16.133.13",53247,"202.173.25.200",443,6,366,18499,0,0,4,246,2,120,238.259128,0.5398429999999905,3645,1778
"172.16.133.43",57961,"172.16.139.250",5440,12,1142,18500,0,0,12,1142,0,0,238.278235,0.0062680000000057134,1457562,0
"172.16.133.13",53248,"172.16.139.250",5440,10,1022,18501,0,0,10,1022,0,0,238.298778,0.015479999999996608,528165,0
"172.16.133.85",52471,"172.16.139.250",5440,10,1022,18502,0,0,10,1022,0,0,238.304424,0.019247999999976173,424771,0
"172.16.133.42",57305,"172.16.139.250",5440,12,1142,18503,0,0,12,1142,0,0,238.308815,0.018233999999978323,501042,0
"172.16.133.20",62609,"172.16.139.250",5440,10,1022,18504,0,0,10,1022,0,0,238.34896,0.004720999999989317,"",""
"172.16.133.28",49360,"172.16.139.250",5440,10,1022,18505,0,0,10,1022,0,0,238.377204,0.005520999999987453,1480891,0
"172.16.133.113",55735,"74.125.226.4",80,6,372,18506,0,0,4,246,2,126,238.39917,0.32337400000000116,6085,3117
"172.16.133.113",55734,"74.125.226.4",80,23,13672,18507,0,0,10,1497,13,12175,238.399171,60.72340699999998,197,1603
"172.16.133.99",56246,"172.16.139.250",5440,10,1022,18508,0,0,10,1022,0,0,238.405982,0.014584000000013475,560614,0
"172.16.133.75",51159,"172.16.139.250",5440,10,1022,18509,0,0,10,1022,0,0,238.41084,0.005305999999990263,1540897,0
"172.16.133.87",60448,"172.16.139.250",5440,12,1142,18510,0,0,12,1142,0,0,238.429902,0.005844999999993661,1563045,0
"172.16.133.35",50153,"172.16.139.250",5440,12,1142,18511,0,0,12,1142,0,0,238.436267,0.013748000000020966,664533,0
"172.16.133.116",53950,"172.16.139.250",5440,10,1022,18512,0,0,10,1022,0,0,238.441564,0.014563000000009652,561422,0
"172.16.133.116",53951,"172.16.139.250",5440,10,1022,18513,0,0,10,1022,0,0,238.456707,0.0054609999999968295,1497161,0
"172.16.133.116",53952,"172.16.139.250",5440,10,1022,18514,0,0,10,1022,0,0,238.462886,0.005888999999996258,1388351,0
"172.16.133.84",58989,"172.16.139.250",5440,10,1022,18515,0,0,10,1022,0,0,238.465488,0.014972999999997683,546049,0
"172.16.133.49",55974,"172.16.139.250",5440,10,1022,18516,0,0,10,1022,0,0,238.539874,0.015885999999994738,514667,0
"172.16.133.95",57156,"172.16.139.250",5440,12,1142,18517,0,0,12,1142,0,0,238.582541,0.015354000000002088,595024,0
"172.16.133.92",57861,"172.16.139.250",5440,10,1022,18518,0,0,10,1022,0,0,238.609397,0.00538699999998471,1517727,0
"172.16.133.29",61196,"172.16.139.250",5440,10,1022,18519,0,0,10,1022,0,0,238.62705,0.005288000000007287,1546142,0
"172.16.133.44",65023,"172.16.139.250",5440,10,1022,18520,0,0,10,1022,0,0,238.632477,0.0156120000000044,523699,0
"172.16.133.207",56130,"172.16.139.250",5440,12,1142,18521,0,0,12,1142,0,0,238.657711,0.04963300000000004,184071,0
"172.16.133.83",57268,"172.16.139.250",5440,12,1142,18522,0,0,12,1142,0,0,238.667349,0.04039499999998952,226166,0
"172.16.133.113",55736,"74.125.226.4",443,44,34431,18523,0,0,18,2460,26,31971,238.669979,60.45341300000001,325,4230
"172.16.133.93",61029,"172.16.139.250",5440,10,1022,18524,0,0,10,1022,0,0,238.682546,0.02446000000000481,334260,0
"172.16.133.11",55357,"172.16.139.250",5440,10,1022,18525,0,0,10,1022,0,0,238.70008,0.006757999999990716,1209825,0
"172.16.133.55",57814,"172.16.139.250",5440,12,1142,18526,0,0,12,1142,0,0,238.705348,0.0072650000000180626,1257536,0
"172.16.133.73",60868,"172.16.139.250",5440,10,1022,18527,0,0,10,1022,0,0,238.726896,0.005416999999994232,1509322,0
"172.16.133.53",54296,"172.16.139.250",5440,12,1142,18528,0,0,12,1142,0,0,238.729801,0.0073610000000030595,1241135,0
"172.16.133.21",53370,"172.16.139.250",5440,12,1142,18529,0,0,12,1142,0,0,238.733178,0.008173999999996795,1117690,0
"172.16.133.30",62865,"172.16.139.250",5440,10,1022,18530,0,0,10,1022,0,0,238.737395,0.014922000000012758,547915,0
"172.16.133.25",63673,"172.16.139.250",5440,12,1142,18531,0,0,12,1142,0,0,238.744071,0.014877000000012686,614102,0
"172.16.133.34",50661,"172.16.139.250",5440,10,1022,18532,0,0,10,1022,0,0,238.754499,0.014896999999990612,548835,0
"172.16.133.97",59574,"172.16.139.250",5440,10,1022,18533,0,0,10,1022,0,0,238.763566,0.014613999999994576,559463,0
"172.16.133.113",55737,"74.125.226.7",443,86,58863,18534,0,0,34,8219,52,50644,238.781025,17.073453999999998,3851,23729
"172.16.133.113",55738,"74.125.226.7",443,59,47589,18535,0,0,24,3981,35,43608,238.781945,1.280682999999982,24867,272404
"172.16.133.33",58081,"172.16.139.250",5440,10,1022,18536,0,0,10,1022,0,0,238.835533,0.005589000000014721,1462873,0
"172.16.133.68",60955,"172.16.139.250",5440,12,1142,18537,0,0,12,1142,0,0,238.869764,0.016165000000000873,565171,0
"172.16.133.132",53915,"199.27.208.55",443,16,5148,18538,0,0,9,945,7,4203,238.872728,0.16351600000001554,46234,205631
"172.16.133.12",59979,"172.16.139.250",5440,10,1022,18539,0,0,10,1022,0,0,238.883696,0.005664000000024316,1443502,0
"172.16.133.63",54120,"172.16.139.250",5440,10,1022,18540,0,0,10,1022,0,0,238.895388,0.015676000000013346,521561,0
"172.16.133.66",54391,"172.16.139.250",5440,10,1022,18541,0,0,10,1022,0,0,238.907194,0.0075730000000078235,1079624,0
"172.16.133.82",61628,"172.16.139.250",5440,10,1022,18542,0,0,10,1022,0,0,238.92051,0.005407999999988533,1511834,0
"172.16.133.37",60846,"172.16.139.250",5440,10,1022,18543,0,0,10,1022,0,0,238.933701,0.005467999999979156,1495245,0
"172.16.133.95",57157,"208.111.160.6",80,19,8545,18544,0,0,8,1504,11,7041,239.015434,40.84630200000001,294,1379
"172.16.133.95",57158,"208.111.160.6",80,18,7276,18545,0,0,8,1504,10,5772,239.015563,40.840911000000006,294,1130
"172.16.133.95",57159,"208.111.160.6",80,19,7230,18546,0,0,8,1504,11,5726,239.015671,40.84595200000001,294,1121
"172.16.133.95",57160,"208.111.160.6",80,35,21306,18547,0,0,14,2894,21,18412,239.015779,40.84564799999998,566,3606
"172.16.133.95",57161,"208.111.160.6",80,34,16799,18548,0,0,15,2484,19,14315,239.015909,40.84921499999999,486,2803
"172.16.133.95",57162,"208.111.160.6",80,36,13417,18549,0,0,15,2505,21,10912,239.016011,40.844213000000025,490,2137
"172.16.133.78",59434,"172.16.139.250",5440,12,1142,18550,0,0,12,1142,0,0,239.090522,0.006227999999993017,1466923,0
"172.16.133.95",57163,"208.47.254.81",80,6,372,18551,0,0,4,246,2,126,239.136274,10.719460000000026,183,94
"172.16.133.95",57164,"23.0.49.244",80,7,432,18552,0,0,4,246,3,186,239.136516,10.725342000000012,183,138
"172.16.133.95",57165,"23.0.49.244",80,6,372,18553,0,0,4,246,2,126,239.136628,10.724329000000012,183,93
"172.16.133.95",57166,"23.0.49.244",80,6,372,18554,0,0,4,246,2,126,239.136731,10.723158000000012,183,94
"172.16.133.95",57167,"23.0.49.244",80,7,432,18555,0,0,4,246,3,186,239.136835,10.734091000000006,183,138
"172.16.133.67",56192,"172.16.139.250",5440,12,1142,18556,0,0,12,1142,0,0,239.146007,0.0176879999999926,516508,0
"172.16.133.56",61618,"172.16.139.250",5440,12,1142,18557,0,0,12,1142,0,0,239.168454,0.004896999999999707,"",""
"172.16.133.41",53336,"172.16.139.250",5440,12,1142,18558,0,0,12,1142,0,0,239.226647,0.005790999999987889,1577620,0
"172.16.133.43",57962,"172.16.139.250",5440,12,1142,18559,0,0,12,1142,0,0,239.292295,0.015350000000012187,595179,0
"172.16.133.13",53249,"172.16.139.250",5440,10,1022,18560,0,0,10,1022,0,0,239.312275,0.005163000000010243,1583575,0
"172.16.133.85",52472,"172.16.139.250",5440,10,1022,18561,0,0,10,1022,0,0,239.318264,0.0053420000000130585,1530512,0
"172.16.133.42",57306,"172.16.139.250",5440,12,1142,18562,0,0,12,1142,0,0,239.327104,0.14204800000001683,64316,0
"172.16.133.20",62610,"172.16.139.250",5440,10,1022,18563,0,0,10,1022,0,0,239.36301,0.014650999999986425,558050,0
"172.16.133.28",49361,"172.16.139.250",5440,10,1022,18564,0,0,10,1022,0,0,239.391411,0.006281000000001313,1301703,0
"172.16.133.95",57168,"138.108.6.20",80,11,3339,18565,0,0,6,2209,5,1130,239.414481,16.615336999999982,1063,544
"172.16.133.99",56247,"172.16.139.250",5440,12,1142,18566,0,0,12,1142,0,0,239.421246,0.014713999999997895,620905,0
"172.16.133.75",51160,"172.16.139.250",5440,10,1022,18567,0,0,10,1022,0,0,239.424772,0.005386000000015656,1518009,0
"172.16.133.95",57169,"64.94.107.18",80,9,1918,18568,0,0,6,1455,3,463,239.438166,6.269794000000019,1856,590
"172.16.133.35",50155,"172.16.139.250",5440,12,1142,18569,0,0,12,1142,0,0,239.451914,0.034046000000017784,268342,0
"172.16.133.87",60449,"172.16.139.250",5440,10,1022,18570,0,0,10,1022,0,0,239.456002,0.008889999999979636,919685,0
"172.16.133.116",53953,"172.16.139.250",5440,10,1022,18571,0,0,10,1022,0,0,239.456067,0.004896000000002232,"",""
"172.16.133.116",53954,"172.16.139.250",5440,10,1022,18572,0,0,10,1022,0,0,239.461811,0.015580999999997402,524741,0
"172.16.133.84",58992,"172.16.139.250",5440,12,1142,18573,0,0,12,1142,0,0,239.478198,0.016188999999997122,564333,0
"172.16.133.116",53955,"172.16.139.250",5440,10,1022,18574,0,0,10,1022,0,0,239.47847,0.004777000000018461,"",""
"172.16.133.49",55975,"172.16.139.250",5440,12,1142,18575,0,0,12,1142,0,0,239.553883,0.016335999999995465,559255,0
"172.16.133.95",57170,"172.16.139.250",5440,12,1142,18576,0,0,12,1142,0,0,239.596245,0.005892999999986159,1550313,0
"172.16.133.92",57862,"172.16.139.250",5440,10,1022,18577,0,0,10,1022,0,0,239.621841,0.0055370000000039,1476611,0
"172.16.133.29",61197,"172.16.139.250",5440,10,1022,18578,0,0,10,1022,0,0,239.64125,0.005725999999981468,1427872,0
"172.16.133.44",65024,"172.16.139.250",5440,10,1022,18579,0,0,10,1022,0,0,239.647675,0.005357000000003609,1526227,0
"172.16.133.207",56131,"172.16.139.250",5440,10,1022,18580,0,0,10,1022,0,0,239.671781,0.0046999999999854936,"",""
"172.16.133.83",57269,"172.16.139.250",5440,12,1142,18581,0,0,12,1142,0,0,239.681451,0.004718999999994367,"",""
"172.16.133.95",57171,"64.94.107.18",80,8,1763,18582,0,0,5,1300,3,463,239.688088,0.09635299999999347,107936,38441
"172.16.133.93",61030,"172.16.139.250",5440,12,1142,18583,0,0,12,1142,0,0,239.69588099999999,0.01449400000001333,630329,0
"172.16.133.11",55358,"172.16.139.250",5440,10,1022,18584,0,0,10,1022,0,0,239.714591,0.01485599999998044,550350,0
"172.16.133.55",57815,"172.16.139.250",5440,10,1022,18585,0,0,10,1022,0,0,239.71926,0.015010000000017953,544703,0
"172.16.133.73",60869,"172.16.139.250",5440,10,1022,18586,0,0,10,1022,0,0,239.740973,0.005601000000012846,1459739,0
"172.16.133.53",54297,"172.16.139.250",5440,10,1022,18587,0,0,10,1022,0,0,239.744174,0.007061000000021522,1157909,0
"172.16.133.21",53371,"172.16.139.250",5440,10,1022,18588,0,0,10,1022,0,0,239.747525,0.006991999999996779,1169336,0
"172.16.133.30",62866,"172.16.139.250",5440,10,1022,18589,0,0,10,1022,0,0,239.751539,0.006755999999995765,1210183,0
"172.16.133.25",63674,"172.16.139.250",5440,10,1022,18590,0,0,10,1022,0,0,239.757884,0.004765000000020336,"",""
"172.16.133.34",50662,"172.16.139.250",5440,10,1022,18591,0,0,10,1022,0,0,239.767832,0.005039000000010674,1622544,0
"172.16.133.97",59575,"172.16.139.250",5440,10,1022,18592,0,0,10,1022,0,0,239.778668,0.014603999999991402,559846,0
"172.16.133.33",58082,"172.16.139.250",5440,10,1022,18593,0,0,10,1022,0,0,239.849697,0.005585999999993874,1463659,0
"172.16.133.68",60956,"172.16.139.250",5440,10,1022,18594,0,0,10,1022,0,0,239.884082,0.11222999999998251,72850,0
"172.16.133.113",55739,"172.16.139.250",135,8,492,18595,0,0,8,492,0,0,239.896779,0.009847999999976764,399675,0
"172.16.133.63",54121,"172.16.139.250",5440,12,1142,18596,0,0,12,1142,0,0,239.909469,0.09045800000001236,100997,0
"172.16.133.113",55740,"172.16.139.250",5462,12,816,18597,0,0,12,816,0,0,239.916611,0.5252140000000054,12429,0
"172.16.133.66",54392,"172.16.139.250",5440,12,1142,18598,0,0,12,1142,0,0,239.92014,0.08385999999998717,108943,0
"172.16.133.12",59980,"172.16.139.250",5440,12,1142,18599,0,0,12,1142,0,0,239.926521,0.09452699999999936,96649,0
"172.16.133.82",61629,"172.16.139.250",5440,12,1142,18600,0,0,12,1142,0,0,239.934533,0.0836529999999982,109213,0
"172.16.133.37",60847,"172.16.139.250",5440,10,1022,18601,0,0,10,1022,0,0,239.949094,0.07533899999998539,108522,0
"172.16.133.78",59435,"172.16.139.250",5440,12,1142,18602,0,0,12,1142,0,0,240.10435,0.006493999999975131,1406837,0
"172.16.133.67",56193,"172.16.139.250",5440,12,1142,18603,0,0,12,1142,0,0,240.159963,0.015578000000004977,586468,0
"172.16.133.56",61619,"172.16.139.250",5440,12,1142,18604,0,0,12,1142,0,0,240.18258,0.005053000000003749,1808034,0
"172.16.133.41",53337,"172.16.139.250",5440,12,1142,18605,0,0,12,1142,0,0,240.236437,0.015609000000011974,585303,0
"172.16.133.43",57963,"172.16.139.250",5440,12,1142,18606,0,0,12,1142,0,0,240.306404,0.006168000000002394,1481193,0
"172.16.133.13",53250,"172.16.139.250",5440,10,1022,18607,0,0,10,1022,0,0,240.326788,0.005351000000018757,1527938,0
"172.16.133.85",52473,"172.16.139.250",5440,10,1022,18608,0,0,10,1022,0,0,240.332226,0.015216000000009444,537329,0
"172.16.133.96",53383,"173.194.43.53",443,16,3604,18609,0,0,9,2545,7,1059,240.339609,0.322291000000007,63172,26286
"172.16.133.42",57307,"172.16.139.250",5440,12,1142,18610,0,0,12,1142,0,0,240.340542,0.012385999999992237,737606,0
"172.16.133.20",62611,"172.16.139.250",5440,12,1142,18611,0,0,12,1142,0,0,240.377135,0.004949999999979582,"",""
"172.16.133.28",49362,"172.16.139.250",5440,10,1022,18612,0,0,10,1022,0,0,240.405271,0.0054110000000093805,1510996,0
"172.16.133.99",56248,"172.16.139.250",5440,10,1022,18613,0,0,10,1022,0,0,240.434233,0.015122999999988451,540633,0
"172.16.133.75",51161,"172.16.139.250",5440,10,1022,18614,0,0,10,1022,0,0,240.438876,0.005871000000013282,1392607,0
"172.16.133.87",60450,"172.16.139.250",5440,10,1022,18615,0,0,10,1022,0,0,240.458569,0.0054459999999778574,1501285,0
"172.16.133.116",53956,"172.16.139.250",5440,10,1022,18616,0,0,10,1022,0,0,240.470404,0.0055680000000108976,1468390,0
"172.16.133.116",53957,"172.16.139.250",5440,10,1022,18617,0,0,10,1022,0,0,240.476921,0.005361999999990985,1524804,0
"172.16.133.35",50156,"172.16.139.250",5440,12,1142,18618,0,0,12,1142,0,0,240.478921,0.05039799999997285,181277,0
"172.16.133.116",53958,"172.16.139.250",5440,10,1022,18619,0,0,10,1022,0,0,240.483135,0.01505599999998708,543039,0
"172.16.133.84",58993,"172.16.139.250",5440,10,1022,18620,0,0,10,1022,0,0,240.492259,0.016130000000003974,506881,0
"172.16.133.73",60870,"23.60.240.63",443,15,3764,18621,0,0,8,2330,7,1434,240.556809,45.23160300000001,412,253
"172.16.133.73",60871,"23.60.240.63",443,60,34591,18622,0,0,27,11418,33,23173,240.556957,33.14126599999997,2756,5593
"172.16.133.73",60872,"23.60.240.63",443,15,3764,18623,0,0,8,2330,7,1434,240.557127,45.26028699999998,411,253
"172.16.133.73",60873,"23.60.240.63",443,13,1277,18624,0,0,6,649,7,628,240.55728,21.907294000000036,236,229
"172.16.133.49",55976,"172.16.139.250",5440,10,1022,18625,0,0,10,1022,0,0,240.568373,0.005482000000000653,1491426,0
"172.16.133.95",57172,"172.16.139.250",5440,10,1022,18626,0,0,10,1022,0,0,240.610731,0.005353000000013708,1527367,0
"172.16.133.12",59981,"172.16.139.250",5440,10,1022,18627,0,0,10,1022,0,0,240.630889,0.005389000000008082,1517164,0
"172.16.133.92",57863,"172.16.139.250",5440,10,1022,18628,0,0,10,1022,0,0,240.636913,0.005599000000017895,1460260,0
"172.16.133.132",32916,"199.27.208.32",80,6,374,18629,0,0,4,254,2,120,240.642821,0.07181399999998916,28295,13367
"172.16.133.29",61198,"172.16.139.250",5440,10,1022,18630,0,0,10,1022,0,0,240.654113,0.005330000000014934,1533958,0
"172.16.133.44",65025,"172.16.139.250",5440,10,1022,18631,0,0,10,1022,0,0,240.660344,0.014566999999999553,561268,0
"172.16.133.207",56132,"172.16.139.250",5440,10,1022,18632,0,0,10,1022,0,0,240.686262,0.004813000000012835,"",""
"172.16.133.83",57270,"172.16.139.250",5440,12,1142,18633,0,0,12,1142,0,0,240.695526,0.004668000000009442,"",""
"172.16.133.93",61031,"172.16.139.250",5440,10,1022,18634,0,0,10,1022,0,0,240.710452,0.004961000000008653,"",""
"172.16.133.11",55359,"172.16.139.250",5440,10,1022,18635,0,0,10,1022,0,0,240.729062,0.005811999999991713,1406744,0
"172.16.133.55",57816,"172.16.139.250",5440,12,1142,18636,0,0,12,1142,0,0,240.733743,0.016170999999985725,564961,0
"172.16.133.73",60874,"107.21.205.223",443,19,6593,18637,0,0,9,1563,10,5030,240.742149,11.700774999999993,1068,3439
"172.16.133.73",60875,"172.16.139.250",5440,10,1022,18638,0,0,10,1022,0,0,240.75736,0.005566999999985001,1468654,0
"172.16.133.53",54298,"172.16.139.250",5440,10,1022,18639,0,0,10,1022,0,0,240.758899,0.01584399999998709,516031,0
"172.16.133.21",53372,"172.16.139.250",5440,12,1142,18640,0,0,12,1142,0,0,240.761286,0.018356999999980417,497684,0
"172.16.133.30",62867,"172.16.139.250",5440,10,1022,18641,0,0,10,1022,0,0,240.765557,0.005588999999986299,1462873,0
"172.16.133.25",63675,"172.16.139.250",5440,10,1022,18642,0,0,10,1022,0,0,240.772175,0.01006000000000995,812723,0
"172.16.133.132",50915,"23.33.83.243",80,6,412,18643,0,0,4,272,2,140,240.772177,0.03452300000000719,63030,32442
"172.16.133.34",50663,"172.16.139.250",5440,12,1142,18644,0,0,12,1142,0,0,240.781949,0.005148999999988746,1774325,0
"172.16.133.97",59576,"172.16.139.250",5440,10,1022,18645,0,0,10,1022,0,0,240.79156,0.014594999999985703,560191,0
"172.16.133.93",61032,"74.63.51.79",80,77,71982,18646,0,0,27,2894,50,69088,240.801135,6.705745000000007,3452,82422
"172.16.133.132",56402,"199.27.208.55",80,6,374,18647,0,0,4,254,2,120,240.828472,0.07584599999998431,26791,12657
"172.16.133.33",58083,"172.16.139.250",5440,10,1022,18648,0,0,10,1022,0,0,240.861533,0.014660999999989599,557670,0
"172.16.133.96",53384,"173.194.74.84",443,26,7751,18649,0,0,15,3081,11,4670,240.896859,0.3388960000000054,72730,110240
"172.16.133.68",60957,"172.16.139.250",5440,10,1022,18650,0,0,10,1022,0,0,240.897517,0.01571799999999257,520167,0
"172.16.133.132",45071,"23.33.83.243",443,6,412,18651,0,0,4,272,2,140,240.908999,0.035269999999997026,61695,31755
"172.16.133.12",59982,"172.16.139.250",5440,12,1142,18652,0,0,12,1142,0,0,240.911791,0.006507999999996628,1403810,0
"172.16.133.63",54122,"172.16.139.250",5440,10,1022,18653,0,0,10,1022,0,0,240.923339,0.01490000000001146,548724,0
"172.16.133.66",54393,"172.16.139.250",5440,10,1022,18654,0,0,10,1022,0,0,240.934164,0.007564000000002125,1080909,0
"172.16.133.82",61630,"172.16.139.250",5440,10,1022,18655,0,0,10,1022,0,0,240.949512,0.0058019999999885385,1409169,0
"172.16.133.132",53920,"199.27.208.55",443,6,374,18656,0,0,4,254,2,120,240.951635,0.08387700000000109,24225,11445
"172.16.133.37",60848,"172.16.139.250",5440,10,1022,18657,0,0,10,1022,0,0,240.961915,0.00586699999999496,1393557,0
"172.16.133.73",60876,"64.208.138.113",443,29,13971,18658,0,0,14,5935,15,8036,241.073037,11.368891999999988,4176,5654
"172.16.133.78",59436,"172.16.139.250",5440,10,1022,18660,0,0,10,1022,0,0,241.118374,0.005533000000013999,1477679,0
"172.16.133.93",61033,"74.63.51.79",80,71,65372,18661,0,0,25,2591,46,62781,241.165449,6.347846000000004,3265,79121
"172.16.133.93",61034,"74.63.51.79",80,30,21972,18662,0,0,12,1800,18,20172,241.169626,6.334372999999999,2273,25476
"172.16.133.93",61035,"74.63.52.167",80,11,1382,18663,0,0,6,907,5,475,241.170274,6.343771000000004,1143,599
"172.16.133.93",61036,"74.63.52.167",80,11,1382,18664,0,0,6,907,5,475,241.170379,6.343587000000014,1143,599
"172.16.133.93",61037,"74.63.52.167",80,11,1382,18665,0,0,6,907,5,475,241.170479,6.343956999999989,1143,598
"172.16.133.93",61038,"74.63.52.167",80,11,1382,18666,0,0,6,907,5,475,241.170575,6.343296999999978,1143,599
"172.16.133.93",61039,"74.63.52.167",80,11,1382,18667,0,0,6,907,5,475,241.170677,6.343082999999979,1143,599
"172.16.133.93",61040,"74.63.52.167",80,11,1382,18668,0,0,6,907,5,475,241.170769,6.343461999999988,1143,599
"172.16.133.67",56194,"172.16.139.250",5440,12,1142,18669,0,0,12,1142,0,0,241.174218,0.0060320000000047,1514588,0
"172.16.133.93",61041,"74.113.233.133",80,9,2016,18670,0,0,5,1071,4,945,241.184092,0.664527000000021,12893,11376
"172.16.133.93",61042,"74.113.233.133",80,12,5345,18671,0,0,6,1149,6,4196,241.1842,0.09474599999998645,97017,354294
"172.16.133.56",61620,"172.16.139.250",5440,10,1022,18672,0,0,10,1022,0,0,241.195882,0.01442000000000121,566990,0
"172.16.133.96",53385,"173.194.74.84",443,45,26451,18673,0,0,21,2558,24,23893,241.204767,0.16846999999998502,121469,1134587
"172.16.133.41",53338,"172.16.139.250",5440,10,1022,18674,0,0,10,1022,0,0,241.251559,0.015540000000015652,526126,0
"172.16.133.93",61043,"208.47.254.34",80,10,3418,18675,0,0,5,745,5,2673,241.271537,45.05741200000003,132,474
"172.16.133.93",61044,"208.47.254.34",80,62,58277,18676,0,0,21,2549,41,55728,241.271651,45.492834999999985,448,9799
"172.16.133.43",57964,"172.16.139.250",5440,10,1022,18677,0,0,10,1022,0,0,241.320053,0.0054419999999879565,1502388,0
"172.16.133.93",61045,"199.59.148.86",443,24,7180,18678,0,0,11,2253,13,4927,241.339717,30.510688000000016,590,1291
"172.16.133.13",53251,"172.16.139.250",5440,10,1022,18679,0,0,10,1022,0,0,241.340863,0.005966999999998279,1370202,0
"172.16.133.85",52474,"172.16.139.250",5440,10,1022,18680,0,0,10,1022,0,0,241.346439,0.00533300000000736,1533095,0
"172.16.133.93",61046,"23.6.17.224",80,12,4103,18681,0,0,7,2253,5,1850,241.372819,43.962042999999994,409,336
"172.16.133.42",57308,"172.16.139.250",5440,12,1142,18682,0,0,12,1142,0,0,241.384545,0.022007999999999583,415121,0
"172.16.133.20",62612,"172.16.139.250",5440,12,1142,18683,0,0,12,1142,0,0,241.390248,0.004991999999987229,"",""
"172.16.133.28",49363,"172.16.139.250",5440,10,1022,18684,0,0,10,1022,0,0,241.419215,0.005496999999991203,1487356,0
"172.16.133.93",61047,"23.67.243.50",80,6,372,18685,0,0,4,246,2,126,241.420316,16.099673999999993,122,62
"172.16.133.93",61048,"23.67.243.50",80,6,372,18686,0,0,4,246,2,126,241.420454,16.099681999999973,122,62
"172.16.133.99",56249,"172.16.139.250",5440,10,1022,18687,0,0,10,1022,0,0,241.448216,0.014673999999985199,557175,0
"172.16.133.75",51162,"172.16.139.250",5440,12,1142,18688,0,0,12,1142,0,0,241.453265,0.006210000000010041,1471175,0
"172.16.133.93",61049,"208.47.254.25",80,87,80287,18689,0,0,32,3173,55,77114,241.453266,45.895842999999985,553,13441
"172.16.133.87",60451,"172.16.139.250",5440,10,1022,18690,0,0,10,1022,0,0,241.472511,0.005814000000015085,1406260,0
"172.16.133.35",50157,"172.16.139.250",5440,12,1142,18691,0,0,12,1142,0,0,241.476018,0.011247999999994818,812233,0
"172.16.133.96",53386,"74.125.226.222",443,17,4942,18692,0,0,10,1953,7,2989,241.47936,0.1852999999999838,84317,129044
"172.16.133.116",53959,"172.16.139.250",5440,10,1022,18693,0,0,10,1022,0,0,241.482983,0.005089999999995598,1606286,0
"172.16.133.93",61050,"63.241.108.124",80,12,6425,18694,0,0,7,3727,5,2698,241.485914,0.19223700000000576,155100,112278
"172.16.133.93",61051,"63.241.108.124",80,15,9902,18695,0,0,8,4360,7,5542,241.488508,0.14373399999999492,242670,308458
"172.16.133.116",53960,"172.16.139.250",5440,10,1022,18696,0,0,10,1022,0,0,241.488948,0.015230999999999995,536799,0
"172.16.133.84",58994,"172.16.139.250",5440,12,1142,18697,0,0,12,1142,0,0,241.506212,0.015234999999989896,599671,0
"172.16.133.116",53961,"172.16.139.250",5440,10,1022,18698,0,0,10,1022,0,0,241.50709,0.005659000000008518,1444778,0
"172.16.133.49",55977,"172.16.139.250",5440,12,1142,18699,0,0,12,1142,0,0,241.581988,0.0064749999999946795,1410965,0
"172.16.133.95",57173,"172.16.139.250",5440,10,1022,18700,0,0,10,1022,0,0,241.625718,0.014677000000006046,557062,0
"172.16.133.92",57864,"172.16.139.250",5440,12,1142,18701,0,0,12,1142,0,0,241.650799,0.006480999999979531,1409659,0
"172.16.133.93",61052,"138.108.6.20",80,8,1427,18702,0,0,4,769,4,658,241.657655,13.091993000000002,469,402
"172.16.133.93",61053,"138.108.6.20",80,8,1422,18703,0,0,4,764,4,658,241.657774,11.491859000000005,531,458
"172.16.133.29",61199,"172.16.139.250",5440,10,1022,18704,0,0,10,1022,0,0,241.668143,0.006394000000000233,1278698,0
"172.16.133.44",65026,"172.16.139.250",5440,10,1022,18705,0,0,10,1022,0,0,241.674427,0.005239999999986367,1560305,0
"172.16.133.207",56133,"172.16.139.250",5440,12,1142,18706,0,0,12,1142,0,0,241.699839,0.014705999999989672,621243,0
"172.16.133.83",57271,"172.16.139.250",5440,12,1142,18707,0,0,12,1142,0,0,241.709467,0.013946000000004233,655098,0
"172.16.133.93",61055,"172.16.139.250",5440,12,1142,18708,0,0,12,1142,0,0,241.726446,0.004702999999977919,"",""
"172.16.133.11",55360,"172.16.139.250",5440,10,1022,18709,0,0,10,1022,0,0,241.742872,0.005683000000004768,1438676,0
"172.16.133.55",57817,"172.16.139.250",5440,12,1142,18710,0,0,12,1142,0,0,241.746907,0.006294999999994388,1451310,0
"172.16.133.73",60877,"172.16.139.250",5440,10,1022,18711,0,0,10,1022,0,0,241.769702,0.016681000000005497,490138,0
"172.16.133.53",54299,"172.16.139.250",5440,10,1022,18712,0,0,10,1022,0,0,241.773043,0.0054609999999968295,1497161,0
"172.16.133.21",53373,"172.16.139.250",5440,10,1022,18713,0,0,10,1022,0,0,241.775254,0.007250999999996566,1127568,0
"172.16.133.30",62868,"172.16.139.250",5440,10,1022,18714,0,0,10,1022,0,0,241.779401,0.010641999999990048,768276,0
"172.16.133.25",63676,"172.16.139.250",5440,12,1142,18715,0,0,12,1142,0,0,241.785882,0.014777000000009366,618258,0
"172.16.133.34",50664,"172.16.139.250",5440,12,1142,18716,0,0,12,1142,0,0,241.795851,0.008658999999994421,1055087,0
"172.16.133.97",59577,"172.16.139.250",5440,12,1142,18717,0,0,12,1142,0,0,241.806683,0.015290000000021564,597514,0
"172.16.133.33",58084,"172.16.139.250",5440,12,1142,18718,0,0,12,1142,0,0,241.875899,0.006353999999987536,1437834,0
"172.16.133.16",59371,"23.67.243.26",443,19,3774,18719,0,0,9,1452,10,2322,241.90431,47.79372799999999,243,388
"172.16.133.63",54123,"107.22.18.198",443,131,73220,18720,0,0,84,52980,47,20240,241.911316,57.239581999999984,7404,2828
"172.16.133.68",60958,"172.16.139.250",5440,12,1142,18721,0,0,12,1142,0,0,241.911567,0.00621900000001574,1469046,0
"172.16.133.12",59983,"172.16.139.250",5440,12,1142,18722,0,0,12,1142,0,0,241.924948,0.0061300000000130694,1490375,0
"172.16.133.63",54124,"172.16.139.250",5440,10,1022,18723,0,0,10,1022,0,0,241.936201,0.00534799999999791,1528795,0
"172.16.133.66",54394,"172.16.139.250",5440,10,1022,18724,0,0,10,1022,0,0,241.948266,0.01548600000000988,527960,0
"172.16.133.82",61631,"172.16.139.250",5440,10,1022,18725,0,0,10,1022,0,0,241.962908,0.005515000000002601,1482502,0
"172.16.133.37",60849,"172.16.139.250",5440,10,1022,18726,0,0,10,1022,0,0,241.975632,0.015305000000012114,534204,0
"172.16.133.78",59437,"172.16.139.250",5440,12,1142,18727,0,0,12,1142,0,0,242.131574,0.0056460000000129185,1618136,0
"172.16.133.67",56195,"172.16.139.250",5440,10,1022,18728,0,0,10,1022,0,0,242.188007,0.016518999999988182,494945,0
"172.16.133.56",61621,"172.16.139.250",5440,10,1022,18729,0,0,10,1022,0,0,242.209986,0.014273000000002867,572829,0
"172.16.133.41",53339,"172.16.139.250",5440,10,1022,18730,0,0,10,1022,0,0,242.264495,0.015475999999978285,528301,0
"172.16.133.20",62613,"116.90.133.49",80,14,2358,18731,0,0,7,1179,7,1179,242.312714,4.374459999999999,2156,2156
"172.16.133.57",60640,"180.153.30.250",443,6,378,18732,0,0,4,258,2,120,242.330051,0.6774450000000058,3046,1417
"172.16.133.43",57965,"172.16.139.250",5440,10,1022,18733,0,0,10,1022,0,0,242.334848,0.01502999999999588,543978,0
"172.16.133.13",53252,"172.16.139.250",5440,10,1022,18734,0,0,10,1022,0,0,242.354466,0.005818000000004986,1405293,0
"172.16.133.85",52475,"172.16.139.250",5440,10,1022,18735,0,0,10,1022,0,0,242.360397,0.014404999999982238,567580,0
"172.16.133.42",57309,"172.16.139.250",5440,12,1142,18736,0,0,12,1142,0,0,242.377021,0.05610299999997892,162843,0
"172.16.133.20",62614,"172.16.139.250",5440,10,1022,18737,0,0,10,1022,0,0,242.405274,0.00485299999999711,"",""
"172.16.133.28",49365,"172.16.139.250",5440,10,1022,18738,0,0,10,1022,0,0,242.43352,0.005477000000013277,1492788,0
"172.16.133.99",56250,"172.16.139.250",5440,10,1022,18739,0,0,10,1022,0,0,242.461417,0.004868999999985135,"",""
"172.16.133.75",51163,"172.16.139.250",5440,10,1022,18740,0,0,10,1022,0,0,242.466838,0.005423000000007505,1507652,0
"172.16.133.87",60452,"172.16.139.250",5440,10,1022,18741,0,0,10,1022,0,0,242.486915,0.005357000000003609,1526227,0
"172.16.133.35",50158,"172.16.139.250",5440,12,1142,18742,0,0,12,1142,0,0,242.492863,0.0323099999999954,282760,0
"172.16.133.116",53962,"172.16.139.250",5440,10,1022,18743,0,0,10,1022,0,0,242.49667,0.005405999999993583,1512393,0
"172.16.133.116",53963,"172.16.139.250",5440,10,1022,18744,0,0,10,1022,0,0,242.50256100000001,0.006924999999995407,1180649,0
"172.16.133.116",53964,"172.16.139.250",5440,10,1022,18745,0,0,10,1022,0,0,242.510146,0.006416999999999007,1274115,0
"172.16.133.84",58995,"172.16.139.250",5440,10,1022,18746,0,0,10,1022,0,0,242.521264,0.005561999999997624,1469974,0
"172.16.133.57",60641,"96.43.146.176",443,34,13605,18747,0,0,19,1882,15,11723,242.524378,0.3113819999999805,48352,301186
"172.16.133.49",55978,"172.16.139.250",5440,10,1022,18748,0,0,10,1022,0,0,242.596124,0.015370999999987589,531910,0
"172.16.133.36",65087,"54.243.254.190",443,34,15342,18749,0,0,18,12369,16,2973,242.627375,48.85161200000002,2025,486
"172.16.133.36",65088,"54.243.254.190",443,48,26099,18750,0,0,25,20531,23,5568,242.627703,51.10670900000002,3213,871
"172.16.133.95",57174,"172.16.139.250",5440,10,1022,18751,0,0,10,1022,0,0,242.639013,0.00557799999998565,1465758,0
"172.16.133.92",57865,"172.16.139.250",5440,10,1022,18752,0,0,10,1022,0,0,242.665195,0.006660999999979822,1227443,0
"172.16.133.29",61200,"172.16.139.250",5440,10,1022,18753,0,0,10,1022,0,0,242.682781,0.01523399999999242,536694,0
"172.16.133.44",65027,"172.16.139.250",5440,10,1022,18754,0,0,10,1022,0,0,242.688945,0.005331000000012409,1533670,0
"172.16.133.207",56134,"172.16.139.250",5440,12,1142,18755,0,0,12,1142,0,0,242.713894,0.01899299999999471,481019,0
"172.16.133.83",57272,"172.16.139.250",5440,12,1142,18756,0,0,12,1142,0,0,242.723664,0.005434999999977208,1680956,0
"172.16.133.93",61056,"172.16.139.250",5440,12,1142,18757,0,0,12,1142,0,0,242.737533,0.004599999999982174,"",""
"172.16.133.11",55361,"172.16.139.250",5440,12,1142,18758,0,0,12,1142,0,0,242.755814,0.01645900000002598,555076,0
"172.16.133.55",57818,"172.16.139.250",5440,10,1022,18759,0,0,10,1022,0,0,242.760432,0.005504000000001952,1485465,0
"172.16.133.73",60878,"172.16.139.250",5440,10,1022,18760,0,0,10,1022,0,0,242.782483,0.0062019999999733955,1318284,0
"172.16.133.53",54300,"172.16.139.250",5440,10,1022,18761,0,0,10,1022,0,0,242.787391,0.0056719999999756965,1441466,0
"172.16.133.21",53374,"172.16.139.250",5440,10,1022,18762,0,0,10,1022,0,0,242.789763,0.015418000000011034,530289,0
"172.16.133.30",62869,"172.16.139.250",5440,10,1022,18763,0,0,10,1022,0,0,242.793416,0.0059029999999893334,1385058,0
"172.16.133.25",63677,"172.16.139.250",5440,10,1022,18764,0,0,10,1022,0,0,242.800302,0.00847699999999918,964492,0
"172.16.133.34",50665,"172.16.139.250",5440,10,1022,18765,0,0,10,1022,0,0,242.810017,0.014450000000010732,565813,0
"172.16.133.97",59578,"172.16.139.250",5440,10,1022,18767,0,0,10,1022,0,0,242.819579,0.00846400000000358,965973,0
"172.16.133.20",62615,"116.90.133.49",80,10,636,18768,0,0,6,378,4,258,242.855381,13.427422000000007,225,153
"172.16.133.33",58085,"172.16.139.250",5440,10,1022,18769,0,0,10,1022,0,0,242.889635,0.014669999999995298,557327,0
"172.16.133.68",60959,"172.16.139.250",5440,10,1022,18770,0,0,10,1022,0,0,242.925766,0.005565999999987525,1468918,0
"172.16.133.12",59984,"172.16.139.250",5440,12,1142,18771,0,0,12,1142,0,0,242.941044,0.021510000000006357,424732,0
"172.16.133.63",54125,"172.16.139.250",5440,12,1142,18772,0,0,12,1142,0,0,242.950384,0.015814999999975043,577679,0
"172.16.133.66",54395,"172.16.139.250",5440,10,1022,18773,0,0,10,1022,0,0,242.962365,0.0069039999999915835,1184241,0
"172.16.133.82",61632,"172.16.139.250",5440,12,1142,18774,0,0,12,1142,0,0,242.975826,0.016426999999993086,556157,0
"172.16.133.37",60850,"172.16.139.250",5440,10,1022,18775,0,0,10,1022,0,0,242.989501,0.005929000000008955,1378984,0
"172.16.133.78",59438,"172.16.139.250",5440,10,1022,18776,0,0,10,1022,0,0,243.146549,0.005767000000020062,1417721,0
"172.16.133.67",56196,"172.16.139.250",5440,12,1142,18777,0,0,12,1142,0,0,243.201984,0.005864000000002534,1557980,0
"172.16.133.56",61623,"172.16.139.250",5440,12,1142,18778,0,0,12,1142,0,0,243.223538,0.005406000000022004,1689974,0
"172.16.133.41",53340,"172.16.139.250",5440,12,1142,18779,0,0,12,1142,0,0,243.279476,0.014531000000005179,628724,0
"172.16.133.43",57966,"172.16.139.250",5440,12,1142,18780,0,0,12,1142,0,0,243.348303,0.006078000000002248,1503126,0
"172.16.133.53",54301,"23.67.243.81",80,7,916,18781,0,0,4,510,3,406,243.359719,0.2414489999999887,16897,13452
"172.16.133.13",53253,"172.16.139.250",5440,10,1022,18782,0,0,10,1022,0,0,243.368808,0.0054189999999891825,1508765,0
"172.16.133.85",52476,"172.16.139.250",5440,10,1022,18783,0,0,10,1022,0,0,243.375204,0.005420000000015079,1508487,0
"172.16.133.42",57310,"172.16.139.250",5440,12,1142,18784,0,0,12,1142,0,0,243.385831,0.018692000000015696,488765,0
"172.16.133.20",62616,"172.16.139.250",5440,12,1142,18785,0,0,12,1142,0,0,243.419478,0.01422199999998952,642385,0
"172.16.133.28",49366,"172.16.139.250",5440,10,1022,18786,0,0,10,1022,0,0,243.447427,0.015358999999989464,532326,0
"172.16.133.99",56251,"172.16.139.250",5440,10,1022,18787,0,0,10,1022,0,0,243.475179,0.01470199999999977,556114,0
"172.16.133.75",51164,"172.16.139.250",5440,10,1022,18788,0,0,10,1022,0,0,243.481048,0.015426000000019258,530014,0
"172.16.133.35",50159,"172.16.139.250",5440,12,1142,18789,0,0,12,1142,0,0,243.504282,0.013433000000020456,680116,0
"172.16.133.87",60453,"172.16.139.250",5440,10,1022,18790,0,0,10,1022,0,0,243.504634,0.005539999999996326,1475812,0
"172.16.133.116",53965,"172.16.139.250",5440,12,1142,18791,0,0,12,1142,0,0,243.511123,0.007914999999997008,1154264,0
"172.16.133.116",53966,"172.16.139.250",5440,12,1142,18792,0,0,12,1142,0,0,243.520242,0.005684999999999718,1607036,0
"172.16.133.116",53967,"172.16.139.250",5440,10,1022,18793,0,0,10,1022,0,0,243.527027,0.005445000000008804,1501561,0
"172.16.133.84",58999,"172.16.139.250",5440,12,1142,18794,0,0,12,1142,0,0,243.534438,0.016475000000014006,554537,0
"172.16.133.132",50249,"38.70.64.178",80,48,29481,18795,0,0,26,4556,22,24925,243.542404,2.401001000000008,15180,83048
"172.16.133.49",55979,"172.16.139.250",5440,10,1022,18796,0,0,10,1022,0,0,243.610338,0.015190999999987298,538213,0
"172.16.133.95",57175,"172.16.139.250",5440,10,1022,18797,0,0,10,1022,0,0,243.652938,0.005582000000003973,1464707,0
"172.16.133.92",57866,"172.16.139.250",5440,10,1022,18798,0,0,10,1022,0,0,243.67848,0.005409999999983484,1511275,0
"172.16.133.29",61201,"172.16.139.250",5440,10,1022,18799,0,0,10,1022,0,0,243.697154,0.005539999999996326,1475812,0
"172.16.133.44",65028,"172.16.139.250",5440,12,1142,18800,0,0,12,1142,0,0,243.7025,0.016352000000011913,558708,0
"172.16.133.207",56135,"172.16.139.250",5440,12,1142,18801,0,0,12,1142,0,0,243.727161,0.005132000000003245,1780202,0
"172.16.133.83",57273,"172.16.139.250",5440,10,1022,18802,0,0,10,1022,0,0,243.737596,0.004647000000005619,"",""
"172.16.133.93",61057,"172.16.139.250",5440,10,1022,18803,0,0,10,1022,0,0,243.751761,0.014677000000006046,557062,0
"172.16.133.68",60960,"180.153.30.250",443,6,366,18804,0,0,4,246,2,120,243.751763,0.6880809999999826,2860,1395
"172.16.133.11",55362,"172.16.139.250",5440,10,1022,18805,0,0,10,1022,0,0,243.770034,0.005701999999985219,1433882,0
"172.16.133.55",57819,"172.16.139.250",5440,12,1142,18806,0,0,12,1142,0,0,243.77553,0.006345000000010259,1439873,0
"172.16.133.132",50250,"38.70.64.178",80,100,91911,18807,0,0,35,4279,65,87632,243.781532,2.170597000000015,15770,322978
"172.16.133.132",50251,"38.70.64.178",80,76,52998,18808,0,0,38,4975,38,48023,243.785799,2.166146999999995,18373,177358
"172.16.133.56",61624,"68.64.13.250",443,6,366,18809,0,0,4,246,2,120,243.788204,0.1155859999999791,17026,8305
"172.16.133.20",62617,"173.194.73.94",443,14,3522,18810,0,0,8,959,6,2563,243.788412,0.46299700000000144,16570,44285
"172.16.133.20",62618,"173.194.73.94",443,99,55402,18811,0,0,40,8743,59,46659,243.788653,47.39486899999997,1475,7875
"172.16.133.56",61625,"67.217.66.244",443,6,366,18812,0,0,4,246,2,120,243.78875,0.0589390000000094,33390,16288
"172.16.133.56",61626,"68.64.30.250",443,6,366,18813,0,0,4,246,2,120,243.789155,0.09852700000001846,19974,9743
"172.16.133.56",61627,"216.219.115.250",443,6,366,18814,0,0,4,246,2,120,243.791138,0.053364000000016176,36878,17989
"172.16.133.73",60879,"172.16.139.250",5440,10,1022,18815,0,0,10,1022,0,0,243.797656,0.015281000000015865,535043,0
"172.16.133.53",54302,"172.16.139.250",5440,12,1142,18816,0,0,12,1142,0,0,243.799959,0.017742999999995845,514907,0
"172.16.133.21",53375,"172.16.139.250",5440,12,1142,18817,0,0,12,1142,0,0,243.80242,0.01952699999998231,467865,0
"172.16.133.30",62870,"172.16.139.250",5440,12,1142,18818,0,0,12,1142,0,0,243.806841,0.02246500000001106,406677,0
"172.16.133.25",63678,"172.16.139.250",5440,10,1022,18819,0,0,10,1022,0,0,243.814384,0.010072000000008074,811755,0
"172.16.133.34",50666,"172.16.139.250",5440,10,1022,18820,0,0,10,1022,0,0,243.824395,0.008264999999994416,989231,0
"172.16.133.97",59579,"172.16.139.250",5440,10,1022,18821,0,0,10,1022,0,0,243.83373,0.005638000000004695,1450159,0
"172.16.133.33",58086,"172.16.139.250",5440,10,1022,18822,0,0,10,1022,0,0,243.903607,0.00565399999999272,1446055,0
"172.16.133.68",60961,"172.16.139.250",5440,10,1022,18823,0,0,10,1022,0,0,243.941213,0.005904999999984284,1384589,0
"172.16.133.12",59985,"172.16.139.250",5440,10,1022,18824,0,0,10,1022,0,0,243.954033,0.005612999999982549,1456618,0
"172.16.133.63",54126,"172.16.139.250",5440,10,1022,18825,0,0,10,1022,0,0,243.965353,0.014695000000017444,556379,0
"172.16.133.66",54396,"172.16.139.250",5440,10,1022,18826,0,0,10,1022,0,0,243.975152,0.008560999999986052,955028,0
"172.16.133.82",61633,"172.16.139.250",5440,10,1022,18827,0,0,10,1022,0,0,243.989922,0.005402000000003682,1513513,0
"172.16.133.37",60851,"172.16.139.250",5440,10,1022,18828,0,0,10,1022,0,0,244.003498,0.005239999999986367,1560305,0
"172.16.133.73",60880,"96.43.146.13",443,14,1994,18829,0,0,8,1220,6,774,244.003619,0.49020800000002396,19909,12631
"172.16.133.73",60881,"96.43.146.13",443,13,1934,18830,0,0,7,1160,6,774,244.003907,50.303923000000026,184,123
"172.16.133.78",59439,"172.16.139.250",5440,10,1022,18831,0,0,10,1022,0,0,244.159575,0.01230499999999779,664445,0
"172.16.133.20",62619,"173.194.43.47",443,312,271761,18832,0,0,112,10414,200,261347,244.207805,47.304175999999984,1761,44198
"172.16.133.67",56197,"172.16.139.250",5440,10,1022,18833,0,0,10,1022,0,0,244.215287,0.011594000000002325,705192,0
"172.16.133.20",62620,"173.194.43.47",443,14,4030,18834,0,0,8,959,6,3071,244.222757,10.027891000000011,765,2449
"172.16.133.56",61628,"172.16.139.250",5440,10,1022,18835,0,0,10,1022,0,0,244.237477,0.005135999999993146,1591900,0
"172.16.133.41",53341,"172.16.139.250",5440,10,1022,18836,0,0,10,1022,0,0,244.292768,0.016617999999994026,491996,0
"172.16.133.43",57967,"172.16.139.250",5440,10,1022,18837,0,0,10,1022,0,0,244.362112,0.005619999999993297,1454804,0
"172.16.133.132",50252,"38.70.64.178",80,14,4158,18838,0,0,9,1531,5,2627,244.37244,1.5798229999999762,7752,13302
"172.16.133.132",50253,"38.70.64.178",80,14,4588,18839,0,0,9,2024,5,2564,244.375824,1.5765519999999924,10270,13010
"172.16.133.132",50254,"38.70.64.178",80,12,3324,18840,0,0,8,1480,4,1844,244.378657,1.5733579999999847,7525,9376
"172.16.133.13",53255,"172.16.139.250",5440,10,1022,18841,0,0,10,1022,0,0,244.384063,0.005482999999998128,1491154,0
"172.16.133.85",52477,"172.16.139.250",5440,10,1022,18842,0,0,10,1022,0,0,244.389382,0.006315000000000737,1294695,0
"172.16.133.42",57311,"172.16.139.250",5440,12,1142,18843,0,0,12,1142,0,0,244.400221,0.037535000000019636,243399,0
"172.16.133.20",62621,"172.16.139.250",5440,12,1142,18844,0,0,12,1142,0,0,244.433024,0.014851000000021486,615177,0
"172.16.133.28",49369,"172.16.139.250",5440,12,1142,18845,0,0,12,1142,0,0,244.46157,0.006636000000014519,1376732,0
"172.16.133.113",55741,"172.16.139.250",135,8,492,18846,0,0,8,492,0,0,244.469008,0.014658999999994649,268503,0
"172.16.133.113",55742,"172.16.139.250",5462,10,696,18847,0,0,10,696,0,0,244.486427,0.5198830000000214,10710,0
"172.16.133.99",56252,"172.16.139.250",5440,10,1022,18848,0,0,10,1022,0,0,244.49047,0.01469800000000987,556266,0
"172.16.133.75",51165,"172.16.139.250",5440,10,1022,18849,0,0,10,1022,0,0,244.494906,0.014588000000003376,560460,0
"172.16.133.87",60454,"172.16.139.250",5440,10,1022,18850,0,0,10,1022,0,0,244.515465,0.014826999999996815,551426,0
"172.16.133.35",50160,"172.16.139.250",5440,12,1142,18851,0,0,12,1142,0,0,244.518224,0.049766000000005306,183579,0
"172.16.133.116",53968,"172.16.139.250",5440,10,1022,18852,0,0,10,1022,0,0,244.525431,0.008657999999996946,944328,0
"172.16.133.116",53969,"172.16.139.250",5440,12,1142,18853,0,0,12,1142,0,0,244.535133,0.007933000000008406,1151645,0
"172.16.133.116",53970,"172.16.139.250",5440,12,1142,18854,0,0,12,1142,0,0,244.5438,0.00686999999999216,1329839,0
"172.16.133.84",59000,"172.16.139.250",5440,12,1142,18855,0,0,12,1142,0,0,244.548659,0.01611400000001595,566960,0
"172.16.133.49",55980,"172.16.139.250",5440,12,1142,18856,0,0,12,1142,0,0,244.623897,0.015924000000012484,573725,0
"172.16.133.57",60642,"180.153.30.250",443,6,378,18857,0,0,4,258,2,120,244.666432,0.688635000000005,2997,1394
"172.16.133.95",57176,"172.16.139.250",5440,12,1142,18858,0,0,12,1142,0,0,244.667696,0.027461999999985665,332677,0
"172.16.133.92",57867,"172.16.139.250",5440,10,1022,18859,0,0,10,1022,0,0,244.693026,0.015409000000005335,530599,0
"172.16.133.29",61202,"172.16.139.250",5440,12,1142,18860,0,0,12,1142,0,0,244.713938,0.018063999999981206,505757,0
"172.16.133.44",65029,"172.16.139.250",5440,12,1142,18861,0,0,12,1142,0,0,244.719725,0.0061249999999972715,1491591,0
"172.16.133.207",56136,"172.16.139.250",5440,10,1022,18862,0,0,10,1022,0,0,244.740987,0.014775000000014415,553367,0
"172.16.133.83",57274,"172.16.139.250",5440,12,1142,18863,0,0,12,1142,0,0,244.751712,0.014853000000016436,615094,0
"172.16.133.93",61058,"172.16.139.250",5440,10,1022,18864,0,0,10,1022,0,0,244.7661,0.004830999999995811,"",""
"172.16.133.11",55363,"172.16.139.250",5440,12,1142,18865,0,0,12,1142,0,0,244.783918,0.016889999999989413,540911,0
"172.16.133.55",57820,"172.16.139.250",5440,12,1142,18866,0,0,12,1142,0,0,244.789819,0.006519999999994752,1401226,0
"172.16.133.73",60882,"172.16.139.250",5440,10,1022,18867,0,0,10,1022,0,0,244.811676,0.015451999999982036,529122,0
"172.16.133.53",54303,"172.16.139.250",5440,10,1022,18868,0,0,10,1022,0,0,244.814021,0.01703200000000038,480037,0
"172.16.133.21",53376,"172.16.139.250",5440,12,1142,18869,0,0,12,1142,0,0,244.817005,0.0062819999999987886,1454313,0
"172.16.133.30",62872,"172.16.139.250",5440,10,1022,18870,0,0,10,1022,0,0,244.821849,0.01678700000002209,487043,0
"172.16.133.25",63679,"172.16.139.250",5440,10,1022,18871,0,0,10,1022,0,0,244.827997,0.006851999999980762,1193228,0
"172.16.133.34",50667,"172.16.139.250",5440,10,1022,18872,0,0,10,1022,0,0,244.838638,0.005154000000004544,1586340,0
"172.16.133.97",59580,"172.16.139.250",5440,10,1022,18873,0,0,10,1022,0,0,244.852079,0.015213999999986072,537399,0
"172.16.133.33",58087,"172.16.139.250",5440,12,1142,18874,0,0,12,1142,0,0,244.919266,0.006322000000011485,1445112,0
"172.16.133.68",60962,"172.16.139.250",5440,10,1022,18875,0,0,10,1022,0,0,244.953885,0.006158999999996695,1327488,0
"172.16.133.20",62622,"199.16.156.8",80,11,2512,18876,0,0,6,1619,5,893,244.961713,31.12235000000001,416,229
"172.16.133.12",59986,"172.16.139.250",5440,12,1142,18877,0,0,12,1142,0,0,244.968519,0.006129000000015594,1490618,0
"172.16.133.63",54127,"172.16.139.250",5440,12,1142,18878,0,0,12,1142,0,0,244.979825,0.006058999999993375,1507839,0
"172.16.133.66",54397,"172.16.139.250",5440,10,1022,18879,0,0,10,1022,0,0,244.990701,0.00537399999998911,1521399,0
"172.16.133.82",61634,"172.16.139.250",5440,10,1022,18880,0,0,10,1022,0,0,245.004708,0.006923999999997932,1180820,0
"172.16.133.37",60852,"172.16.139.250",5440,10,1022,18881,0,0,10,1022,0,0,245.018874,0.0151209999999935,540704,0
"172.16.133.78",59440,"172.16.139.250",5440,12,1142,18882,0,0,12,1142,0,0,245.174838,0.015422000000000935,592400,0
"172.16.133.67",56198,"172.16.139.250",5440,12,1142,18883,0,0,12,1142,0,0,245.229656,0.006202999999999292,1472835,0
"172.16.133.56",61629,"172.16.139.250",5440,10,1022,18884,0,0,10,1022,0,0,245.252675,0.004751999999996315,"",""
"172.16.133.41",53342,"172.16.139.250",5440,10,1022,18885,0,0,10,1022,0,0,245.306321,0.01493899999999826,547292,0
"172.16.133.68",60963,"198.74.58.38",80,10,2587,18886,0,0,5,496,5,2091,245.309439,20.308288000000005,195,823
"172.16.133.95",57177,"206.33.41.253",80,6,372,18887,0,0,4,246,2,126,245.345602,14.557302999999962,135,69
"172.16.133.95",57178,"206.33.41.253",80,6,372,18888,0,0,4,246,2,126,245.345727,14.555728999999985,135,69
"172.16.133.95",57179,"206.33.41.253",80,6,372,18889,0,0,4,246,2,126,245.345838,14.557065999999992,135,69
"172.16.133.95",57180,"206.33.41.253",80,6,372,18890,0,0,4,246,2,126,245.345948,14.55695399999999,135,69
"172.16.133.43",57968,"172.16.139.250",5440,10,1022,18891,0,0,10,1022,0,0,245.376763,0.005454999999983556,1498808,0
"172.16.133.20",62623,"74.125.226.37",443,14,4143,18892,0,0,8,958,6,3185,245.377225,8.873728,863,2871
"172.16.133.20",62624,"74.125.226.37",443,15,4203,18893,0,0,8,958,7,3245,245.377497,8.914258999999987,859,2912
"172.16.133.20",62625,"74.125.226.37",443,14,4143,18894,0,0,8,958,6,3185,245.377719,8.873751999999996,863,2871
"172.16.133.20",62626,"74.125.226.37",443,15,4203,18895,0,0,8,958,7,3245,245.378022,8.91708700000001,859,2911
"172.16.133.20",62627,"74.125.226.37",443,438,367217,18896,0,0,154,30776,284,336441,245.378397,46.09973200000002,5340,58384
"172.16.133.20",62628,"74.125.226.37",443,14,4143,18897,0,0,8,958,6,3185,245.378619,8.873516000000023,863,2871
"172.16.133.20",62629,"74.125.226.37",443,14,4143,18898,0,0,8,958,6,3185,245.378883,8.873498000000012,863,2871
"172.16.133.13",53256,"172.16.139.250",5440,12,1142,18899,0,0,12,1142,0,0,245.396467,0.006005999999985079,1521145,0
"172.16.133.85",52478,"172.16.139.250",5440,10,1022,18900,0,0,10,1022,0,0,245.403656,0.005325999999996611,1535110,0
"172.16.133.42",57312,"172.16.139.250",5440,12,1142,18901,0,0,12,1142,0,0,245.412891,0.04874899999998661,187408,0
"172.16.133.20",62630,"172.16.139.250",5440,12,1142,18902,0,0,12,1142,0,0,245.446385,0.006066000000004124,1506099,0
"172.16.133.28",49370,"172.16.139.250",5440,10,1022,18903,0,0,10,1022,0,0,245.475669,0.0060829999999896245,1344073,0
"172.16.133.99",56253,"172.16.139.250",5440,12,1142,18904,0,0,12,1142,0,0,245.503757,0.014972999999997683,610164,0
"172.16.133.75",51166,"172.16.139.250",5440,12,1142,18905,0,0,12,1142,0,0,245.509172,0.005747999999982767,1589422,0
"172.16.133.46",64485,"192.147.107.14",443,4,274,18906,0,0,2,137,2,137,245.523306,9.000000000014552e-05,"",""
"172.16.133.46",64589,"192.147.107.14",443,21,5549,18907,0,0,11,2105,10,3444,245.525322,31.234462000000036,539,882
"172.16.133.87",60456,"172.16.139.250",5440,12,1142,18908,0,0,12,1142,0,0,245.530619,0.0062859999999886895,1453388,0
"172.16.133.35",50161,"172.16.139.250",5440,12,1142,18909,0,0,12,1142,0,0,245.531671,0.018888000000004013,483693,0
"172.16.133.116",53971,"172.16.139.250",5440,10,1022,18910,0,0,10,1022,0,0,245.539321,0.005481000000003178,1491698,0
"172.16.133.116",53972,"172.16.139.250",5440,10,1022,18911,0,0,10,1022,0,0,245.545777,0.00713300000001027,1146221,0
"172.16.133.116",53973,"172.16.139.250",5440,10,1022,18912,0,0,10,1022,0,0,245.553833,0.006391000000007807,1279299,0
"172.16.133.84",59001,"172.16.139.250",5440,10,1022,18913,0,0,10,1022,0,0,245.561434,0.005452000000019552,1499633,0
"172.16.133.18",50316,"128.177.36.72",443,37,16442,18914,0,0,18,2465,19,13977,245.633412,9.638114999999999,2046,11601
"172.16.133.49",55981,"172.16.139.250",5440,12,1142,18915,0,0,12,1142,0,0,245.638294,0.006486999999992804,1408355,0
"172.16.133.95",57181,"172.16.139.250",5440,12,1142,18916,0,0,12,1142,0,0,245.680608,0.015620999999981677,584853,0
"172.16.133.92",57868,"172.16.139.250",5440,12,1142,18917,0,0,12,1142,0,0,245.706976,0.01563200000001075,584442,0
"172.16.133.29",61203,"172.16.139.250",5440,12,1142,18918,0,0,12,1142,0,0,245.725678,0.005680000000012342,1608450,0
"172.16.133.44",65030,"172.16.139.250",5440,10,1022,18919,0,0,10,1022,0,0,245.730609,0.015455000000002883,529019,0
"172.16.133.207",56137,"172.16.139.250",5440,12,1142,18920,0,0,12,1142,0,0,245.755167,0.005194999999986294,1758614,0
"172.16.133.83",57275,"172.16.139.250",5440,10,1022,18921,0,0,10,1022,0,0,245.765664,0.004579000000006772,"",""
"172.16.133.93",61059,"172.16.139.250",5440,10,1022,18922,0,0,10,1022,0,0,245.780215,0.014037999999999329,582419,0
"172.16.133.11",55364,"172.16.139.250",5440,10,1022,18923,0,0,10,1022,0,0,245.797748,0.0055499999999995,1473153,0
"172.16.133.55",57821,"172.16.139.250",5440,10,1022,18924,0,0,10,1022,0,0,245.802467,0.006150999999988471,1329214,0
"172.16.133.56",61630,"216.219.115.250",443,6,366,18925,0,0,4,246,2,120,245.825247,0.07906200000002173,24891,12142
"172.16.133.56",61631,"67.217.66.244",443,6,366,18926,0,0,4,246,2,120,245.825248,0.09442500000000109,20841,10166
"172.16.133.73",60883,"172.16.139.250",5440,10,1022,18927,0,0,10,1022,0,0,245.826551,0.015429000000011683,529911,0
"172.16.133.53",54304,"172.16.139.250",5440,12,1142,18928,0,0,12,1142,0,0,245.828617,0.01800899999997796,507301,0
"172.16.133.21",53377,"172.16.139.250",5440,10,1022,18929,0,0,10,1022,0,0,245.830861,0.005465000000015152,1496065,0
"172.16.133.56",61632,"68.64.30.250",443,6,366,18930,0,0,4,246,2,120,245.836154,0.12506400000000895,15735,7676
"172.16.133.30",62873,"172.16.139.250",5440,12,1142,18931,0,0,12,1142,0,0,245.840849,0.021246000000019194,430010,0
"172.16.133.25",63680,"172.16.139.250",5440,12,1142,18932,0,0,12,1142,0,0,245.842895,0.007075000000014597,1291307,0
"172.16.133.34",50668,"172.16.139.250",5440,10,1022,18933,0,0,10,1022,0,0,245.852455,0.005168999999995094,1581737,0
"172.16.133.56",61633,"68.64.13.250",443,6,366,18934,0,0,4,246,2,120,245.854178,0.11659199999999714,16879,8233
"172.16.133.97",59581,"172.16.139.250",5440,10,1022,18935,0,0,10,1022,0,0,245.861676,0.014676000000008571,557100,0
"172.16.133.30",62874,"96.43.146.22",443,15,4132,18936,0,0,9,3355,6,777,245.917394,45.18899099999999,593,137
"172.16.133.33",58088,"172.16.139.250",5440,10,1022,18937,0,0,10,1022,0,0,245.931561,0.015842000000020562,516096,0
"172.16.133.68",60964,"172.16.139.250",5440,10,1022,18938,0,0,10,1022,0,0,245.967872,0.005573999999995749,1466810,0
"172.16.133.12",59987,"172.16.139.250",5440,10,1022,18939,0,0,10,1022,0,0,245.980633,0.005645999999984497,1448104,0
"172.16.133.40",50290,"173.194.43.47",80,9,1276,18940,0,0,5,832,4,444,245.992138,45.07952,147,78
"172.16.133.63",54128,"172.16.139.250",5440,10,1022,18941,0,0,10,1022,0,0,245.994077,0.005324000000001661,1535687,0
"172.16.133.66",54398,"172.16.139.250",5440,10,1022,18942,0,0,10,1022,0,0,246.004172,0.01848499999999831,442304,0
"172.16.128.169",3813,"172.16.139.250",135,14,1461,18943,0,0,8,775,6,686,246.015043,32.613203999999996,190,168
"172.16.133.82",61635,"172.16.139.250",5440,10,1022,18944,0,0,10,1022,0,0,246.017767,0.0071310000000153195,1146543,0
"172.16.133.37",60853,"172.16.139.250",5440,10,1022,18945,0,0,10,1022,0,0,246.031551,0.006411999999983209,1275109,0
"172.16.133.18",50317,"178.255.83.1",80,11,2084,18946,0,0,6,888,5,1196,246.080702,0.06131500000000756,115860,156046
"172.16.133.68",60965,"180.153.30.250",443,6,366,18947,0,0,4,246,2,120,246.091252,0.6686760000000049,2943,1435
"172.16.133.41",53343,"157.56.236.102",443,31,18719,18948,0,0,13,3444,18,15275,246.127907,0.6627909999999986,41569,184371
"172.16.133.18",50318,"217.118.26.135",80,12,2378,18949,0,0,7,1215,5,1163,246.149267,0.3151239999999973,30845,29524
"172.16.133.78",59441,"172.16.139.250",5440,10,1022,18950,0,0,10,1022,0,0,246.187531,0.0055490000000020245,1473418,0
"172.16.133.67",56199,"172.16.139.250",5440,12,1142,18951,0,0,12,1142,0,0,246.24225,0.015746999999976197,580174,0
"172.16.133.56",61634,"172.16.139.250",5440,10,1022,18952,0,0,10,1022,0,0,246.266162,0.004868999999985135,"",""
"172.16.133.41",53344,"172.16.139.250",5440,12,1142,18953,0,0,12,1142,0,0,246.320312,0.015292999999985568,597397,0
"172.16.128.169",3814,"172.16.139.250",80,9,1229,18954,0,0,5,488,4,741,246.340118,0.3034120000000087,12866,19537
"172.16.133.43",57969,"172.16.139.250",5440,10,1022,18955,0,0,10,1022,0,0,246.390117,0.0053690000000017335,1522816,0
"172.16.133.13",53257,"172.16.139.250",5440,12,1142,18956,0,0,12,1142,0,0,246.412148,0.006303000000002612,1449468,0
"172.16.133.85",52479,"172.16.139.250",5440,10,1022,18957,0,0,10,1022,0,0,246.416438,0.005595999999997048,1461043,0
"172.16.133.42",57313,"172.16.139.250",5440,12,1142,18958,0,0,12,1142,0,0,246.42522,0.04657499999999004,196156,0
"172.16.133.132",50255,"38.70.64.178",80,5,340,18959,0,0,3,206,2,134,246.448848,0.13660999999999035,12063,7847
"172.16.133.20",62631,"172.16.139.250",5440,10,1022,18960,0,0,10,1022,0,0,246.46157,0.014599000000004025,560038,0
"172.16.133.28",49371,"172.16.139.250",5440,10,1022,18961,0,0,10,1022,0,0,246.489089,0.014633000000003449,558737,0
"172.16.133.99",56254,"172.16.139.250",5440,12,1142,18962,0,0,12,1142,0,0,246.517152,0.015593999999993002,585866,0
"172.16.133.75",51167,"172.16.139.250",5440,10,1022,18963,0,0,10,1022,0,0,246.523109,0.006157000000001744,1327919,0
"172.16.133.87",60457,"172.16.139.250",5440,10,1022,18964,0,0,10,1022,0,0,246.543713,0.006097000000011121,1340987,0
"172.16.133.35",50162,"172.16.139.250",5440,12,1142,18965,0,0,12,1142,0,0,246.545175,0.021783999999996695,419390,0
"172.16.133.116",53974,"172.16.139.250",5440,10,1022,18966,0,0,10,1022,0,0,246.554643,0.0056219999999882475,1454286,0
"172.16.133.96",53387,"23.0.54.218",80,10,2527,18967,0,0,6,1042,4,1485,246.558491,0.48365899999998874,17235,24562
"172.16.133.18",50319,"128.177.36.72",443,61,39897,18968,0,0,29,4044,32,35853,246.558922,8.28365500000001,3905,34625
"172.16.133.18",50320,"128.177.36.72",443,1668,1537935,18969,0,0,575,42490,1093,1495445,246.558924,8.284845000000018,41029,1444029
"172.16.133.116",53975,"172.16.139.250",5440,10,1022,18970,0,0,10,1022,0,0,246.561135,0.007022000000006301,1164340,0
"172.16.133.116",53976,"172.16.139.250",5440,12,1142,18971,0,0,12,1142,0,0,246.571342,0.005812000000020134,1571920,0
"172.16.133.84",59002,"172.16.139.250",5440,10,1022,18972,0,0,10,1022,0,0,246.57521,0.005436000000003105,1504047,0
"172.16.133.49",55982,"172.16.139.250",5440,12,1142,18973,0,0,12,1142,0,0,246.652303,0.00682700000001546,1338215,0
"172.16.133.95",57182,"172.16.139.250",5440,12,1142,18974,0,0,12,1142,0,0,246.694946,0.006228000000021439,1466923,0
"172.16.133.114",55343,"78.108.118.250",443,6,366,18975,0,0,4,246,2,120,246.713675,0.3154870000000187,6237,3042
"172.16.133.114",55344,"216.219.118.244",443,6,366,18976,0,0,4,246,2,120,246.713675,0.3180619999999976,6187,3018
"172.16.133.114",55345,"216.115.219.126",443,6,366,18977,0,0,4,246,2,120,246.713676,0.5075620000000072,3877,1891
"172.16.133.114",55346,"68.64.24.250",443,6,366,18978,0,0,4,246,2,120,246.713677,0.12152900000000955,16193,7899
"172.16.133.92",57869,"172.16.139.250",5440,10,1022,18979,0,0,10,1022,0,0,246.721551,0.01745999999999981,468270,0
"172.16.133.29",61204,"172.16.139.250",5440,10,1022,18980,0,0,10,1022,0,0,246.738192,0.0053729999999916345,1521682,0
"172.16.133.44",65031,"172.16.139.250",5440,10,1022,18981,0,0,10,1022,0,0,246.744446,0.014671999999990248,557251,0
"172.16.133.207",56138,"172.16.139.250",5440,10,1022,18982,0,0,10,1022,0,0,246.769289,0.004924000000016804,"",""
"172.16.133.83",57276,"172.16.139.250",5440,12,1142,18983,0,0,12,1142,0,0,246.779725,0.013848999999993339,659686,0
"172.16.133.93",61060,"172.16.139.250",5440,10,1022,18984,0,0,10,1022,0,0,246.793933,0.0047969999999963875,"",""
"172.16.133.11",55365,"172.16.139.250",5440,10,1022,18985,0,0,10,1022,0,0,246.813341,0.015156999999987875,539420,0
"172.16.133.55",57822,"172.16.139.250",5440,12,1142,18986,0,0,12,1142,0,0,246.816525,0.017401999999975715,524997,0
"172.16.133.73",60884,"172.16.139.250",5440,12,1142,18987,0,0,12,1142,0,0,246.838843,0.02251699999999346,405737,0
"172.16.133.53",54305,"172.16.139.250",5440,12,1142,18988,0,0,12,1142,0,0,246.843186,0.006514000000009901,1402517,0
"172.16.133.21",53378,"172.16.139.250",5440,10,1022,18989,0,0,10,1022,0,0,246.84475,0.008082000000001699,1011630,0
"172.16.133.30",62875,"172.16.139.250",5440,10,1022,18990,0,0,10,1022,0,0,246.849645,0.007283000000001039,1122614,0
"172.16.133.25",63681,"172.16.139.250",5440,10,1022,18991,0,0,10,1022,0,0,246.85613,0.00818799999998987,998534,0
"172.16.133.34",50669,"172.16.139.250",5440,10,1022,18992,0,0,10,1022,0,0,246.866264,0.004855999999989535,"",""
"172.16.133.97",59582,"172.16.139.250",5440,10,1022,18993,0,0,10,1022,0,0,246.875853,0.014519000000007054,563124,0
"172.16.133.33",58089,"172.16.139.250",5440,12,1142,18994,0,0,12,1142,0,0,246.946588,0.006369000000006508,1434448,0
"172.16.133.68",60966,"172.16.139.250",5440,12,1142,18995,0,0,12,1142,0,0,246.981951,0.0060599999999908505,1507590,0
"172.16.133.12",59988,"172.16.139.250",5440,12,1142,18996,0,0,12,1142,0,0,246.995018,0.006150000000019418,1485528,0
"172.16.133.63",54129,"172.16.139.250",5440,10,1022,18997,0,0,10,1022,0,0,247.006599,0.005375000000015007,1521116,0
"172.16.133.96",53388,"23.0.54.218",80,7,2233,18998,0,0,4,981,3,1252,247.012461,0.09207699999998908,85233,108778
"172.16.133.66",54399,"172.16.139.250",5440,10,1022,18999,0,0,10,1022,0,0,247.018195,0.005425999999999931,1506819,0
"172.16.133.82",61636,"172.16.139.250",5440,10,1022,19000,0,0,10,1022,0,0,247.032165,0.005612000000013495,1456878,0
"172.16.133.96",53389,"68.71.216.157",843,2,138,19001,0,0,1,78,1,60,247.035173,0.09895500000001789,6305,4850
"172.16.133.57",60643,"180.153.30.250",443,6,378,19002,0,0,4,258,2,120,247.035549,0.6689939999999979,3085,1434
"172.16.133.37",60854,"172.16.139.250",5440,10,1022,19003,0,0,10,1022,0,0,247.046017,0.016321000000004915,500949,0
"172.16.133.96",53390,"23.0.54.218",80,10,1264,19004,0,0,6,778,4,486,247.046855,0.08657800000000293,71888,44907
"172.16.133.18",50321,"192.150.16.64",443,24,8960,19005,0,0,14,1846,10,7114,247.129616,2.4898239999999987,5931,22857
"172.16.133.78",59442,"172.16.139.250",5440,12,1142,19006,0,0,12,1142,0,0,247.201706,0.007949999999993906,1149182,0
"172.16.133.67",56200,"172.16.139.250",5440,12,1142,19007,0,0,12,1142,0,0,247.257342,0.015352000000007138,595101,0
"172.16.133.56",61635,"172.16.139.250",5440,10,1022,19008,0,0,10,1022,0,0,247.280749,0.004757000000012113,"",""
"172.16.133.18",50322,"199.7.48.72",80,11,3363,19009,0,0,5,791,6,2572,247.332618,0.10564600000000723,59898,194763
"172.16.133.41",53345,"172.16.139.250",5440,12,1142,19010,0,0,12,1142,0,0,247.334833,0.01609199999998623,567735,0
"172.16.133.43",57970,"172.16.139.250",5440,10,1022,19011,0,0,10,1022,0,0,247.404219,0.014546999999993204,562040,0
"172.16.133.13",53258,"172.16.139.250",5440,10,1022,19012,0,0,10,1022,0,0,247.425144,0.005482000000000653,1491426,0
"172.16.133.85",52480,"172.16.139.250",5440,10,1022,19013,0,0,10,1022,0,0,247.429332,0.014750000000020691,554305,0
"172.16.133.95",57184,"184.73.225.104",443,22,7276,19014,0,0,11,1982,11,5294,247.436011,5.323003,2978,7956
"172.16.133.42",57314,"172.16.139.250",5440,12,1142,19015,0,0,12,1142,0,0,247.439545,0.01552499999999668,588470,0
"172.16.133.20",62632,"172.16.139.250",5440,12,1142,19016,0,0,12,1142,0,0,247.474397,0.014945999999980586,611267,0
"172.16.133.28",49372,"172.16.139.250",5440,12,1142,19017,0,0,12,1142,0,0,247.503317,0.006206999999989193,1471886,0
"172.16.133.99",56255,"172.16.139.250",5440,12,1142,19018,0,0,12,1142,0,0,247.532281,0.07848399999997469,116405,0
"172.16.133.75",51168,"172.16.139.250",5440,10,1022,19019,0,0,10,1022,0,0,247.537164,0.06984900000000493,117052,0
"172.16.133.35",50163,"172.16.139.250",5440,12,1142,19020,0,0,12,1142,0,0,247.56283,0.05701500000000692,160238,0
"172.16.133.116",53977,"172.16.139.250",5440,10,1022,19021,0,0,10,1022,0,0,247.567144,0.03151899999997454,259399,0
"172.16.133.87",60458,"172.16.139.250",5440,10,1022,19022,0,0,10,1022,0,0,247.571869,0.03162100000000123,258562,0
"172.16.133.84",59003,"172.16.139.250",5440,10,1022,19023,0,0,10,1022,0,0,247.590282,0.027619999999984657,296017,0
"172.16.133.116",53978,"172.16.139.250",5440,12,1142,19024,0,0,12,1142,0,0,247.599736,0.02688100000000304,339868,0
"172.16.133.116",53979,"172.16.139.250",5440,12,1142,19025,0,0,12,1142,0,0,247.627664,0.005682999999976346,1607601,0
"172.16.133.49",55983,"172.16.139.250",5440,12,1142,19026,0,0,12,1142,0,0,247.665961,0.007666000000000395,1191755,0
"172.16.133.163",3607,"15.240.238.56",80,11,1318,19027,0,0,6,701,5,617,247.677364,5.238636999999983,1070,942
"172.16.133.18",50323,"157.56.238.6",443,27,10586,19028,0,0,14,2526,13,8060,247.686722,1.176417999999984,17177,54810
"172.16.133.163",3608,"15.240.238.56",80,7,432,19029,0,0,4,246,3,186,247.706941,6.1246380000000045,321,242
"172.16.133.95",57185,"172.16.139.250",5440,10,1022,19030,0,0,10,1022,0,0,247.710152,0.01587900000001241,514893,0
"172.16.133.21",53380,"96.43.146.176",443,22,5507,19031,0,0,13,3364,9,2143,247.724494,49.202841000000035,546,348
"172.16.133.95",57186,"157.56.244.217",443,6,374,19032,0,0,3,194,3,180,247.724948,1.1370859999999823,1364,1266
"172.16.133.92",57870,"172.16.139.250",5440,10,1022,19033,0,0,10,1022,0,0,247.735016,0.01541900000000851,530254,0
"172.16.133.29",61205,"172.16.139.250",5440,10,1022,19034,0,0,10,1022,0,0,247.752612,0.005572999999998274,1467073,0
"172.16.133.44",65032,"172.16.139.250",5440,12,1142,19035,0,0,12,1142,0,0,247.758663,0.006237999999996191,1464571,0
"172.16.133.96",53391,"68.71.216.157",80,16,9292,19036,0,0,7,497,9,8795,247.770224,0.3518969999999797,11298,199944
"172.16.133.207",56139,"172.16.139.250",5440,12,1142,19037,0,0,12,1142,0,0,247.783066,0.014825000000001864,616256,0
"172.16.133.83",57277,"172.16.139.250",5440,12,1142,19038,0,0,12,1142,0,0,247.794775,0.0069000000000016826,1324057,0
"172.16.133.22",53995,"184.72.243.110",80,9,882,19039,0,0,5,494,4,388,247.795913,0.08846699999998009,44672,35086
"172.16.133.96",53392,"63.251.28.128",80,11,4939,19040,0,0,5,1987,6,2952,247.800303,0.08188199999997892,194133,288415
"172.16.133.93",61061,"172.16.139.250",5440,12,1142,19041,0,0,12,1142,0,0,247.807836,0.014718999999985272,620694,0
"172.16.133.11",55366,"172.16.139.250",5440,10,1022,19042,0,0,10,1022,0,0,247.826095,0.005731999999994741,1426378,0
"172.16.133.55",57823,"172.16.139.250",5440,12,1142,19043,0,0,12,1142,0,0,247.831766,0.0063829999999995835,1431301,0
"172.16.133.73",60885,"172.16.139.250",5440,12,1142,19044,0,0,12,1142,0,0,247.852974,0.00629500000002281,1451310,0
"172.16.133.53",54306,"172.16.139.250",5440,10,1022,19045,0,0,10,1022,0,0,247.857158,0.01589400000000296,514407,0
"172.16.133.30",62876,"172.16.139.250",5440,12,1142,19046,0,0,12,1142,0,0,247.86366,0.006385999999992009,1430629,0
"172.16.133.25",63682,"172.16.139.250",5440,12,1142,19047,0,0,12,1142,0,0,247.869212,0.007827999999989288,1167092,0
"172.16.133.163",3609,"15.216.110.21",80,105,78926,19048,0,0,41,4533,64,74393,247.874201,8.969776999999993,4042,66349
"172.16.133.34",50670,"172.16.139.250",5440,10,1022,19049,0,0,10,1022,0,0,247.880101,0.005980999999991354,1366995,0
"172.16.133.56",61636,"216.219.115.250",443,6,366,19050,0,0,4,246,2,120,247.880321,0.11025999999998248,17848,8706
"172.16.133.21",53381,"172.16.139.250",5440,10,1022,19051,0,0,10,1022,0,0,247.883939,0.04853099999999699,168469,0
"172.16.133.96",53393,"199.127.194.80",80,11,1738,19052,0,0,6,809,5,929,247.884006,0.1706269999999961,37930,43556
"172.16.133.97",59583,"172.16.139.250",5440,10,1022,19053,0,0,10,1022,0,0,247.888823,0.047289000000006354,172894,0
"172.16.133.56",61637,"67.217.66.244",443,6,366,19054,0,0,4,246,2,120,247.890217,0.13356699999999933,14734,7187
"172.16.133.56",61638,"68.64.30.250",443,6,366,19055,0,0,4,246,2,120,247.914299,0.16374400000000833,12018,5862
"172.16.133.56",61639,"68.64.13.250",443,6,366,19056,0,0,4,246,2,120,247.921239,0.17822699999999259,11042,5386
"172.16.133.33",58090,"172.16.139.250",5440,12,1142,19057,0,0,12,1142,0,0,247.959806,0.008628000000015845,1058878,0
"172.16.133.96",53394,"23.67.243.91",80,12,2952,19058,0,0,7,2419,5,533,247.987342,0.13428999999999292,144106,31752
"172.16.133.68",60967,"172.16.139.250",5440,10,1022,19059,0,0,10,1022,0,0,247.994826,0.005892000000017106,1387644,0
"172.16.133.12",59989,"172.16.139.250",5440,12,1142,19060,0,0,12,1142,0,0,248.009332,0.006189000000006217,1476167,0
"172.16.133.63",54130,"172.16.139.250",5440,10,1022,19061,0,0,10,1022,0,0,248.021559,0.059887000000003354,136523,0
"172.16.133.96",53395,"68.71.216.157",80,12,940,19062,0,0,7,503,5,437,248.02525,8.954141000000021,449,390
"172.16.133.96",53396,"199.127.194.80",80,23,17705,19063,0,0,8,995,15,16710,248.031488,0.12146200000000817,65534,1100591
"172.16.133.66",54400,"172.16.139.250",5440,10,1022,19064,0,0,10,1022,0,0,248.032845,0.05683399999998073,143857,0
"172.16.133.82",61637,"172.16.139.250",5440,12,1142,19065,0,0,12,1142,0,0,248.045935,0.04769200000001206,191562,0
"172.16.133.37",60855,"172.16.139.250",5440,10,1022,19066,0,0,10,1022,0,0,248.05902,0.027661999999992304,295567,0
"172.16.133.96",53397,"69.31.117.22",80,12,1156,19067,0,0,7,696,5,460,248.162758,0.1008950000000084,55186,36473
"172.16.133.41",53346,"157.56.236.102",443,27,16007,19068,0,0,11,3375,16,12632,248.164263,1.2138500000000079,22243,83252
"172.16.133.78",59443,"172.16.139.250",5440,10,1022,19069,0,0,10,1022,0,0,248.215742,0.0055109999999842785,1483578,0
"172.16.133.96",53398,"69.31.117.22",80,18,2001,19070,0,0,11,1193,7,808,248.244514,0.9430009999999811,10120,6854
"172.16.133.67",56201,"172.16.139.250",5440,10,1022,19071,0,0,10,1022,0,0,248.271454,0.005688999999989619,1437159,0
"172.16.133.96",53399,"199.127.194.178",443,24,6888,19072,0,0,14,2143,10,4745,248.281777,0.2895499999999913,59209,131099
"172.16.133.96",53400,"50.17.207.24",80,8,1306,19073,0,0,5,917,3,389,248.282671,0.10261800000000676,71488,30326
"172.16.133.56",61640,"172.16.139.250",5440,10,1022,19074,0,0,10,1022,0,0,248.293931,0.020219000000025744,404372,0
"172.16.133.96",53401,"50.17.207.24",80,11,2978,19075,0,0,6,2457,5,521,248.345672,0.2367699999999786,83017,17603
"172.16.133.41",53347,"172.16.139.250",5440,12,1142,19076,0,0,12,1142,0,0,248.350418,0.015349000000014712,595217,0
"172.16.133.23",55051,"64.90.204.229",443,45,23417,19077,0,0,19,11326,26,12091,248.350809,17.217703999999998,5262,5617
"172.16.133.43",57971,"172.16.139.250",5440,12,1142,19078,0,0,12,1142,0,0,248.4177,0.01035300000000916,882449,0
"172.16.133.68",60968,"180.153.30.250",443,6,366,19079,0,0,4,246,2,120,248.425317,0.7464919999999893,2636,1286
"172.16.133.13",53259,"172.16.139.250",5440,10,1022,19080,0,0,10,1022,0,0,248.438548,0.00515899999999192,1584803,0
"172.16.133.85",52481,"172.16.139.250",5440,12,1142,19081,0,0,12,1142,0,0,248.4435,0.016341000000011263,559084,0
"172.16.133.42",57315,"172.16.139.250",5440,12,1142,19082,0,0,12,1142,0,0,248.483623,0.0453160000000139,201606,0
"172.16.133.96",53402,"69.31.117.22",1935,30,9113,19083,0,0,17,4811,13,4302,248.486405,8.42327499999999,4569,4085
"172.16.133.20",62633,"172.16.139.250",5440,12,1142,19084,0,0,12,1142,0,0,248.489373,0.005101999999993723,1790670,0
"172.16.133.163",3610,"15.216.110.22",80,10,1494,19085,0,0,6,703,4,791,248.496836,5.2377170000000035,1073,1208
"172.16.133.28",49376,"172.16.139.250",5440,10,1022,19086,0,0,10,1022,0,0,248.51743,0.005344000000008009,1529940,0
"172.16.133.99",56256,"172.16.139.250",5440,10,1022,19087,0,0,10,1022,0,0,248.546503,0.005748000000011189,1422407,0
"172.16.133.75",51169,"172.16.139.250",5440,10,1022,19088,0,0,10,1022,0,0,248.551045,0.005316000000021859,1537998,0
"172.16.133.87",60459,"172.16.139.250",5440,10,1022,19089,0,0,10,1022,0,0,248.572449,0.005413000000004331,1510437,0
"172.16.133.96",53403,"68.71.212.152",80,10,6171,19090,0,0,5,2308,5,3863,248.574968,0.46238699999997834,39931,66835
"172.16.133.35",50164,"172.16.139.250",5440,12,1142,19091,0,0,12,1142,0,0,248.577199,0.0372950000000003,244965,0
"172.16.133.116",53980,"172.16.139.250",5440,10,1022,19092,0,0,10,1022,0,0,248.582826,0.006422999999983858,1272925,0
"172.16.133.116",53981,"172.16.139.250",5440,10,1022,19093,0,0,10,1022,0,0,248.590107,0.006751000000008389,1211079,0
"172.16.133.116",53982,"172.16.139.250",5440,10,1022,19094,0,0,10,1022,0,0,248.597743,0.00638999999998191,1279499,0
"172.16.133.84",59004,"172.16.139.250",5440,10,1022,19095,0,0,10,1022,0,0,248.604682,0.005413000000004331,1510437,0
"172.16.133.96",53404,"69.31.117.22",80,15,5973,19096,0,0,8,2310,7,3663,248.649012,0.7153030000000058,25835,40967
"172.16.133.49",55984,"172.16.139.250",5440,10,1022,19097,0,0,10,1022,0,0,248.680155,0.015753999999986945,518979,0
"172.16.133.95",57187,"172.16.139.250",5440,12,1142,19098,0,0,12,1142,0,0,248.723975,0.006074000000012347,1504115,0
"172.16.133.92",57871,"172.16.139.250",5440,10,1022,19099,0,0,10,1022,0,0,248.748017,0.005541999999991276,1475279,0
"172.16.133.29",61206,"172.16.139.250",5440,10,1022,19100,0,0,10,1022,0,0,248.765739,0.005443000000013853,1502112,0
"172.16.133.44",65033,"172.16.139.250",5440,10,1022,19101,0,0,10,1022,0,0,248.772951,0.005463999999989255,1496339,0
"172.16.133.114",55347,"68.64.24.250",443,6,366,19102,0,0,4,246,2,120,248.799325,0.12080399999999258,16290,7946
"172.16.133.207",56140,"172.16.139.250",5440,10,1022,19103,0,0,10,1022,0,0,248.799877,0.004784999999998263,"",""
"172.16.133.83",57278,"172.16.139.250",5440,10,1022,19104,0,0,10,1022,0,0,248.807689,0.006776000000002114,1206611,0
"172.16.133.93",61062,"172.16.139.250",5440,12,1142,19105,0,0,12,1142,0,0,248.822086,0.014504999999985557,629851,0
"172.16.133.163",3611,"15.193.0.234",80,6,1261,19106,0,0,4,599,2,662,248.837288,0.32091700000000856,14932,16502
"172.16.133.11",55367,"172.16.139.250",5440,12,1142,19107,0,0,12,1142,0,0,248.840869,0.015365000000002738,594598,0
"172.16.133.114",55348,"78.108.118.250",443,6,366,19108,0,0,4,246,2,120,248.843864,0.3943490000000054,4990,2434
"172.16.133.114",55349,"216.219.118.244",443,6,366,19109,0,0,4,246,2,120,248.845445,0.3927699999999845,5010,2444
"172.16.133.55",57824,"172.16.139.250",5440,10,1022,19110,0,0,10,1022,0,0,248.845606,0.005528999999995676,1478748,0
"172.16.133.95",57188,"157.56.234.137",443,6,374,19111,0,0,3,194,3,180,248.862499,1.209955999999977,1282,1190
"172.16.133.73",60886,"172.16.139.250",5440,10,1022,19112,0,0,10,1022,0,0,248.86688,0.005702999999982694,1433631,0
"172.16.133.53",54307,"172.16.139.250",5440,12,1142,19113,0,0,12,1142,0,0,248.871646,0.006180000000000518,1478317,0
"172.16.133.21",53382,"172.16.139.250",5440,12,1142,19114,0,0,12,1142,0,0,248.872751,0.016058000000015227,568937,0
"172.16.133.30",62877,"172.16.139.250",5440,12,1142,19115,0,0,12,1142,0,0,248.878096,0.019928999999990538,458427,0
"172.16.133.25",63683,"172.16.139.250",5440,12,1142,19116,0,0,12,1142,0,0,248.88327,0.009864999999990687,926102,0
"172.16.133.24",57706,"172.16.139.250",5440,6,780,19117,0,0,6,780,0,0,248.89233,0.0013399999999990087,"",""
"172.16.133.34",50671,"172.16.139.250",5440,12,1142,19118,0,0,12,1142,0,0,248.893227,0.014517000000012104,629331,0
"172.16.133.97",59584,"172.16.139.250",5440,10,1022,19119,0,0,10,1022,0,0,248.902732,0.014758000000000493,554004,0
"172.16.133.33",58091,"172.16.139.250",5440,10,1022,19120,0,0,10,1022,0,0,248.97457,0.01874499999999557,436169,0
"172.16.133.113",55743,"172.16.139.250",135,8,492,19121,0,0,8,492,0,0,249.007577,0.03627199999999675,108513,0
"172.16.133.68",60969,"172.16.139.250",5440,10,1022,19122,0,0,10,1022,0,0,249.008727,0.005497000000019625,1487356,0
"172.16.133.12",59990,"172.16.139.250",5440,12,1142,19123,0,0,12,1142,0,0,249.023115,0.005398000000013781,1692478,0
"172.16.133.63",54131,"172.16.139.250",5440,12,1142,19124,0,0,12,1142,0,0,249.035649,0.00819899999999052,1114282,0
"172.16.133.163",3612,"15.192.136.170",80,514,441418,19125,0,0,183,15452,331,425966,249.037697,1.7547909999999831,70444,1941956
"172.16.133.113",55744,"172.16.139.250",5462,10,696,19126,0,0,10,696,0,0,249.043774,0.5244589999999789,10616,0
"172.16.133.66",54401,"172.16.139.250",5440,12,1142,19127,0,0,12,1142,0,0,249.046178,0.011244000000004917,812522,0
"172.16.133.82",61638,"172.16.139.250",5440,12,1142,19128,0,0,12,1142,0,0,249.059846,0.01578600000001984,578740,0
"172.16.133.18",50324,"128.177.36.78",80,23,6321,19129,0,0,12,2588,11,3733,249.066814,30.763149000000027,673,970
"172.16.133.37",60856,"172.16.139.250",5440,10,1022,19130,0,0,10,1022,0,0,249.072482,0.0062669999999798165,1304611,0
"172.16.133.96",53405,"69.31.117.22",80,8,544,19131,0,0,5,342,3,202,249.131711,0.23481499999999755,11651,6882
"172.16.133.78",59444,"172.16.139.250",5440,12,1142,19132,0,0,12,1142,0,0,249.229526,0.005629999999996471,1622735,0
"172.16.133.114",55350,"216.115.219.126",443,7,426,19133,0,0,4,246,3,180,249.237082,3.777957000000015,520,381
"172.16.133.67",56202,"172.16.139.250",5440,10,1022,19134,0,0,10,1022,0,0,249.285574,0.0053959999999904085,1515196,0
"172.16.133.56",61641,"172.16.139.250",5440,10,1022,19135,0,0,10,1022,0,0,249.307952,0.004735000000010814,"",""
"172.16.133.163",3613,"15.192.136.170",80,125,99831,19136,0,0,49,8128,76,91703,249.350119,1.3880570000000034,46845,528525
"172.16.133.41",53348,"172.16.139.250",5440,10,1022,19137,0,0,10,1022,0,0,249.364014,0.015202000000016369,537823,0
"172.16.133.57",60644,"180.153.30.250",443,6,378,19138,0,0,4,258,2,120,249.370385,0.665820999999994,3099,1441
"172.16.133.163",3614,"63.116.244.155",80,32,20948,19139,0,0,14,2648,18,18300,249.387861,0.422647000000012,50122,346388
"172.16.133.163",3615,"63.116.244.155",80,69,54047,19140,0,0,25,2997,44,51050,249.388103,0.960140999999993,24971,425354
"172.16.133.163",3616,"63.116.244.155",80,34,22394,19141,0,0,14,1924,20,20470,249.388484,0.4807309999999916,32017,340647
"172.16.133.163",3617,"63.116.244.155",80,50,37823,19142,0,0,20,3360,30,34463,249.388754,0.25650299999998083,104794,1074856
"172.16.133.163",3618,"63.116.244.155",80,36,23042,19143,0,0,15,2686,21,20356,249.388988,0.18636999999998238,115297,873788
"172.16.133.163",3619,"63.116.244.155",80,117,91851,19144,0,0,45,6647,72,85204,249.405547,7.571625999999981,7023,90024
"172.16.133.43",57972,"172.16.139.250",5440,10,1022,19145,0,0,10,1022,0,0,249.431136,0.005393999999995458,1515758,0
"172.16.133.13",53260,"172.16.139.250",5440,12,1142,19146,0,0,12,1142,0,0,249.452458,0.01660400000000095,550228,0
"172.16.133.163",3620,"15.192.136.170",80,107,86512,19147,0,0,41,6433,66,80079,249.457415,1.2885530000000074,39939,497171
"172.16.133.163",3621,"15.192.136.170",80,203,169832,19148,0,0,75,8503,128,161329,249.457766,1.4804530000000113,45948,871781
"172.16.133.85",52482,"172.16.139.250",5440,10,1022,19149,0,0,10,1022,0,0,249.458322,0.018698999999998023,437242,0
"172.16.133.163",3622,"15.192.136.170",80,75,57855,19150,0,0,30,5353,45,52502,249.464661,0.823993999999999,51971,509731
"172.16.133.42",57316,"172.16.139.250",5440,12,1142,19151,0,0,12,1142,0,0,249.469064,0.044870000000003074,203610,0
"172.16.133.163",3623,"63.116.244.162",80,19,7014,19152,0,0,9,1630,10,5384,249.476736,1.2248530000000244,10646,35165
"172.16.133.163",3624,"63.116.244.162",80,20,10045,19153,0,0,9,1263,11,8782,249.476907,1.4520890000000009,6958,48382
"172.16.133.20",62634,"172.16.139.250",5440,10,1022,19154,0,0,10,1022,0,0,249.504371,0.004735000000010814,"",""
"172.16.133.28",49377,"172.16.139.250",5440,10,1022,19155,0,0,10,1022,0,0,249.530102,0.0069959999999866795,1168667,0
"172.16.133.99",56257,"172.16.139.250",5440,10,1022,19156,0,0,10,1022,0,0,249.559292,0.015379999999993288,531599,0
"172.16.133.75",51170,"172.16.139.250",5440,10,1022,19157,0,0,10,1022,0,0,249.564919,0.005780999999984715,1414288,0
"172.16.133.87",60460,"172.16.139.250",5440,10,1022,19158,0,0,10,1022,0,0,249.584994,0.040896000000003596,199921,0
"172.16.133.116",53983,"172.16.139.250",5440,10,1022,19159,0,0,10,1022,0,0,249.595824,0.03339500000001294,244827,0
"172.16.133.35",50165,"172.16.139.250",5440,12,1142,19160,0,0,12,1142,0,0,249.59907,0.038422999999994545,237774,0
"172.16.133.18",50325,"128.177.36.72",80,16,7000,19161,0,0,8,922,8,6078,249.610231,5.233734999999996,1409,9290
"172.16.133.84",59005,"172.16.139.250",5440,12,1142,19162,0,0,12,1142,0,0,249.617441,0.020285999999998694,450359,0
"172.16.133.63",54133,"96.43.146.22",443,9,935,19163,0,0,5,566,4,369,249.628628,45.17132700000002,100,65
"172.16.133.116",53984,"172.16.139.250",5440,10,1022,19164,0,0,10,1022,0,0,249.63066,0.009730999999987944,840201,0
"172.16.133.116",53985,"172.16.139.250",5440,10,1022,19165,0,0,10,1022,0,0,249.641084,0.0071159999999963475,1148960,0
"172.16.133.49",55985,"172.16.139.250",5440,10,1022,19166,0,0,10,1022,0,0,249.694287,0.0055989999999894735,1460260,0
"172.16.133.163",3625,"15.192.136.170",80,79,62756,19167,0,0,31,4585,48,58171,249.700284,1.0458189999999945,35072,444979
"172.16.133.163",3626,"72.21.91.196",80,14,4681,19168,0,0,7,1228,7,3453,249.701484,5.656123000000008,1736,4883
"172.16.133.163",3627,"72.21.91.196",80,6,372,19169,0,0,4,246,2,126,249.724632,5.051600999999977,389,199
"172.16.133.163",3628,"63.116.244.162",80,39,28390,19170,0,0,16,2010,23,26380,249.729375,0.9705730000000017,16567,217438
"172.16.133.95",57189,"172.16.139.250",5440,10,1022,19171,0,0,10,1022,0,0,249.737177,0.0064059999999983575,1276303,0
"172.16.133.92",57872,"172.16.139.250",5440,12,1142,19172,0,0,12,1142,0,0,249.763439,0.005687999999992144,1606188,0
"172.16.133.163",3629,"74.125.228.115",443,70,29912,19173,0,0,30,5722,40,24190,249.763718,47.57913599999998,962,4067
"172.16.133.29",61207,"172.16.139.250",5440,10,1022,19174,0,0,10,1022,0,0,249.78028,0.014533999999997604,562543,0
"172.16.133.44",65034,"172.16.139.250",5440,12,1142,19175,0,0,12,1142,0,0,249.788537,0.016623000000009824,549599,0
"172.16.133.207",56141,"172.16.139.250",5440,12,1142,19176,0,0,12,1142,0,0,249.811306,0.004955999999992855,"",""
"172.16.133.83",57279,"172.16.139.250",5440,10,1022,19177,0,0,10,1022,0,0,249.821884,0.014839999999992415,550943,0
"172.16.133.93",61063,"172.16.139.250",5440,12,1142,19178,0,0,12,1142,0,0,249.835847,0.005132000000003245,1780202,0
"172.16.133.11",55368,"172.16.139.250",5440,10,1022,19179,0,0,10,1022,0,0,249.854312,0.01661300000000665,492144,0
"172.16.133.55",57825,"172.16.139.250",5440,12,1142,19180,0,0,12,1142,0,0,249.858681,0.006197000000014441,1474261,0
"172.16.133.73",60887,"172.16.139.250",5440,10,1022,19181,0,0,10,1022,0,0,249.881654,0.015543000000008078,526024,0
"172.16.133.53",54308,"172.16.139.250",5440,12,1142,19182,0,0,12,1142,0,0,249.885258,0.01997000000000071,457486,0
"172.16.133.21",53383,"172.16.139.250",5440,10,1022,19183,0,0,10,1022,0,0,249.886561,0.006182999999992944,1322335,0
"172.16.133.30",62878,"172.16.139.250",5440,12,1142,19184,0,0,12,1142,0,0,249.891942,0.010221000000001368,893846,0
"172.16.133.25",63684,"172.16.139.250",5440,12,1142,19185,0,0,12,1142,0,0,249.897195,0.012191000000001395,749405,0
"172.16.133.34",50672,"172.16.139.250",5440,12,1142,19186,0,0,12,1142,0,0,249.908428,0.005167000000000144,1768143,0
"172.16.133.56",61642,"216.219.115.250",443,6,366,19187,0,0,4,246,2,120,249.911344,0.038140999999995984,51598,25169
"172.16.133.97",59585,"172.16.139.250",5440,10,1022,19188,0,0,10,1022,0,0,249.917109,0.01547499999998081,528336,0
"172.16.133.56",61643,"67.217.66.244",443,6,366,19189,0,0,4,246,2,120,249.925362,0.05641199999999458,34886,17017
"172.16.133.33",58092,"172.16.139.250",5440,12,1142,19190,0,0,12,1142,0,0,249.988769,0.06170099999999934,148068,0
"172.16.133.68",60971,"172.16.139.250",5440,12,1142,19191,0,0,12,1142,0,0,250.026211,0.038074000000023034,239953,0
"172.16.133.56",61644,"68.64.30.250",443,6,366,19192,0,0,4,246,2,120,250.03632,0.09788800000001174,20104,9807
"172.16.133.12",59991,"172.16.139.250",5440,12,1142,19193,0,0,12,1142,0,0,250.037179,0.03080900000000497,296536,0
"172.16.133.56",61645,"68.64.13.250",443,6,366,19194,0,0,4,246,2,120,250.046246,0.14526599999999235,13547,6608
"172.16.133.63",54134,"172.16.139.250",5440,12,1142,19195,0,0,12,1142,0,0,250.049895,0.02200000000001978,415272,0
"172.16.133.66",54402,"172.16.139.250",5440,10,1022,19196,0,0,10,1022,0,0,250.059504,0.01703000000000543,480093,0
"172.16.133.95",57190,"157.56.236.89",443,5,314,19197,0,0,3,194,2,120,250.072941,1.208342000000016,1284,794
"172.16.133.82",61639,"172.16.139.250",5440,10,1022,19198,0,0,10,1022,0,0,250.074583,0.010665000000017244,766619,0
"172.16.133.37",60857,"172.16.139.250",5440,10,1022,19199,0,0,10,1022,0,0,250.087573,0.005772000000007438,1416493,0
"172.16.133.63",54135,"96.43.146.22",443,22,10826,19200,0,0,13,9396,9,1430,250.191775,46.20787100000001,1626,247
"172.16.133.163",3630,"63.116.244.155",80,77,61172,19201,0,0,28,2672,49,58500,250.239252,1.6569470000000024,12900,282447
"172.16.133.78",59445,"172.16.139.250",5440,10,1022,19202,0,0,10,1022,0,0,250.243832,0.005569000000008373,1468127,0
"172.16.133.163",3631,"199.27.72.130",80,127,104754,19203,0,0,46,4962,81,99792,250.278827,11.51899899999998,3446,69306
"172.16.133.163",3632,"199.27.72.130",80,6,372,19204,0,0,4,246,2,126,250.28859,5.494713999999988,358,183
"172.16.133.67",56203,"172.16.139.250",5440,12,1142,19205,0,0,12,1142,0,0,250.299226,0.005798999999996113,1575444,0
"172.16.133.163",3633,"63.116.244.155",80,54,44871,19206,0,0,18,1549,36,43322,250.301262,0.16194799999999532,76518,2140044
"172.16.133.56",61646,"172.16.139.250",5440,12,1142,19207,0,0,12,1142,0,0,250.320748,0.005098000000003822,1792075,0
"172.16.133.96",53406,"50.17.207.24",80,12,1772,19208,0,0,7,1257,5,515,250.373311,0.17343099999999367,57982,23755
"172.16.133.41",53349,"172.16.139.250",5440,12,1142,19209,0,0,12,1142,0,0,250.376661,0.0061789999999746215,1478556,0
"172.16.133.43",57973,"172.16.139.250",5440,12,1142,19210,0,0,12,1142,0,0,250.445342,0.028457000000003063,321045,0
"172.16.133.13",53261,"172.16.139.250",5440,12,1142,19211,0,0,12,1142,0,0,250.465939,0.011355000000008886,804579,0
"172.16.133.85",52483,"172.16.139.250",5440,12,1142,19212,0,0,12,1142,0,0,250.471747,0.010316000000017311,885614,0
"172.16.133.42",57317,"172.16.139.250",5440,12,1142,19213,0,0,12,1142,0,0,250.484236,0.01694899999998256,539028,0
"172.16.133.20",62635,"172.16.139.250",5440,12,1142,19214,0,0,12,1142,0,0,250.516378,0.004806000000002086,"",""
"172.16.133.28",49378,"172.16.139.250",5440,12,1142,19215,0,0,12,1142,0,0,250.544221,0.015160000000008722,602638,0
"172.16.133.63",54136,"68.64.5.249",443,6,366,19216,0,0,4,246,2,120,250.547612,0.11048900000000117,17811,8688
"172.16.133.63",54137,"216.115.209.254",443,6,366,19217,0,0,4,246,2,120,250.547762,0.20174699999998325,9754,4758
"172.16.133.63",54138,"78.108.119.250",443,6,366,19218,0,0,4,246,2,120,250.548127,0.25685000000001423,7662,3737
"172.16.133.99",56258,"172.16.139.250",5440,12,1142,19219,0,0,12,1142,0,0,250.573367,0.016951000000005934,538965,0
"172.16.133.63",54139,"68.64.25.250",443,6,366,19220,0,0,4,246,2,120,250.573574,0.09730099999998743,20225,9866
"172.16.133.68",60972,"113.28.52.78",80,10,2227,19221,0,0,5,497,5,1730,250.577895,1.0615329999999972,3745,13037
"172.16.133.75",51171,"172.16.139.250",5440,10,1022,19222,0,0,10,1022,0,0,250.579207,0.007053000000013299,1159223,0
"172.16.133.36",65004,"23.32.177.224",80,2,132,19223,0,0,1,66,1,66,250.586136,7.499999998117346e-05,"",""
"172.16.133.36",65002,"23.32.177.224",80,2,132,19224,0,0,1,66,1,66,250.5865,6.600000000389628e-05,"",""
"172.16.133.66",54403,"173.194.43.42",443,11,2221,19225,0,0,6,1418,5,803,250.598318,0.5841739999999902,19418,10996
"172.16.133.87",60461,"172.16.139.250",5440,12,1142,19226,0,0,12,1142,0,0,250.598814,0.00607299999998645,1504363,0
"172.16.133.35",50166,"172.16.139.250",5440,12,1142,19227,0,0,12,1142,0,0,250.602266,0.02093200000001616,436460,0
"172.16.133.116",53986,"172.16.139.250",5440,10,1022,19228,0,0,10,1022,0,0,250.610479,0.004764999999991915,"",""
"172.16.133.116",53987,"172.16.139.250",5440,10,1022,19229,0,0,10,1022,0,0,250.615815,0.007384999999999309,1107109,0
"172.16.133.116",53988,"172.16.139.250",5440,10,1022,19230,0,0,10,1022,0,0,250.623729,0.005523000000010825,1480354,0
"172.16.133.84",59006,"172.16.139.250",5440,12,1142,19231,0,0,12,1142,0,0,250.632407,0.015444000000002234,591556,0
"172.16.133.96",53407,"50.17.207.24",80,8,1406,19232,0,0,5,1017,3,389,250.65644,0.08820599999998535,92238,35281
"172.16.133.163",3634,"66.235.139.153",80,15,8822,19233,0,0,8,5321,7,3501,250.702473,9.606041000000005,4431,2915
"172.16.133.49",55987,"172.16.139.250",5440,10,1022,19234,0,0,10,1022,0,0,250.707967,0.005439999999993006,1502941,0
"172.16.133.95",57191,"172.16.139.250",5440,10,1022,19235,0,0,10,1022,0,0,250.750151,0.0053380000000231576,1531659,0
"172.16.133.66",54404,"173.194.43.47",443,20,10730,19236,0,0,10,2509,10,8221,250.770081,1.7944420000000036,11185,36650
"172.16.133.66",54405,"173.194.43.47",443,26,17573,19237,0,0,10,1981,16,15592,250.770273,0.6772269999999878,23401,184186
"172.16.133.68",60973,"180.153.30.250",443,6,366,19238,0,0,4,246,2,120,250.770351,0.6786349999999857,2899,1414
"172.16.133.66",54406,"173.194.43.47",443,17,5762,19239,0,0,9,2417,8,3345,250.770452,5.075163000000003,3809,5272
"172.16.133.66",54407,"173.194.43.47",443,16,6223,19240,0,0,9,2429,7,3794,250.7711,1.9954160000000059,9738,15210
"172.16.133.66",54408,"173.194.43.47",443,12,3305,19241,0,0,7,1804,5,1501,250.776246,0.8662530000000004,16660,13862
"172.16.133.92",57873,"172.16.139.250",5440,10,1022,19242,0,0,10,1022,0,0,250.777097,0.005586999999991349,1463397,0
"172.16.133.29",61208,"172.16.139.250",5440,10,1022,19243,0,0,10,1022,0,0,250.793589,0.007717000000013741,1059479,0
"172.16.133.44",65035,"172.16.139.250",5440,10,1022,19244,0,0,10,1022,0,0,250.800778,0.015495999999984633,527620,0
"172.16.133.66",54409,"173.194.43.53",443,40,22665,19245,0,0,18,9050,22,13615,250.811802,4.057649999999995,17842,26843
"172.16.133.207",56142,"172.16.139.250",5440,10,1022,19246,0,0,10,1022,0,0,250.825513,0.004851000000002159,"",""
"172.16.133.83",57280,"172.16.139.250",5440,10,1022,19247,0,0,10,1022,0,0,250.836901,0.013742999999976746,594921,0
"172.16.133.66",54410,"173.194.43.53",443,36,20524,19248,0,0,18,9748,18,10776,250.842486,27.386514999999974,2847,3147
"172.16.133.93",61064,"172.16.139.250",5440,12,1142,19249,0,0,12,1142,0,0,250.850362,0.0049820000000124764,"",""
"172.16.133.11",55369,"172.16.139.250",5440,10,1022,19250,0,0,10,1022,0,0,250.868023,0.014668000000000347,557403,0
"172.16.133.55",57826,"172.16.139.250",5440,10,1022,19251,0,0,10,1022,0,0,250.872857,0.005436000000003105,1504047,0
"172.16.133.73",60888,"172.16.139.250",5440,10,1022,19252,0,0,10,1022,0,0,250.895332,0.005339999999989686,1531086,0
"172.16.133.53",54309,"172.16.139.250",5440,12,1142,19253,0,0,12,1142,0,0,250.898182,0.018716000000011945,488138,0
"172.16.133.21",53384,"172.16.139.250",5440,10,1022,19254,0,0,10,1022,0,0,250.900851,0.005583000000001448,1464445,0
"172.16.133.30",62879,"172.16.139.250",5440,10,1022,19255,0,0,10,1022,0,0,250.905966,0.0063779999999837855,1281906,0
"172.16.133.25",63685,"172.16.139.250",5440,12,1142,19256,0,0,12,1142,0,0,250.911429,0.008579999999994925,1064801,0
"172.16.133.34",50673,"172.16.139.250",5440,10,1022,19257,0,0,10,1022,0,0,250.921913,0.00521800000001349,1566883,0
"172.16.133.97",59586,"172.16.139.250",5440,10,1022,19258,0,0,10,1022,0,0,250.930976,0.015850000000000364,515835,0
"172.16.133.33",58093,"172.16.139.250",5440,10,1022,19259,0,0,10,1022,0,0,251.001643,0.00572800000000484,1427374,0
"172.16.133.68",60974,"172.16.139.250",5440,12,1142,19260,0,0,12,1142,0,0,251.037094,0.006403000000005932,1426831,0
"172.16.133.12",59992,"172.16.139.250",5440,12,1142,19261,0,0,12,1142,0,0,251.051094,0.012955000000005157,705210,0
"172.16.133.63",54140,"172.16.139.250",5440,12,1142,19262,0,0,12,1142,0,0,251.06246,0.015650000000022146,583769,0
"172.16.133.66",54411,"172.16.139.250",5440,12,1142,19263,0,0,12,1142,0,0,251.07311,0.00881999999998584,1035827,0
"172.16.133.82",61640,"172.16.139.250",5440,12,1142,19264,0,0,12,1142,0,0,251.087972,0.006356999999979962,1437155,0
"172.16.133.37",60858,"172.16.139.250",5440,12,1142,19265,0,0,12,1142,0,0,251.100597,0.015423999999995885,592323,0
"172.16.133.78",59446,"172.16.139.250",5440,10,1022,19266,0,0,10,1022,0,0,251.258871,0.005698999999992793,1434637,0
"172.16.133.67",56204,"172.16.139.250",5440,12,1142,19267,0,0,12,1142,0,0,251.313115,0.005929999999978008,1540640,0
"172.16.133.56",61647,"172.16.139.250",5440,12,1142,19268,0,0,12,1142,0,0,251.335674,0.004953000000000429,"",""
"172.16.133.41",53350,"172.16.139.250",5440,12,1142,19269,0,0,12,1142,0,0,251.390511,0.01522099999999682,600223,0
"172.16.133.43",57974,"172.16.139.250",5440,10,1022,19270,0,0,10,1022,0,0,251.459607,0.005358999999998559,1525657,0
"172.16.133.13",53262,"172.16.139.250",5440,10,1022,19271,0,0,10,1022,0,0,251.479887,0.014325000000013688,570750,0
"172.16.133.85",52484,"172.16.139.250",5440,10,1022,19272,0,0,10,1022,0,0,251.485514,0.014365999999995438,569121,0
"172.16.133.42",57318,"172.16.139.250",5440,12,1142,19273,0,0,12,1142,0,0,251.498129,0.014236999999980071,641708,0
"172.16.133.66",54412,"74.125.228.114",443,18,5354,19274,0,0,10,2109,8,3245,251.522897,0.8093069999999898,20847,32076
"172.16.133.20",62636,"172.16.139.250",5440,12,1142,19275,0,0,12,1142,0,0,251.530711,0.014333999999990965,637365,0
"172.16.133.28",49379,"172.16.139.250",5440,10,1022,19276,0,0,10,1022,0,0,251.558423,0.00537599999998406,1520833,0
"172.16.133.66",54413,"173.194.43.32",443,16,5573,19277,0,0,9,2016,7,3557,251.566062,0.7244320000000073,22262,39280
"172.16.133.99",56259,"172.16.139.250",5440,10,1022,19278,0,0,10,1022,0,0,251.589008,0.015088999999989028,541851,0
"172.16.133.75",51172,"172.16.139.250",5440,10,1022,19279,0,0,10,1022,0,0,251.593278,0.00543700000000058,1503770,0
"172.16.133.87",60462,"172.16.139.250",5440,12,1142,19280,0,0,12,1142,0,0,251.614099,0.006233999999977868,1465511,0
"172.16.133.35",50167,"172.16.139.250",5440,12,1142,19281,0,0,12,1142,0,0,251.615244,0.014288000000021839,639417,0
"172.16.133.116",53989,"172.16.139.250",5440,10,1022,19282,0,0,10,1022,0,0,251.62364,0.006484000000000378,1260950,0
"172.16.133.116",53990,"172.16.139.250",5440,10,1022,19283,0,0,10,1022,0,0,251.631641,0.016526999999996406,494705,0
"172.16.133.84",59007,"172.16.139.250",5440,10,1022,19284,0,0,10,1022,0,0,251.645992,0.018294999999994843,446898,0
"172.16.133.116",53991,"172.16.139.250",5440,10,1022,19285,0,0,10,1022,0,0,251.64865700000001,0.005704999999977645,1433128,0
"172.16.133.163",3635,"173.194.43.38",80,11,5695,19286,0,0,5,747,6,4948,251.662227,0.1199579999999969,49817,329982
"172.16.133.57",60645,"180.153.30.250",443,6,378,19287,0,0,4,258,2,120,251.706554,0.6806489999999883,3032,1410
"172.16.133.49",55988,"172.16.139.250",5440,12,1142,19288,0,0,12,1142,0,0,251.720931,0.006341999999989412,1440555,0
"172.16.133.95",57192,"172.16.139.250",5440,10,1022,19289,0,0,10,1022,0,0,251.765206,0.005380999999999858,1519420,0
"172.16.133.11",55370,"216.10.195.152",443,44,26070,19290,0,0,27,22821,17,3249,251.776101,1.0846159999999827,168325,23964
"172.16.133.163",3636,"64.215.255.88",80,8,1410,19291,0,0,5,1089,3,321,251.787067,0.0961240000000032,90632,26715
"172.16.133.163",3637,"64.215.255.88",80,6,572,19292,0,0,4,246,2,326,251.787287,5.9766610000000355,329,436
"172.16.133.163",3638,"64.215.255.94",80,9,3744,19293,0,0,5,1420,4,2324,251.788171,0.11607200000000262,97870,160176
"172.16.133.163",3639,"64.215.255.94",80,6,572,19294,0,0,4,246,2,326,251.788309,5.975568999999979,329,436
"172.16.133.92",57874,"172.16.139.250",5440,10,1022,19295,0,0,10,1022,0,0,251.791629,0.005596999999994523,1460782,0
"172.16.133.163",3640,"184.173.190.13",80,34,15062,19296,0,0,15,6630,19,8432,251.794814,45.009781000000004,1178,1498
"172.16.133.29",61209,"172.16.139.250",5440,10,1022,19297,0,0,10,1022,0,0,251.808801,0.016074000000003252,508647,0
"172.16.133.44",65036,"172.16.139.250",5440,10,1022,19298,0,0,10,1022,0,0,251.814739,0.01551200000000108,527075,0
"172.16.133.163",3641,"184.173.190.13",80,6,366,19299,0,0,4,246,2,120,251.818234,6.007013999999998,327,159
"172.16.133.207",56143,"172.16.139.250",5440,12,1142,19300,0,0,12,1142,0,0,251.839282,0.005079999999992424,1798425,0
"172.16.133.83",57281,"172.16.139.250",5440,12,1142,19301,0,0,12,1142,0,0,251.850031,0.014724999999998545,620441,0
"172.16.133.93",61065,"172.16.139.250",5440,10,1022,19302,0,0,10,1022,0,0,251.864385,0.014152999999993199,577686,0
"172.16.133.11",55371,"172.16.139.250",5440,10,1022,19303,0,0,10,1022,0,0,251.882137,0.005470000000002528,1494698,0
"172.16.133.55",57827,"172.16.139.250",5440,10,1022,19304,0,0,10,1022,0,0,251.8868,0.01452399999999443,562930,0
"172.16.133.163",3642,"173.194.43.57",80,9,3001,19305,0,0,5,1258,4,1743,251.888569,0.469678000000016,21427,29688
"172.16.133.96",53408,"50.17.207.24",80,8,1430,19306,0,0,5,1041,3,389,251.890782,0.18381899999999973,45305,16929
"172.16.133.163",3643,"64.215.255.94",80,8,1141,19307,0,0,5,649,3,492,251.8909,0.08755500000000893,59299,44954
"172.16.133.163",3644,"208.71.125.1",80,9,2172,19308,0,0,5,755,4,1417,251.891021,0.08070200000000227,74843,140467
"172.16.133.163",3645,"64.215.255.94",80,8,1242,19309,0,0,5,726,3,516,251.892591,0.07876600000000167,73737,52408
"172.16.133.73",60889,"172.16.139.250",5440,10,1022,19310,0,0,10,1022,0,0,251.91018,0.005781000000013137,1414288,0
"172.16.133.53",54310,"172.16.139.250",5440,12,1142,19311,0,0,12,1142,0,0,251.9126,0.007939999999990732,1150629,0
"172.16.133.21",53385,"172.16.139.250",5440,10,1022,19312,0,0,10,1022,0,0,251.916031,0.00808399999999665,1011380,0
"172.16.133.30",62880,"172.16.139.250",5440,12,1142,19313,0,0,12,1142,0,0,251.919872,0.01572100000001342,581133,0
"172.16.133.163",3646,"108.170.194.161",80,8,2067,19314,0,0,5,883,3,1184,251.924374,0.16077699999999595,43936,58913
"172.16.133.163",3647,"108.170.194.161",80,11,3230,19315,0,0,6,1904,5,1326,251.924726,0.166955999999999,91233,63537
"172.16.133.163",3648,"108.170.194.161",80,12,3362,19316,0,0,6,1925,6,1437,251.924867,0.16781199999999785,91769,68505
"172.16.133.25",63686,"172.16.139.250",5440,12,1142,19317,0,0,12,1142,0,0,251.925685,0.00487500000002683,"",""
"172.16.133.163",3649,"107.21.110.186",80,8,2331,19318,0,0,4,691,4,1640,251.926818,0.17808999999999742,31040,73670
"172.16.133.163",3650,"205.188.93.194",80,9,1395,19319,0,0,5,701,4,694,251.926958,0.09230299999998692,60756,60149
"172.16.133.163",3651,"108.170.194.161",80,6,553,19320,0,0,4,246,2,307,251.927363,5.919996999999967,332,414
"172.16.133.163",3652,"64.215.255.95",80,8,1135,19321,0,0,5,643,3,492,251.927472,0.09070800000000645,56709,43391
"172.16.133.163",3653,"23.32.181.109",80,7,1436,19322,0,0,4,674,3,762,251.927585,0.2506180000000029,21514,24323
"172.16.133.163",3654,"64.215.255.94",80,6,572,19323,0,0,4,246,2,326,251.927714,5.836028999999968,337,446
"172.16.133.163",3655,"64.208.138.174",80,11,1869,19324,0,0,6,897,5,972,251.927806,10.089555999999988,711,770
"172.16.133.163",3656,"65.54.165.64",80,9,2300,19325,0,0,5,1771,4,529,251.927929,40.488485999999966,349,104
"172.16.133.163",3657,"65.54.165.64",80,7,1191,19326,0,0,4,722,3,469,251.928015,40.489367999999985,142,92
"172.16.133.163",3658,"216.38.163.167",80,10,1569,19327,0,0,6,763,4,806,251.928128,2.1438440000000014,2847,3007
"172.16.133.163",3659,"208.71.125.1",80,9,1753,19328,0,0,5,876,4,877,251.928243,0.09129799999999477,76759,76847
"172.16.133.163",3660,"64.215.255.94",80,6,572,19329,0,0,4,246,2,326,251.928347,5.835463999999973,337,446
"172.16.133.56",61648,"216.219.115.250",443,6,366,19330,0,0,4,246,2,120,251.928405,0.057631000000014865,34148,16657
"172.16.133.163",3661,"50.116.194.21",80,13,2935,19331,0,0,7,2114,6,821,251.928461,5.124222000000003,3300,1281
"172.16.133.163",3662,"50.116.194.21",80,6,366,19332,0,0,4,246,2,120,251.928549,5.901997000000023,333,162
"172.16.133.163",3663,"23.32.181.109",80,7,1726,19333,0,0,4,805,3,921,251.928652,0.3776200000000074,17054,19511
"172.16.133.163",3664,"64.208.138.174",80,7,432,19334,0,0,4,246,3,186,251.92875,5.890146999999985,334,252
"172.16.133.163",3665,"64.215.255.95",80,6,572,19335,0,0,4,246,2,326,251.928835,5.8348100000000045,337,446
"172.16.133.163",3666,"107.21.110.186",80,8,2266,19336,0,0,4,798,4,1468,251.929188,0.21793900000000122,29292,53886
"172.16.133.163",3667,"205.188.93.194",80,6,372,19337,0,0,4,246,2,126,251.92949,5.8914740000000165,334,171
"172.16.133.163",3668,"216.38.163.167",80,12,1551,19338,0,0,7,835,5,716,251.929592,2.278847999999982,2931,2513
"172.16.133.163",3669,"108.170.194.161",80,6,553,19339,0,0,4,246,2,307,251.929742,5.918734000000001,332,414
"172.16.133.163",3670,"65.54.165.64",80,7,432,19340,0,0,4,246,3,186,251.929853,5.9570349999999905,330,249
"172.16.133.163",3671,"108.170.194.161",80,6,553,19341,0,0,4,246,2,307,251.929955,5.913106999999968,332,415
"172.16.133.163",3672,"65.54.165.64",80,7,432,19342,0,0,4,246,3,186,251.930064,5.957158000000021,330,249
"172.16.133.163",3673,"209.167.231.15",80,6,366,19343,0,0,4,246,2,120,251.930173,5.911789000000027,332,162
"172.16.133.163",3674,"209.167.231.15",80,9,2361,19344,0,0,5,1883,4,478,251.930269,1.2569809999999961,11984,3042
"172.16.133.34",50674,"172.16.139.250",5440,12,1142,19345,0,0,12,1142,0,0,251.93536,0.0050269999999841275,1817386,0
"172.16.133.97",59587,"172.16.139.250",5440,12,1142,19346,0,0,12,1142,0,0,251.944881,0.006090000000000373,1500164,0
"172.16.133.163",3675,"64.215.255.95",80,8,2009,19347,0,0,5,1058,3,951,251.950711,0.08852499999997576,95611,85941
"172.16.133.163",3676,"64.215.255.95",80,8,2024,19348,0,0,5,1085,3,939,251.950829,0.08245999999999754,105263,91098
"172.16.133.163",3677,"208.71.125.1",80,6,366,19349,0,0,4,246,2,120,251.951244,5.86959699999997,335,163
"172.16.133.163",3678,"208.71.125.1",80,6,366,19350,0,0,4,246,2,120,251.954697,5.866209999999967,335,163
"172.16.133.163",3679,"50.116.194.24",80,6,366,19351,0,0,4,246,2,120,251.955728,5.881925999999993,334,163
"172.16.133.163",3680,"50.116.194.24",80,14,3169,19352,0,0,7,1831,7,1338,251.95591,5.134875999999991,2852,2084
"172.16.133.56",61649,"67.217.66.244",443,6,366,19353,0,0,4,246,2,120,251.958319,0.061348000000009506,32079,15648
"172.16.133.163",3681,"98.139.225.42",80,8,703,19354,0,0,4,246,4,457,251.960504,5.872311999999994,335,622
"172.16.133.163",3682,"98.139.225.42",80,13,3222,19355,0,0,7,1858,6,1364,251.96067,15.116578000000004,983,721
"172.16.133.163",3683,"64.215.255.95",80,8,1981,19356,0,0,5,1044,3,937,251.967448,0.07559100000000285,110489,99165
"172.16.133.163",3684,"64.215.255.95",80,8,1592,19357,0,0,5,1037,3,555,251.970272,0.07745300000001976,107110,57325
"172.16.133.163",3685,"64.215.255.95",80,8,1965,19358,0,0,5,1036,3,929,251.976799,0.07734400000001074,107157,96090
"172.16.133.163",3686,"64.215.255.95",80,8,2125,19359,0,0,5,1116,3,1009,251.979987,0.09203800000000228,97003,87702
"172.16.133.163",3687,"23.67.242.106",80,9,2422,19360,0,0,5,808,4,1614,252.01407,0.31782799999999156,20338,40625
"172.16.133.163",3688,"23.67.242.106",80,7,432,19361,0,0,4,246,3,186,252.014237,5.806191999999982,338,256
"172.16.133.33",58094,"172.16.139.250",5440,12,1142,19362,0,0,12,1142,0,0,252.016536,0.014780999999999267,618090,0
"172.16.133.163",3689,"208.71.123.131",443,17,7314,19363,0,0,8,1419,9,5895,252.021097,0.3851280000000088,29475,122452
"172.16.133.163",3690,"50.116.194.23",80,14,3248,19364,0,0,7,2163,7,1085,252.046792,5.115380999999985,3382,1696
"172.16.133.163",3691,"50.116.194.23",80,6,366,19365,0,0,4,246,2,120,252.046966,5.784517999999991,340,165
"172.16.133.68",60975,"172.16.139.250",5440,10,1022,19366,0,0,10,1022,0,0,252.051854,0.016031999999995605,509980,0
"172.16.133.163",3692,"173.194.43.58",80,8,2479,19367,0,0,5,1811,3,668,252.054141,0.2740630000000124,52863,19499
"172.16.133.12",59993,"172.16.139.250",5440,12,1142,19368,0,0,12,1142,0,0,252.065315,0.007151999999990721,1277404,0
"172.16.133.63",54141,"172.16.139.250",5440,12,1142,19369,0,0,12,1142,0,0,252.07864,0.006181999999995469,1477838,0
"172.16.133.163",3693,"199.7.48.72",80,11,3319,19370,0,0,5,768,6,2551,252.079188,0.28901100000001634,21258,70613
"172.16.133.163",3694,"199.7.48.72",80,6,366,19371,0,0,4,246,2,120,252.079574,5.756793999999985,341,166
"172.16.133.56",61650,"68.64.30.250",443,6,366,19372,0,0,4,246,2,120,252.086305,0.09845400000000382,19989,9750
"172.16.133.66",54414,"172.16.139.250",5440,10,1022,19373,0,0,10,1022,0,0,252.089092,0.005585999999993874,1463659,0
"172.16.133.82",61641,"172.16.139.250",5440,10,1022,19374,0,0,10,1022,0,0,252.101999,0.0056639999999958945,1443502,0
"172.16.133.56",61651,"68.64.13.250",443,6,366,19375,0,0,4,246,2,120,252.109523,0.1178510000000017,16699,8145
"172.16.133.37",60859,"172.16.139.250",5440,12,1142,19376,0,0,12,1142,0,0,252.116261,0.0056960000000003674,1603932,0
"172.16.133.163",3695,"64.215.255.95",443,22,8527,19377,0,0,11,2114,11,6413,252.205767,0.34367399999999293,49209,149281
"172.16.133.78",59448,"65.25.77.209",30960,3,194,19378,0,0,3,194,0,0,252.20971,9.000279000000006,172,0
"172.16.133.78",59449,"174.67.109.47",51661,3,194,19379,0,0,3,194,0,0,252.20989,8.997052000000025,172,0
"172.16.133.78",59450,"96.226.88.52",36828,3,194,19380,0,0,3,194,0,0,252.210047,8.996893999999969,172,0
"172.16.133.78",59451,"74.62.191.66",23615,3,194,19381,0,0,3,194,0,0,252.210199,8.999789000000021,172,0
"172.16.133.78",59452,"99.61.13.155",24449,3,194,19382,0,0,3,194,0,0,252.210348,8.991606999999988,172,0
"172.16.133.78",59453,"172.16.139.250",5440,10,1022,19383,0,0,10,1022,0,0,252.271241,0.00476599999998939,"",""
"172.16.133.67",56205,"172.16.139.250",5440,10,1022,19384,0,0,10,1022,0,0,252.327015,0.015924000000012484,513438,0
"172.16.133.56",61652,"172.16.139.250",5440,12,1142,19385,0,0,12,1142,0,0,252.350194,0.005770000000012487,1583362,0
"172.16.133.163",3696,"174.37.236.20",80,6,366,19386,0,0,4,246,2,120,252.395562,5.430014999999997,362,176
"172.16.133.163",3697,"174.37.236.20",80,11,3157,19387,0,0,6,1290,5,1867,252.395734,0.11885999999998376,86824,125660
"172.16.133.41",53351,"172.16.139.250",5440,10,1022,19388,0,0,10,1022,0,0,252.404592,0.014828999999991765,551352,0
"172.16.133.163",3698,"173.194.43.39",80,346,305573,19389,0,0,117,7405,229,298168,252.470929,0.4143579999999929,142968,5756722
"172.16.133.43",57975,"172.16.139.250",5440,10,1022,19390,0,0,10,1022,0,0,252.473337,0.005438000000026477,1503493,0
"172.16.133.163",3699,"173.194.43.39",80,6,372,19391,0,0,4,246,2,126,252.487243,5.33325499999998,369,189
"172.16.133.13",53263,"172.16.139.250",5440,10,1022,19392,0,0,10,1022,0,0,252.494087,0.005428999999992357,1505986,0
"172.16.133.163",3700,"23.45.65.58",80,6,372,19393,0,0,4,246,2,126,252.499224,5.346197999999987,368,188
"172.16.133.163",3701,"23.45.65.58",80,8,2439,19394,0,0,4,755,4,1684,252.499716,0.10822699999999941,55808,124479
"172.16.133.85",52485,"172.16.139.250",5440,12,1142,19395,0,0,12,1142,0,0,252.50279,0.005485999999990554,1665329,0
"172.16.133.42",57319,"172.16.139.250",5440,12,1142,19396,0,0,12,1142,0,0,252.524349,0.25385299999999233,35989,0
"172.16.133.20",62637,"172.16.139.250",5440,12,1142,19397,0,0,12,1142,0,0,252.544585,0.005599999999986949,1631428,0
"172.16.133.28",49380,"172.16.139.250",5440,10,1022,19398,0,0,10,1022,0,0,252.572225,0.014604999999988877,559808,0
"172.16.133.110",57728,"174.129.20.55",80,10,1098,19399,0,0,6,514,4,584,252.587819,0.08909199999999373,46154,52440
"172.16.133.99",56260,"172.16.139.250",5440,10,1022,19400,0,0,10,1022,0,0,252.602633,0.014393000000012535,568053,0
"172.16.133.75",51173,"172.16.139.250",5440,10,1022,19401,0,0,10,1022,0,0,252.607124,0.005444000000011329,1501836,0
"172.16.133.63",54142,"68.64.5.249",443,6,366,19402,0,0,4,246,2,120,252.608465,0.11173099999999181,17613,8592
"172.16.133.87",60463,"172.16.139.250",5440,12,1142,19403,0,0,12,1142,0,0,252.627774,0.006209000000012566,1471412,0
"172.16.133.63",54143,"68.64.25.250",443,6,366,19404,0,0,4,246,2,120,252.628441,0.10361199999999826,18993,9265
"172.16.133.35",50168,"172.16.139.250",5440,12,1142,19405,0,0,12,1142,0,0,252.630573,0.04658900000001154,196097,0
"172.16.133.116",53992,"172.16.139.250",5440,12,1142,19406,0,0,12,1142,0,0,252.63768,0.0072000000000116415,1268888,0
"172.16.133.116",53993,"172.16.139.250",5440,10,1022,19407,0,0,10,1022,0,0,252.645516,0.0060610000000167474,1348952,0
"172.16.133.116",53994,"172.16.139.250",5440,10,1022,19408,0,0,10,1022,0,0,252.651962,0.005540999999993801,1475545,0
"172.16.133.63",54144,"216.115.209.254",443,6,366,19409,0,0,4,246,2,120,252.657565,0.2044429999999977,9626,4695
"172.16.133.84",59008,"172.16.139.250",5440,10,1022,19410,0,0,10,1022,0,0,252.659578,0.0064059999999983575,1276303,0
"172.16.133.63",54145,"78.108.119.250",443,6,366,19411,0,0,4,246,2,120,252.682497,0.24992799999998283,7874,3841
"172.16.133.66",54415,"173.194.43.61",443,13,3795,19412,0,0,7,2426,6,1369,252.686581,0.3002079999999978,64648,36481
"172.16.133.18",50326,"174.129.20.55",443,26,9590,19413,0,0,13,2336,13,7254,252.688121,10.321159999999992,1810,5622
"172.16.133.68",60976,"68.71.212.152",80,34,34174,19414,0,0,11,911,23,33263,252.71683,0.7081430000000069,10291,375777
"172.16.133.49",55989,"172.16.139.250",5440,10,1022,19415,0,0,10,1022,0,0,252.735414,0.015320000000002665,533681,0
"172.16.133.95",57193,"172.16.139.250",5440,10,1022,19416,0,0,10,1022,0,0,252.779476,0.005371000000025106,1522249,0
"172.16.133.60",62202,"208.98.232.43",80,30,25116,19417,0,0,11,1130,19,23986,252.788024,0.3748339999999928,24117,511927
"172.16.133.92",57875,"172.16.139.250",5440,10,1022,19418,0,0,10,1022,0,0,252.804149,0.015429000000011683,529911,0
"172.16.133.29",61210,"172.16.139.250",5440,12,1142,19419,0,0,12,1142,0,0,252.82146,0.006533999999987827,1398224,0
"172.16.133.44",65037,"172.16.139.250",5440,10,1022,19420,0,0,10,1022,0,0,252.828676,0.006054000000005999,1350512,0
"172.16.133.207",56144,"172.16.139.250",5440,10,1022,19421,0,0,10,1022,0,0,252.853327,0.014476999999999407,564757,0
"172.16.133.83",57282,"172.16.139.250",5440,12,1142,19422,0,0,12,1142,0,0,252.865131,0.006489000000016176,1407921,0
"172.16.133.93",61066,"172.16.139.250",5440,12,1142,19423,0,0,12,1142,0,0,252.878103,0.014510000000001355,629634,0
"172.16.133.11",55372,"172.16.139.250",5440,10,1022,19424,0,0,10,1022,0,0,252.896276,0.005684999999999718,1438170,0
"172.16.133.55",57828,"172.16.139.250",5440,12,1142,19425,0,0,12,1142,0,0,252.900791,0.006202000000001817,1473073,0
"172.16.133.73",60890,"172.16.139.250",5440,10,1022,19426,0,0,10,1022,0,0,252.923736,0.01528200000001334,535008,0
"172.16.133.53",54311,"172.16.139.250",5440,10,1022,19427,0,0,10,1022,0,0,252.925377,0.021845000000013215,374273,0
"172.16.133.21",53386,"172.16.139.250",5440,10,1022,19428,0,0,10,1022,0,0,252.928801,0.0055220000000133496,1480622,0
"172.16.133.30",62882,"172.16.139.250",5440,10,1022,19429,0,0,10,1022,0,0,252.933914,0.009169000000014194,891700,0
"172.16.133.25",63687,"172.16.139.250",5440,12,1142,19430,0,0,12,1142,0,0,252.939558,0.014561999999983755,627386,0
"172.16.133.34",50675,"172.16.139.250",5440,10,1022,19431,0,0,10,1022,0,0,252.94938,0.014549000000016576,561963,0
"172.16.133.97",59588,"172.16.139.250",5440,12,1142,19432,0,0,12,1142,0,0,252.960163,0.008184999999997444,1116188,0
"172.16.133.114",55351,"68.64.24.250",443,6,366,19433,0,0,4,246,2,120,253.015204,0.1395159999999862,14105,6880
"172.16.133.114",55352,"78.108.118.250",443,6,366,19434,0,0,4,246,2,120,253.015206,0.24737500000000523,7955,3880
"172.16.133.114",55353,"216.219.118.244",443,6,366,19435,0,0,4,246,2,120,253.015207,0.2484049999999911,7922,3864
"172.16.133.114",55354,"216.115.219.126",443,6,366,19436,0,0,4,246,2,120,253.015298,0.5087469999999996,3868,1886
"172.16.133.33",58095,"172.16.139.250",5440,10,1022,19437,0,0,10,1022,0,0,253.030637,0.02277499999999577,358990,0
"172.16.133.60",62203,"66.199.173.81",80,11,2177,19438,0,0,6,878,5,1299,253.05862,15.169174000000027,463,685
"172.16.133.68",60977,"172.16.139.250",5440,10,1022,19439,0,0,10,1022,0,0,253.065234,0.015366000000000213,532083,0
"172.16.133.12",59994,"172.16.139.250",5440,12,1142,19440,0,0,12,1142,0,0,253.079275,0.006413000000009106,1424606,0
"172.16.133.63",54146,"172.16.139.250",5440,10,1022,19441,0,0,10,1022,0,0,253.091098,0.005436000000003105,1504047,0
"172.16.133.66",54416,"172.16.139.250",5440,10,1022,19442,0,0,10,1022,0,0,253.101807,0.005471999999997479,1494152,0
"172.16.133.82",61642,"172.16.139.250",5440,12,1142,19443,0,0,12,1142,0,0,253.116311,0.016276000000004842,561317,0
"172.16.133.68",60978,"180.153.30.250",443,6,366,19444,0,0,4,246,2,120,253.116367,0.6904010000000085,2850,1390
"172.16.133.37",60860,"172.16.139.250",5440,10,1022,19445,0,0,10,1022,0,0,253.130002,0.015074999999995953,542354,0
"172.16.133.78",59454,"172.16.139.250",5440,10,1022,19446,0,0,10,1022,0,0,253.285822,0.08996799999999894,90876,0
"172.16.133.163",3702,"173.194.43.39",80,38,27596,19447,0,0,15,1691,23,25905,253.328294,0.5470909999999947,24727,378803
"172.16.133.67",56206,"172.16.139.250",5440,12,1142,19448,0,0,12,1142,0,0,253.340621,0.04408000000000811,207259,0
"172.16.133.56",61653,"172.16.139.250",5440,10,1022,19449,0,0,10,1022,0,0,253.362674,0.0242409999999893,337279,0
"172.16.133.68",60979,"23.67.242.115",80,9,4756,19450,0,0,4,514,5,4242,253.382151,0.12262200000000689,33533,276752
"172.16.133.41",53352,"172.16.139.250",5440,10,1022,19451,0,0,10,1022,0,0,253.418901,0.00562600000000657,1453252,0
"172.16.133.43",57976,"172.16.139.250",5440,12,1142,19452,0,0,12,1142,0,0,253.487214,0.006315999999998212,1446485,0
"172.16.133.13",53264,"172.16.139.250",5440,10,1022,19453,0,0,10,1022,0,0,253.5093,0.005451999999991131,1499633,0
"172.16.133.85",52486,"172.16.139.250",5440,10,1022,19454,0,0,10,1022,0,0,253.513446,0.005530000000021573,1478481,0
"172.16.133.42",57320,"172.16.139.250",5440,12,1142,19455,0,0,12,1142,0,0,253.528949,0.008584999999982301,1064181,0
"172.16.133.68",60980,"173.194.43.60",80,9,995,19456,0,0,5,515,4,480,253.530507,0.10068999999998596,40917,38136
"172.16.133.20",62638,"172.16.139.250",5440,10,1022,19457,0,0,10,1022,0,0,253.559497,0.015239000000008218,536518,0
"172.16.133.113",55745,"172.16.139.250",135,8,492,19458,0,0,8,492,0,0,253.576313,0.006080999999994674,647261,0
"172.16.133.28",49381,"172.16.139.250",5440,12,1142,19459,0,0,12,1142,0,0,253.586314,0.0070440000000076,1296990,0
"172.16.133.113",55746,"172.16.139.250",5462,12,816,19460,0,0,12,816,0,0,253.587058,0.509996000000001,12800,0
"172.16.133.68",60981,"173.194.43.59",80,22,4434,19461,0,0,13,1764,9,2670,253.611372,10.063590000000005,1402,2122
"172.16.133.99",56261,"172.16.139.250",5440,10,1022,19462,0,0,10,1022,0,0,253.615453,0.015517999999985932,526872,0
"172.16.133.75",51174,"172.16.139.250",5440,12,1142,19463,0,0,12,1142,0,0,253.621287,0.006545000000016898,1395874,0
"172.16.133.87",60464,"172.16.139.250",5440,12,1142,19464,0,0,12,1142,0,0,253.640092,0.016492999999996982,553931,0
"172.16.133.35",50169,"172.16.139.250",5440,12,1142,19465,0,0,12,1142,0,0,253.643859,0.010834000000016886,843271,0
"172.16.133.116",53995,"172.16.139.250",5440,10,1022,19466,0,0,10,1022,0,0,253.651038,0.008627999999987424,947612,0
"172.16.133.68",60982,"173.194.43.60",80,9,999,19467,0,0,5,519,4,480,253.653105,0.10651899999999159,38978,36049
"172.16.133.109",34125,"96.43.146.48",443,32,13463,19468,0,0,17,1740,15,11723,253.65944,0.3435929999999985,40513,272950
"172.16.133.116",53996,"172.16.139.250",5440,12,1142,19469,0,0,12,1142,0,0,253.660555,0.005575000000021646,1638744,0
"172.16.133.116",53997,"172.16.139.250",5440,10,1022,19470,0,0,10,1022,0,0,253.667111,0.00940399999998931,869417,0
"172.16.133.84",59009,"172.16.139.250",5440,12,1142,19471,0,0,12,1142,0,0,253.673644,0.01596399999999676,572287,0
"172.16.133.63",54147,"64.56.203.22",443,13,4800,19472,0,0,7,948,6,3852,253.676893,45.40087,167,678
"172.16.133.63",54148,"64.56.203.22",443,9,923,19473,0,0,5,561,4,362,253.677001,45.397662999999994,98,63
"172.16.133.63",54149,"64.56.203.22",443,19,8022,19474,0,0,10,3373,9,4649,253.677098,14.80588899999998,1822,2511
"172.16.133.60",62204,"208.98.232.43",80,10,1491,19475,0,0,5,633,5,858,253.698524,0.3559099999999944,14228,19285
"172.16.133.63",54150,"216.137.33.221",443,19,7386,19476,0,0,9,920,10,6466,253.711489,36.77849999999998,200,1406
"172.16.133.63",54151,"216.137.33.221",443,18,7326,19477,0,0,8,860,10,6466,253.711606,36.78693899999999,187,1406
"172.16.133.63",54152,"216.137.33.221",443,19,7386,19478,0,0,9,920,10,6466,253.711706,36.77720199999999,200,1406
"172.16.133.63",54153,"216.137.33.221",443,19,7386,19479,0,0,9,920,10,6466,253.711871,36.78686400000001,200,1406
"172.16.133.63",54154,"216.137.33.221",443,19,7386,19480,0,0,9,920,10,6466,253.712035,36.77784700000004,200,1406
"172.16.133.63",54155,"216.137.33.221",443,19,7386,19481,0,0,9,920,10,6466,253.712181,36.78535099999999,200,1406
"172.16.133.49",55990,"172.16.139.250",5440,12,1142,19482,0,0,12,1142,0,0,253.748983,0.006309999999984939,1447860,0
"172.16.133.95",57194,"172.16.139.250",5440,12,1142,19483,0,0,12,1142,0,0,253.793189,0.006184999999987895,1477122,0
"172.16.133.68",60984,"63.116.244.81",80,74,51809,19484,0,0,33,4746,41,47063,253.801856,9.883076000000017,3841,38095
"172.16.133.92",57876,"172.16.139.250",5440,12,1142,19485,0,0,12,1142,0,0,253.817934,0.0055629999999951,1642279,0
"172.16.133.29",61211,"172.16.139.250",5440,12,1142,19486,0,0,12,1142,0,0,253.836526,0.015455000000002883,591135,0
"172.16.133.44",65038,"172.16.139.250",5440,12,1142,19487,0,0,12,1142,0,0,253.841803,0.006108000000011771,1495743,0
"172.16.133.207",56145,"172.16.139.250",5440,12,1142,19488,0,0,12,1142,0,0,253.867214,0.014972000000000207,610205,0
"172.16.133.83",57283,"172.16.139.250",5440,12,1142,19489,0,0,12,1142,0,0,253.878959,0.007038999999991802,1297911,0
"172.16.133.93",61067,"172.16.139.250",5440,12,1142,19490,0,0,12,1142,0,0,253.892092,0.014621000000005324,624854,0
"172.16.133.11",55373,"172.16.139.250",5440,10,1022,19491,0,0,10,1022,0,0,253.911093,0.005582000000003973,1464707,0
"172.16.133.55",57829,"172.16.139.250",5440,12,1142,19492,0,0,12,1142,0,0,253.914909,0.006392000000005282,1429286,0
"172.16.133.73",60891,"172.16.139.250",5440,12,1142,19493,0,0,12,1142,0,0,253.937354,0.00625999999999749,1459424,0
"172.16.133.53",54312,"172.16.139.250",5440,12,1142,19494,0,0,12,1142,0,0,253.940575,0.006731999999999516,1357100,0
"172.16.133.21",53387,"172.16.139.250",5440,12,1142,19495,0,0,12,1142,0,0,253.942921,0.014773999999988519,618383,0
"172.16.133.30",62883,"172.16.139.250",5440,12,1142,19496,0,0,12,1142,0,0,253.946903,0.006302000000005137,1449698,0
"172.16.133.25",63688,"172.16.139.250",5440,12,1142,19497,0,0,12,1142,0,0,253.953313,0.008053999999987127,1134343,0
"172.16.133.109",37913,"23.33.81.213",443,42,26138,19498,0,0,19,1965,23,24173,253.962141,0.23874699999998938,65843,809995
"172.16.133.34",50676,"172.16.139.250",5440,12,1142,19499,0,0,12,1142,0,0,253.963643,0.005147000000022217,1775014,0
"172.16.133.97",59589,"172.16.139.250",5440,12,1142,19500,0,0,12,1142,0,0,253.976305,0.006249999999994316,1461760,0
"172.16.133.68",60985,"173.194.43.60",80,9,994,19501,0,0,5,514,4,480,253.994868,0.10612499999999159,38746,36183
"172.16.133.33",58096,"172.16.139.250",5440,10,1022,19502,0,0,10,1022,0,0,254.044988,0.04834999999999923,169100,0
"172.16.133.68",60986,"172.16.139.250",5440,12,1142,19503,0,0,12,1142,0,0,254.079158,0.018054000000006454,506037,0
"172.16.133.12",59995,"172.16.139.250",5440,12,1142,19504,0,0,12,1142,0,0,254.092047,0.017318999999986318,527513,0
"172.16.133.68",60987,"173.194.43.60",80,9,985,19505,0,0,5,505,4,480,254.100994,0.11101000000002159,36393,34591
"172.16.133.63",54156,"172.16.139.250",5440,10,1022,19506,0,0,10,1022,0,0,254.105837,0.006542999999993526,1249579,0
"172.16.133.66",54417,"172.16.139.250",5440,12,1142,19507,0,0,12,1142,0,0,254.116451,0.015790999999978794,578557,0
"172.16.133.82",61643,"172.16.139.250",5440,10,1022,19508,0,0,10,1022,0,0,254.130994,0.005547000000007074,1473949,0
"172.16.133.37",60861,"172.16.139.250",5440,12,1142,19509,0,0,12,1142,0,0,254.143283,0.006349999999997635,1438740,0
"172.16.133.63",54157,"23.0.49.244",80,17,9408,19510,0,0,8,2821,9,6587,254.175508,40.486151999999976,557,1301
"172.16.133.109",40485,"23.33.81.213",443,53,38288,19511,0,0,23,2261,30,36027,254.182061,0.3396229999999889,53259,848635
"172.16.133.20",62639,"74.125.226.47",443,14,3540,19512,0,0,8,958,6,2582,254.192891,10.058145999999994,761,2053
"172.16.133.78",59455,"172.16.139.250",5440,12,1142,19513,0,0,12,1142,0,0,254.300774,0.006581000000011272,1388238,0
"172.16.133.23",55052,"64.90.204.229",443,17,3032,19514,0,0,8,1745,9,1287,254.315363,11.25344100000001,1240,914
"172.16.133.23",55053,"64.90.204.229",443,17,3024,19515,0,0,8,1735,9,1289,254.316103,11.252206000000001,1233,916
"172.16.133.23",55054,"64.90.204.229",443,17,3031,19516,0,0,8,1747,9,1284,254.317229,11.251387000000022,1242,912
"172.16.133.23",55055,"64.90.204.229",443,17,3010,19517,0,0,8,1781,9,1229,254.317434,11.248141000000032,1266,874
"172.16.133.23",55056,"64.90.204.229",443,17,3824,19518,0,0,8,1749,9,2075,254.32874,11.239970999999997,1244,1476
"172.16.133.67",56207,"172.16.139.250",5440,10,1022,19519,0,0,10,1022,0,0,254.355579,0.015315999999984342,533820,0
"172.16.133.56",61654,"172.16.139.250",5440,12,1142,19520,0,0,12,1142,0,0,254.377666,0.00473800000000324,"",""
"172.16.133.41",53353,"172.16.139.250",5440,10,1022,19521,0,0,10,1022,0,0,254.432638,0.005417999999991707,1509043,0
"172.16.133.43",57977,"172.16.139.250",5440,10,1022,19522,0,0,10,1022,0,0,254.501694,0.015203000000013844,537788,0
"172.16.133.13",53265,"172.16.139.250",5440,10,1022,19523,0,0,10,1022,0,0,254.522003,0.005387999999982185,1517446,0
"172.16.133.85",52487,"172.16.139.250",5440,10,1022,19524,0,0,10,1022,0,0,254.527573,0.00580000000002201,1409655,0
"172.16.133.68",60988,"23.67.242.120",80,12,5201,19525,0,0,6,549,6,4652,254.546894,9.129593,481,4076
"172.16.133.42",57321,"172.16.139.250",5440,12,1142,19526,0,0,12,1142,0,0,254.548798,0.013021000000009053,701635,0
"172.16.133.20",62640,"172.16.139.250",5440,12,1142,19527,0,0,12,1142,0,0,254.572526,0.004989999999992278,"",""
"172.16.133.28",49382,"172.16.139.250",5440,10,1022,19528,0,0,10,1022,0,0,254.60071,0.005318000000016809,1537420,0
"172.16.133.68",60989,"173.194.43.60",80,9,986,19529,0,0,5,506,4,480,254.60222,0.11107900000001791,36442,34569
"172.16.133.99",56262,"172.16.139.250",5440,12,1142,19530,0,0,12,1142,0,0,254.629802,0.005124999999992497,1782634,0
"172.16.133.75",51175,"172.16.139.250",5440,10,1022,19531,0,0,10,1022,0,0,254.635195,0.005657999999982621,1445033,0
"172.16.133.87",60465,"172.16.139.250",5440,10,1022,19532,0,0,10,1022,0,0,254.654406,0.017527999999998656,466453,0
"172.16.133.35",50170,"172.16.139.250",5440,12,1142,19533,0,0,12,1142,0,0,254.657296,0.01386399999998389,658972,0
"172.16.133.116",53998,"172.16.139.250",5440,12,1142,19534,0,0,12,1142,0,0,254.665388,0.010807999999997264,845299,0
"172.16.133.63",54158,"68.64.5.249",443,6,366,19535,0,0,4,246,2,120,254.671455,0.11046699999999987,17815,8690
"172.16.133.116",53999,"172.16.139.250",5440,12,1142,19536,0,0,12,1142,0,0,254.677399,0.005332999999978938,1713107,0
"172.16.133.116",54000,"172.16.139.250",5440,10,1022,19537,0,0,10,1022,0,0,254.683695,0.015149000000008073,539705,0
"172.16.133.63",54159,"68.64.25.250",443,6,366,19538,0,0,4,246,2,120,254.684435,0.10915499999998701,18029,8794
"172.16.133.84",59010,"172.16.139.250",5440,10,1022,19539,0,0,10,1022,0,0,254.687301,0.015103000000010525,541349,0
"172.16.133.68",60990,"173.194.43.60",80,9,985,19540,0,0,5,505,4,480,254.715241,0.10386300000001825,38897,36971
"172.16.133.49",55991,"172.16.139.250",5440,10,1022,19541,0,0,10,1022,0,0,254.763153,0.005649000000005344,1447335,0
"172.16.133.63",54160,"216.115.209.254",443,6,366,19542,0,0,4,246,2,120,254.770641,0.19182899999998426,10259,5004
"172.16.133.95",57195,"172.16.139.250",5440,12,1142,19543,0,0,12,1142,0,0,254.806107,0.006118000000014945,1493298,0
"172.16.133.63",54161,"78.108.119.250",443,6,366,19544,0,0,4,246,2,120,254.813275,0.2598959999999977,7572,3693
"172.16.133.92",57877,"172.16.139.250",5440,12,1142,19545,0,0,12,1142,0,0,254.830906,0.00586699999999496,1557184,0
"172.16.133.29",61212,"172.16.139.250",5440,10,1022,19546,0,0,10,1022,0,0,254.850834,0.015997999999996182,511063,0
"172.16.133.44",65039,"172.16.139.250",5440,12,1142,19547,0,0,12,1142,0,0,254.856404,0.006168999999999869,1480953,0
"172.16.133.207",56146,"172.16.139.250",5440,12,1142,19548,0,0,12,1142,0,0,254.88126,0.015041999999994005,607366,0
"172.16.133.83",57284,"172.16.139.250",5440,12,1142,19549,0,0,12,1142,0,0,254.89197,0.00794500000000653,1149905,0
"172.16.133.93",61068,"172.16.139.250",5440,12,1142,19550,0,0,12,1142,0,0,254.906122,0.00479399999997554,"",""
"172.16.133.11",55374,"172.16.139.250",5440,12,1142,19551,0,0,12,1142,0,0,254.92335,0.01631800000001249,559872,0
"172.16.133.55",57830,"172.16.139.250",5440,10,1022,19552,0,0,10,1022,0,0,254.929139,0.005771000000009963,1416738,0
"172.16.133.63",54162,"204.232.250.57",443,17,4711,19553,0,0,10,3731,7,980,254.929427,5.56114199999999,5367,1409
"172.16.133.73",60892,"172.16.139.250",5440,12,1142,19554,0,0,12,1142,0,0,254.951002,0.006217000000020789,1469519,0
"172.16.133.53",54313,"172.16.139.250",5440,12,1142,19555,0,0,12,1142,0,0,254.954907,0.016863999999998214,541745,0
"172.16.133.21",53388,"172.16.139.250",5440,10,1022,19556,0,0,10,1022,0,0,254.956892,0.017977000000001908,454803,0
"172.16.133.30",62884,"172.16.139.250",5440,10,1022,19557,0,0,10,1022,0,0,254.961605,0.005397000000016305,1514915,0
"172.16.133.25",63689,"172.16.139.250",5440,12,1142,19558,0,0,12,1142,0,0,254.967347,0.011158000000023094,818784,0
"172.16.133.34",50677,"172.16.139.250",5440,10,1022,19559,0,0,10,1022,0,0,254.977404,0.005512999999979229,1483040,0
"172.16.133.97",59590,"172.16.139.250",5440,12,1142,19560,0,0,12,1142,0,0,254.988055,0.0085550000000012,1067913,0
"172.16.133.33",58097,"172.16.139.250",5440,12,1142,19561,0,0,12,1142,0,0,255.058827,0.006226999999995542,1467159,0
"172.16.133.114",55355,"68.64.24.250",443,6,366,19562,0,0,4,246,2,120,255.083645,0.1394769999999994,14109,6882
"172.16.133.68",60991,"172.16.139.250",5440,12,1142,19563,0,0,12,1142,0,0,255.093323,0.006295999999991864,1451080,0
"172.16.133.12",59996,"172.16.139.250",5440,12,1142,19564,0,0,12,1142,0,0,255.106246,0.006161999999989121,1482635,0
"172.16.133.63",54163,"172.16.139.250",5440,12,1142,19565,0,0,12,1142,0,0,255.120017,0.00582800000000816,1567604,0
"172.16.133.66",54418,"172.16.139.250",5440,10,1022,19566,0,0,10,1022,0,0,255.130542,0.005679000000014867,1439690,0
"172.16.133.82",61644,"172.16.139.250",5440,10,1022,19567,0,0,10,1022,0,0,255.144078,0.015721999999982472,520035,0
"172.16.133.20",62641,"74.125.226.78",80,7,2167,19568,0,0,4,637,3,1530,255.14413,1.3615240000000028,3742,8989
"172.16.133.20",62642,"74.125.226.78",80,9,4801,19569,0,0,4,633,5,4168,255.144392,1.1636009999999999,4352,28655
"172.16.133.20",62643,"74.125.226.73",80,19,13124,19570,0,0,8,1262,11,11862,255.144687,5.906025999999969,1709,16067
"172.16.133.20",62644,"74.125.226.73",80,8,3630,19571,0,0,4,633,4,2997,255.144938,1.159335000000027,4368,20680
"172.16.133.114",55356,"78.108.118.250",443,6,366,19572,0,0,4,246,2,120,255.154408,0.209210000000013,9406,4588
"172.16.133.114",55357,"216.219.118.244",443,6,366,19573,0,0,4,246,2,120,255.157024,0.2089379999999892,9419,4594
"172.16.133.37",60863,"172.16.139.250",5440,10,1022,19574,0,0,10,1022,0,0,255.157778,0.016448999999994385,497051,0
"172.16.133.20",62645,"74.125.142.84",443,47,28644,19575,0,0,19,3594,28,25050,255.161428,0.5332050000000095,53922,375840
"172.16.133.20",62646,"74.125.226.33",80,106,107625,19576,0,0,31,3412,75,104213,255.204268,1.1110769999999661,24567,750356
"172.16.133.20",62647,"74.125.226.33",80,75,69869,19577,0,0,26,3181,49,66688,255.204525,5.536269000000004,4596,96365
"172.16.133.20",62648,"74.125.226.33",80,7,432,19578,0,0,4,246,3,186,255.20476,10.872796000000022,181,136
"172.16.133.20",62649,"74.125.226.33",80,100,104412,19579,0,0,28,2889,72,101523,255.204988,1.0872670000000255,21256,746995
"172.16.133.20",62650,"74.125.226.0",80,47,36283,19580,0,0,16,4595,31,31688,255.20527,28.017243999999977,1312,9048
"172.16.133.33",58098,"157.56.245.198",443,22,9669,19581,0,0,9,1918,13,7751,255.211293,0.5538009999999929,27706,111968
"172.16.133.114",55358,"216.115.219.126",443,6,366,19582,0,0,4,246,2,120,255.288018,0.5425330000000201,3627,1769
"172.16.133.78",59456,"172.16.139.250",5440,12,1142,19583,0,0,12,1142,0,0,255.313685,0.006242000000014514,1463633,0
"172.16.133.68",60992,"72.1.65.180",80,50,39912,19584,0,0,18,1551,32,38361,255.334306,1.024911000000003,12106,299428
"172.16.133.67",56208,"172.16.139.250",5440,12,1142,19585,0,0,12,1142,0,0,255.371074,0.05164300000001276,176906,0
"172.16.133.56",61655,"172.16.139.250",5440,12,1142,19586,0,0,12,1142,0,0,255.39218,0.03481800000000135,262393,0
"172.16.133.41",53354,"172.16.139.250",5440,10,1022,19587,0,0,10,1022,0,0,255.446706,0.006573000000003049,1243876,0
"172.16.133.34",50678,"96.43.146.176",443,88,58403,19588,0,0,42,22400,46,36003,255.494779,37.31053700000001,4802,7719
"172.16.133.43",57978,"172.16.139.250",5440,10,1022,19589,0,0,10,1022,0,0,255.515328,0.005433999999979733,1504600,0
"172.16.133.13",53266,"172.16.139.250",5440,10,1022,19590,0,0,10,1022,0,0,255.536182,0.005399000000011256,1514354,0
"172.16.133.53",54314,"173.194.43.39",443,18,4628,19591,0,0,11,3069,7,1559,255.537765,0.4037620000000004,60808,30889
"172.16.133.85",52488,"172.16.139.250",5440,10,1022,19592,0,0,10,1022,0,0,255.542453,0.00584100000000376,1399760,0
"172.16.133.42",57322,"172.16.139.250",5440,12,1142,19593,0,0,12,1142,0,0,255.563968,0.039636999999999034,230491,0
"172.16.133.20",62651,"172.16.139.250",5440,12,1142,19594,0,0,12,1142,0,0,255.585499,0.01482999999998924,616048,0
"172.16.133.28",49383,"172.16.139.250",5440,10,1022,19595,0,0,10,1022,0,0,255.614265,0.005324999999999136,1535399,0
"172.16.133.99",56263,"172.16.139.250",5440,10,1022,19596,0,0,10,1022,0,0,255.643641,0.014717999999987796,555510,0
"172.16.133.75",51176,"172.16.139.250",5440,10,1022,19597,0,0,10,1022,0,0,255.6492,0.014522999999996955,562969,0
"172.16.133.87",60466,"172.16.139.250",5440,12,1142,19598,0,0,12,1142,0,0,255.668121,0.016398999999978514,557107,0
"172.16.133.116",54001,"172.16.139.250",5440,10,1022,19599,0,0,10,1022,0,0,255.679861,0.00782600000002276,1044722,0
"172.16.133.35",50171,"172.16.139.250",5440,12,1142,19600,0,0,12,1142,0,0,255.684978,0.01695399999999836,538869,0
"172.16.133.116",54002,"172.16.139.250",5440,10,1022,19601,0,0,10,1022,0,0,255.688203,0.00714600000000587,1144136,0
"172.16.133.116",54003,"172.16.139.250",5440,10,1022,19602,0,0,10,1022,0,0,255.695873,0.009472999999985632,863084,0
"172.16.133.84",59011,"172.16.139.250",5440,12,1142,19603,0,0,12,1142,0,0,255.701571,0.006744999999995116,1354484,0
"172.16.133.20",62652,"74.125.170.153",80,1001,1103420,19604,0,0,270,18087,731,1085333,255.769716,40.36332300000001,3584,215112
"172.16.133.20",62653,"74.125.170.153",80,7,1746,19605,0,0,4,1426,3,320,255.769836,0.3978190000000268,28676,6435
"172.16.133.20",62654,"74.125.170.153",80,6,372,19606,0,0,4,246,2,126,255.7758,10.358584000000008,189,97
"172.16.133.49",55992,"172.16.139.250",5440,12,1142,19607,0,0,12,1142,0,0,255.777379,0.006220000000013215,1468810,0
"172.16.133.95",57196,"172.16.139.250",5440,12,1142,19608,0,0,12,1142,0,0,255.821372,0.006182999999992944,1477599,0
"172.16.133.20",62655,"74.125.226.42",443,20,7132,19609,0,0,10,1520,10,5612,255.82885,0.3507789999999886,34665,127989
"172.16.133.92",57878,"172.16.139.250",5440,12,1142,19610,0,0,12,1142,0,0,255.846831,0.0055370000000039,1649990,0
"172.16.133.29",61213,"172.16.139.250",5440,12,1142,19611,0,0,12,1142,0,0,255.864523,0.006099000000006072,1497950,0
"172.16.133.44",65040,"172.16.139.250",5440,10,1022,19612,0,0,10,1022,0,0,255.87029,0.00667899999999122,1224135,0
"172.16.133.207",56147,"172.16.139.250",5440,12,1142,19613,0,0,12,1142,0,0,255.895553,0.004959999999982756,"",""
"172.16.133.83",57285,"172.16.139.250",5440,10,1022,19614,0,0,10,1022,0,0,255.906191,0.014790000000004966,552805,0
"172.16.133.93",61069,"172.16.139.250",5440,10,1022,19615,0,0,10,1022,0,0,255.920111,0.00492900000000418,"",""
"172.16.133.11",55375,"172.16.139.250",5440,10,1022,19616,0,0,10,1022,0,0,255.938414,0.005647000000010394,1447848,0
"172.16.133.55",57831,"172.16.139.250",5440,10,1022,19617,0,0,10,1022,0,0,255.942934,0.015681999999998197,521362,0
"172.16.133.73",60893,"172.16.139.250",5440,12,1142,19618,0,0,12,1142,0,0,255.964903,0.005533000000013999,1651183,0
"172.16.133.53",54315,"172.16.139.250",5440,10,1022,19619,0,0,10,1022,0,0,255.96833,0.01537299999998254,531841,0
"172.16.133.21",53389,"172.16.139.250",5440,12,1142,19620,0,0,12,1142,0,0,255.970863,0.006388999999984435,1429957,0
"172.16.133.30",62885,"172.16.139.250",5440,12,1142,19621,0,0,12,1142,0,0,255.975861,0.0161329999999964,566292,0
"172.16.133.25",63690,"172.16.139.250",5440,12,1142,19622,0,0,12,1142,0,0,255.982116,0.005006000000008726,1825009,0
"172.16.133.34",50679,"172.16.139.250",5440,10,1022,19623,0,0,10,1022,0,0,255.991662,0.005030000000004975,1625447,0
"172.16.133.97",59591,"172.16.139.250",5440,10,1022,19624,0,0,10,1022,0,0,256.001008,0.005354000000011183,1527082,0
"172.16.133.68",60993,"72.21.91.111",80,11,1344,19625,0,0,6,585,5,759,256.035037,7.638733000000002,612,794
"172.16.133.33",58099,"172.16.139.250",5440,10,1022,19626,0,0,10,1022,0,0,256.072685,0.015722000000039316,520035,0
"172.16.133.68",60994,"76.74.248.254",80,114,102928,19627,0,0,36,3923,78,99005,256.105343,7.625225,4115,103871
"172.16.133.68",60995,"172.16.139.250",5440,10,1022,19628,0,0,10,1022,0,0,256.106906,0.01473500000003014,554869,0
"172.16.133.12",59997,"172.16.139.250",5440,10,1022,19629,0,0,10,1022,0,0,256.120097,0.005460000000027776,1497435,0
"172.16.133.63",54164,"172.16.139.250",5440,12,1142,19630,0,0,12,1142,0,0,256.134135,0.006484000000000378,1409006,0
"172.16.133.66",54419,"172.16.139.250",5440,12,1142,19631,0,0,12,1142,0,0,256.144613,0.0071310000000153195,1281166,0
"172.16.133.82",61645,"172.16.139.250",5440,10,1022,19632,0,0,10,1022,0,0,256.158427,0.0055789999999547035,1465495,0
"172.16.133.37",60864,"172.16.139.250",5440,10,1022,19633,0,0,10,1022,0,0,256.171573,0.01495599999998376,546670,0
"172.16.133.20",62656,"74.125.226.70",80,25,19400,19634,0,0,10,1382,15,18018,256.210789,4.782187000000022,2311,30141
"172.16.133.20",62657,"74.125.226.71",80,82,78094,19635,0,0,28,3359,54,74735,256.21263,6.075044999999989,4423,98415
"172.16.133.20",62658,"74.125.226.73",80,18,13664,19636,0,0,7,1202,11,12462,256.213815,4.835827999999992,1988,20616
"172.16.133.20",62659,"74.125.226.73",80,20,13234,19637,0,0,8,1688,12,11546,256.214254,4.834574000000032,2793,19105
"172.16.133.20",62660,"74.125.226.78",80,21,15935,19638,0,0,8,1262,13,14673,256.21448,4.741039999999998,2129,24759
"172.16.133.20",62661,"74.125.226.78",80,19,13129,19639,0,0,8,1262,11,11867,256.214647,4.737238999999988,2131,20040
"172.16.133.20",62662,"74.125.226.78",80,8,3538,19640,0,0,4,633,4,2905,256.214807,0.13836700000001656,36598,167959
"172.16.133.20",62663,"74.125.226.78",80,18,11810,19641,0,0,8,1262,10,10548,256.214963,4.746873999999991,2126,17776
"172.16.133.20",62664,"74.125.226.70",80,10,4876,19642,0,0,5,693,5,4183,256.215121,0.3365119999999706,16474,99443
"172.16.133.20",62665,"74.125.226.70",80,35,26452,19643,0,0,15,2073,20,24379,256.215273,4.78459399999997,3466,40762
"172.16.133.20",62666,"74.125.226.70",80,21,14807,19644,0,0,9,1322,12,13485,256.215424,5.003445999999997,2113,21561
"172.16.133.68",60996,"72.1.65.180",80,9,1025,19645,0,0,5,589,4,436,256.301791,0.41792300000003024,11274,8346
"172.16.133.78",59457,"172.16.139.250",5440,10,1022,19646,0,0,10,1022,0,0,256.327765,0.015105000000005475,541277,0
"172.16.133.20",62667,"74.125.226.89",80,10,1838,19647,0,0,5,1066,5,772,256.345899,0.4856510000000185,17559,12716
"172.16.133.67",56209,"172.16.139.250",5440,12,1142,19648,0,0,12,1142,0,0,256.382328,0.005723000000045886,1596365,0
"172.16.133.56",61656,"172.16.139.250",5440,10,1022,19649,0,0,10,1022,0,0,256.406021,0.005487000000016451,1490067,0
"172.16.133.41",53355,"172.16.139.250",5440,10,1022,19650,0,0,10,1022,0,0,256.460711,0.0054599999999709325,1497435,0
"172.16.133.68",60997,"76.74.248.254",80,123,112502,19651,0,0,38,4024,85,108478,256.490868,7.239698000000033,4446,119870
"172.16.133.67",56210,"107.23.112.156",80,26,6753,19652,0,0,13,3472,13,3281,256.505929,7.697046999999998,3608,3410
"172.16.133.96",53409,"98.139.183.24",80,11,1513,19653,0,0,6,774,5,739,256.511117,0.15780599999999367,39238,37463
"172.16.133.96",53410,"68.71.220.175",80,8,2718,19654,0,0,5,2168,3,550,256.511922,0.42055399999998144,41240,10462
"172.16.133.96",53411,"68.71.220.175",80,8,2719,19655,0,0,5,2169,3,550,256.512699,0.42781300000001465,40559,10284
"172.16.133.96",53412,"68.71.220.175",80,8,2719,19656,0,0,5,2169,3,550,256.5127,0.4263639999999782,40697,10319
"172.16.133.43",57979,"172.16.139.250",5440,10,1022,19657,0,0,10,1022,0,0,256.529373,0.015883999999971365,514731,0
"172.16.133.13",53267,"172.16.139.250",5440,10,1022,19658,0,0,10,1022,0,0,256.551197,0.005532000000016524,1477946,0
"172.16.133.85",52489,"172.16.139.250",5440,10,1022,19659,0,0,10,1022,0,0,256.556789,0.005371000000025106,1522249,0
"172.16.133.42",57323,"172.16.139.250",5440,12,1142,19660,0,0,12,1142,0,0,256.574046,0.027028999999970438,338007,0
"172.16.125.220",52727,"172.16.133.233",80,7,420,19661,0,0,4,240,3,180,256.575747,0.25694200000003775,7472,5604
"172.16.133.20",62668,"172.16.139.250",5440,12,1142,19662,0,0,12,1142,0,0,256.600511,0.004885999999999058,"",""
"172.16.133.28",49384,"172.16.139.250",5440,12,1142,19663,0,0,12,1142,0,0,256.628429,0.006137000000023818,1488675,0
"172.16.133.20",62669,"74.125.226.47",80,7,1288,19664,0,0,4,635,3,653,256.636659,0.28005200000001196,18139,18653
"172.16.133.20",62670,"74.125.226.90",80,8,3377,19665,0,0,4,1641,4,1736,256.644415,0.37531300000000556,34978,37003
"172.16.133.99",56264,"172.16.139.250",5440,12,1142,19666,0,0,12,1142,0,0,256.65865,0.016000999999960186,570964,0
"172.16.133.75",51177,"172.16.139.250",5440,10,1022,19667,0,0,10,1022,0,0,256.663528,0.005601000000012846,1459739,0
"172.16.133.96",53413,"98.139.183.24",80,167,133531,19668,0,0,67,16632,100,116899,256.670942,11.475420999999983,11594,81495
"172.16.133.20",62671,"74.125.226.72",80,7,1640,19669,0,0,4,1320,3,320,256.675792,0.27993400000002566,37723,9145
"172.16.133.87",60467,"172.16.139.250",5440,12,1142,19670,0,0,12,1142,0,0,256.682031,0.0060639999999807515,1506596,0
"172.16.133.35",50172,"172.16.139.250",5440,12,1142,19671,0,0,12,1142,0,0,256.688598,0.015456999999969412,591059,0
"172.16.133.116",54004,"172.16.139.250",5440,10,1022,19672,0,0,10,1022,0,0,256.693539,0.005625000000009095,1453511,0
"172.16.133.116",54005,"172.16.139.250",5440,10,1022,19673,0,0,10,1022,0,0,256.700127,0.005241000000012264,1560007,0
"172.16.133.116",54006,"172.16.139.250",5440,10,1022,19674,0,0,10,1022,0,0,256.706295,0.005246999999997115,1558223,0
"172.16.133.84",59012,"172.16.139.250",5440,10,1022,19675,0,0,10,1022,0,0,256.715482,0.01449400000001333,564095,0
"172.16.133.63",54165,"68.64.5.249",443,6,366,19676,0,0,4,246,2,120,256.733388,0.10623700000002145,18524,9036
"172.16.133.63",54166,"68.64.25.250",443,6,366,19677,0,0,4,246,2,120,256.753355,0.11074400000001106,17770,8668
"172.16.133.68",60998,"54.243.166.36",80,25,11090,19678,0,0,13,2516,12,8574,256.764135,6.918649000000016,2909,9914
"172.16.133.49",55993,"172.16.139.250",5440,12,1142,19679,0,0,12,1142,0,0,256.791069,0.006338000000027932,1441464,0
"172.16.133.95",57197,"172.16.139.250",5440,10,1022,19680,0,0,10,1022,0,0,256.834348,0.0052780000000325344,1549071,0
"172.16.133.92",57880,"172.16.139.250",5440,10,1022,19681,0,0,10,1022,0,0,256.859624,0.015043999999988955,543472,0
"172.16.133.63",54167,"216.115.209.254",443,6,366,19682,0,0,4,246,2,120,256.870386,0.19163000000003194,10269,5009
"172.16.133.29",61214,"172.16.139.250",5440,10,1022,19683,0,0,10,1022,0,0,256.878486,0.005369999999970787,1522532,0
"172.16.133.44",65041,"172.16.139.250",5440,10,1022,19684,0,0,10,1022,0,0,256.884019,0.015356999999994514,532395,0
"172.16.133.207",56148,"172.16.139.250",5440,10,1022,19685,0,0,10,1022,0,0,256.909388,0.0047430000000190375,"",""
"172.16.133.83",57286,"172.16.139.250",5440,12,1142,19686,0,0,12,1142,0,0,256.920239,0.004648000000031516,"",""
"172.16.133.93",61070,"172.16.139.250",5440,10,1022,19687,0,0,10,1022,0,0,256.934353,0.014456999999993059,565539,0
"172.16.133.63",54168,"78.108.119.250",443,6,366,19688,0,0,4,246,2,120,256.948585,0.25443500000000085,7734,3773
"172.16.133.11",55376,"172.16.139.250",5440,10,1022,19689,0,0,10,1022,0,0,256.951367,0.005507000000022799,1484655,0
"172.16.133.113",55747,"63.147.189.115",80,17,6418,19690,0,0,8,1418,9,5000,256.95592,25.308035000000018,448,1580
"172.16.133.55",57832,"172.16.139.250",5440,10,1022,19691,0,0,10,1022,0,0,256.956983,0.006371000000001459,1283315,0
"172.16.133.113",55748,"63.147.189.115",80,15,6286,19692,0,0,7,1352,8,4934,256.959638,0.4462790000000041,24235,88446
"172.16.133.73",60894,"172.16.139.250",5440,10,1022,19693,0,0,10,1022,0,0,256.979029,0.0050809999999614774,1609132,0
"172.16.133.53",54316,"172.16.139.250",5440,10,1022,19694,0,0,10,1022,0,0,256.982727,0.0059180000000083055,1381547,0
"172.16.133.21",53390,"172.16.139.250",5440,12,1142,19695,0,0,12,1142,0,0,256.984959,0.008281000000010863,1103248,0
"172.16.133.30",62886,"172.16.139.250",5440,10,1022,19696,0,0,10,1022,0,0,256.990084,0.006284999999991214,1300875,0
"172.16.133.25",63691,"172.16.139.250",5440,10,1022,19697,0,0,10,1022,0,0,256.995436,0.014632000000005974,558775,0
"172.16.133.34",50680,"172.16.139.250",5440,10,1022,19698,0,0,10,1022,0,0,257.005678,0.008194000000003143,997803,0
"172.16.133.97",59592,"172.16.139.250",5440,10,1022,19699,0,0,10,1022,0,0,257.015159,0.010298000000034335,793940,0
"172.16.133.33",58100,"172.16.139.250",5440,10,1022,19700,0,0,10,1022,0,0,257.086591,0.005858999999986736,1395459,0
"172.16.133.68",60999,"172.16.139.250",5440,12,1142,19701,0,0,12,1142,0,0,257.121117,0.0063399999999660395,1441009,0
"172.16.133.12",59998,"172.16.139.250",5440,10,1022,19702,0,0,10,1022,0,0,257.134007,0.005369000000030155,1522816,0
"172.16.133.114",55359,"68.64.24.250",443,7,426,19703,0,0,4,246,3,180,257.139093,0.09676600000000235,20337,14881
"172.16.133.63",54169,"172.16.139.250",5440,12,1142,19704,0,0,12,1142,0,0,257.146173,0.005838000000039756,1564919,0
"172.16.133.66",54420,"172.16.139.250",5440,10,1022,19705,0,0,10,1022,0,0,257.157192,0.004983999999979005,"",""
"172.16.133.96",53414,"98.137.80.33",80,90,73260,19706,0,0,40,6235,50,67025,257.164763,26.61748,1873,20144
"172.16.133.96",53415,"23.67.242.104",80,12,2943,19707,0,0,7,2389,5,554,257.166563,0.120412999999985,158720,36806
"172.16.133.96",53416,"98.137.80.33",80,172,166272,19708,0,0,60,7914,112,158358,257.169943,26.694721000000015,2371,47457
"172.16.133.96",53417,"98.137.80.33",80,146,142915,19709,0,0,49,6092,97,136823,257.170267,20.830061999999998,2339,52548
"172.16.133.96",53418,"23.67.242.104",80,12,2943,19710,0,0,7,2389,5,554,257.170714,0.12256600000000617,155932,36160
"172.16.133.96",53419,"98.137.80.33",80,43,30753,19711,0,0,19,2040,24,28713,257.171108,18.872157000000016,864,12171
"172.16.133.96",53420,"23.67.242.104",80,12,2943,19712,0,0,7,2389,5,554,257.171512,0.12125399999996489,157619,36551
"172.16.133.96",53421,"98.137.80.33",80,11,1526,19713,0,0,6,845,5,681,257.172006,18.871696999999983,358,288
"172.16.133.96",53422,"98.137.80.33",80,107,108708,19714,0,0,33,3092,74,105616,257.172008,22.729588999999976,1088,37173
"172.16.133.82",61646,"172.16.139.250",5440,10,1022,19715,0,0,10,1022,0,0,257.172324,0.006298000000015236,1298189,0
"172.16.133.96",53423,"98.137.80.33",80,134,116914,19716,0,0,54,5689,80,111225,257.172325,22.731004999999982,2002,39144
"172.16.133.96",53424,"98.137.80.33",80,11,1526,19717,0,0,6,845,5,681,257.172327,18.870937000000026,358,288
"172.16.133.96",53425,"98.137.80.33",80,11,1526,19718,0,0,6,846,5,680,257.172673,19.099018,354,284
"172.16.133.37",60867,"172.16.139.250",5440,10,1022,19719,0,0,10,1022,0,0,257.186359,0.014994999999998981,545248,0
"172.16.133.96",53426,"98.137.80.33",80,11,1527,19720,0,0,6,846,5,681,257.193718,19.12999400000001,353,284
"172.16.133.96",53427,"98.137.80.33",80,45,35648,19721,0,0,19,2595,26,33053,257.194067,20.79573799999997,998,12715
"172.16.133.96",53428,"98.137.80.33",80,141,133400,19722,0,0,50,6858,91,126542,257.195107,20.794899999999984,2638,48681
"172.16.133.96",53429,"98.137.80.33",80,90,78517,19723,0,0,36,5166,54,73351,257.19552,29.228249000000005,1413,20076
"172.16.133.96",53430,"98.137.80.33",80,59,53044,19724,0,0,21,2337,38,50707,257.195522,15.915967000000023,1174,25487
"172.16.133.96",53431,"98.137.80.33",80,24,16308,19725,0,0,10,1560,14,14748,257.195524,15.916277000000036,784,7412
"172.16.133.114",55360,"78.108.118.250",443,6,366,19726,0,0,4,246,2,120,257.261738,0.20771100000001752,9474,4621
"172.16.133.114",55361,"216.219.118.244",443,6,366,19727,0,0,4,246,2,120,257.270424,0.2036820000000148,9662,4713
"172.16.133.63",54170,"8.27.243.253",80,24,14623,19728,0,0,10,2208,14,12415,257.286218,10.437846999999977,1692,9515
"172.16.133.96",53432,"98.139.50.175",80,12,1966,19729,0,0,7,1168,5,798,257.328691,0.07317399999999452,127695,87244
"172.16.133.96",53433,"98.139.240.23",80,10,1847,19730,0,0,6,1229,4,618,257.329029,0.10611000000000104,92658,46593
"172.16.133.78",59458,"172.16.139.250",5440,10,1022,19731,0,0,10,1022,0,0,257.341982,0.01551900000004025,526838,0
"172.16.133.96",53434,"208.47.254.83",80,37,11857,19732,0,0,24,5993,13,5864,257.353977,20.63937100000004,2322,2272
"172.16.133.63",54171,"208.111.161.254",80,45,28728,19733,0,0,18,5854,27,22874,257.360349,40.37015500000001,1160,4532
"172.16.133.63",54172,"208.111.161.254",80,44,21288,19734,0,0,17,5011,27,16277,257.36856,40.361673999999994,993,3226
"172.16.133.63",54173,"208.111.161.254",80,50,29416,19735,0,0,19,6742,31,22674,257.371886,40.361874,1336,4494
"172.16.133.63",54174,"208.111.161.254",80,36,15758,19736,0,0,14,4834,22,10924,257.378549,40.35531899999995,958,2165
"172.16.133.63",54175,"208.111.161.254",80,33,15933,19737,0,0,13,4773,20,11160,257.378876,40.35465099999999,946,2212
"172.16.133.63",54176,"208.111.161.254",80,50,31448,19738,0,0,18,5855,32,25593,257.379519,40.35381100000001,1160,5073
"172.16.133.67",56211,"172.16.139.250",5440,10,1022,19739,0,0,10,1022,0,0,257.397409,0.005198000000007141,1572912,0
"172.16.133.56",61657,"172.16.139.250",5440,12,1142,19740,0,0,12,1142,0,0,257.419075,0.005317999999988388,1717939,0
"172.16.133.55",57833,"199.16.156.8",80,11,1896,19741,0,0,6,1003,5,893,257.447449,40.08325100000002,200,178
"172.16.133.41",53356,"172.16.139.250",5440,10,1022,19742,0,0,10,1022,0,0,257.474707,0.008379999999988286,975656,0
"172.16.133.95",57198,"23.0.49.244",80,7,432,19743,0,0,4,246,3,186,257.495205,12.371516999999983,159,120
"172.16.133.95",57199,"23.0.49.244",80,6,372,19744,0,0,4,246,2,126,257.495484,12.370353000000023,159,81
"172.16.133.63",54177,"173.194.43.59",80,13,5569,19745,0,0,7,3490,6,2079,257.525793,8.31863599999997,3356,1999
"172.16.133.43",57980,"172.16.139.250",5440,10,1022,19746,0,0,10,1022,0,0,257.543636,0.015627999999992426,523163,0
"172.16.133.13",53268,"172.16.139.250",5440,12,1142,19747,0,0,12,1142,0,0,257.565113,0.014714000000026317,620905,0
"172.16.133.85",52490,"172.16.139.250",5440,10,1022,19748,0,0,10,1022,0,0,257.569634,0.01467400000001362,557175,0
"172.16.133.114",55362,"216.115.219.126",443,6,366,19749,0,0,4,246,2,120,257.573697,0.5056969999999978,3891,1898
"172.16.133.42",57324,"172.16.139.250",5440,12,1142,19750,0,0,12,1142,0,0,257.588179,0.011175999999977648,817465,0
"172.16.133.46",64595,"192.147.107.14",8883,8,521,19751,0,0,5,335,3,186,257.613064,0.1689829999999688,15859,8805
"172.16.133.20",62672,"172.16.139.250",5440,12,1142,19752,0,0,12,1142,0,0,257.613776,0.004969000000016877,"",""
"172.16.133.28",49385,"172.16.139.250",5440,10,1022,19753,0,0,10,1022,0,0,257.642586,0.00559099999998125,1462350,0
"172.16.133.63",54178,"23.0.49.244",80,6,372,19754,0,0,4,246,2,126,257.663382,10.057917999999972,195,100
"172.16.133.63",54179,"23.0.49.244",80,7,432,19755,0,0,4,246,3,186,257.663522,10.064706999999999,195,147
"172.16.133.63",54180,"23.0.49.244",80,6,372,19756,0,0,4,246,2,126,257.663639,10.064659000000006,195,100
"172.16.133.63",54181,"208.47.254.83",80,6,372,19757,0,0,4,246,2,126,257.665416,10.05217399999998,195,100
"172.16.133.63",54182,"208.47.254.83",80,18,7565,19758,0,0,11,6413,7,1152,257.66553,37.338153000000034,1374,246
"172.16.133.63",54183,"23.0.49.244",80,7,432,19759,0,0,4,246,3,186,257.666263,10.061968999999976,195,147
"172.16.133.63",54184,"23.0.49.244",80,6,372,19760,0,0,4,246,2,126,257.666402,10.061828999999989,195,100
"172.16.133.99",56265,"172.16.139.250",5440,10,1022,19761,0,0,10,1022,0,0,257.672121,0.004949000000010528,"",""
"172.16.133.75",51178,"172.16.139.250",5440,10,1022,19762,0,0,10,1022,0,0,257.676222,0.00536800000003268,1523099,0
"172.16.133.87",60468,"172.16.139.250",5440,12,1142,19763,0,0,12,1142,0,0,257.696589,0.006245999999975993,1462696,0
"172.16.133.35",50173,"172.16.139.250",5440,12,1142,19764,0,0,12,1142,0,0,257.698226,0.04146600000001399,220325,0
"172.16.133.116",54007,"172.16.139.250",5440,10,1022,19765,0,0,10,1022,0,0,257.707482,0.0050729999999816755,1611669,0
"172.16.133.116",54008,"172.16.139.250",5440,12,1142,19766,0,0,12,1142,0,0,257.715243,0.006187000000011267,1476644,0
"172.16.133.116",54009,"172.16.139.250",5440,10,1022,19767,0,0,10,1022,0,0,257.722435,0.016659000000004198,490785,0
"172.16.133.84",59013,"172.16.139.250",5440,10,1022,19768,0,0,10,1022,0,0,257.72959,0.005702000000042062,1433882,0
"172.16.133.96",53435,"98.139.225.43",80,41,18898,19769,0,0,22,8368,19,10530,257.735147,20.267403,3303,4156
"172.16.133.96",53436,"173.194.43.60",80,16,3506,19770,0,0,10,1770,6,1736,257.735794,20.25531000000001,699,685
"172.16.133.49",55994,"172.16.139.250",5440,10,1022,19771,0,0,10,1022,0,0,257.805279,0.015436000000022432,529670,0
"172.16.133.96",53437,"98.139.225.13",80,11,1884,19772,0,0,6,974,5,910,257.814297,0.11553499999996575,67442,63011
"172.16.133.95",57200,"172.16.139.250",5440,10,1022,19773,0,0,10,1022,0,0,257.849515,0.005496999999991203,1487356,0
"172.16.133.96",53438,"76.13.234.33",80,12,1848,19774,0,0,7,1135,5,713,257.872759,0.08037300000000869,112973,70969
"172.16.133.92",57881,"172.16.139.250",5440,10,1022,19775,0,0,10,1022,0,0,257.874422,0.005492000000003827,1488710,0
"172.16.133.29",61215,"172.16.139.250",5440,10,1022,19776,0,0,10,1022,0,0,257.893442,0.005297999999982039,1543223,0
"172.16.133.44",65042,"172.16.139.250",5440,10,1022,19777,0,0,10,1022,0,0,257.897922,0.086716000000024,94284,0
"172.16.133.207",56149,"172.16.139.250",5440,12,1142,19778,0,0,12,1142,0,0,257.923379,0.06579399999998259,138857,0
"172.16.133.83",57287,"172.16.139.250",5440,12,1142,19779,0,0,12,1142,0,0,257.933175,0.05929800000001251,154069,0
"172.16.133.93",61071,"172.16.139.250",5440,12,1142,19780,0,0,12,1142,0,0,257.948289,0.04865899999998646,187755,0
"172.16.133.121",56643,"184.169.137.94",443,18,9033,19781,0,0,9,4563,9,4470,257.960809,0.4744840000000181,76934,75366
"172.16.133.11",55377,"172.16.139.250",5440,12,1142,19782,0,0,12,1142,0,0,257.966011,0.03638800000004494,251071,0
"172.16.133.55",57834,"172.16.139.250",5440,12,1142,19783,0,0,12,1142,0,0,257.971044,0.0348329999999919,262280,0
"172.16.133.73",60895,"172.16.139.250",5440,12,1142,19784,0,0,12,1142,0,0,257.99471,0.015151000000003023,602996,0
"172.16.133.53",54317,"172.16.139.250",5440,10,1022,19785,0,0,10,1022,0,0,257.996548,0.018189000000006672,449502,0
"172.16.133.21",53391,"172.16.139.250",5440,12,1142,19786,0,0,12,1142,0,0,257.999307,0.027873999999997068,327760,0
"172.16.133.30",62888,"172.16.139.250",5440,12,1142,19787,0,0,12,1142,0,0,258.003354,0.016122999999993226,566643,0
"172.16.133.25",63692,"172.16.139.250",5440,12,1142,19788,0,0,12,1142,0,0,258.00953,0.013338000000032935,684960,0
"172.16.133.121",56644,"184.169.137.94",443,6,372,19789,0,0,4,246,2,126,258.010686,16.016057999999987,122,62
"172.16.133.63",54185,"138.108.6.20",80,15,5262,19790,0,0,8,4012,7,1250,258.015767,21.596058000000028,1486,463
"172.16.133.34",50681,"172.16.139.250",5440,12,1142,19791,0,0,12,1142,0,0,258.019479,0.01145600000000968,797486,0
"172.16.133.97",59593,"172.16.139.250",5440,12,1142,19792,0,0,12,1142,0,0,258.030161,0.006369000000006508,1434448,0
"172.16.133.113",55749,"172.16.139.250",135,8,492,19793,0,0,8,492,0,0,258.098347,0.011558000000036373,340543,0
"172.16.133.34",50188,"96.43.146.176",443,2,120,19794,0,0,1,60,1,60,258.100114,0.00015700000000151704,"",""
"172.16.133.33",58101,"172.16.139.250",5440,10,1022,19795,0,0,10,1022,0,0,258.100676,0.005903999999986809,1384823,0
"172.16.133.34",50682,"96.43.146.176",443,32,8941,19796,0,0,19,5435,13,3506,258.108351,39.806151,1092,704
"172.16.133.113",55750,"172.16.139.250",5462,10,696,19797,0,0,10,696,0,0,258.113795,0.535347999999999,10400,0
"172.16.133.63",54186,"64.94.107.54",80,11,2712,19798,0,0,6,2129,5,583,258.125045,0.0650330000000281,261897,71717
"172.16.133.68",61000,"172.16.139.250",5440,10,1022,19799,0,0,10,1022,0,0,258.135422,0.005565999999987525,1468918,0
"172.16.133.12",59999,"172.16.139.250",5440,12,1142,19800,0,0,12,1142,0,0,258.148117,0.005804000000011911,1574086,0
"172.16.133.63",54187,"172.16.139.250",5440,12,1142,19801,0,0,12,1142,0,0,258.160049,0.005978999999967982,1528014,0
"172.16.133.66",54421,"172.16.139.250",5440,12,1142,19802,0,0,12,1142,0,0,258.17183,0.006154999999978372,1484321,0
"172.16.133.82",61647,"172.16.139.250",5440,12,1142,19803,0,0,12,1142,0,0,258.187481,0.006223000000034062,1468102,0
"172.16.133.37",60868,"172.16.139.250",5440,10,1022,19804,0,0,10,1022,0,0,258.199871,0.005653000000052089,1446311,0
"172.16.133.41",53357,"157.56.236.102",443,24,9789,19805,0,0,11,2038,13,7751,258.351764,0.5041749999999752,32337,122989
"172.16.133.78",59459,"172.16.139.250",5440,12,1142,19806,0,0,12,1142,0,0,258.355827,0.006371000000001459,1433997,0
"172.16.133.67",56212,"172.16.139.250",5440,10,1022,19807,0,0,10,1022,0,0,258.411449,0.005432999999982258,1504877,0
"172.16.133.56",61658,"172.16.139.250",5440,10,1022,19808,0,0,10,1022,0,0,258.434906,0.004707999999993717,"",""
"172.16.133.41",53358,"172.16.139.250",5440,12,1142,19809,0,0,12,1142,0,0,258.488648,0.006107999999983349,1495743,0
"172.16.133.24",57711,"96.43.146.48",443,49,37949,19810,0,0,26,20713,23,17236,258.495014,17.721118999999987,9350,7780
"172.16.133.43",57981,"172.16.139.250",5440,10,1022,19811,0,0,10,1022,0,0,258.55723,0.005428999999992357,1505986,0
"172.16.133.13",53269,"172.16.139.250",5440,10,1022,19812,0,0,10,1022,0,0,258.578378,0.005375000000015007,1521116,0
"172.16.133.85",52491,"172.16.139.250",5440,10,1022,19813,0,0,10,1022,0,0,258.58353,0.005387999999982185,1517446,0
"172.16.133.42",57325,"172.16.139.250",5440,12,1142,19814,0,0,12,1142,0,0,258.616332,0.03742899999997462,244088,0
"172.16.133.24",57712,"96.43.146.22",443,7,817,19815,0,0,4,508,3,309,258.620185,0.13066000000003442,31103,18919
"172.16.133.24",57713,"96.43.146.22",443,21,6933,19816,0,0,11,5899,10,1034,258.62039,15.238953000000038,3096,542
"172.16.133.24",57714,"96.43.146.22",443,7,817,19817,0,0,4,508,3,309,258.620671,0.1303649999999834,31174,18962
"172.16.133.24",57715,"96.43.146.22",443,20,9855,19818,0,0,12,8453,8,1402,258.62111,17.57561000000004,3847,638
"172.16.133.24",57716,"96.43.146.22",443,21,6933,19819,0,0,11,5899,10,1034,258.621226,8.716177000000016,5414,949
"172.16.133.20",62673,"172.16.139.250",5440,12,1142,19820,0,0,12,1142,0,0,258.628799,0.016570999999999003,551324,0
"172.16.133.28",49386,"172.16.139.250",5440,10,1022,19821,0,0,10,1022,0,0,258.657505,0.006225999999969645,1313202,0
"172.16.133.99",56266,"172.16.139.250",5440,10,1022,19822,0,0,10,1022,0,0,258.686665,0.014622999999971853,559119,0
"172.16.133.95",57201,"138.108.6.20",80,8,1782,19823,0,0,4,1124,4,658,258.689667,10.285536000000036,874,511
"172.16.133.75",51179,"172.16.139.250",5440,10,1022,19824,0,0,10,1022,0,0,258.690244,0.014739000000020042,554718,0
"172.16.133.95",57202,"64.94.107.18",80,8,1763,19825,0,0,5,1300,3,463,258.697453,0.0710409999999797,146394,52138
"172.16.133.87",60469,"172.16.139.250",5440,10,1022,19826,0,0,10,1022,0,0,258.711492,0.019624999999962256,416611,0
"172.16.133.35",50174,"172.16.139.250",5440,12,1142,19827,0,0,12,1142,0,0,258.714316,0.013972000000023854,653879,0
"172.16.133.116",54010,"172.16.139.250",5440,12,1142,19828,0,0,12,1142,0,0,258.721849,0.0063089999999874635,1448090,0
"172.16.133.116",54011,"172.16.139.250",5440,10,1022,19829,0,0,10,1022,0,0,258.728684,0.0062859999999886895,1300668,0
"172.16.133.116",54012,"172.16.139.250",5440,10,1022,19830,0,0,10,1022,0,0,258.735804,0.0055960000000254695,1461043,0
"172.16.133.84",59014,"172.16.139.250",5440,10,1022,19831,0,0,10,1022,0,0,258.744734,0.005480000000034124,1491970,0
"172.16.133.63",54188,"68.64.5.249",443,6,366,19832,0,0,4,246,2,120,258.786652,0.15231399999998985,12920,6302
"172.16.133.63",54190,"68.64.25.250",443,6,366,19833,0,0,4,246,2,120,258.814627,0.11880300000001398,16565,8080
"172.16.133.49",55995,"172.16.139.250",5440,12,1142,19834,0,0,12,1142,0,0,258.819489,0.006279000000006363,1455008,0
"172.16.133.95",57203,"172.16.139.250",5440,12,1142,19835,0,0,12,1142,0,0,258.862351,0.005888000000027205,1551630,0
"172.16.133.92",57882,"172.16.139.250",5440,10,1022,19836,0,0,10,1022,0,0,258.888503,0.005418999999960761,1508765,0
"172.16.133.29",61216,"172.16.139.250",5440,10,1022,19837,0,0,10,1022,0,0,258.905492,0.006287000000043008,1300461,0
"172.16.133.44",65043,"172.16.139.250",5440,10,1022,19838,0,0,10,1022,0,0,258.911923,0.01449400000001333,564095,0
"172.16.133.207",56150,"172.16.139.250",5440,12,1142,19839,0,0,12,1142,0,0,258.93743,0.01468899999997575,621962,0
"172.16.133.83",57288,"172.16.139.250",5440,12,1142,19840,0,0,12,1142,0,0,258.947315,0.014896000000021559,613319,0
"172.16.133.93",61072,"172.16.139.250",5440,12,1142,19841,0,0,12,1142,0,0,258.962158,0.014462000000037278,631724,0
"172.16.133.63",54191,"216.115.209.254",443,6,366,19842,0,0,4,246,2,120,258.965618,0.2138879999999972,9201,4488
"172.16.133.11",55378,"172.16.139.250",5440,10,1022,19843,0,0,10,1022,0,0,258.979306,0.005641999999966174,1449131,0
"172.16.133.55",57835,"172.16.139.250",5440,12,1142,19844,0,0,12,1142,0,0,258.984902,0.006185000000016316,1477122,0
"172.16.133.73",60896,"172.16.139.250",5440,10,1022,19845,0,0,10,1022,0,0,259.008166,0.005504999999971005,1485195,0
"172.16.133.53",54318,"172.16.139.250",5440,10,1022,19846,0,0,10,1022,0,0,259.009472,0.01808299999999008,452137,0
"172.16.133.21",53392,"172.16.139.250",5440,10,1022,19847,0,0,10,1022,0,0,259.012888,0.00623200000001134,1311938,0
"172.16.133.30",62889,"172.16.139.250",5440,10,1022,19848,0,0,10,1022,0,0,259.018221,0.0054850000000215005,1490610,0
"172.16.133.25",63693,"172.16.139.250",5440,10,1022,19849,0,0,10,1022,0,0,259.023861,0.007662999999979547,1066945,0
"172.16.133.96",53439,"216.39.54.36",80,23,14365,19850,0,0,10,1278,13,13087,259.032325,10.316337999999973,991,10148
"172.16.133.96",53440,"216.39.54.36",80,21,12346,19851,0,0,10,1278,11,11068,259.033035,10.318683000000021,990,8580
"172.16.133.96",53441,"216.39.54.36",80,14,8052,19852,0,0,6,708,8,7344,259.033037,10.211862999999994,554,5753
"172.16.133.96",53442,"216.39.54.36",80,14,8309,19853,0,0,6,708,8,7601,259.033537,10.211781999999971,554,5954
"172.16.133.34",50683,"172.16.139.250",5440,10,1022,19854,0,0,10,1022,0,0,259.033826,0.023210000000005948,352261,0
"172.16.133.97",59594,"172.16.139.250",5440,10,1022,19855,0,0,10,1022,0,0,259.043226,0.018032000000005155,453416,0
"172.16.133.63",54192,"78.108.119.250",443,6,366,19856,0,0,4,246,2,120,259.08263,0.2570309999999836,7656,3734
"172.16.133.96",53443,"216.39.54.36",80,15,7733,19857,0,0,7,768,8,6965,259.093259,10.199675000000013,602,5462
"172.16.133.96",53444,"216.39.54.36",80,24,15653,19858,0,0,11,1008,13,14645,259.093734,10.20400699999999,790,11481
"172.16.133.11",55379,"172.16.139.250",5440,12,1136,19859,0,0,12,1136,0,0,259.111905,0.0051630000000386644,1760216,0
"172.16.133.33",58102,"172.16.139.250",5440,10,1022,19860,0,0,10,1022,0,0,259.113646,0.01782700000001114,458630,0
"172.16.133.68",61001,"172.16.139.250",5440,10,1022,19861,0,0,10,1022,0,0,259.14908,0.005612999999982549,1456618,0
"172.16.133.12",60000,"172.16.139.250",5440,12,1142,19862,0,0,12,1142,0,0,259.162195,0.006236999999998716,1464806,0
"172.16.133.63",54193,"172.16.139.250",5440,10,1022,19863,0,0,10,1022,0,0,259.174973,0.0056960000000003674,1435393,0
"172.16.133.66",54422,"172.16.139.250",5440,10,1022,19864,0,0,10,1022,0,0,259.186429,0.005460000000027776,1497435,0
"172.16.133.82",61648,"172.16.139.250",5440,10,1022,19865,0,0,10,1022,0,0,259.201439,0.007087000000012722,1153661,0
"172.16.133.37",60869,"172.16.139.250",5440,12,1142,19866,0,0,12,1142,0,0,259.212792,0.01536700000002611,594520,0
"172.16.133.78",59460,"172.16.139.250",5440,12,1142,19867,0,0,12,1142,0,0,259.369797,0.006366000000014083,1435124,0
"172.16.133.67",56213,"172.16.139.250",5440,10,1022,19868,0,0,10,1022,0,0,259.425662,0.01466800000002877,557403,0
"172.16.133.56",61659,"172.16.139.250",5440,10,1022,19869,0,0,10,1022,0,0,259.448571,0.004909999999995307,"",""
"172.16.133.41",53359,"172.16.139.250",5440,12,1142,19870,0,0,12,1142,0,0,259.503104,0.006260999999994965,1459191,0
"172.16.133.43",57982,"172.16.139.250",5440,10,1022,19871,0,0,10,1022,0,0,259.571267,0.01467000000002372,557327,0
"172.16.133.13",53270,"172.16.139.250",5440,10,1022,19872,0,0,10,1022,0,0,259.592438,0.00542200000001003,1507930,0
"172.16.133.85",52492,"172.16.139.250",5440,10,1022,19873,0,0,10,1022,0,0,259.598724,0.01455199999998058,561847,0
"172.16.133.42",57326,"172.16.139.250",5440,12,1142,19874,0,0,12,1142,0,0,259.618716,0.015447999999992135,591403,0
"172.16.133.20",62674,"172.16.139.250",5440,10,1022,19875,0,0,10,1022,0,0,259.642643,0.004951000000005479,"",""
"172.16.133.28",49387,"172.16.139.250",5440,10,1022,19876,0,0,10,1022,0,0,259.671902,0.005284000000017386,1547312,0
"172.16.133.99",56267,"172.16.139.250",5440,12,1142,19877,0,0,12,1142,0,0,259.699826,0.014795000000049185,617505,0
"172.16.133.75",51180,"172.16.139.250",5440,12,1142,19878,0,0,12,1142,0,0,259.704424,0.0061519999999859465,1485045,0
"172.16.133.87",60470,"172.16.139.250",5440,10,1022,19879,0,0,10,1022,0,0,259.725221,0.005533000000013999,1477679,0
"172.16.133.35",50175,"172.16.139.250",5440,12,1142,19880,0,0,12,1142,0,0,259.728516,0.013957000000004882,654581,0
"172.16.133.116",54013,"172.16.139.250",5440,10,1022,19881,0,0,10,1022,0,0,259.739837,0.0059259999999881074,1379682,0
"172.16.133.116",54014,"172.16.139.250",5440,10,1022,19882,0,0,10,1022,0,0,259.746869,0.006009000000005926,1360625,0
"172.16.133.116",54015,"172.16.139.250",5440,10,1022,19883,0,0,10,1022,0,0,259.754412,0.006999000000007527,1168166,0
"172.16.133.84",59015,"172.16.139.250",5440,10,1022,19884,0,0,10,1022,0,0,259.758868,0.014995999999996457,545212,0
"172.16.133.49",55996,"172.16.139.250",5440,10,1022,19885,0,0,10,1022,0,0,259.83311,0.006175000000041564,1324048,0
"172.16.133.95",57204,"172.16.139.250",5440,12,1142,19886,0,0,12,1142,0,0,259.877588,0.015809999999987667,577862,0
"172.16.133.92",57883,"172.16.139.250",5440,10,1022,19887,0,0,10,1022,0,0,259.902413,0.01538999999996804,531254,0
"172.16.133.29",61217,"172.16.139.250",5440,10,1022,19888,0,0,10,1022,0,0,259.920074,0.005335999999999785,1532233,0
"172.16.133.44",65044,"172.16.139.250",5440,12,1142,19889,0,0,12,1142,0,0,259.926585,0.00603000000000975,1515091,0
"172.16.133.207",56151,"172.16.139.250",5440,10,1022,19890,0,0,10,1022,0,0,259.951402,0.004913000000044576,"",""
"172.16.133.83",57289,"172.16.139.250",5440,10,1022,19891,0,0,10,1022,0,0,259.961339,0.00472700000000259,"",""
"172.16.133.93",61073,"172.16.139.250",5440,12,1142,19892,0,0,12,1142,0,0,259.977994,0.014761999999961972,618886,0
"172.16.133.11",55380,"172.16.139.250",5440,10,1022,19893,0,0,10,1022,0,0,259.993313,0.01591600000000426,513696,0
"172.16.133.55",57836,"172.16.139.250",5440,12,1142,19894,0,0,12,1142,0,0,259.999481,0.006310999999982414,1447631,0
"172.16.133.73",60897,"172.16.139.250",5440,10,1022,19895,0,0,10,1022,0,0,260.0203,0.0050539999999728025,1617728,0
"172.16.133.53",54319,"172.16.139.250",5440,10,1022,19896,0,0,10,1022,0,0,260.024606,0.00541499999997086,1509879,0
"172.16.133.21",53393,"172.16.139.250",5440,10,1022,19897,0,0,10,1022,0,0,260.027027,0.015257000000019616,535885,0
"172.16.133.30",62890,"172.16.139.250",5440,10,1022,19898,0,0,10,1022,0,0,260.03243,0.006096000000013646,1341207,0
"172.16.133.25",63694,"172.16.139.250",5440,10,1022,19899,0,0,10,1022,0,0,260.03822,0.007555999999965479,1082053,0
"172.16.133.34",50684,"172.16.139.250",5440,10,1022,19900,0,0,10,1022,0,0,260.047879,0.011935999999991509,684986,0
"172.16.133.97",59595,"172.16.139.250",5440,10,1022,19901,0,0,10,1022,0,0,260.058621,0.015095999999971355,541600,0
"172.16.133.95",57205,"184.168.192.63",80,126,128799,19902,0,0,36,3831,90,124968,260.090084,7.140293999999983,4292,140014
"172.16.133.33",58103,"172.16.139.250",5440,10,1022,19903,0,0,10,1022,0,0,260.131022,0.005456000000037875,1498533,0
"172.16.133.68",61002,"172.16.139.250",5440,12,1142,19904,0,0,12,1142,0,0,260.164095,0.006202000000030239,1473073,0
"172.16.133.12",60001,"172.16.139.250",5440,12,1142,19905,0,0,12,1142,0,0,260.176266,0.0062399999999911415,1464102,0
"172.16.133.83",57290,"78.108.117.250",443,6,366,19906,0,0,4,246,2,120,260.18488,0.20064299999995683,9808,4784
"172.16.133.83",57291,"202.173.25.200",443,6,366,19907,0,0,4,246,2,120,260.184881,0.5306779999999662,3708,1809
"172.16.133.83",57292,"216.219.117.244",443,6,366,19908,0,0,4,246,2,120,260.185404,0.21157999999996946,9301,4537
"172.16.133.83",57293,"67.217.95.254",443,6,366,19909,0,0,4,246,2,120,260.185757,0.05224699999996574,37667,18374
"172.16.133.63",54194,"172.16.139.250",5440,10,1022,19910,0,0,10,1022,0,0,260.188272,0.005386000000044078,1518009,0
"172.16.133.66",54423,"172.16.139.250",5440,10,1022,19911,0,0,10,1022,0,0,260.20088,0.005411000000037802,1510996,0
"172.16.133.82",61649,"172.16.139.250",5440,10,1022,19912,0,0,10,1022,0,0,260.215286,0.015770000000031814,518452,0
"172.16.133.37",60870,"172.16.139.250",5440,10,1022,19913,0,0,10,1022,0,0,260.22804,0.006861999999955515,1191489,0
"172.16.133.68",61003,"98.142.99.171",80,36,34699,19914,0,0,10,1236,26,33463,260.255072,0.44178800000003093,22381,605955
"172.16.133.95",57206,"184.168.192.63",80,50,46652,19915,0,0,16,1753,34,44899,260.324538,6.906269000000009,2030,52009
"172.16.133.95",57207,"184.168.192.63",80,87,93516,19916,0,0,22,2114,65,91402,260.324879,6.905722999999966,2448,105885
"172.16.133.78",59461,"172.16.139.250",5440,12,1142,19917,0,0,12,1142,0,0,260.383068,0.016224000000022443,563116,0
"172.16.133.95",57208,"184.168.192.63",80,114,115821,19918,0,0,34,3142,80,112679,260.415982,6.815032000000031,3688,132271
"172.16.133.95",57209,"184.168.192.63",80,20,9634,19919,0,0,10,1390,10,8244,260.416546,6.814372999999989,1631,9678
"172.16.133.95",57210,"184.168.192.63",80,136,147425,19920,0,0,35,3258,101,144167,260.416992,6.813503000000026,3825,169272
"172.16.133.67",56214,"172.16.139.250",5440,10,1022,19921,0,0,10,1022,0,0,260.439457,0.014906999999993786,548467,0
"172.16.133.56",61660,"172.16.139.250",5440,12,1142,19922,0,0,12,1142,0,0,260.460725,0.004975999999999203,"",""
"172.16.133.114",55363,"173.67.229.116",20305,3,194,19923,0,0,3,194,0,0,260.471057,9.022249000000045,172,0
"172.16.133.41",53360,"172.16.139.250",5440,10,1022,19924,0,0,10,1022,0,0,260.516672,0.0054679999999507345,1495245,0
"172.16.133.43",57983,"172.16.139.250",5440,10,1022,19925,0,0,10,1022,0,0,260.585847,0.005358999999998559,1525657,0
"172.16.133.13",53271,"172.16.139.250",5440,10,1022,19926,0,0,10,1022,0,0,260.606261,0.005527999999969779,1479015,0
"172.16.133.85",52493,"172.16.139.250",5440,10,1022,19927,0,0,10,1022,0,0,260.614468,0.014882999999997537,549351,0
"172.16.133.42",57327,"172.16.139.250",5440,12,1142,19928,0,0,12,1142,0,0,260.632824,0.012185999999985597,749712,0
"172.16.133.20",62675,"172.16.139.250",5440,12,1142,19929,0,0,12,1142,0,0,260.656389,0.004546000000004824,"",""
"172.16.133.28",49388,"172.16.139.250",5440,10,1022,19930,0,0,10,1022,0,0,260.684489,0.005490000000008877,1489253,0
"172.16.133.99",56268,"172.16.139.250",5440,10,1022,19931,0,0,10,1022,0,0,260.715642,0.004870999999980086,"",""
"172.16.133.75",51181,"172.16.139.250",5440,10,1022,19932,0,0,10,1022,0,0,260.718576,0.005865000000028431,1394032,0
"172.16.133.87",60471,"172.16.139.250",5440,10,1022,19933,0,0,10,1022,0,0,260.740793,0.005237000000022363,1561199,0
"172.16.133.35",50176,"172.16.139.250",5440,12,1142,19934,0,0,12,1142,0,0,260.742307,0.016544000000010328,552224,0
"172.16.133.116",54017,"172.16.139.250",5440,10,1022,19935,0,0,10,1022,0,0,260.755732,0.005769999999984066,1416984,0
"172.16.133.116",54018,"172.16.139.250",5440,10,1022,19936,0,0,10,1022,0,0,260.764417,0.00606500000003507,1348062,0
"172.16.133.116",54019,"172.16.139.250",5440,10,1022,19937,0,0,10,1022,0,0,260.771607,0.004818999999997686,"",""
"172.16.133.84",59016,"172.16.139.250",5440,12,1142,19938,0,0,12,1142,0,0,260.771721,0.009199999999964348,993043,0
"172.16.133.49",55997,"172.16.139.250",5440,12,1142,19939,0,0,12,1142,0,0,260.847295,0.016275000000007367,561351,0
"172.16.133.95",57211,"172.16.139.250",5440,10,1022,19940,0,0,10,1022,0,0,260.890303,0.015266999999994368,535534,0
"172.16.133.92",57884,"172.16.139.250",5440,10,1022,19941,0,0,10,1022,0,0,260.916432,0.005553000000020347,1472357,0
"172.16.133.83",57297,"96.43.146.22",443,7,815,19942,0,0,4,506,3,309,260.927109,0.183400000000006,22071,13478
"172.16.133.83",57298,"96.43.146.22",443,7,815,19943,0,0,4,506,3,309,260.927239,0.18316300000003594,22100,13496
"172.16.133.83",57299,"96.43.146.22",443,7,815,19944,0,0,4,506,3,309,260.927349,0.1818010000000072,22266,13597
"172.16.133.83",57300,"96.43.146.22",443,15,6621,19945,0,0,9,5624,6,997,260.929009,1.149628000000007,39136,6937
"172.16.133.29",61218,"172.16.139.250",5440,12,1142,19946,0,0,12,1142,0,0,260.935095,0.014743000000009943,619683,0
"172.16.133.44",65045,"172.16.139.250",5440,12,1142,19947,0,0,12,1142,0,0,260.94051,0.006330999999988762,1443057,0
"172.16.133.83",57301,"96.43.146.22",443,13,4165,19948,0,0,8,3482,5,683,260.954074,0.5916470000000231,47082,9235
"172.16.133.83",57302,"96.43.146.22",443,13,3856,19949,0,0,8,3139,5,717,260.954353,0.5193639999999959,48351,11044
"172.16.133.207",56152,"172.16.139.250",5440,12,1142,19950,0,0,12,1142,0,0,260.965636,0.005343999999979587,1709580,0
"172.16.133.83",57303,"172.16.139.250",5440,10,1022,19951,0,0,10,1022,0,0,260.976429,0.01495399999998881,546743,0
"172.16.133.93",61074,"172.16.139.250",5440,12,1142,19952,0,0,12,1142,0,0,260.989498,0.005752999999970143,1588041,0
"172.16.133.11",55381,"172.16.139.250",5440,10,1022,19953,0,0,10,1022,0,0,261.007256,0.005673999999999069,1440958,0
"172.16.133.55",57837,"172.16.139.250",5440,12,1142,19954,0,0,12,1142,0,0,261.012,0.01551000000000613,589039,0
"172.16.133.184",40810,"205.216.16.228",80,124,102030,19955,0,0,51,3166,73,98864,261.029715,0.7349529999999618,34462,1076139
"172.16.133.73",60898,"172.16.139.250",5440,12,1142,19956,0,0,12,1142,0,0,261.035198,0.0256350000000225,356387,0
"172.16.133.53",54320,"172.16.139.250",5440,10,1022,19957,0,0,10,1022,0,0,261.039078,0.0056209999999623506,1454545,0
"172.16.133.21",53394,"172.16.139.250",5440,10,1022,19958,0,0,10,1022,0,0,261.041184,0.007734000000027663,1057150,0
"172.16.133.30",62891,"172.16.139.250",5440,12,1142,19959,0,0,12,1142,0,0,261.045,0.0197369999999637,462886,0
"172.16.133.25",63695,"172.16.139.250",5440,10,1022,19960,0,0,10,1022,0,0,261.052146,0.015494999999987158,527654,0
"172.16.133.34",50685,"172.16.139.250",5440,10,1022,19961,0,0,10,1022,0,0,261.061964,0.01849800000002233,441993,0
"172.16.133.97",59596,"172.16.139.250",5440,10,1022,19962,0,0,10,1022,0,0,261.071049,0.005378000000007432,1520267,0
"172.16.133.33",58104,"172.16.139.250",5440,10,1022,19963,0,0,10,1022,0,0,261.140627,0.014762000000018816,553854,0
"172.16.133.68",61004,"172.16.139.250",5440,10,1022,19964,0,0,10,1022,0,0,261.178619,0.015317999999979293,533751,0
"172.16.133.12",60002,"172.16.139.250",5440,12,1142,19965,0,0,12,1142,0,0,261.190415,0.008040000000050895,1136318,0
"172.16.133.63",54195,"172.16.139.250",5440,10,1022,19966,0,0,10,1022,0,0,261.203525,0.005604000000005271,1458957,0
"172.16.133.66",54424,"172.16.139.250",5440,12,1142,19967,0,0,12,1142,0,0,261.214851,0.006104999999990923,1496478,0
"172.16.133.82",61650,"172.16.139.250",5440,10,1022,19968,0,0,10,1022,0,0,261.22835,0.0055540000000178225,1472092,0
"172.16.133.37",60874,"172.16.139.250",5440,10,1022,19969,0,0,10,1022,0,0,261.241984,0.005332000000009884,1533383,0
"172.16.133.78",59462,"172.16.139.250",5440,12,1142,19970,0,0,12,1142,0,0,261.397856,0.015476000000035128,590333,0
"172.16.133.67",56215,"172.16.139.250",5440,10,1022,19971,0,0,10,1022,0,0,261.452437,0.014856000000008862,550350,0
"172.16.133.56",61661,"172.16.139.250",5440,10,1022,19972,0,0,10,1022,0,0,261.476591,0.005043000000000575,1621257,0
"172.16.133.41",53361,"172.16.139.250",5440,12,1142,19973,0,0,12,1142,0,0,261.53447,0.006318000000021584,1446027,0
"172.16.133.43",57984,"172.16.139.250",5440,10,1022,19974,0,0,10,1022,0,0,261.599312,0.005525999999974829,1479551,0
"172.16.133.13",53272,"172.16.139.250",5440,10,1022,19975,0,0,10,1022,0,0,261.620294,0.006159000000025117,1327488,0
"172.16.133.20",62676,"74.125.226.78",80,23,9680,19976,0,0,14,7510,9,2170,261.625029,27.29767400000003,2200,635
"172.16.133.85",52494,"172.16.139.250",5440,10,1022,19977,0,0,10,1022,0,0,261.626871,0.005765999999994165,1417967,0
"172.16.133.20",62677,"173.194.41.79",80,7,1431,19978,0,0,4,1036,3,395,261.628715,0.3861299999999801,21464,8183
"172.16.133.42",57328,"172.16.139.250",5440,12,1142,19979,0,0,12,1142,0,0,261.666364,0.017140000000040345,533022,0
"172.16.133.20",62678,"172.16.139.250",5440,12,1142,19980,0,0,12,1142,0,0,261.669641,0.005499999999983629,1661090,0
"172.16.133.184",43799,"204.14.232.101",443,31,13386,19981,0,0,16,1681,15,11705,261.683812,0.15464500000001635,86960,605515
"172.16.133.28",49389,"172.16.139.250",5440,10,1022,19982,0,0,10,1022,0,0,261.698387,0.01460399999996298,559846,0
"172.16.133.99",56269,"172.16.139.250",5440,10,1022,19983,0,0,10,1022,0,0,261.726737,0.015432999999973163,529773,0
"172.16.133.75",51182,"172.16.139.250",5440,10,1022,19984,0,0,10,1022,0,0,261.732552,0.005453999999986081,1499083,0
"172.16.133.87",60472,"172.16.139.250",5440,10,1022,19985,0,0,10,1022,0,0,261.752947,0.021515000000022155,380013,0
"172.16.133.35",50177,"172.16.139.250",5440,12,1142,19986,0,0,12,1142,0,0,261.757333,0.011846999999988839,771165,0
"172.16.133.116",54020,"172.16.139.250",5440,10,1022,19987,0,0,10,1022,0,0,261.76292,0.007535000000018499,1085069,0
"172.16.133.28",49390,"167.8.226.13",80,8,1375,19988,0,0,5,911,3,464,261.763831,0.0766320000000178,95103,48439
"172.16.133.116",54021,"172.16.139.250",5440,10,1022,19989,0,0,10,1022,0,0,261.770988,0.0072460000000091895,1128346,0
"172.16.133.116",54022,"172.16.139.250",5440,10,1022,19990,0,0,10,1022,0,0,261.778617,0.013961999999992258,585589,0
"172.16.133.84",59017,"172.16.139.250",5440,10,1022,19991,0,0,10,1022,0,0,261.785432,0.014542000000005828,562233,0
"172.16.133.49",55998,"172.16.139.250",5440,10,1022,19992,0,0,10,1022,0,0,261.861297,0.005516999999997552,1481964,0
"172.16.133.95",57212,"172.16.139.250",5440,12,1142,19993,0,0,12,1142,0,0,261.90456,0.006681000000014592,1367459,0
"172.16.133.92",57885,"172.16.139.250",5440,10,1022,19994,0,0,10,1022,0,0,261.930139,0.016163000000005923,505846,0
"172.16.133.29",61219,"172.16.139.250",5440,10,1022,19995,0,0,10,1022,0,0,261.947573,0.005493999999998778,1488168,0
"172.16.133.44",65046,"172.16.139.250",5440,10,1022,19996,0,0,10,1022,0,0,261.954013,0.005296000000043932,1543806,0
"172.16.133.207",56153,"172.16.139.250",5440,12,1142,19997,0,0,12,1142,0,0,261.979715,0.006387000000017906,1430405,0
"172.16.133.83",57304,"172.16.139.250",5440,12,1142,19998,0,0,12,1142,0,0,261.990458,0.005107000000009521,1788917,0
"172.16.133.93",61075,"172.16.139.250",5440,10,1022,19999,0,0,10,1022,0,0,262.003272,0.014378000000021984,568646,0
"172.16.133.11",55382,"172.16.139.250",5440,10,1022,20000,0,0,10,1022,0,0,262.021507,0.015529000000015003,526498,0
"172.16.133.55",57838,"172.16.139.250",5440,12,1142,20001,0,0,12,1142,0,0,262.026981,0.015611000000035347,585228,0
"172.16.133.28",49391,"208.111.160.6",80,69,35308,20002,0,0,24,7313,45,27995,262.033184,12.346236999999974,4738,18139
"172.16.133.73",60899,"172.16.139.250",5440,10,1022,20003,0,0,10,1022,0,0,262.049178,0.0057419999999979154,1423894,0
"172.16.133.53",54321,"172.16.139.250",5440,10,1022,20004,0,0,10,1022,0,0,262.051624,0.007126999999968575,1147186,0
"172.16.133.21",53395,"172.16.139.250",5440,10,1022,20005,0,0,10,1022,0,0,262.055066,0.014744000000007418,554530,0
"172.16.133.30",62892,"172.16.139.250",5440,10,1022,20006,0,0,10,1022,0,0,262.058875,0.005239000000017313,1560603,0
"172.16.133.25",63696,"172.16.139.250",5440,10,1022,20007,0,0,10,1022,0,0,262.06532,0.008001000000035674,1021872,0
"172.16.133.34",50686,"172.16.139.250",5440,10,1022,20008,0,0,10,1022,0,0,262.075765,0.00513300000000072,1592830,0
"172.16.133.97",59597,"172.16.139.250",5440,10,1022,20009,0,0,10,1022,0,0,262.085353,0.0055080000000202745,1484386,0
"172.16.133.41",53364,"172.16.139.250",5440,6,780,20010,0,0,6,780,0,0,262.104577,0.0007209999999986394,"",""
"172.16.133.41",53365,"96.43.146.22",443,10,3533,20011,0,0,6,893,4,2640,262.147991,0.349913000000015,20416,60357
"172.16.133.41",53366,"96.43.146.22",443,10,3535,20012,0,0,6,895,4,2640,262.149686,0.34821700000003375,20561,60651
"172.16.133.41",53367,"96.43.146.22",443,19,9062,20013,0,0,10,5834,9,3228,262.149799,0.4289380000000165,108808,60204
"172.16.133.41",53368,"96.43.146.22",443,10,3535,20014,0,0,6,895,4,2640,262.149912,0.34798900000004096,20575,60691
"172.16.133.33",58105,"172.16.139.250",5440,10,1022,20015,0,0,10,1022,0,0,262.154638,0.005549000000030446,1473418,0
"172.16.133.68",61005,"172.16.139.250",5440,10,1022,20016,0,0,10,1022,0,0,262.191339,0.005809999999996762,1407228,0
"172.16.133.12",60003,"172.16.139.250",5440,10,1022,20017,0,0,10,1022,0,0,262.204231,0.0054620000000227265,1496887,0
"172.16.133.63",54197,"172.16.139.250",5440,10,1022,20018,0,0,10,1022,0,0,262.216442,0.00531400000005533,1538577,0
"172.16.133.83",57305,"67.217.95.254",443,6,366,20019,0,0,4,246,2,120,262.218094,0.03689400000001797,53342,26020
"172.16.133.66",54425,"172.16.139.250",5440,10,1022,20020,0,0,10,1022,0,0,262.227505,0.005415999999968335,1509601,0
"172.16.133.82",61651,"172.16.139.250",5440,10,1022,20021,0,0,10,1022,0,0,262.241738,0.005670000000009168,1441975,0
"172.16.133.37",60875,"172.16.139.250",5440,10,1022,20022,0,0,10,1022,0,0,262.256452,0.0056669999999598986,1442738,0
"172.16.133.83",57306,"78.108.117.250",443,6,366,20023,0,0,4,246,2,120,262.289914,0.2208119999999667,8912,4347
"172.16.133.83",57307,"216.219.117.244",443,6,366,20024,0,0,4,246,2,120,262.296976,0.2151230000000055,9148,4462
"172.16.133.78",59463,"208.95.51.166",47857,3,194,20025,0,0,3,194,0,0,262.378298,9.001931000000013,172,0
"172.16.133.78",59464,"134.181.229.92",52004,45,5910,20026,0,0,22,2523,23,3387,262.378467,32.97188399999999,612,821
"172.16.133.78",59465,"68.185.61.10",56137,6,374,20027,0,0,3,194,3,180,262.378629,1.4287239999999883,1086,1007
"172.16.133.78",59466,"69.146.143.158",58049,43,7808,20028,0,0,20,3670,23,4138,262.378785,33.422999000000004,878,990
"172.16.133.78",59467,"38.122.145.250",32998,6,374,20029,0,0,3,194,3,180,262.378977,1.0987599999999702,1412,1310
"172.16.133.78",59468,"172.16.139.250",5440,12,1142,20030,0,0,12,1142,0,0,262.410718,0.00989100000003873,923667,0
"172.16.133.83",57308,"202.173.25.200",443,6,366,20031,0,0,4,246,2,120,262.456974,0.527341999999976,3731,1820
"172.16.133.67",56216,"172.16.139.250",5440,10,1022,20032,0,0,10,1022,0,0,262.467645,0.015467000000001008,528609,0
"172.16.133.56",61662,"172.16.139.250",5440,10,1022,20033,0,0,10,1022,0,0,262.489269,0.004790000000014061,"",""
"172.16.133.41",53369,"172.16.139.250",5440,12,1142,20034,0,0,12,1142,0,0,262.543872,0.006771999999955369,1349084,0
"172.16.133.43",57985,"172.16.139.250",5440,10,1022,20035,0,0,10,1022,0,0,262.613765,0.005547999999976128,1473684,0
"172.16.133.13",53273,"172.16.139.250",5440,10,1022,20036,0,0,10,1022,0,0,262.635305,0.005770999999981541,1416738,0
"172.16.133.85",52495,"172.16.139.250",5440,10,1022,20037,0,0,10,1022,0,0,262.639747,0.015532000000007429,526397,0
"172.16.133.113",55751,"172.16.139.250",135,8,492,20038,0,0,8,492,0,0,262.654538,0.01731399999999894,227330,0
"172.16.133.42",57329,"172.16.139.250",5440,12,1142,20039,0,0,12,1142,0,0,262.656417,0.023005000000011933,397131,0
"172.16.133.113",55752,"172.16.139.250",5462,10,696,20040,0,0,10,696,0,0,262.681132,0.5147340000000327,10817,0
"172.16.133.20",62679,"172.16.139.250",5440,12,1142,20041,0,0,12,1142,0,0,262.685668,0.0049659999999676074,"",""
"172.16.133.78",59469,"66.103.118.222",36468,6,374,20042,0,0,3,194,3,180,262.698752,1.2627899999999954,1229,1140
"172.16.133.28",49392,"172.16.139.250",5440,10,1022,20043,0,0,10,1022,0,0,262.714127,0.01490200000000641,548651,0
"172.16.133.99",56270,"172.16.139.250",5440,12,1142,20044,0,0,12,1142,0,0,262.74083,0.015172000000006847,602161,0
"172.16.133.75",51183,"172.16.139.250",5440,10,1022,20045,0,0,10,1022,0,0,262.746553,0.0053449999999770625,1529653,0
"172.16.133.87",60474,"172.16.139.250",5440,10,1022,20046,0,0,10,1022,0,0,262.768029,0.02040199999999004,400745,0
"172.16.133.35",50178,"172.16.139.250",5440,12,1142,20047,0,0,12,1142,0,0,262.770485,0.019874000000015712,459696,0
"172.16.133.116",54023,"172.16.139.250",5440,10,1022,20048,0,0,10,1022,0,0,262.776021,0.008804999999995289,928563,0
"172.16.133.116",54024,"172.16.139.250",5440,10,1022,20049,0,0,10,1022,0,0,262.78542,0.015219999999999345,537187,0
"172.16.133.84",59018,"172.16.139.250",5440,10,1022,20050,0,0,10,1022,0,0,262.799593,0.0055370000000039,1476611,0
"172.16.133.116",54025,"172.16.139.250",5440,10,1022,20051,0,0,10,1022,0,0,262.801552,0.0073419999999941865,1113593,0
"172.16.133.49",55999,"172.16.139.250",5440,12,1142,20052,0,0,12,1142,0,0,262.875074,0.006975000000011278,1309820,0
"172.16.128.233",50951,"172.16.133.233",22,171,20178,20053,0,0,52,4316,119,15862,262.893301,11.116606999999988,3105,11414
"172.16.133.95",57213,"172.16.139.250",5440,10,1022,20054,0,0,10,1022,0,0,262.918969,0.005276999999978216,1549365,0
"172.16.133.92",57886,"172.16.139.250",5440,10,1022,20055,0,0,10,1022,0,0,262.943282,0.014607000000012249,559731,0
"172.16.133.29",61220,"172.16.139.250",5440,12,1142,20056,0,0,12,1142,0,0,262.962951,0.006368000000009033,1434673,0
"172.16.133.44",65047,"172.16.139.250",5440,10,1022,20057,0,0,10,1022,0,0,262.968117,0.00538899999997966,1517164,0
"172.16.133.28",49393,"208.111.160.6",80,48,33162,20058,0,0,16,6072,32,27090,262.969073,11.403085000000033,4259,19005
"172.16.133.28",49394,"208.111.160.6",80,42,20186,20059,0,0,16,6096,26,14090,262.969673,11.383623999999998,4284,9901
"172.16.133.28",49395,"208.111.160.6",80,52,36154,20060,0,0,18,6924,34,29230,262.969986,11.397445000000005,4860,20516
"172.16.133.28",49396,"208.111.160.6",80,40,26403,20061,0,0,14,5946,26,20457,262.98409,11.388067000000035,4177,14370
"172.16.133.28",49397,"208.111.160.6",80,41,23586,20062,0,0,15,6753,26,16833,262.984266,11.427257999999995,4727,11784
"172.16.133.207",56154,"172.16.139.250",5440,12,1142,20063,0,0,12,1142,0,0,262.993608,0.018323000000009415,498608,0
"172.16.133.83",57309,"172.16.139.250",5440,12,1142,20064,0,0,12,1142,0,0,263.003269,0.004887999999994008,"",""
"172.16.133.97",59598,"180.153.30.250",443,6,366,20065,0,0,4,246,2,120,263.007818,0.6775949999999966,2904,1416
"172.16.133.93",61076,"172.16.139.250",5440,10,1022,20066,0,0,10,1022,0,0,263.017283,0.004706999999996242,"",""
"172.16.133.28",49398,"8.27.243.253",80,22,14439,20067,0,0,9,2084,13,12355,263.020711,16.610937999999976,1003,5950
"172.16.133.11",55383,"172.16.139.250",5440,10,1022,20068,0,0,10,1022,0,0,263.036439,0.020735000000001946,394309,0
"172.16.133.55",57839,"172.16.139.250",5440,12,1142,20069,0,0,12,1142,0,0,263.040922,0.005898000000001957,1548999,0
"172.16.133.73",60900,"172.16.139.250",5440,10,1022,20070,0,0,10,1022,0,0,263.061568,0.0062249999999721695,1313413,0
"172.16.133.53",54322,"172.16.139.250",5440,10,1022,20071,0,0,10,1022,0,0,263.065443,0.0066119999999614265,1236539,0
"172.16.133.28",49399,"167.8.226.9",80,6,372,20072,0,0,4,246,2,126,263.066821,16.56580500000001,118,60
"172.16.133.28",49400,"167.8.226.9",80,6,372,20073,0,0,4,246,2,126,263.066975,16.565572999999972,118,60
"172.16.133.28",49401,"167.8.226.9",80,6,372,20074,0,0,4,246,2,126,263.067097,16.56552700000003,118,60
"172.16.133.28",49402,"216.52.242.80",80,6,372,20075,0,0,4,246,2,126,263.067857,16.632653000000005,118,60
"172.16.133.21",53396,"172.16.139.250",5440,10,1022,20076,0,0,10,1022,0,0,263.068619,0.007508999999970456,1088826,0
"172.16.133.30",62893,"172.16.139.250",5440,10,1022,20077,0,0,10,1022,0,0,263.073217,0.007038000000022748,1161693,0
"172.16.133.25",63697,"172.16.139.250",5440,10,1022,20078,0,0,10,1022,0,0,263.079504,0.005235000000027412,1561795,0
"172.16.133.34",50687,"172.16.139.250",5440,10,1022,20079,0,0,10,1022,0,0,263.089794,0.005182999999988169,1577464,0
"172.16.133.97",59599,"172.16.139.250",5440,10,1022,20080,0,0,10,1022,0,0,263.100305,0.005898000000001957,1386232,0
"172.16.133.33",58106,"172.16.139.250",5440,10,1022,20081,0,0,10,1022,0,0,263.16882,0.006385000000022956,1280501,0
"172.16.133.28",49403,"63.97.94.126",80,7,428,20082,0,0,4,246,3,182,263.18505,16.491552000000013,119,88
"172.16.133.28",49404,"63.97.94.126",80,7,428,20083,0,0,4,246,3,182,263.185182,16.491370000000018,119,88
"172.16.133.28",49405,"63.97.94.126",80,7,428,20084,0,0,4,246,3,182,263.1853,16.495370000000037,119,88
"172.16.133.28",49406,"63.97.94.126",80,7,428,20085,0,0,4,246,3,182,263.185406,16.495317999999997,119,88
"172.16.133.28",49407,"63.97.94.126",80,7,428,20086,0,0,4,246,3,182,263.185517,16.49509999999998,119,88
"172.16.133.28",49408,"63.97.94.126",80,7,428,20087,0,0,4,246,3,182,263.185659,16.490894000000026,119,88
"172.16.133.28",49409,"63.97.94.126",80,7,428,20088,0,0,4,246,3,182,263.185822,16.494794000000013,119,88
"172.16.133.28",49410,"63.97.94.126",80,7,428,20089,0,0,4,246,3,182,263.185941,16.490612999999996,119,88
"172.16.133.28",49411,"23.45.65.67",80,6,372,20090,0,0,4,246,2,126,263.186272,16.468751000000054,119,61
"172.16.133.28",49412,"167.8.226.13",80,6,372,20091,0,0,4,246,2,126,263.186448,16.447868000000028,119,61
"172.16.133.28",49413,"167.8.226.13",80,6,372,20092,0,0,4,246,2,126,263.186547,16.44777099999999,119,61
"172.16.133.28",49414,"167.8.226.13",80,6,372,20093,0,0,4,246,2,126,263.18667,16.44771300000002,119,61
"172.16.133.68",61007,"172.16.139.250",5440,10,1022,20094,0,0,10,1022,0,0,263.205116,0.006254000000012638,1307323,0
"172.16.133.12",60004,"172.16.139.250",5440,10,1022,20095,0,0,10,1022,0,0,263.218043,0.005567999999982476,1468390,0
"172.16.133.28",49415,"208.47.254.32",80,6,372,20096,0,0,4,246,2,126,263.218655,16.410117000000014,119,61
"172.16.133.28",49416,"208.47.254.32",80,6,372,20097,0,0,4,246,2,126,263.21878,16.410044000000028,119,61
"172.16.133.28",49417,"208.47.254.32",80,6,372,20098,0,0,4,246,2,126,263.218894,16.40828700000003,119,61
"172.16.133.28",49418,"23.67.242.74",80,6,372,20099,0,0,4,246,2,126,263.225951,16.40375899999998,119,61
"172.16.133.28",49419,"23.67.242.74",80,6,372,20100,0,0,4,246,2,126,263.226071,16.402811999999983,119,61
"172.16.133.28",49420,"23.67.242.74",80,7,432,20101,0,0,4,246,3,186,263.226181,16.403526999999997,119,90
"172.16.133.63",54198,"172.16.139.250",5440,10,1022,20102,0,0,10,1022,0,0,263.231223,0.005448999999998705,1500458,0
"172.16.133.66",54426,"172.16.139.250",5440,10,1022,20103,0,0,10,1022,0,0,263.240677,0.005357000000003609,1526227,0
"172.16.133.82",61652,"172.16.139.250",5440,12,1142,20104,0,0,12,1142,0,0,263.256103,0.00638400000002548,1431077,0
"172.16.133.37",60876,"172.16.139.250",5440,10,1022,20105,0,0,10,1022,0,0,263.269044,0.01464099999998325,558431,0
"172.16.133.95",57214,"157.56.240.137",443,6,374,20106,0,0,3,194,3,180,263.274135,1.062326999999982,1460,1355
"172.16.133.78",59470,"172.16.139.250",5440,12,1142,20107,0,0,12,1142,0,0,263.426268,0.006876000000033855,1328679,0
"172.16.133.67",56217,"172.16.139.250",5440,12,1142,20108,0,0,12,1142,0,0,263.479544,0.006011000000000877,1519880,0
"172.16.133.56",61663,"172.16.139.250",5440,10,1022,20109,0,0,10,1022,0,0,263.503046,0.004853000000025531,"",""
"172.16.133.41",53370,"172.16.139.250",5440,10,1022,20110,0,0,10,1022,0,0,263.557959,0.005399000000011256,1514354,0
"172.16.133.43",57986,"172.16.139.250",5440,12,1142,20111,0,0,12,1142,0,0,263.627688,0.016324999999994816,559632,0
"172.16.133.13",53274,"172.16.139.250",5440,10,1022,20112,0,0,10,1022,0,0,263.650169,0.005481999999972231,1491426,0
"172.16.133.85",52496,"172.16.139.250",5440,10,1022,20113,0,0,10,1022,0,0,263.654777,0.005502999999976055,1485735,0
"172.16.133.42",57330,"172.16.139.250",5440,12,1142,20114,0,0,12,1142,0,0,263.675762,0.023024999999961437,396786,0
"172.16.133.20",62680,"172.16.139.250",5440,12,1142,20115,0,0,12,1142,0,0,263.699101,0.004848000000038155,"",""
"172.16.133.96",53446,"98.139.183.24",80,12,2017,20116,0,0,7,1477,5,540,263.719563,0.1307909999999879,90342,33029
"172.16.133.28",49421,"172.16.139.250",5440,10,1022,20117,0,0,10,1022,0,0,263.726995,0.01521900000000187,537223,0
"172.16.133.99",56271,"172.16.139.250",5440,10,1022,20118,0,0,10,1022,0,0,263.755096,0.015572000000020125,525044,0
"172.16.133.75",51184,"172.16.139.250",5440,10,1022,20119,0,0,10,1022,0,0,263.761472,0.005583999999998923,1464183,0
"172.16.133.28",49422,"138.108.6.20",80,8,2289,20120,0,0,4,1631,4,658,263.778926,11.590428999999972,1125,454
"172.16.133.87",60475,"172.16.139.250",5440,10,1022,20121,0,0,10,1022,0,0,263.781574,0.01777500000002874,459971,0
"172.16.133.35",50179,"172.16.139.250",5440,12,1142,20122,0,0,12,1142,0,0,263.783855,0.00904800000000705,1009725,0
"172.16.133.28",49423,"64.94.107.62",80,10,2386,20123,0,0,6,1863,4,523,263.787149,0.07643000000001621,195001,54742
"172.16.133.116",54026,"172.16.139.250",5440,10,1022,20124,0,0,10,1022,0,0,263.790979,0.014641999999980726,558393,0
"172.16.133.116",54027,"172.16.139.250",5440,10,1022,20125,0,0,10,1022,0,0,263.806232,0.005255999999974392,1555555,0
"172.16.133.116",54028,"172.16.139.250",5440,10,1022,20126,0,0,10,1022,0,0,263.812402,0.00512599999996155,1595005,0
"172.16.133.84",59020,"172.16.139.250",5440,10,1022,20127,0,0,10,1022,0,0,263.813455,0.014643000000035045,558355,0
"172.16.133.30",62894,"172.16.139.250",5440,6,780,20128,0,0,6,780,0,0,263.854851,0.011311999999975342,551626,0
"172.16.133.49",56000,"172.16.139.250",5440,12,1142,20129,0,0,12,1142,0,0,263.889193,0.015631000000041695,584479,0
"172.16.133.95",57215,"172.16.139.250",5440,10,1022,20130,0,0,10,1022,0,0,263.933363,0.005151000000012118,1587264,0
"172.16.133.92",57887,"172.16.139.250",5440,10,1022,20131,0,0,10,1022,0,0,263.957368,0.014573000000041247,561037,0
"172.16.133.29",61221,"172.16.139.250",5440,10,1022,20132,0,0,10,1022,0,0,263.977097,0.015288999999995667,534763,0
"172.16.133.44",65048,"172.16.139.250",5440,10,1022,20133,0,0,10,1022,0,0,263.982421,0.015206000000034692,537682,0
"172.16.133.207",56155,"172.16.139.250",5440,12,1142,20134,0,0,12,1142,0,0,264.006839,0.015064999999992779,606438,0
"172.16.133.83",57310,"172.16.139.250",5440,12,1142,20135,0,0,12,1142,0,0,264.017441,0.008128999999996722,1123877,0
"172.16.133.93",61077,"172.16.139.250",5440,12,1142,20136,0,0,12,1142,0,0,264.031307,0.004955999999992855,"",""
"172.16.133.11",55384,"172.16.139.250",5440,10,1022,20137,0,0,10,1022,0,0,264.050259,0.030454000000020187,268470,0
"172.16.133.55",57840,"172.16.139.250",5440,10,1022,20138,0,0,10,1022,0,0,264.055208,0.02925500000003467,279473,0
"172.16.133.73",60901,"172.16.139.250",5440,10,1022,20139,0,0,10,1022,0,0,264.077359,0.010633999999981825,768854,0
"172.16.133.53",54323,"172.16.139.250",5440,10,1022,20140,0,0,10,1022,0,0,264.080893,0.0106049999999982,770957,0
"172.16.133.21",53397,"172.16.139.250",5440,12,1142,20141,0,0,12,1142,0,0,264.082262,0.02075400000001082,440204,0
"172.16.133.30",62895,"172.16.139.250",5440,10,1022,20142,0,0,10,1022,0,0,264.087447,0.024019000000009783,340397,0
"172.16.133.29",61222,"172.16.139.250",5440,6,780,20143,0,0,6,780,0,0,264.092507,0.001672999999982494,"",""
"172.16.133.44",65049,"172.16.139.250",5440,6,780,20144,0,0,6,780,0,0,264.092834,0.010742999999990843,580843,0
"172.16.133.53",54324,"172.16.139.250",5440,6,780,20145,0,0,6,780,0,0,264.093222,0.0014919999999847278,"",""
"172.16.133.25",63698,"172.16.139.250",5440,10,1022,20146,0,0,10,1022,0,0,264.093866,0.012653000000000247,646170,0
"172.16.133.46",64596,"172.16.139.250",5440,6,780,20147,0,0,6,780,0,0,264.095732,0.013169000000004871,473840,0
"172.16.133.34",50688,"172.16.139.250",5440,10,1022,20148,0,0,10,1022,0,0,264.103658,0.015354999999999563,532464,0
"172.16.133.33",58107,"172.16.139.250",5440,6,780,20149,0,0,6,780,0,0,264.1074,0.0016580000000203654,"",""
"172.16.133.43",57987,"172.16.139.250",5440,6,780,20150,0,0,6,780,0,0,264.108644,0.0011759999999867432,"",""
"172.16.133.97",59600,"172.16.139.250",5440,10,1022,20151,0,0,10,1022,0,0,264.113245,0.014516000000014628,563240,0
"172.16.133.132",60554,"96.43.146.176",443,32,13469,20152,0,0,17,1746,15,11723,264.127409,3.280885000000012,4257,28584
"172.16.133.95",57216,"96.43.146.22",443,13,3905,20153,0,0,8,3188,5,717,264.138768,0.4020569999999566,63433,14266
"172.16.133.34",50689,"172.16.139.250",5440,6,780,20154,0,0,6,780,0,0,264.167699,0.012142999999980475,513876,0
"172.16.133.45",61384,"172.16.139.250",5440,6,780,20155,0,0,6,780,0,0,264.169825,0.0013680000000135806,"",""
"172.16.133.33",58108,"172.16.139.250",5440,12,1142,20156,0,0,12,1142,0,0,264.182607,0.006498999999962507,1405754,0
"172.16.133.68",61008,"172.16.139.250",5440,12,1142,20157,0,0,12,1142,0,0,264.219429,0.006461000000001604,1414022,0
"172.16.133.12",60005,"172.16.139.250",5440,12,1142,20158,0,0,12,1142,0,0,264.232276,0.006260999999994965,1459191,0
"172.16.133.83",57311,"67.217.95.254",443,6,366,20159,0,0,4,246,2,120,264.234327,0.07693199999999933,25581,12478
"172.16.133.63",54199,"172.16.139.250",5440,10,1022,20160,0,0,10,1022,0,0,264.245446,0.005437999999969634,1503493,0
"172.16.133.66",54427,"172.16.139.250",5440,12,1142,20161,0,0,12,1142,0,0,264.254774,0.0061749999999847205,1479514,0
"172.16.133.82",61653,"172.16.139.250",5440,10,1022,20162,0,0,10,1022,0,0,264.269338,0.015778000000011616,518189,0
"172.16.133.37",60877,"172.16.139.250",5440,10,1022,20163,0,0,10,1022,0,0,264.283913,0.0056420000000230175,1449131,0
"172.16.133.95",57217,"157.56.244.217",80,8,884,20164,0,0,5,532,3,352,264.341161,0.13020699999998442,32686,21627
"172.16.133.55",57841,"72.32.20.63",80,9,1614,20165,0,0,5,1082,4,532,264.366795,0.2134009999999762,40562,19943
"172.16.133.83",57312,"78.108.117.250",443,6,366,20166,0,0,4,246,2,120,264.399133,0.18899799999996958,10412,5079
"172.16.133.83",57313,"216.219.117.244",443,6,366,20167,0,0,4,246,2,120,264.403985,0.2005420000000413,9813,4787
"172.16.133.78",59471,"172.16.139.250",5440,12,1142,20168,0,0,12,1142,0,0,264.439903,0.016215999999985797,563394,0
"172.16.133.95",57218,"157.56.232.182",443,23,9379,20169,0,0,10,2643,13,6736,264.444558,1.6493500000000267,12819,32672
"172.16.133.67",56218,"172.16.139.250",5440,10,1022,20170,0,0,10,1022,0,0,264.494361,0.005587999999988824,1463135,0
"172.16.133.56",61664,"172.16.139.250",5440,12,1142,20171,0,0,12,1142,0,0,264.518301,0.00489599999997381,"",""
"172.16.133.41",53371,"172.16.139.250",5440,12,1142,20172,0,0,12,1142,0,0,264.572108,0.00626199999999244,1458958,0
"172.16.133.43",57988,"172.16.139.250",5440,12,1142,20173,0,0,12,1142,0,0,264.641337,0.006480999999951109,1409659,0
"172.16.133.13",53275,"172.16.139.250",5440,10,1022,20174,0,0,10,1022,0,0,264.663308,0.005553000000020347,1472357,0
"172.16.133.85",52497,"172.16.139.250",5440,10,1022,20175,0,0,10,1022,0,0,264.66744,0.015177999999991698,538674,0
"172.16.133.42",57331,"172.16.139.250",5440,12,1142,20176,0,0,12,1142,0,0,264.692844,0.008150000000000546,1120981,0
"172.16.133.20",62681,"172.16.139.250",5440,12,1142,20177,0,0,12,1142,0,0,264.713052,0.015358999999989464,594830,0
"172.16.133.83",57314,"202.173.25.200",443,6,366,20178,0,0,4,246,2,120,264.72336,0.5293459999999754,3717,1813
"172.16.133.28",49424,"172.16.139.250",5440,10,1022,20179,0,0,10,1022,0,0,264.740643,0.016063000000031025,508995,0
"172.16.133.99",56272,"172.16.139.250",5440,12,1142,20180,0,0,12,1142,0,0,264.768796,0.016415999999992437,556530,0
"172.16.133.75",51185,"172.16.139.250",5440,12,1142,20181,0,0,12,1142,0,0,264.775462,0.006448999999975058,1416653,0
"172.16.133.87",60476,"172.16.139.250",5440,12,1142,20182,0,0,12,1142,0,0,264.795719,0.016155999999966753,565486,0
"172.16.133.35",50180,"172.16.139.250",5440,12,1142,20183,0,0,12,1142,0,0,264.797372,0.011952000000007956,764390,0
"172.16.133.116",54029,"172.16.139.250",5440,12,1142,20184,0,0,12,1142,0,0,264.805938,0.01542299999999841,592362,0
"172.16.133.116",54030,"172.16.139.250",5440,10,1022,20185,0,0,10,1022,0,0,264.821896,0.005453000000045449,1499358,0
"172.16.133.84",59021,"172.16.139.250",5440,12,1142,20186,0,0,12,1142,0,0,264.827888,0.009812000000010812,931104,0
"172.16.133.116",54031,"172.16.139.250",5440,10,1022,20187,0,0,10,1022,0,0,264.82789,0.005533999999954631,1477412,0
"172.16.133.49",56001,"172.16.139.250",5440,10,1022,20188,0,0,10,1022,0,0,264.90363,0.005680999999981395,1439183,0
"172.16.133.95",57219,"172.16.139.250",5440,12,1142,20189,0,0,12,1142,0,0,264.947742,0.006195999999988544,1474499,0
"172.16.133.92",57888,"172.16.139.250",5440,12,1142,20190,0,0,12,1142,0,0,264.972116,0.015555999999946835,587297,0
"172.16.133.29",61223,"172.16.139.250",5440,10,1022,20191,0,0,10,1022,0,0,264.994313,0.013819000000012238,591649,0
"172.16.133.44",65050,"172.16.139.250",5440,12,1142,20192,0,0,12,1142,0,0,264.996109,0.006165000000009968,1481914,0
"172.16.133.207",56156,"172.16.139.250",5440,12,1142,20193,0,0,12,1142,0,0,265.020785,0.014507000000037351,629764,0
"172.16.133.83",57315,"172.16.139.250",5440,12,1142,20194,0,0,12,1142,0,0,265.03145,0.00765200000000732,1193936,0
"172.16.133.93",61078,"172.16.139.250",5440,12,1142,20195,0,0,12,1142,0,0,265.045339,0.015627999999992426,584591,0
"172.16.133.11",55385,"172.16.139.250",5440,10,1022,20196,0,0,10,1022,0,0,265.065792,0.005606999999997697,1458177,0
"172.16.133.55",57842,"172.16.139.250",5440,10,1022,20197,0,0,10,1022,0,0,265.069216,0.006137000000023818,1332247,0
"172.16.133.73",60902,"172.16.139.250",5440,10,1022,20198,0,0,10,1022,0,0,265.091112,0.015388999999970565,531288,0
"172.16.133.53",54325,"172.16.139.250",5440,10,1022,20199,0,0,10,1022,0,0,265.093612,0.02045900000001666,399628,0
"172.16.133.21",53398,"172.16.139.250",5440,12,1142,20200,0,0,12,1142,0,0,265.096097,0.0065230000000156,1400582,0
"172.16.133.30",62896,"172.16.139.250",5440,10,1022,20201,0,0,10,1022,0,0,265.101383,0.009318000000007487,877441,0
"172.16.133.25",63699,"172.16.139.250",5440,12,1142,20202,0,0,12,1142,0,0,265.10757,0.014792999999997392,617589,0
"172.16.133.34",50690,"172.16.139.250",5440,12,1142,20203,0,0,12,1142,0,0,265.117881,0.008258000000012089,1106321,0
"172.16.133.97",59601,"172.16.139.250",5440,12,1142,20204,0,0,12,1142,0,0,265.126986,0.005844000000024607,1563312,0
"172.16.133.60",62205,"172.16.139.250",5440,6,780,20205,0,0,6,780,0,0,265.183588,0.010338999999987664,603539,0
"172.16.133.207",56157,"172.16.139.250",5440,6,780,20206,0,0,6,780,0,0,265.183589,0.000795000000039181,"",""
"172.16.133.75",51186,"172.16.139.250",5440,6,780,20207,0,0,6,780,0,0,265.184264,0.010709000000019842,582687,0
"172.16.133.128",65094,"172.16.139.250",5440,6,780,20208,0,0,6,780,0,0,265.185227,0.0013450000000148066,"",""
"172.16.133.63",54200,"172.16.139.250",5440,6,780,20209,0,0,6,780,0,0,265.18616,0.010709000000019842,582687,0
"172.16.133.12",60006,"172.16.139.250",5440,6,780,20210,0,0,6,780,0,0,265.186495,0.011280999999996766,553142,0
"172.16.133.78",59472,"172.16.139.250",5440,6,780,20211,0,0,6,780,0,0,265.186807,0.000734000000022661,"",""
"172.16.133.37",60878,"172.16.139.250",5440,6,780,20212,0,0,6,780,0,0,265.187721,0.010533000000009451,592423,0
"172.16.133.103",63446,"172.16.139.250",5440,6,780,20213,0,0,6,780,0,0,265.188559,0.010999000000026626,567324,0
"172.16.133.88",51244,"172.16.139.250",5440,6,780,20214,0,0,6,780,0,0,265.189332,0.010910000000023956,571952,0
"172.16.133.35",50181,"172.16.139.250",5440,6,780,20215,0,0,6,780,0,0,265.191132,0.011624000000040269,536820,0
"172.16.133.33",58109,"172.16.139.250",5440,12,1142,20216,0,0,12,1142,0,0,265.19682,0.015504000000021279,589267,0
"172.16.133.68",61009,"172.16.139.250",5440,12,1142,20217,0,0,12,1142,0,0,265.233741,0.006346000000007734,1439647,0
"172.16.133.95",57220,"172.16.139.250",5440,6,780,20218,0,0,6,780,0,0,265.245403,0.0007719999999835636,"",""
"172.16.133.13",53277,"172.16.139.250",5440,6,780,20219,0,0,6,780,0,0,265.245799,0.011054000000001452,564501,0
"172.16.133.66",54428,"172.16.139.250",5440,6,780,20220,0,0,6,780,0,0,265.245965,0.0010239999999726024,"",""
"172.16.133.12",60007,"172.16.139.250",5440,12,1142,20221,0,0,12,1142,0,0,265.246228,0.00580200000001696,1574629,0
"172.16.133.25",63700,"172.16.139.250",5440,6,780,20222,0,0,6,780,0,0,265.2467,0.0104710000000523,595931,0
"172.16.133.40",50291,"172.16.139.250",5440,6,780,20223,0,0,6,780,0,0,265.250151,0.011028000000010252,565832,0
"172.16.133.63",54201,"172.16.139.250",5440,10,1022,20224,0,0,10,1022,0,0,265.259436,0.011301000000003114,723475,0
"172.16.133.84",59022,"172.16.139.250",5440,6,780,20225,0,0,6,780,0,0,265.261044,0.00080499999995709,"",""
"172.16.133.11",55386,"172.16.139.250",5440,6,780,20226,0,0,6,780,0,0,265.261452,0.01147499999996171,543790,0
"172.16.133.55",57843,"172.16.139.250",5440,6,780,20227,0,0,6,780,0,0,265.262432,0.011285999999984142,552897,0
"172.16.133.73",60903,"172.16.139.250",5440,6,780,20228,0,0,6,780,0,0,265.262737,0.0015060000000062246,"",""
"172.16.133.97",59602,"172.16.139.250",5440,6,780,20229,0,0,6,780,0,0,265.262898,0.001492999999982203,"",""
"172.16.133.68",61010,"172.16.139.250",5440,6,780,20230,0,0,6,780,0,0,265.263265,0.0014070000000288019,"",""
"172.16.133.83",57316,"172.16.139.250",5440,6,780,20231,0,0,6,780,0,0,265.264053,0.0006200000000262662,"",""
"172.16.133.116",54032,"172.16.139.250",5440,6,780,20232,0,0,6,780,0,0,265.265633,0.0014920000000415712,"",""
"172.16.133.28",49425,"172.16.139.250",5440,6,780,20233,0,0,6,780,0,0,265.265635,0.011321000000009462,551188,0
"172.16.133.20",62682,"172.16.139.250",5440,6,780,20234,0,0,6,780,0,0,265.266481,0.010913000000016382,571795,0
"172.16.133.21",53399,"172.16.139.250",5440,6,780,20235,0,0,6,780,0,0,265.2666,0.0015490000000113469,"",""
"172.16.133.23",55057,"172.16.139.250",5440,6,780,20236,0,0,6,780,0,0,265.270332,0.0013030000000071595,"",""
"172.16.133.66",54429,"172.16.139.250",5440,10,1022,20237,0,0,10,1022,0,0,265.270474,0.019963000000018383,409557,0
"172.16.133.85",52498,"172.16.139.250",5440,6,780,20238,0,0,6,780,0,0,265.27671,0.011617000000001099,537143,0
"172.16.133.56",61665,"172.16.139.250",5440,6,780,20239,0,0,6,780,0,0,265.277392,0.0007369999999582433,"",""
"172.16.133.82",61654,"172.16.139.250",5440,12,1142,20240,0,0,12,1142,0,0,265.284697,0.009958999999980733,917361,0
"172.16.133.68",61011,"69.164.199.102",80,27,23408,20241,0,0,9,732,18,22676,265.284762,20.157404999999983,290,8999
"172.16.133.92",57889,"172.16.139.250",5440,6,780,20242,0,0,6,780,0,0,265.294981,0.0013690000000110558,"",""
"172.16.133.37",60879,"172.16.139.250",5440,10,1022,20243,0,0,10,1022,0,0,265.296985,0.004960999999980231,"",""
"172.16.133.153",50430,"141.101.113.194",80,102,83129,20244,0,0,44,3012,58,80117,265.300615,0.18099999999998317,133127,3541082
"172.16.133.97",59603,"180.153.30.250",443,10,606,20245,0,0,6,366,4,240,265.352938,3.687583000000018,794,520
"172.16.133.78",59473,"172.16.139.250",5440,12,1142,20246,0,0,12,1142,0,0,265.453974,0.015505999999959386,589191,0
"172.16.133.153",53736,"209.112.253.15",80,183,151814,20247,0,0,77,5191,106,146623,265.459727,0.9436220000000048,44009,1243065
"172.16.133.67",56219,"172.16.139.250",5440,10,1022,20248,0,0,10,1022,0,0,265.507749,0.014632000000005974,558775,0
"172.16.133.56",61666,"172.16.139.250",5440,12,1142,20249,0,0,12,1142,0,0,265.531114,0.005046999999990476,1810184,0
"172.16.133.63",54202,"173.194.43.59",80,23,13188,20250,0,0,13,7294,10,5894,265.581523,34.35539,1698,1372
"172.16.133.41",53372,"172.16.139.250",5440,10,1022,20251,0,0,10,1022,0,0,265.585906,0.005282999999963067,1547605,0
"172.16.133.96",53447,"98.139.183.24",80,11,1957,20252,0,0,6,1417,5,540,265.628774,0.11143599999996923,101726,38766
"172.16.133.43",57989,"172.16.139.250",5440,10,1022,20253,0,0,10,1022,0,0,265.655596,0.019103999999970256,427973,0
"172.16.133.63",54203,"8.27.243.253",80,6,372,20254,0,0,4,246,2,126,265.674853,12.04950500000001,163,83
"172.16.133.63",54204,"8.27.243.253",80,6,372,20255,0,0,4,246,2,126,265.675056,12.05109200000004,163,83
"172.16.133.63",54205,"8.27.243.253",80,6,372,20256,0,0,4,246,2,126,265.675212,12.050086000000022,163,83
"172.16.133.63",54206,"8.27.243.253",80,6,372,20257,0,0,4,246,2,126,265.675369,12.048883999999987,163,83
"172.16.133.63",54207,"8.27.243.253",80,6,372,20258,0,0,4,246,2,126,265.67556,12.049679999999967,163,83
"172.16.133.13",53278,"172.16.139.250",5440,10,1022,20259,0,0,10,1022,0,0,265.676355,0.015428999999983262,529911,0
"172.16.133.85",52499,"172.16.139.250",5440,10,1022,20260,0,0,10,1022,0,0,265.682689,0.005502000000035423,1486005,0
"172.16.133.63",54208,"54.243.89.226",80,10,5459,20261,0,0,5,3031,5,2428,265.6847,0.06688399999995909,362538,290413
"172.16.133.42",57332,"172.16.139.250",5440,12,1142,20262,0,0,12,1142,0,0,265.705438,0.01731000000000904,527787,0
"172.16.133.63",54209,"23.15.129.231",80,9,2983,20263,0,0,5,2188,4,795,265.710458,0.3459970000000112,50590,18381
"172.16.133.63",54210,"23.0.52.46",80,14,6636,20264,0,0,6,1381,8,5255,265.711637,32.01873899999998,345,1312
"172.16.133.20",62683,"172.16.139.250",5440,10,1022,20265,0,0,10,1022,0,0,265.725898,0.005407000000047901,1512113,0
"172.16.133.63",54211,"173.194.43.60",80,31,31931,20266,0,0,8,1351,23,30580,265.726869,0.06559699999996838,164763,3729438
"172.16.133.28",49426,"172.16.139.250",5440,12,1142,20267,0,0,12,1142,0,0,265.755552,0.006215999999994892,1469755,0
"172.16.133.99",56273,"172.16.139.250",5440,10,1022,20268,0,0,10,1022,0,0,265.783937,0.004993000000013126,"",""
"172.16.133.75",51187,"172.16.139.250",5440,10,1022,20269,0,0,10,1022,0,0,265.789593,0.0053949999999645115,1515477,0
"172.16.133.87",60477,"172.16.139.250",5440,10,1022,20270,0,0,10,1022,0,0,265.809575,0.01771999999999707,461399,0
"172.16.133.35",50182,"172.16.139.250",5440,12,1142,20271,0,0,12,1142,0,0,265.814466,0.012881999999990512,709206,0
"172.16.133.63",54212,"204.154.111.33",80,11,2984,20272,0,0,6,2458,5,526,265.81673,0.0917840000000183,214242,45846
"172.16.133.116",54033,"172.16.139.250",5440,10,1022,20273,0,0,10,1022,0,0,265.820288,0.010979000000020278,744694,0
"172.16.133.116",54034,"172.16.139.250",5440,10,1022,20274,0,0,10,1022,0,0,265.833011,0.005515000000002601,1482502,0
"172.16.133.116",54035,"172.16.139.250",5440,10,1022,20275,0,0,10,1022,0,0,265.838997,0.005490000000008877,1489253,0
"172.16.133.84",59023,"172.16.139.250",5440,10,1022,20276,0,0,10,1022,0,0,265.841603,0.006641000000001895,1231139,0
"172.16.133.49",56002,"172.16.139.250",5440,12,1142,20277,0,0,12,1142,0,0,265.917303,0.006260999999994965,1459191,0
"172.16.133.63",54213,"184.73.187.64",80,7,1401,20278,0,0,4,1176,3,225,265.918672,0.25779899999997724,36493,6982
"172.16.133.63",54214,"64.94.107.54",80,11,2999,20279,0,0,6,2416,5,583,265.919749,0.06829299999998284,283015,68293
"172.16.133.95",57221,"172.16.139.250",5440,10,1022,20280,0,0,10,1022,0,0,265.961894,0.006233000000008815,1311727,0
"172.16.133.93",61079,"172.16.139.250",5440,6,780,20281,0,0,6,780,0,0,265.964201,0.010693000000003394,583559,0
"172.16.133.92",57890,"172.16.139.250",5440,10,1022,20282,0,0,10,1022,0,0,265.985428,0.005560000000002674,1470503,0
"172.16.133.29",61224,"172.16.139.250",5440,10,1022,20283,0,0,10,1022,0,0,266.003871,0.014474000000006981,564874,0
"172.16.133.44",65051,"172.16.139.250",5440,10,1022,20284,0,0,10,1022,0,0,266.025553,0.017485000000021955,467600,0
"172.16.133.207",56158,"172.16.139.250",5440,10,1022,20285,0,0,10,1022,0,0,266.034531,0.0047509999999988395,"",""
"172.16.133.83",57317,"172.16.139.250",5440,12,1142,20286,0,0,12,1142,0,0,266.045496,0.013843000000008487,659972,0
"172.16.133.93",61080,"172.16.139.250",5440,12,1142,20287,0,0,12,1142,0,0,266.059427,0.014598999999975604,625796,0
"172.16.133.11",55387,"172.16.139.250",5440,12,1142,20288,0,0,12,1142,0,0,266.077656,0.006318000000021584,1446027,0
"172.16.133.55",57844,"172.16.139.250",5440,12,1142,20289,0,0,12,1142,0,0,266.082997,0.015161000000034619,602598,0
"172.16.133.95",57222,"157.56.238.6",443,26,16399,20290,0,0,11,1930,15,14469,266.101648,0.8036069999999995,19213,144040
"172.16.133.73",60904,"172.16.139.250",5440,10,1022,20291,0,0,10,1022,0,0,266.10413,0.005389999999977135,1516883,0
"172.16.133.53",54326,"172.16.139.250",5440,10,1022,20292,0,0,10,1022,0,0,266.107452,0.0058530000000018845,1396890,0
"172.16.133.21",53400,"172.16.139.250",5440,12,1142,20293,0,0,12,1142,0,0,266.111183,0.01548600000000988,589952,0
"172.16.133.30",62897,"172.16.139.250",5440,10,1022,20294,0,0,10,1022,0,0,266.115267,0.01834999999999809,445558,0
"172.16.133.25",63701,"172.16.139.250",5440,10,1022,20295,0,0,10,1022,0,0,266.121536,0.008256000000017139,990310,0
"172.16.133.34",50691,"172.16.139.250",5440,10,1022,20296,0,0,10,1022,0,0,266.131859,0.017915999999956966,456351,0
"172.16.133.97",59604,"172.16.139.250",5440,10,1022,20297,0,0,10,1022,0,0,266.140418,0.005513000000007651,1483040,0
"172.16.133.33",58110,"172.16.139.250",5440,10,1022,20298,0,0,10,1022,0,0,266.210821,0.015513999999996031,527007,0
"172.16.133.68",61012,"172.16.139.250",5440,10,1022,20299,0,0,10,1022,0,0,266.248385,0.005635000000040691,1450931,0
"172.16.133.12",60008,"172.16.139.250",5440,12,1142,20300,0,0,12,1142,0,0,266.260456,0.006207000000017615,1471886,0
"172.16.133.83",57318,"67.217.95.254",443,6,366,20301,0,0,4,246,2,120,266.268204,0.12453599999997778,15802,7708
"172.16.133.63",54215,"172.16.139.250",5440,10,1022,20302,0,0,10,1022,0,0,266.27356,0.0053850000000466025,1518291,0
"172.16.133.66",54430,"172.16.139.250",5440,10,1022,20303,0,0,10,1022,0,0,266.284064,0.0226170000000252,361497,0
"172.16.133.82",61655,"172.16.139.250",5440,10,1022,20304,0,0,10,1022,0,0,266.297319,0.005684999999971296,1438170,0
"172.16.133.153",42776,"64.17.236.31",80,62,40839,20305,0,0,32,2213,30,38626,266.304549,1.9120510000000195,9259,161610
"172.16.133.37",60880,"172.16.139.250",5440,10,1022,20306,0,0,10,1022,0,0,266.312142,0.005611999999985073,1456878,0
"172.16.133.78",59474,"172.16.139.250",5440,12,1142,20307,0,0,12,1142,0,0,266.467171,0.006326000000001386,1444198,0
"172.16.133.83",57319,"78.108.117.250",443,6,366,20308,0,0,4,246,2,120,266.490234,0.19118400000002111,10293,5021
"172.16.133.83",57320,"216.219.117.244",443,6,366,20309,0,0,4,246,2,120,266.512426,0.2031289999999899,9688,4726
"172.16.133.67",56220,"172.16.139.250",5440,12,1142,20310,0,0,12,1142,0,0,266.521813,0.006258000000002539,1459891,0
"172.16.133.56",61667,"172.16.139.250",5440,10,1022,20311,0,0,10,1022,0,0,266.546562,0.05598400000002357,146041,0
"172.16.133.41",53373,"172.16.139.250",5440,10,1022,20312,0,0,10,1022,0,0,266.599891,0.015406999999981963,530667,0
"172.16.133.43",57990,"172.16.139.250",5440,12,1142,20313,0,0,12,1142,0,0,266.669605,0.07881300000002511,115919,0
"172.16.133.13",53279,"172.16.139.250",5440,10,1022,20314,0,0,10,1022,0,0,266.691245,0.06028600000001916,135620,0
"172.16.133.85",52500,"172.16.139.250",5440,10,1022,20315,0,0,10,1022,0,0,266.695081,0.05973499999998921,136871,0
"172.16.133.42",57333,"172.16.139.250",5440,12,1142,20316,0,0,12,1142,0,0,266.727145,0.08285200000000259,110268,0
"172.16.133.20",62684,"172.16.139.250",5440,12,1142,20317,0,0,12,1142,0,0,266.73979,0.02431699999999637,375704,0
"172.16.133.28",49427,"172.16.139.250",5440,12,1142,20318,0,0,12,1142,0,0,266.768668,0.01638900000000376,557447,0
"172.16.133.99",56274,"172.16.139.250",5440,12,1142,20319,0,0,12,1142,0,0,266.798607,0.014480999999989308,630895,0
"172.16.133.75",51188,"172.16.139.250",5440,10,1022,20320,0,0,10,1022,0,0,266.802273,0.016544000000010328,494197,0
"172.16.133.87",60478,"172.16.139.250",5440,12,1142,20321,0,0,12,1142,0,0,266.822316,0.015592000000026474,585941,0
"172.16.133.35",50183,"172.16.139.250",5440,12,1142,20322,0,0,12,1142,0,0,266.830182,0.02073200000000952,440671,0
"172.16.133.116",54036,"172.16.139.250",5440,10,1022,20323,0,0,10,1022,0,0,266.832902,0.016633000000013,491552,0
"172.16.133.116",54037,"172.16.139.250",5440,10,1022,20324,0,0,10,1022,0,0,266.850057,0.015348000000017237,532707,0
"172.16.133.84",59024,"172.16.139.250",5440,12,1142,20325,0,0,12,1142,0,0,266.855971,0.017477999999982785,522714,0
"172.16.133.116",54038,"172.16.139.250",5440,12,1142,20326,0,0,12,1142,0,0,266.86601,0.015509000000008655,589077,0
"172.16.133.49",56003,"172.16.139.250",5440,12,1142,20327,0,0,12,1142,0,0,266.931228,0.006214999999997417,1469991,0
"172.16.133.95",57223,"172.16.139.250",5440,12,1142,20328,0,0,12,1142,0,0,266.97583,0.021376000000032036,427395,0
"172.16.133.83",57321,"202.173.25.200",443,6,366,20329,0,0,4,246,2,120,266.987276,0.5188600000000179,3792,1850
"172.16.133.92",57891,"172.16.139.250",5440,12,1142,20330,0,0,12,1142,0,0,267.00011,0.015962999999999283,572323,0
"172.16.133.29",61225,"172.16.139.250",5440,10,1022,20331,0,0,10,1022,0,0,267.017221,0.015913000000011834,513793,0
"172.16.133.44",65052,"172.16.139.250",5440,10,1022,20332,0,0,10,1022,0,0,267.024095,0.005258000000026186,1554963,0
"172.16.133.207",56159,"172.16.139.250",5440,12,1142,20333,0,0,12,1142,0,0,267.048639,0.014923000000010234,612209,0
"172.16.133.83",57322,"172.16.139.250",5440,12,1142,20334,0,0,12,1142,0,0,267.059594,0.007648000000017419,1194560,0
"172.16.133.93",61081,"172.16.139.250",5440,10,1022,20335,0,0,10,1022,0,0,267.073583,0.01423099999999522,574520,0
"172.16.133.11",55388,"172.16.139.250",5440,10,1022,20336,0,0,10,1022,0,0,267.091588,0.015770999999972446,518419,0
"172.16.133.55",57845,"172.16.139.250",5440,10,1022,20337,0,0,10,1022,0,0,267.096296,0.005904999999984284,1384589,0
"172.16.133.73",60905,"172.16.139.250",5440,10,1022,20338,0,0,10,1022,0,0,267.118453,0.005426999999997406,1506541,0
"172.16.133.53",54327,"172.16.139.250",5440,10,1022,20339,0,0,10,1022,0,0,267.122114,0.016378999999972166,499175,0
"172.16.133.21",53401,"172.16.139.250",5440,10,1022,20340,0,0,10,1022,0,0,267.124277,0.018691999999987274,437406,0
"172.16.133.30",62898,"172.16.139.250",5440,10,1022,20341,0,0,10,1022,0,0,267.129454,0.021091000000012627,387653,0
"172.16.133.95",57224,"184.168.192.63",80,19,10470,20342,0,0,8,925,11,9545,267.134738,10.982057999999995,673,6953
"172.16.133.25",63702,"172.16.139.250",5440,10,1022,20343,0,0,10,1022,0,0,267.135069,0.011253000000010616,726561,0
"172.16.133.34",50692,"172.16.139.250",5440,10,1022,20344,0,0,10,1022,0,0,267.146082,0.018608000000028824,439380,0
"172.16.133.97",59605,"172.16.139.250",5440,10,1022,20345,0,0,10,1022,0,0,267.15422,0.016674999999963802,490314,0
"172.16.133.113",55753,"172.16.139.250",135,8,492,20346,0,0,8,492,0,0,267.20548,0.030526999999949567,128935,0
"172.16.133.33",58111,"172.16.139.250",5440,10,1022,20347,0,0,10,1022,0,0,267.224628,0.005571000000031745,1467600,0
"172.16.133.113",55754,"172.16.139.250",5462,12,816,20348,0,0,12,816,0,0,267.243324,0.5228460000000155,12485,0
"172.16.133.68",61013,"172.16.139.250",5440,10,1022,20349,0,0,10,1022,0,0,267.261677,0.015588999999977204,524472,0
"172.16.133.12",60009,"172.16.139.250",5440,12,1142,20350,0,0,12,1142,0,0,267.274542,0.0072959999999966385,1252192,0
"172.16.133.12",60010,"172.16.139.250",5440,12,1142,20351,0,0,12,1142,0,0,267.284158,0.008156999999982872,1120019,0
"172.16.133.63",54216,"172.16.139.250",5440,12,1142,20352,0,0,12,1142,0,0,267.2875,0.008490999999992255,1075962,0
"172.16.133.66",54431,"172.16.139.250",5440,10,1022,20353,0,0,10,1022,0,0,267.296688,0.007225000000005366,1131626,0
"172.16.133.82",61656,"172.16.139.250",5440,12,1142,20354,0,0,12,1142,0,0,267.312498,0.006332999999983713,1442602,0
"172.16.133.132",48088,"216.185.152.144",80,42,24871,20355,0,0,22,1430,20,23441,267.320129,0.4295439999999644,26632,436574
"172.16.133.37",60881,"172.16.139.250",5440,10,1022,20356,0,0,10,1022,0,0,267.324849,0.014746999999999844,554417,0
"172.16.133.78",59475,"172.16.139.250",5440,12,1142,20357,0,0,12,1142,0,0,267.480899,0.006586999999967702,1386974,0
"172.16.133.67",56221,"172.16.139.250",5440,12,1142,20358,0,0,12,1142,0,0,267.536074,0.006349999999997635,1438740,0
"172.16.133.56",61668,"172.16.139.250",5440,12,1142,20359,0,0,12,1142,0,0,267.559517,0.005281999999965592,1729647,0
"172.16.133.41",53374,"172.16.139.250",5440,10,1022,20360,0,0,10,1022,0,0,267.614908,0.051606999999989966,158428,0
"172.16.133.132",55239,"38.70.64.178",80,37,22811,20361,0,0,20,1525,17,21286,267.665886,0.81472100000002,14974,209013
"172.16.133.43",57991,"172.16.139.250",5440,12,1142,20362,0,0,12,1142,0,0,267.682461,0.007178000000010343,1272777,0
"172.16.133.97",59606,"180.153.30.250",443,6,366,20363,0,0,4,246,2,120,267.688075,0.672963999999979,2924,1426
"172.16.133.13",53282,"172.16.139.250",5440,12,1142,20364,0,0,12,1142,0,0,267.704502,0.01956400000000258,466980,0
"172.16.133.85",52501,"172.16.139.250",5440,12,1142,20365,0,0,12,1142,0,0,267.70896,0.0063279999999963366,1443742,0
"172.16.133.42",57334,"172.16.139.250",5440,12,1142,20366,0,0,12,1142,0,0,267.734741,0.015391000000022359,593593,0
"172.16.133.73",60906,"68.64.5.249",443,7,426,20367,0,0,4,246,3,180,267.743572,0.12598300000001927,15621,11430
"172.16.133.73",60907,"68.64.25.250",443,6,366,20368,0,0,4,246,2,120,267.744889,0.12368400000002566,15911,7761
"172.16.133.73",60908,"78.108.119.250",443,7,426,20369,0,0,5,306,2,120,267.745402,0.6639429999999606,3687,1445
"172.16.133.73",60909,"216.115.209.254",443,7,426,20370,0,0,5,306,2,120,267.746529,0.504209000000003,4855,1903
"172.16.133.20",62685,"172.16.139.250",5440,12,1142,20371,0,0,12,1142,0,0,267.755243,0.005138999999985572,1777777,0
"172.16.133.28",49428,"172.16.139.250",5440,10,1022,20372,0,0,10,1022,0,0,267.78252,0.005538000000001375,1476345,0
"172.16.133.99",56275,"172.16.139.250",5440,12,1142,20373,0,0,12,1142,0,0,267.810942,0.016014999999981683,570465,0
"172.16.133.75",51189,"172.16.139.250",5440,12,1142,20374,0,0,12,1142,0,0,267.816637,0.009903000000008433,922548,0
"172.16.133.87",60479,"172.16.139.250",5440,12,1142,20375,0,0,12,1142,0,0,267.836444,0.009331000000031509,979101,0
"172.16.133.35",50184,"172.16.139.250",5440,12,1142,20376,0,0,12,1142,0,0,267.839688,0.014325999999982741,637721,0
"172.16.133.116",54039,"172.16.139.250",5440,10,1022,20377,0,0,10,1022,0,0,267.84611,0.008429999999975735,969869,0
"172.16.133.116",54040,"172.16.139.250",5440,12,1142,20378,0,0,12,1142,0,0,267.855012,0.005526000000031672,1653275,0
"172.16.133.116",54041,"172.16.139.250",5440,10,1022,20379,0,0,10,1022,0,0,267.86076,0.006205999999963296,1317434,0
"172.16.133.84",59025,"172.16.139.250",5440,10,1022,20380,0,0,10,1022,0,0,267.868821,0.006641000000001895,1231139,0
"172.16.133.49",56004,"172.16.139.250",5440,10,1022,20381,0,0,10,1022,0,0,267.94548,0.005522000000041771,1480622,0
"172.16.133.95",57225,"172.16.139.250",5440,12,1142,20382,0,0,12,1142,0,0,267.990207,0.021066000000018903,433684,0
"172.16.133.92",57892,"172.16.139.250",5440,10,1022,20383,0,0,10,1022,0,0,268.013862,0.005649000000005344,1447335,0
"172.16.133.29",61226,"172.16.139.250",5440,12,1142,20384,0,0,12,1142,0,0,268.032051,0.027559999999994034,331494,0
"172.16.133.44",65053,"172.16.139.250",5440,12,1142,20385,0,0,12,1142,0,0,268.038201,0.007316000000002987,1248769,0
"172.16.133.207",56160,"172.16.139.250",5440,12,1142,20386,0,0,12,1142,0,0,268.062908,0.014836999999999989,615757,0
"172.16.133.83",57323,"172.16.139.250",5440,10,1022,20387,0,0,10,1022,0,0,268.07461,0.006715999999983069,1217391,0
"172.16.133.93",61082,"172.16.139.250",5440,12,1142,20388,0,0,12,1142,0,0,268.087435,0.0049080000000003565,"",""
"172.16.133.11",55389,"172.16.139.250",5440,12,1142,20389,0,0,12,1142,0,0,268.10657,0.006862000000012358,1331390,0
"172.16.133.55",57846,"172.16.139.250",5440,12,1142,20390,0,0,12,1142,0,0,268.110347,0.007116999999993823,1283686,0
"172.16.133.73",60910,"172.16.139.250",5440,10,1022,20391,0,0,10,1022,0,0,268.132351,0.015566999999975906,525213,0
"172.16.133.53",54328,"172.16.139.250",5440,12,1142,20392,0,0,12,1142,0,0,268.135789,0.016756999999984146,545204,0
"172.16.133.21",53402,"172.16.139.250",5440,12,1142,20393,0,0,12,1142,0,0,268.138219,0.007946000000004005,1149760,0
"172.16.133.30",62899,"172.16.139.250",5440,10,1022,20394,0,0,10,1022,0,0,268.143417,0.01690600000000586,483615,0
"172.16.133.25",63703,"172.16.139.250",5440,10,1022,20395,0,0,10,1022,0,0,268.148753,0.007272000000000389,1124312,0
"172.16.133.34",50693,"172.16.139.250",5440,12,1142,20396,0,0,12,1142,0,0,268.159927,0.00528100000002496,1729975,0
"172.16.133.97",59607,"172.16.139.250",5440,12,1142,20397,0,0,12,1142,0,0,268.169096,0.01555499999994936,587335,0
"172.16.133.153",47215,"64.17.236.31",80,138,103988,20398,0,0,68,5390,70,98598,268.181899,0.4746200000000158,90851,1661927
"172.16.133.33",58112,"172.16.139.250",5440,10,1022,20399,0,0,10,1022,0,0,268.238926,0.005999000000031174,1362893,0
"172.16.133.68",61014,"172.16.139.250",5440,10,1022,20400,0,0,10,1022,0,0,268.275402,0.015837000000033186,516259,0
"172.16.133.12",60011,"172.16.139.250",5440,12,1142,20401,0,0,12,1142,0,0,268.288001,0.014825999999970918,616214,0
"172.16.133.63",54217,"172.16.139.250",5440,12,1142,20402,0,0,12,1142,0,0,268.300468,0.015588999999977204,586054,0
"172.16.133.66",54432,"172.16.139.250",5440,10,1022,20403,0,0,10,1022,0,0,268.310707,0.008346000000017284,979630,0
"172.16.133.132",43081,"38.70.64.178",80,69,49021,20404,0,0,34,2394,35,46627,268.325375,0.6017400000000066,31827,619895
"172.16.133.82",61658,"172.16.139.250",5440,10,1022,20405,0,0,10,1022,0,0,268.325452,0.014651000000014847,558050,0
"172.16.133.37",60882,"172.16.139.250",5440,10,1022,20406,0,0,10,1022,0,0,268.339018,0.016166999999995824,505721,0
"172.16.133.83",57324,"67.217.95.254",443,7,426,20407,0,0,4,246,3,180,268.3712,0.04000899999999774,49188,35991
"172.16.133.78",59476,"172.16.139.250",5440,12,1142,20408,0,0,12,1142,0,0,268.496183,0.0065370000000370965,1397582,0
"172.16.133.67",56222,"172.16.139.250",5440,12,1142,20409,0,0,12,1142,0,0,268.550128,0.02772400000003472,329533,0
"172.16.133.56",61669,"172.16.139.250",5440,12,1142,20410,0,0,12,1142,0,0,268.57313,0.014825000000030286,616256,0
"172.16.133.83",57325,"78.108.117.250",443,6,366,20411,0,0,4,246,2,120,268.591342,0.20589899999998806,9558,4662
"172.16.133.83",57326,"216.219.117.244",443,6,366,20412,0,0,4,246,2,120,268.618187,0.2160949999999957,9107,4442
"172.16.133.153",35309,"184.84.3.78",80,252,215925,20413,0,0,111,7574,141,208351,268.624736,0.3369130000000382,179844,4947294
"172.16.133.41",53375,"172.16.139.250",5440,10,1022,20414,0,0,10,1022,0,0,268.631304,0.006011999999998352,1359946,0
"172.16.133.113",55755,"216.115.223.200",443,6,366,20415,0,0,4,246,2,120,268.686306,0.1428070000000048,13780,6722
"172.16.133.113",55756,"216.219.113.250",443,6,366,20416,0,0,4,246,2,120,268.69063,0.23571299999997564,8349,4072
"172.16.133.113",55757,"67.217.64.244",443,6,366,20417,0,0,4,246,2,120,268.690631,0.08347700000001623,23575,11500
"172.16.133.113",55758,"66.151.150.190",443,6,366,20418,0,0,4,246,2,120,268.69092,0.20911000000000968,9411,4590
"172.16.133.43",57992,"172.16.139.250",5440,12,1142,20419,0,0,12,1142,0,0,268.696359,0.006527000000005501,1399724,0
"172.16.133.13",53283,"172.16.139.250",5440,12,1142,20420,0,0,12,1142,0,0,268.719411,0.006213999999999942,1470228,0
"172.16.133.85",52502,"172.16.139.250",5440,12,1142,20421,0,0,12,1142,0,0,268.723909,0.015298000000029788,597202,0
"172.16.133.42",57335,"172.16.139.250",5440,12,1142,20422,0,0,12,1142,0,0,268.750014,0.015864999999962492,575858,0
"172.16.133.20",62686,"172.16.139.250",5440,10,1022,20423,0,0,10,1022,0,0,268.768016,0.005908000000033553,1383886,0
"172.16.133.28",49429,"172.16.139.250",5440,12,1142,20424,0,0,12,1142,0,0,268.795599,0.006664999999998145,1370742,0
"172.16.133.99",56276,"172.16.139.250",5440,10,1022,20425,0,0,10,1022,0,0,268.82596,0.015120999999965079,540704,0
"172.16.133.75",51190,"172.16.139.250",5440,10,1022,20426,0,0,10,1022,0,0,268.831666,0.005533000000013999,1477679,0
"172.16.133.87",60480,"172.16.139.250",5440,12,1142,20427,0,0,12,1142,0,0,268.850962,0.01577500000001919,579144,0
"172.16.133.116",54042,"172.16.139.250",5440,10,1022,20428,0,0,10,1022,0,0,268.860966,0.014650999999958003,558050,0
"172.16.133.116",54043,"172.16.139.250",5440,10,1022,20429,0,0,10,1022,0,0,268.876142,0.01704499999999598,479671,0
"172.16.133.84",59026,"172.16.139.250",5440,10,1022,20430,0,0,10,1022,0,0,268.88395,0.0054639999999608335,1496339,0
"172.16.133.35",50185,"172.16.139.250",5440,12,1142,20431,0,0,12,1142,0,0,268.893771,0.016598999999985153,550394,0
"172.16.133.116",54044,"172.16.139.250",5440,10,1022,20432,0,0,10,1022,0,0,268.89454,0.005094999999982974,1604710,0
"172.16.133.87",60481,"199.47.217.174",443,20,6442,20433,0,0,9,1134,11,5308,268.898242,15.997209999999995,567,2654
"172.16.133.41",53376,"96.43.146.176",443,12,2362,20434,0,0,7,1381,5,981,268.937349,0.3947160000000167,27989,19882
"172.16.133.153",52499,"23.33.83.78",80,63,44917,20435,0,0,31,2152,32,42765,268.939128,0.1254650000000197,137217,2726816
"172.16.133.49",56005,"172.16.139.250",5440,10,1022,20436,0,0,10,1022,0,0,268.959739,0.0070999999999799,1151549,0
"172.16.133.95",57226,"172.16.139.250",5440,10,1022,20437,0,0,10,1022,0,0,269.004022,0.015347999999960393,532707,0
"172.16.133.92",57893,"172.16.139.250",5440,10,1022,20438,0,0,10,1022,0,0,269.027554,0.014614999999992051,559425,0
"172.16.133.153",43682,"23.33.83.78",80,117,102686,20439,0,0,48,3309,69,99377,269.041736,0.18476899999996022,143270,4302756
"172.16.133.29",61227,"172.16.139.250",5440,12,1142,20440,0,0,12,1142,0,0,269.046573,0.017779999999959273,513835,0
"172.16.133.44",65054,"172.16.139.250",5440,10,1022,20441,0,0,10,1022,0,0,269.05253,0.015984000000003107,511511,0
"172.16.133.207",56161,"172.16.139.250",5440,10,1022,20442,0,0,10,1022,0,0,269.076705,0.014836000000002514,551091,0
"172.16.133.83",57327,"172.16.139.250",5440,12,1142,20443,0,0,12,1142,0,0,269.088524,0.006559999999979027,1392682,0
"172.16.133.93",61083,"172.16.139.250",5440,12,1142,20444,0,0,12,1142,0,0,269.101574,0.00495499999999538,"",""
"172.16.133.11",55390,"172.16.139.250",5440,10,1022,20445,0,0,10,1022,0,0,269.121835,0.015553000000011252,525686,0
"172.16.133.55",57847,"172.16.139.250",5440,10,1022,20446,0,0,10,1022,0,0,269.125572,0.005613000000039392,1456618,0
"172.16.133.73",60911,"172.16.139.250",5440,10,1022,20447,0,0,10,1022,0,0,269.146204,0.03668299999998226,222882,0
"172.16.133.23",55058,"64.90.204.229",443,20,4665,20448,0,0,9,2867,11,1798,269.148674,5.076632999999958,4517,2833
"172.16.133.53",54329,"172.16.139.250",5440,10,1022,20449,0,0,10,1022,0,0,269.150707,0.0359009999999671,227737,0
"172.16.133.21",53403,"172.16.139.250",5440,12,1142,20450,0,0,12,1142,0,0,269.153358,0.041123999999967964,222157,0
"172.16.133.30",62901,"172.16.139.250",5440,10,1022,20451,0,0,10,1022,0,0,269.158096,0.03902599999997847,209501,0
"172.16.133.25",63704,"172.16.139.250",5440,12,1142,20452,0,0,12,1142,0,0,269.164504,0.060515999999950054,150968,0
"172.16.133.24",57717,"96.43.146.22",443,7,815,20453,0,0,4,506,3,309,269.166044,0.12758800000000292,31727,19374
"172.16.133.24",57718,"96.43.146.22",443,7,815,20454,0,0,4,506,3,309,269.166278,0.1271480000000338,31836,19441
"172.16.133.34",50694,"172.16.139.250",5440,10,1022,20455,0,0,10,1022,0,0,269.173052,0.054124000000001615,151060,0
"172.16.133.97",59608,"172.16.139.250",5440,10,1022,20456,0,0,10,1022,0,0,269.182581,0.04325299999999288,189027,0
"172.16.133.153",47511,"205.153.84.114",80,8,771,20457,0,0,4,403,4,368,269.199459,0.09195599999998194,35060,32015
"172.16.133.96",53448,"98.139.183.24",80,12,2802,20458,0,0,7,1618,5,1184,269.205546,21.018062999999984,615,450
"172.16.133.83",57328,"202.173.25.200",443,6,366,20459,0,0,4,246,2,120,269.246304,0.5793199999999956,3397,1657
"172.16.133.33",58113,"172.16.139.250",5440,10,1022,20460,0,0,10,1022,0,0,269.252928,0.005801000000019485,1409412,0
"172.16.133.68",61015,"172.16.139.250",5440,12,1142,20461,0,0,12,1142,0,0,269.289311,0.006222999999977219,1468102,0
"172.16.133.12",60012,"172.16.139.250",5440,12,1142,20462,0,0,12,1142,0,0,269.302502,0.005532000000016524,1651482,0
"172.16.133.63",54218,"172.16.139.250",5440,10,1022,20463,0,0,10,1022,0,0,269.314304,0.01486699999998109,549942,0
"172.16.133.96",53449,"76.13.115.116",80,10,2817,20464,0,0,6,1290,4,1527,269.322068,2.185812999999996,4721,5588
"172.16.133.66",54433,"172.16.139.250",5440,10,1022,20465,0,0,10,1022,0,0,269.326035,0.0069510000000150285,1176233,0
"172.16.133.82",61659,"172.16.139.250",5440,10,1022,20466,0,0,10,1022,0,0,269.339441,0.006186999999954423,1321480,0
"172.16.133.37",60883,"172.16.139.250",5440,12,1142,20467,0,0,12,1142,0,0,269.352009,0.015964999999994234,572251,0
"172.16.133.78",59477,"172.16.139.250",5440,10,1022,20468,0,0,10,1022,0,0,269.510154,0.008295999999972992,985535,0
"172.16.133.93",61084,"74.63.51.79",80,219,231305,20469,0,0,64,4946,155,226359,269.548614,7.954701,4974,227648
"172.16.133.93",61085,"74.63.52.167",80,15,1646,20470,0,0,8,1039,7,607,269.548999,27.96802100000002,297,173
"172.16.133.93",61086,"74.63.52.167",80,15,1646,20471,0,0,8,1039,7,607,269.54923,27.980719999999963,297,173
"172.16.133.93",61087,"74.63.52.167",80,15,1646,20472,0,0,8,1039,7,607,269.549456,27.980289999999968,297,173
"172.16.133.93",61088,"74.63.52.167",80,15,1646,20473,0,0,8,1039,7,607,269.549668,27.980185000000006,297,173
"172.16.133.93",61089,"74.63.52.167",80,15,1646,20474,0,0,8,1039,7,607,269.549892,27.97966600000001,297,173
"172.16.133.93",61090,"74.63.52.167",80,15,1646,20475,0,0,8,1039,7,607,269.550083,27.978421000000026,297,173
"172.16.133.93",61091,"208.47.254.83",80,6,372,20476,0,0,4,246,2,126,269.550355,17.956218999999976,109,56
"172.16.133.93",61092,"208.47.254.83",80,6,372,20477,0,0,4,246,2,126,269.550561,17.955960000000005,109,56
"172.16.133.93",61093,"23.33.95.139",80,7,432,20478,0,0,4,246,3,186,269.550828,17.958326999999997,109,82
"172.16.133.93",61094,"173.194.43.57",80,6,372,20479,0,0,4,246,2,126,269.551244,17.954975999999988,109,56
"172.16.133.93",61095,"23.67.243.50",80,6,372,20480,0,0,4,246,2,126,269.551519,17.95732400000003,109,56
"172.16.133.93",61096,"23.67.243.50",80,6,372,20481,0,0,4,246,2,126,269.551725,17.957176000000004,109,56
"172.16.133.93",61097,"23.67.243.50",80,6,372,20482,0,0,4,246,2,126,269.551929,17.95664400000004,109,56
"172.16.133.93",61098,"23.67.243.50",80,6,372,20483,0,0,4,246,2,126,269.552132,17.95467500000001,109,56
"172.16.133.93",61099,"74.125.226.4",80,6,372,20484,0,0,4,246,2,126,269.552412,17.973795999999993,109,56
"172.16.133.93",61100,"74.125.226.4",80,6,372,20485,0,0,4,246,2,126,269.552619,17.973310000000026,109,56
"172.16.133.93",61101,"23.33.82.110",443,13,1206,20486,0,0,6,632,7,574,269.552916,21.377460000000042,236,214
"172.16.133.93",61102,"23.33.82.110",443,13,1206,20487,0,0,6,632,7,574,269.553145,21.377380000000016,236,214
"172.16.133.93",61103,"23.33.82.110",443,13,1206,20488,0,0,6,632,7,574,269.55336,21.376852999999983,236,214
"172.16.133.93",61104,"173.194.43.45",80,7,432,20489,0,0,4,246,3,186,269.556261,17.949674000000016,109,82
"172.16.133.93",61105,"173.194.43.45",80,7,432,20490,0,0,4,246,3,186,269.556495,17.94997900000004,109,82
"172.16.133.93",61106,"173.194.43.45",80,6,372,20491,0,0,4,246,2,126,269.556697,17.94977499999999,109,56
"172.16.133.67",56223,"172.16.139.250",5440,10,1022,20492,0,0,10,1022,0,0,269.563891,0.014820999999983542,551649,0
"172.16.133.56",61670,"172.16.139.250",5440,10,1022,20493,0,0,10,1022,0,0,269.587251,0.006479000000013002,1261923,0
"172.16.133.95",57227,"199.59.148.247",80,11,1722,20494,0,0,6,963,5,759,269.618553,30.316002999999967,254,200
"172.16.133.41",53377,"172.16.139.250",5440,10,1022,20495,0,0,10,1022,0,0,269.642045,0.005552000000022872,1472622,0
"172.16.133.43",57993,"172.16.139.250",5440,10,1022,20496,0,0,10,1022,0,0,269.710902,0.015435000000024957,529705,0
"172.16.133.13",53284,"172.16.139.250",5440,10,1022,20497,0,0,10,1022,0,0,269.731394,0.005430999999987307,1505431,0
"172.16.133.85",52503,"172.16.139.250",5440,10,1022,20498,0,0,10,1022,0,0,269.737011,0.015551000000016302,525753,0
"172.16.133.42",57336,"172.16.139.250",5440,12,1142,20499,0,0,12,1142,0,0,269.763854,0.015641000000016447,584105,0
"172.16.133.20",62687,"172.16.139.250",5440,12,1142,20500,0,0,12,1142,0,0,269.782959,0.014752999999984695,619263,0
"172.16.133.73",60912,"68.64.5.249",443,6,366,20501,0,0,4,246,2,120,269.808596,0.13794599999999946,14266,6959
"172.16.133.28",49431,"172.16.139.250",5440,10,1022,20502,0,0,10,1022,0,0,269.809857,0.005425000000002456,1507096,0
"172.16.133.73",60913,"68.64.25.250",443,6,366,20503,0,0,4,246,2,120,269.810433,0.13192700000001878,14917,7276
"172.16.133.99",56277,"172.16.139.250",5440,10,1022,20504,0,0,10,1022,0,0,269.840256,0.015452999999979511,529088,0
"172.16.133.75",51191,"172.16.139.250",5440,10,1022,20505,0,0,10,1022,0,0,269.844182,0.01564899999999625,522461,0
"172.16.133.73",60914,"216.115.209.254",443,6,366,20506,0,0,4,246,2,120,269.852555,0.19422200000002476,10132,4942
"172.16.133.87",60482,"172.16.139.250",5440,10,1022,20507,0,0,10,1022,0,0,269.865319,0.017024999999989632,480234,0
"172.16.133.35",50186,"172.16.139.250",5440,12,1142,20508,0,0,12,1142,0,0,269.867516,0.013051999999959207,699969,0
"172.16.133.116",54045,"172.16.139.250",5440,8,902,20509,0,0,8,902,0,0,269.875077,0.010782000000006065,669263,0
"172.16.133.73",60915,"78.108.119.250",443,6,366,20510,0,0,4,246,2,120,269.879497,0.25494599999996126,7719,3765
"172.16.133.116",54046,"172.16.139.250",5440,10,1022,20511,0,0,10,1022,0,0,269.886737,0.005528000000026623,1479015,0
"172.16.133.116",54047,"172.16.139.250",5440,10,1022,20512,0,0,10,1022,0,0,269.893243,0.005345000000033906,1529653,0
"172.16.133.84",59027,"172.16.139.250",5440,10,1022,20513,0,0,10,1022,0,0,269.897974,0.015384000000040032,531461,0
"172.16.133.49",56006,"172.16.139.250",5440,12,1142,20514,0,0,12,1142,0,0,269.973239,0.006283999999993739,1453851,0
"172.16.133.95",57228,"172.16.139.250",5440,10,1022,20515,0,0,10,1022,0,0,270.015863,0.014568999999994503,561191,0
"172.16.133.97",59609,"180.153.30.250",443,6,366,20516,0,0,4,246,2,120,270.032096,0.6809159999999679,2890,1409
"172.16.133.92",57894,"172.16.139.250",5440,12,1142,20517,0,0,12,1142,0,0,270.042033,0.006480000000010477,1409876,0
"172.16.133.29",61228,"172.16.139.250",5440,10,1022,20518,0,0,10,1022,0,0,270.060553,0.005612999999982549,1456618,0
"172.16.133.44",65055,"172.16.139.250",5440,12,1142,20519,0,0,12,1142,0,0,270.066361,0.015511000000003605,589001,0
"172.16.133.207",56162,"172.16.139.250",5440,12,1142,20520,0,0,12,1142,0,0,270.090962,0.0146349999999984,624256,0
"172.16.128.169",8014,"172.16.133.69",59824,5,446,20521,0,0,3,326,2,120,270.100824,0.09925600000002532,26275,9671
"172.16.133.83",57329,"172.16.139.250",5440,10,1022,20522,0,0,10,1022,0,0,270.101642,0.007570999999984451,1079910,0
"172.16.133.25",63705,"156.110.114.86",28207,3,194,20523,0,0,3,194,0,0,270.109823,8.99236000000002,172,0
"172.16.133.93",61107,"172.16.139.250",5440,12,1142,20524,0,0,12,1142,0,0,270.115203,0.004617999999993572,"",""
"172.16.133.11",55391,"172.16.139.250",5440,10,1022,20525,0,0,10,1022,0,0,270.134519,0.005601000000012846,1459739,0
"172.16.133.55",57848,"172.16.139.250",5440,10,1022,20526,0,0,10,1022,0,0,270.138711,0.005823000000020784,1404087,0
"172.16.133.73",60916,"172.16.139.250",5440,10,1022,20527,0,0,10,1022,0,0,270.160376,0.005444000000011329,1501836,0
"172.16.133.53",54330,"172.16.139.250",5440,10,1022,20528,0,0,10,1022,0,0,270.164982,0.005696999999997843,1435141,0
"172.16.133.21",53404,"172.16.139.250",5440,10,1022,20529,0,0,10,1022,0,0,270.166401,0.008215000000006967,995252,0
"172.16.133.30",62902,"172.16.139.250",5440,10,1022,20530,0,0,10,1022,0,0,270.171036,0.0072769999999877655,1123539,0
"172.16.133.25",63706,"172.16.139.250",5440,12,1142,20531,0,0,12,1142,0,0,270.176898,0.006173999999987245,1479753,0
"172.16.133.34",50695,"172.16.139.250",5440,10,1022,20532,0,0,10,1022,0,0,270.186862,0.010249999999984993,797658,0
"172.16.133.97",59610,"172.16.139.250",5440,10,1022,20533,0,0,10,1022,0,0,270.196287,0.01467200000001867,557251,0
"172.16.133.68",61016,"208.117.46.102",80,9,1110,20534,0,0,5,609,4,501,270.228026,0.6957949999999755,7002,5760
"172.16.133.33",58114,"172.16.139.250",5440,8,902,20535,0,0,8,902,0,0,270.266735,0.015558999999996104,463783,0
"172.16.133.93",61108,"63.241.108.124",80,15,9599,20536,0,0,8,4179,7,5420,270.281475,0.12576100000001134,265837,344780
"172.16.133.93",61109,"63.241.108.124",80,15,9608,20537,0,0,8,4189,7,5419,270.285461,0.1365910000000099,245345,317385
"172.16.133.93",61110,"63.241.108.124",80,12,6425,20538,0,0,7,3727,5,2698,270.285878,0.11282299999999168,264272,191308
"172.16.133.68",61017,"172.16.139.250",5440,10,1022,20539,0,0,10,1022,0,0,270.303725,0.015531000000009954,526431,0
"172.16.133.12",60013,"172.16.139.250",5440,10,1022,20540,0,0,10,1022,0,0,270.316727,0.006664999999998145,1226706,0
"172.16.133.63",54219,"172.16.139.250",5440,12,1142,20541,0,0,12,1142,0,0,270.329079,0.0166370000000029,549137,0
"172.16.133.66",54434,"172.16.139.250",5440,12,1142,20542,0,0,12,1142,0,0,270.339165,0.010035000000016225,910413,0
"172.16.133.82",61660,"172.16.139.250",5440,10,1022,20543,0,0,10,1022,0,0,270.354536,0.005898000000001957,1386232,0
"172.16.133.93",61111,"138.108.6.20",80,8,1427,20544,0,0,4,769,4,658,270.363712,10.238167999999973,600,514
"172.16.133.93",61112,"138.108.6.20",80,8,1427,20545,0,0,4,769,4,658,270.36399,11.603980999999976,530,453
"172.16.133.93",61113,"138.108.6.20",80,8,1422,20546,0,0,4,764,4,658,270.364226,10.896147000000042,560,483
"172.16.133.37",60884,"172.16.139.250",5440,10,1022,20547,0,0,10,1022,0,0,270.367173,0.037509000000000015,217974,0
"172.16.133.78",59478,"172.16.139.250",5440,10,1022,20548,0,0,10,1022,0,0,270.523248,0.005648999999948501,1447335,0
"172.16.133.67",56224,"172.16.139.250",5440,10,1022,20549,0,0,10,1022,0,0,270.577782,0.01735800000000154,471022,0
"172.16.133.56",61671,"172.16.139.250",5440,10,1022,20550,0,0,10,1022,0,0,270.601248,0.004711999999983618,"",""
"172.16.133.41",53378,"172.16.139.250",5440,10,1022,20551,0,0,10,1022,0,0,270.655977,0.00567999999998392,1439436,0
"172.16.133.43",57994,"172.16.139.250",5440,10,1022,20552,0,0,10,1022,0,0,270.724515,0.0055960000000254695,1461043,0
"172.16.133.113",55759,"67.217.64.244",443,6,366,20553,0,0,4,246,2,120,270.741078,0.07697400000000698,25567,12471
"172.16.133.13",53285,"172.16.139.250",5440,10,1022,20554,0,0,10,1022,0,0,270.746817,0.005419999999958236,1508487,0
"172.16.133.85",52504,"172.16.139.250",5440,10,1022,20555,0,0,10,1022,0,0,270.750784,0.015701999999976124,520698,0
"172.16.133.113",55760,"216.115.223.200",443,6,366,20556,0,0,4,246,2,120,270.755993,0.10511800000000449,18721,9132
"172.16.133.42",57337,"172.16.139.250",5440,12,1142,20557,0,0,12,1142,0,0,270.778282,0.0166189999999915,549732,0
"172.16.133.113",55761,"66.151.150.190",443,5,306,20558,0,0,3,186,2,120,270.795863,0.1917970000000082,7758,5005
"172.16.133.20",62688,"172.16.139.250",5440,12,1142,20559,0,0,12,1142,0,0,270.79628,0.004920999999967535,"",""
"172.16.133.113",55762,"216.219.113.250",443,7,426,20560,0,0,3,186,4,240,270.815265,23.06128799999999,64,83
"172.16.133.28",49432,"172.16.139.250",5440,10,1022,20561,0,0,10,1022,0,0,270.823615,0.005341999999984637,1530512,0
"172.16.133.99",56278,"172.16.139.250",5440,12,1142,20562,0,0,12,1142,0,0,270.853202,0.01570099999997865,581873,0
"172.16.133.75",51192,"172.16.139.250",5440,10,1022,20563,0,0,10,1022,0,0,270.858715,0.005657999999982621,1445033,0
"172.16.133.87",60483,"172.16.139.250",5440,10,1022,20564,0,0,10,1022,0,0,270.878852,0.020711000000005697,394766,0
"172.16.133.23",55059,"64.90.204.229",443,17,2655,20565,0,0,8,1580,9,1075,270.880387,3.345945000000029,3777,2570
"172.16.133.35",50187,"172.16.139.250",5440,12,1142,20566,0,0,12,1142,0,0,270.885607,0.010738000000003467,850810,0
"172.16.133.116",54048,"172.16.139.250",5440,10,1022,20567,0,0,10,1022,0,0,270.888627,0.007064000000013948,1157417,0
"172.16.133.116",54049,"172.16.139.250",5440,12,1142,20568,0,0,12,1142,0,0,270.896634,0.007963000000017928,1147306,0
"172.16.133.116",54050,"172.16.139.250",5440,10,1022,20569,0,0,10,1022,0,0,270.905578,0.0050160000000119,1629984,0
"172.16.133.84",59028,"172.16.139.250",5440,10,1022,20570,0,0,10,1022,0,0,270.910775,0.01489800000001651,548798,0
"172.16.133.49",56007,"172.16.139.250",5440,12,1142,20571,0,0,12,1142,0,0,270.987593,0.016172999999980675,564892,0
"172.16.133.95",57229,"172.16.139.250",5440,10,1022,20572,0,0,10,1022,0,0,271.031105,0.005493000000001302,1488439,0
"172.16.133.92",57895,"172.16.139.250",5440,10,1022,20573,0,0,10,1022,0,0,271.055991,0.005816999999979089,1405535,0
"172.16.133.29",61229,"172.16.139.250",5440,12,1142,20574,0,0,12,1142,0,0,271.073125,0.016390999999998712,557379,0
"172.16.133.44",65056,"172.16.139.250",5440,10,1022,20575,0,0,10,1022,0,0,271.080395,0.015412999999966814,530461,0
"172.16.133.207",56163,"172.16.139.250",5440,10,1022,20576,0,0,10,1022,0,0,271.104974,0.014726999999993495,555170,0
"172.16.133.83",57330,"172.16.139.250",5440,12,1142,20577,0,0,12,1142,0,0,271.116717,0.00846599999999853,1079140,0
"172.16.133.93",61114,"172.16.139.250",5440,12,1142,20578,0,0,12,1142,0,0,271.129654,0.014396999999974014,634576,0
"172.16.133.11",55392,"172.16.139.250",5440,10,1022,20579,0,0,10,1022,0,0,271.148547,0.005650000000002819,1447079,0
"172.16.133.55",57849,"172.16.139.250",5440,12,1142,20580,0,0,12,1142,0,0,271.152451,0.007028999999988628,1299758,0
"172.16.133.73",60917,"172.16.139.250",5440,12,1142,20581,0,0,12,1142,0,0,271.175509,0.07102600000001758,128628,0
"172.16.133.53",54331,"172.16.139.250",5440,12,1142,20582,0,0,12,1142,0,0,271.176827,0.06162100000000237,148261,0
"172.16.133.21",53405,"172.16.139.250",5440,12,1142,20583,0,0,12,1142,0,0,271.180076,0.06225200000000086,146758,0
"172.16.133.30",62903,"172.16.139.250",5440,12,1142,20584,0,0,12,1142,0,0,271.185653,0.07159500000000207,127606,0
"172.16.133.25",63707,"172.16.139.250",5440,12,1142,20585,0,0,12,1142,0,0,271.191037,0.06110799999999017,149505,0
"172.16.133.34",50696,"172.16.139.250",5440,12,1142,20586,0,0,12,1142,0,0,271.201003,0.059631999999965046,153206,0
"172.16.133.97",59611,"172.16.139.250",5440,12,1142,20587,0,0,12,1142,0,0,271.21043,0.05576500000000806,163830,0
"172.16.133.55",57850,"172.16.128.169",8014,10,4598,20588,0,0,5,1898,5,2700,271.267028,2.120059000000026,7162,10188
"172.16.133.33",58115,"172.16.139.250",5440,12,1142,20589,0,0,12,1142,0,0,271.280662,0.02063599999996768,442721,0
"172.16.133.68",61018,"172.16.139.250",5440,10,1022,20590,0,0,10,1022,0,0,271.317238,0.007477000000051248,1093486,0
"172.16.133.63",54220,"172.16.139.250",5440,12,1142,20591,0,0,12,1142,0,0,271.342796,0.007003999999994903,1304397,0
"172.16.133.66",54435,"172.16.139.250",5440,12,1142,20592,0,0,12,1142,0,0,271.353843,0.005698999999992793,1603088,0
"172.16.133.12",60014,"172.16.139.250",5440,12,1142,20593,0,0,12,1142,0,0,271.35506,0.008793000000025586,1039008,0
"172.16.133.82",61661,"172.16.139.250",5440,12,1142,20594,0,0,12,1142,0,0,271.368963,0.006348000000002685,1439193,0
"172.16.133.37",60885,"172.16.139.250",5440,12,1142,20595,0,0,12,1142,0,0,271.381209,0.00654399999996258,1396088,0
"172.16.133.96",53450,"98.139.183.24",80,92,86968,20596,0,0,33,2868,59,84100,271.503217,15.372768000000008,1492,43765
"172.16.133.78",59479,"172.16.139.250",5440,10,1022,20597,0,0,10,1022,0,0,271.559159,0.006580999999982851,1242364,0
"172.16.133.67",56225,"172.16.139.250",5440,10,1022,20598,0,0,10,1022,0,0,271.592234,0.015716999999995096,520201,0
"172.16.133.56",61672,"172.16.139.250",5440,10,1022,20599,0,0,10,1022,0,0,271.615618,0.004974000000004253,"",""
"172.16.133.41",53379,"172.16.139.250",5440,10,1022,20600,0,0,10,1022,0,0,271.669999,0.01272799999998142,642363,0
"172.16.133.43",57995,"172.16.139.250",5440,10,1022,20601,0,0,10,1022,0,0,271.738454,0.014661999999987074,557631,0
"172.16.133.13",53289,"172.16.139.250",5440,10,1022,20602,0,0,10,1022,0,0,271.760543,0.00571300000001429,1431122,0
"172.16.133.85",52505,"172.16.139.250",5440,10,1022,20603,0,0,10,1022,0,0,271.765213,0.005380000000002383,1519702,0
"172.16.133.42",57338,"172.16.139.250",5440,12,1142,20604,0,0,12,1142,0,0,271.791737,0.008599000000003798,1062449,0
"172.16.133.20",62689,"172.16.139.250",5440,12,1142,20605,0,0,12,1142,0,0,271.810363,0.005560000000002674,1643165,0
"172.16.133.28",49433,"172.16.139.250",5440,10,1022,20606,0,0,10,1022,0,0,271.838701,0.0054869999999596075,1490067,0
"172.16.133.99",56279,"172.16.139.250",5440,10,1022,20607,0,0,10,1022,0,0,271.867999,0.015490999999997257,527790,0
"172.16.133.75",51193,"172.16.139.250",5440,10,1022,20608,0,0,10,1022,0,0,271.872974,0.006271000000026561,1303779,0
"172.16.133.73",60918,"68.64.25.250",443,6,366,20609,0,0,4,246,2,120,271.888733,0.11473399999999856,17152,8367
"172.16.133.73",60919,"68.64.5.249",443,6,366,20610,0,0,4,246,2,120,271.889557,0.10199899999997797,19294,9411
"172.16.133.87",60484,"172.16.139.250",5440,12,1142,20611,0,0,12,1142,0,0,271.893777,0.019202000000007047,475783,0
"172.16.133.35",50188,"172.16.139.250",5440,12,1142,20612,0,0,12,1142,0,0,271.901338,0.010031999999966956,910685,0
"172.16.133.116",54051,"172.16.139.250",5440,10,1022,20613,0,0,10,1022,0,0,271.904124,0.011867999999992662,688911,0
"172.16.133.116",54052,"172.16.139.250",5440,10,1022,20614,0,0,10,1022,0,0,271.917001,0.0049349999999890315,"",""
"172.16.133.116",54053,"172.16.139.250",5440,10,1022,20615,0,0,10,1022,0,0,271.922764,0.0053160000000502805,1537998,0
"172.16.133.84",59029,"172.16.139.250",5440,10,1022,20616,0,0,10,1022,0,0,271.925782,0.01471899999995685,555472,0
"172.16.133.73",60920,"216.115.209.254",443,6,366,20617,0,0,4,246,2,120,271.972918,0.21906400000000303,8983,4382
"172.16.133.49",56008,"172.16.139.250",5440,12,1142,20618,0,0,12,1142,0,0,272.001388,0.006317999999964741,1446027,0
"172.16.133.73",60921,"78.108.119.250",443,6,366,20619,0,0,4,246,2,120,272.013462,0.25457499999998845,7730,3770
"172.16.133.95",57230,"172.16.139.250",5440,10,1022,20620,0,0,10,1022,0,0,272.044187,0.005470000000002528,1494698,0
"172.16.133.96",53451,"98.139.50.175",80,12,1965,20621,0,0,7,1167,5,798,272.066003,0.08874399999996285,105201,71937
"172.16.133.92",57896,"172.16.139.250",5440,12,1142,20622,0,0,12,1142,0,0,272.070189,0.01521399999995765,600499,0
"172.16.133.29",61230,"172.16.139.250",5440,10,1022,20623,0,0,10,1022,0,0,272.088031,0.005603000000007796,1459218,0
"172.16.133.44",65057,"172.16.139.250",5440,10,1022,20624,0,0,10,1022,0,0,272.094599,0.015347999999960393,532707,0
"172.16.133.207",56164,"172.16.139.250",5440,10,1022,20625,0,0,10,1022,0,0,272.118755,0.013192000000003645,619769,0
"172.16.133.83",57331,"172.16.139.250",5440,10,1022,20626,0,0,10,1022,0,0,272.130789,0.0059640000000058535,1370892,0
"172.16.133.93",61115,"172.16.139.250",5440,12,1142,20627,0,0,12,1142,0,0,272.143615,0.004847999999981312,"",""
"172.16.133.11",55393,"172.16.139.250",5440,12,1142,20628,0,0,12,1142,0,0,272.162032,0.01623899999998457,562596,0
"172.16.133.55",57851,"172.16.139.250",5440,12,1142,20629,0,0,12,1142,0,0,272.166574,0.006387999999958538,1430181,0
"172.16.133.73",60922,"172.16.139.250",5440,12,1142,20630,0,0,12,1142,0,0,272.188779,0.006723999999962871,1358715,0
"172.16.133.53",54332,"172.16.139.250",5440,12,1142,20632,0,0,12,1142,0,0,272.192038,0.007187999999985095,1271007,0
"172.16.133.21",53406,"172.16.139.250",5440,10,1022,20633,0,0,10,1022,0,0,272.194668,0.019144000000039796,427078,0
"172.16.133.30",62904,"172.16.139.250",5440,12,1142,20634,0,0,12,1142,0,0,272.199462,0.006099000000006072,1497950,0
"172.16.133.25",63708,"172.16.139.250",5440,12,1142,20635,0,0,12,1142,0,0,272.205036,0.0048620000000028085,"",""
"172.16.133.34",50697,"172.16.139.250",5440,10,1022,20636,0,0,10,1022,0,0,272.21504,0.006437000000005355,1270156,0
"172.16.133.97",59612,"172.16.139.250",5440,12,1142,20637,0,0,12,1142,0,0,272.224562,0.015495999999984633,589571,0
"172.16.133.33",58116,"172.16.139.250",5440,12,1142,20638,0,0,12,1142,0,0,272.295194,0.006545000000016898,1395874,0
"172.16.133.68",61019,"172.16.139.250",5440,10,1022,20639,0,0,10,1022,0,0,272.330722,0.005783000000008087,1413799,0
"172.16.133.12",60015,"172.16.139.250",5440,12,1142,20640,0,0,12,1142,0,0,272.3447,0.005898000000001957,1548999,0
"172.16.133.63",54221,"172.16.139.250",5440,12,1142,20641,0,0,12,1142,0,0,272.356856,0.0065180000000282234,1401656,0
"172.16.133.66",54436,"172.16.139.250",5440,12,1142,20642,0,0,12,1142,0,0,272.366742,0.015299000000027263,597163,0
"172.16.133.97",59613,"180.153.30.250",443,6,366,20643,0,0,4,246,2,120,272.370158,0.7310979999999745,2691,1313
"172.16.133.82",61662,"172.16.139.250",5440,10,1022,20644,0,0,10,1022,0,0,272.381684,0.015851999999995314,515770,0
"172.16.133.37",60886,"172.16.139.250",5440,10,1022,20645,0,0,10,1022,0,0,272.395099,0.00625999999999749,1306070,0
"172.16.133.96",53452,"98.139.240.23",80,10,1846,20646,0,0,6,1228,4,618,272.395805,0.10904199999998809,90093,45340
"172.16.133.96",53453,"98.139.225.13",80,12,1949,20647,0,0,7,1039,5,910,272.40383,0.10948199999995722,75921,66494
"172.16.133.96",53454,"76.13.234.33",80,12,1848,20648,0,0,7,1135,5,713,272.444539,0.08342399999997951,108841,68373
"172.16.133.78",59481,"172.16.139.250",5440,10,1022,20649,0,0,10,1022,0,0,272.553125,0.005546999999978652,1473949,0
"172.16.133.67",56226,"172.16.139.250",5440,12,1142,20650,0,0,12,1142,0,0,272.605994,0.006245999999975993,1462696,0
"172.16.133.56",61673,"172.16.139.250",5440,10,1022,20651,0,0,10,1022,0,0,272.628663,0.004845999999986361,"",""
"172.16.133.41",53380,"172.16.139.250",5440,10,1022,20652,0,0,10,1022,0,0,272.683017,0.005632999999988897,1451446,0
"172.16.133.43",57996,"172.16.139.250",5440,10,1022,20653,0,0,10,1022,0,0,272.752818,0.015457000000026255,528951,0
"172.16.133.13",53290,"172.16.139.250",5440,10,1022,20654,0,0,10,1022,0,0,272.773459,0.005332000000009884,1533383,0
"172.16.128.233",50954,"172.16.133.233",22,185,28716,20655,0,0,52,4300,133,24416,272.777079,7.943434999999965,4330,24589
"172.16.133.85",52506,"172.16.139.250",5440,10,1022,20656,0,0,10,1022,0,0,272.778987,0.01472900000004529,555095,0
"172.16.133.84",59031,"184.73.225.104",443,22,7276,20657,0,0,11,1982,11,5294,272.801918,5.382069000000001,2946,7869
"172.16.133.42",57339,"172.16.139.250",5440,12,1142,20658,0,0,12,1142,0,0,272.811086,0.012095999999985452,755291,0
"172.16.133.20",62690,"172.16.139.250",5440,12,1142,20659,0,0,12,1142,0,0,272.824477,0.004818000000000211,"",""
"172.16.133.28",49434,"172.16.139.250",5440,10,1022,20660,0,0,10,1022,0,0,272.852931,0.015249999999980446,536131,0
"172.16.133.99",56280,"172.16.139.250",5440,10,1022,20661,0,0,10,1022,0,0,272.881433,0.014707999999984622,555887,0
"172.16.133.75",51194,"172.16.139.250",5440,10,1022,20662,0,0,10,1022,0,0,272.886304,0.006657000000018343,1228180,0
"172.16.133.87",60485,"172.16.139.250",5440,10,1022,20663,0,0,10,1022,0,0,272.906651,0.005566999999985001,1468654,0
"172.16.133.35",50189,"172.16.139.250",5440,12,1142,20664,0,0,12,1142,0,0,272.908968,0.009976999999992131,915706,0
"172.16.133.116",54054,"172.16.139.250",5440,10,1022,20665,0,0,10,1022,0,0,272.918029,0.005675999999994019,1440451,0
"172.16.133.116",54055,"172.16.139.250",5440,10,1022,20666,0,0,10,1022,0,0,272.924683,0.005286000000012336,1546727,0
"172.16.133.116",54056,"172.16.139.250",5440,10,1022,20667,0,0,10,1022,0,0,272.930994,0.005656999999985146,1445289,0
"172.16.133.84",59032,"172.16.139.250",5440,10,1022,20668,0,0,10,1022,0,0,272.939049,0.005369999999970787,1522532,0
"172.16.133.68",61020,"50.16.236.36",80,10,1430,20669,0,0,5,951,5,479,272.983304,0.12987800000001926,58578,29504
"172.16.133.49",56009,"172.16.139.250",5440,10,1022,20670,0,0,10,1022,0,0,273.015392,0.01559199999996963,524371,0
"172.16.133.95",57231,"172.16.139.250",5440,10,1022,20671,0,0,10,1022,0,0,273.059291,0.005423000000007505,1507652,0
"172.16.133.92",57897,"172.16.139.250",5440,10,1022,20672,0,0,10,1022,0,0,273.082162,0.005311000000006061,1539446,0
"172.16.133.84",59033,"157.56.234.137",443,6,374,20673,0,0,3,194,3,180,273.096157,1.208488999999986,1284,1191
"172.16.133.29",61231,"172.16.139.250",5440,10,1022,20674,0,0,10,1022,0,0,273.101425,0.005195000000014716,1573820,0
"172.16.133.44",65058,"172.16.139.250",5440,10,1022,20675,0,0,10,1022,0,0,273.107481,0.015452999999979511,529088,0
"172.16.133.207",56165,"172.16.139.250",5440,12,1142,20676,0,0,12,1142,0,0,273.132906,0.014810000000011314,616880,0
"172.16.133.83",57332,"172.16.139.250",5440,10,1022,20677,0,0,10,1022,0,0,273.144766,0.006596000000001823,1239539,0
"172.16.133.93",61116,"172.16.139.250",5440,10,1022,20678,0,0,10,1022,0,0,273.157913,0.004769000000010237,"",""
"172.16.133.11",55394,"172.16.139.250",5440,10,1022,20679,0,0,10,1022,0,0,273.176547,0.014854999999954543,550387,0
"172.16.133.55",57852,"172.16.139.250",5440,10,1022,20680,0,0,10,1022,0,0,273.180422,0.014827999999965868,551389,0
"172.16.133.73",60923,"172.16.139.250",5440,10,1022,20681,0,0,10,1022,0,0,273.203201,0.005556000000012773,1471562,0
"172.16.133.53",54333,"172.16.139.250",5440,10,1022,20682,0,0,10,1022,0,0,273.206124,0.006475000000023101,1262702,0
"172.16.133.21",53407,"172.16.139.250",5440,10,1022,20683,0,0,10,1022,0,0,273.208639,0.019036999999968884,429479,0
"172.16.133.30",62905,"172.16.139.250",5440,10,1022,20684,0,0,10,1022,0,0,273.214223,0.017368999999973767,470723,0
"172.16.133.25",63709,"172.16.139.250",5440,12,1142,20685,0,0,12,1142,0,0,273.218975,0.004995000000008076,"",""
"172.16.133.34",50698,"172.16.139.250",5440,10,1022,20686,0,0,10,1022,0,0,273.228784,0.007120999999983724,1148153,0
"172.16.133.97",59614,"172.16.139.250",5440,10,1022,20687,0,0,10,1022,0,0,273.238704,0.00550900000001775,1484116,0
"172.16.133.78",59482,"172.16.128.169",8014,9,1412,20688,0,0,6,1050,3,362,273.262894,15.19066799999996,552,190
"172.16.133.33",58117,"172.16.139.250",5440,10,1022,20689,0,0,10,1022,0,0,273.308663,0.005821999999966465,1404328,0
"172.16.133.68",61021,"172.16.139.250",5440,10,1022,20690,0,0,10,1022,0,0,273.344519,0.005621000000019194,1454545,0
"172.16.133.12",60016,"172.16.139.250",5440,10,1022,20691,0,0,10,1022,0,0,273.357659,0.006619999999998072,1235045,0
"172.16.133.63",54222,"172.16.139.250",5440,12,1142,20692,0,0,12,1142,0,0,273.371136,0.01948400000003403,468897,0
"172.16.133.66",54437,"172.16.139.250",5440,10,1022,20693,0,0,10,1022,0,0,273.380674,0.005580000000009022,1465232,0
"172.16.133.82",61663,"172.16.139.250",5440,12,1142,20694,0,0,12,1142,0,0,273.396885,0.006267999999977292,1457562,0
"172.16.133.37",60887,"172.16.139.250",5440,10,1022,20695,0,0,10,1022,0,0,273.408941,0.005474999999989905,1493333,0
"172.16.133.78",59483,"172.16.139.250",5440,12,1142,20696,0,0,12,1142,0,0,273.566237,0.0064469999999801075,1417093,0
"172.16.133.67",56227,"172.16.139.250",5440,12,1142,20697,0,0,12,1142,0,0,273.619818,0.0059679999999957545,1530831,0
"172.16.133.56",61674,"172.16.139.250",5440,10,1022,20698,0,0,10,1022,0,0,273.64352,0.005220999999949072,1565983,0
"172.16.133.41",53381,"172.16.139.250",5440,10,1022,20699,0,0,10,1022,0,0,273.697276,0.005506000000025324,1484925,0
"172.16.133.43",57997,"172.16.139.250",5440,12,1142,20700,0,0,12,1142,0,0,273.766951,0.006177999999977146,1478795,0
"172.16.133.13",53291,"172.16.139.250",5440,10,1022,20701,0,0,10,1022,0,0,273.788013,0.00533500000000231,1532521,0
"172.16.133.85",52507,"172.16.139.250",5440,10,1022,20702,0,0,10,1022,0,0,273.792886,0.005385999999987234,1518009,0
"172.16.133.42",57340,"172.16.139.250",5440,12,1142,20703,0,0,12,1142,0,0,273.823802,0.016633000000013,549269,0
"172.16.133.20",62691,"172.16.139.250",5440,12,1142,20704,0,0,12,1142,0,0,273.838464,0.005357000000003609,1705432,0
"172.16.133.126",62157,"157.56.244.214",443,24,11274,20705,0,0,11,2497,13,8777,273.842618,0.774454999999989,25793,90665
"172.16.133.28",49435,"172.16.139.250",5440,10,1022,20706,0,0,10,1022,0,0,273.865626,0.014536999999961608,562426,0
"172.16.133.99",56281,"172.16.139.250",5440,12,1142,20707,0,0,12,1142,0,0,273.89534,0.014718000000016218,620736,0
"172.16.133.36",65038,"96.43.146.22",443,2,132,20708,0,0,1,66,1,66,273.897693,8.600000001024455e-05,"",""
"172.16.133.36",65035,"96.43.146.22",443,2,132,20709,0,0,1,66,1,66,273.898064,6.400000000894579e-05,"",""
"172.16.133.36",65032,"96.43.146.22",443,2,132,20710,0,0,1,66,1,66,273.898577,0.0011570000000347136,"",""
"172.16.133.36",65036,"96.43.146.22",443,2,132,20711,0,0,1,66,1,66,273.898579,0.0011570000000347136,"",""
"172.16.133.36",65033,"96.43.146.22",443,2,132,20712,0,0,1,66,1,66,273.899001,0.0008090000000038344,"",""
"172.16.133.36",65034,"96.43.146.22",443,2,132,20713,0,0,1,66,1,66,273.899003,0.0008090000000038344,"",""
"172.16.133.75",51195,"172.16.139.250",5440,12,1142,20714,0,0,12,1142,0,0,273.901785,0.015280999999959022,597866,0
"172.16.133.87",60486,"172.16.139.250",5440,10,1022,20715,0,0,10,1022,0,0,273.920097,0.008545000000026448,956816,0
"172.16.133.35",50190,"172.16.139.250",5440,12,1142,20716,0,0,12,1142,0,0,273.922977,0.013423999999986336,680572,0
"172.16.133.116",54057,"172.16.139.250",5440,10,1022,20717,0,0,10,1022,0,0,273.931363,0.007516000000009626,1087812,0
"172.16.133.116",54058,"172.16.139.250",5440,12,1142,20718,0,0,12,1142,0,0,273.939792,0.015802000000007865,578154,0
"172.16.133.73",60924,"68.64.5.249",443,6,366,20719,0,0,4,246,2,120,273.945702,0.10714799999999514,18367,8959
"172.16.133.84",59034,"172.16.139.250",5440,10,1022,20720,0,0,10,1022,0,0,273.954102,0.015271000000041113,535393,0
"172.16.133.116",54059,"172.16.139.250",5440,10,1022,20721,0,0,10,1022,0,0,273.956288,0.0051170000000411164,1597811,0
"172.16.133.73",60925,"68.64.25.250",443,6,366,20722,0,0,4,246,2,120,273.972659,0.10228599999999233,19240,9385
"172.16.133.49",56010,"172.16.139.250",5440,10,1022,20723,0,0,10,1022,0,0,274.028752,0.015516999999988457,526905,0
"172.16.133.36",65089,"54.243.254.190",443,22,8920,20724,0,0,12,7153,10,1767,274.029021,17.36477400000001,3295,814
"172.16.133.36",65090,"54.243.254.190",443,22,8792,20725,0,0,12,7137,10,1655,274.039737,17.41424999999998,3278,760
"172.16.133.95",57232,"172.16.139.250",5440,12,1142,20726,0,0,12,1142,0,0,274.073447,0.02618000000001075,348968,0
"172.16.133.73",60926,"216.115.209.254",443,6,366,20727,0,0,4,246,2,120,274.093691,0.19489000000004353,10098,4925
"172.16.133.92",57898,"172.16.139.250",5440,10,1022,20728,0,0,10,1022,0,0,274.097057,0.012196000000017193,670383,0
"172.16.133.29",61232,"172.16.139.250",5440,10,1022,20729,0,0,10,1022,0,0,274.116053,0.005496999999991203,1487356,0
"172.16.133.44",65059,"172.16.139.250",5440,10,1022,20730,0,0,10,1022,0,0,274.12143,0.015522000000032676,526736,0
"172.16.133.73",60927,"78.108.119.250",443,6,366,20731,0,0,4,246,2,120,274.144617,0.250282000000027,7863,3835
"172.16.133.207",56166,"172.16.139.250",5440,12,1142,20732,0,0,12,1142,0,0,274.1469,0.01469299999996565,621792,0
"172.16.133.23",55060,"64.90.204.229",443,17,3101,20733,0,0,8,1780,9,1321,274.149193,11.412938999999994,1247,925
"172.16.133.83",57333,"172.16.139.250",5440,12,1142,20734,0,0,12,1142,0,0,274.157743,0.013922000000036405,656227,0
"172.16.133.93",61117,"172.16.139.250",5440,10,1022,20735,0,0,10,1022,0,0,274.171549,0.004773000000000138,"",""
"172.16.133.11",55395,"172.16.139.250",5440,10,1022,20736,0,0,10,1022,0,0,274.190274,0.015081000000009226,542139,0
"172.16.133.55",57853,"172.16.139.250",5440,10,1022,20737,0,0,10,1022,0,0,274.194472,0.014830999999958294,551277,0
"172.16.133.73",60928,"172.16.139.250",5440,10,1022,20738,0,0,10,1022,0,0,274.217288,0.005385999999987234,1518009,0
"172.16.133.53",54334,"172.16.139.250",5440,12,1142,20739,0,0,12,1142,0,0,274.220075,0.007435999999984233,1228617,0
"172.16.133.21",53408,"172.16.139.250",5440,10,1022,20740,0,0,10,1022,0,0,274.223442,0.0072959999999966385,1120614,0
"172.16.133.30",62906,"172.16.139.250",5440,10,1022,20741,0,0,10,1022,0,0,274.227149,0.007382000000006883,1107558,0
"172.16.133.25",63710,"172.16.139.250",5440,10,1022,20742,0,0,10,1022,0,0,274.233247,0.006048000000021148,1351851,0
"172.16.133.34",50699,"172.16.139.250",5440,12,1142,20743,0,0,12,1142,0,0,274.243134,0.005055000000027121,1807319,0
"172.16.133.97",59615,"172.16.139.250",5440,10,1022,20744,0,0,10,1022,0,0,274.252685,0.005631999999991422,1451704,0
"172.16.133.84",59035,"157.56.236.89",443,5,314,20745,0,0,3,194,2,120,274.305167,6.6775670000000105,232,143
"172.16.133.33",58118,"172.16.139.250",5440,10,1022,20746,0,0,10,1022,0,0,274.322569,0.014905999999996311,548503,0
"172.16.133.68",61022,"172.16.139.250",5440,10,1022,20747,0,0,10,1022,0,0,274.359544,0.005778999999961343,1414777,0
"172.16.133.12",60017,"172.16.139.250",5440,10,1022,20748,0,0,10,1022,0,0,274.371977,0.0054369999999721585,1503770,0
"172.16.133.63",54223,"172.16.139.250",5440,10,1022,20749,0,0,10,1022,0,0,274.384756,0.014599000000032447,560038,0
"172.16.133.66",54438,"172.16.139.250",5440,12,1142,20750,0,0,12,1142,0,0,274.395054,0.008854999999982738,1031733,0
"172.16.133.82",61664,"172.16.139.250",5440,12,1142,20751,0,0,12,1142,0,0,274.410264,0.01597100000003593,572036,0
"172.16.133.37",60888,"172.16.139.250",5440,12,1142,20752,0,0,12,1142,0,0,274.42329,0.00611700000001747,1493542,0
"172.16.133.78",59484,"172.16.139.250",5440,12,1142,20753,0,0,12,1142,0,0,274.579145,0.0062629999999899155,1458725,0
"172.16.133.67",56228,"172.16.139.250",5440,12,1142,20754,0,0,12,1142,0,0,274.648468,0.006793000000016036,1344913,0
"172.16.133.56",61675,"172.16.139.250",5440,10,1022,20755,0,0,10,1022,0,0,274.657321,0.01746399999996129,468163,0
"172.16.133.41",53382,"172.16.139.250",5440,10,1022,20756,0,0,10,1022,0,0,274.711208,0.005448999999998705,1500458,0
"172.16.133.43",57998,"172.16.139.250",5440,10,1022,20757,0,0,10,1022,0,0,274.780554,0.01454799999999068,562001,0
"172.16.133.13",53292,"172.16.139.250",5440,10,1022,20758,0,0,10,1022,0,0,274.801767,0.01539300000001731,531150,0
"172.16.133.85",52508,"172.16.139.250",5440,10,1022,20759,0,0,10,1022,0,0,274.807098,0.014851000000021486,550535,0
"172.16.133.42",57341,"172.16.139.250",5440,12,1142,20760,0,0,12,1142,0,0,274.83777,0.060252000000048156,151629,0
"172.16.133.20",62692,"172.16.139.250",5440,12,1142,20761,0,0,12,1142,0,0,274.852232,0.019663999999977477,464605,0
"172.16.133.28",49436,"172.16.139.250",5440,10,1022,20762,0,0,10,1022,0,0,274.881158,0.008277999999961594,987678,0
"172.16.133.99",56282,"172.16.139.250",5440,10,1022,20763,0,0,10,1022,0,0,274.9092,0.014954999999986285,546706,0
"172.16.133.24",57719,"96.43.146.22",443,8,881,20764,0,0,5,572,3,309,274.913015,3.146346000000051,1454,785
"172.16.133.75",51196,"172.16.139.250",5440,10,1022,20765,0,0,10,1022,0,0,274.914833,0.0054620000000227265,1496887,0
"172.16.133.87",60487,"172.16.139.250",5440,10,1022,20766,0,0,10,1022,0,0,274.934744,0.005776999999966392,1415267,0
"172.16.133.35",50191,"172.16.139.250",5440,12,1142,20767,0,0,12,1142,0,0,274.937428,0.03725099999996928,245255,0
"172.16.133.116",54060,"172.16.139.250",5440,10,1022,20768,0,0,10,1022,0,0,274.945783,0.00510300000001962,1602194,0
"172.16.133.116",54061,"172.16.139.250",5440,10,1022,20769,0,0,10,1022,0,0,274.953155,0.006819000000007236,1199002,0
"172.16.133.116",54062,"172.16.139.250",5440,12,1142,20770,0,0,12,1142,0,0,274.960843,0.007244000000014239,1261181,0
"172.16.133.84",59036,"172.16.139.250",5440,10,1022,20771,0,0,10,1022,0,0,274.968088,0.005495999999993728,1487627,0
"172.16.133.24",57720,"75.101.140.131",443,33,14752,20772,0,0,16,7259,17,7493,274.983286,4.561224999999979,12731,13142
"172.16.133.24",57721,"75.101.140.131",443,8,1080,20773,0,0,4,695,4,385,274.983412,0.12961100000001124,42897,23763
"172.16.133.24",57722,"96.43.146.22",443,13,4251,20774,0,0,8,3568,5,683,274.983898,0.40947199999999384,69709,13344
"172.16.133.24",57723,"75.101.140.131",443,8,1080,20775,0,0,4,695,4,385,275.007639,0.7365139999999997,7549,4181
"172.16.133.49",56011,"172.16.139.250",5440,10,1022,20776,0,0,10,1022,0,0,275.043355,0.022921999999994114,356687,0
"172.16.133.95",57233,"172.16.139.250",5440,10,1022,20777,0,0,10,1022,0,0,275.087569,0.015286000000003241,534868,0
"172.16.133.92",57899,"172.16.139.250",5440,10,1022,20778,0,0,10,1022,0,0,275.110724,0.005556000000012773,1471562,0
"172.16.133.29",61233,"172.16.139.250",5440,10,1022,20779,0,0,10,1022,0,0,275.129314,0.015826000000004115,516618,0
"172.16.133.44",65060,"172.16.139.250",5440,10,1022,20780,0,0,10,1022,0,0,275.136035,0.005420000000015079,1508487,0
"172.16.133.207",56167,"172.16.139.250",5440,10,1022,20781,0,0,10,1022,0,0,275.160691,0.004537000000027547,"",""
"172.16.133.83",57334,"172.16.139.250",5440,12,1142,20782,0,0,12,1142,0,0,275.171065,0.014502999999990607,629938,0
"172.16.133.93",61118,"172.16.139.250",5440,12,1142,20783,0,0,12,1142,0,0,275.186867,0.0048390000000040345,"",""
"172.16.133.11",55396,"172.16.139.250",5440,10,1022,20784,0,0,10,1022,0,0,275.20275,0.015885000000025684,514699,0
"172.16.133.55",57854,"172.16.139.250",5440,10,1022,20785,0,0,10,1022,0,0,275.209151,0.00547599999998738,1493060,0
"172.16.133.68",61023,"208.117.46.102",80,12,2882,20786,0,0,6,847,6,2035,275.226954,1.0806340000000318,6270,15065
"172.16.133.96",53455,"76.13.115.116",80,83,76144,20787,0,0,31,2940,52,73204,275.227553,2.761117000000013,8518,212099
"172.16.133.73",60929,"172.16.139.250",5440,10,1022,20788,0,0,10,1022,0,0,275.230235,0.005498999999986154,1486815,0
"172.16.133.53",54335,"172.16.139.250",5440,10,1022,20789,0,0,10,1022,0,0,275.234049,0.015677999999979875,521495,0
"172.16.133.21",53409,"172.16.139.250",5440,12,1142,20790,0,0,12,1142,0,0,275.236691,0.006409000000019205,1425495,0
"172.16.133.30",62907,"172.16.139.250",5440,10,1022,20791,0,0,10,1022,0,0,275.240961,0.016651999999965028,490992,0
"172.16.133.25",63711,"172.16.139.250",5440,10,1022,20792,0,0,10,1022,0,0,275.246923,0.006682000000012067,1223585,0
"172.16.133.34",50700,"172.16.139.250",5440,10,1022,20793,0,0,10,1022,0,0,275.257612,0.005015000000014425,1630309,0
"172.16.133.97",59616,"172.16.139.250",5440,10,1022,20794,0,0,10,1022,0,0,275.266842,0.0053449999999770625,1529653,0
"172.16.133.33",58119,"172.16.139.250",5440,12,1142,20795,0,0,12,1142,0,0,275.33723,0.006342000000017833,1440555,0
"172.16.133.68",61024,"172.16.139.250",5440,10,1022,20796,0,0,10,1022,0,0,275.372675,0.005479999999977281,1491970,0
"172.16.133.12",60018,"172.16.139.250",5440,10,1022,20797,0,0,10,1022,0,0,275.386049,0.0055289999999672546,1478748,0
"172.16.133.63",54224,"172.16.139.250",5440,10,1022,20798,0,0,10,1022,0,0,275.398949,0.005415999999968335,1509601,0
"172.16.133.66",54439,"172.16.139.250",5440,10,1022,20799,0,0,10,1022,0,0,275.409034,0.005345999999974538,1529367,0
"172.16.133.82",61665,"172.16.139.250",5440,10,1022,20800,0,0,10,1022,0,0,275.424947,0.015503000000023803,527381,0
"172.16.133.37",60889,"172.16.139.250",5440,10,1022,20801,0,0,10,1022,0,0,275.436259,0.008094999999968877,1010006,0
"172.16.133.78",59485,"172.16.139.250",5440,12,1142,20802,0,0,12,1142,0,0,275.594545,0.0062629999999899155,1458725,0
"172.16.133.67",56229,"172.16.139.250",5440,10,1022,20803,0,0,10,1022,0,0,275.648062,0.005834999999990487,1401199,0
"172.16.133.24",57724,"75.101.140.131",443,8,1080,20804,0,0,4,695,4,385,275.651268,0.12289399999997386,45242,25062
"172.16.133.24",57725,"75.101.140.131",443,8,1080,20805,0,0,4,695,4,385,275.651462,0.12270100000000639,45313,25101
"172.16.133.24",57726,"204.93.223.146",443,14,3639,20806,0,0,7,3015,7,624,275.651859,1.8316039999999703,13168,2725
"172.16.133.24",57727,"23.20.10.203",443,18,5914,20807,0,0,9,966,9,4948,275.652359,10.250253999999984,753,3861
"172.16.133.24",57728,"23.20.10.203",443,18,5914,20808,0,0,9,966,9,4948,275.652654,10.243749000000037,754,3864
"172.16.133.24",57729,"23.20.10.203",443,18,5914,20809,0,0,9,966,9,4948,275.652942,10.249582000000032,753,3862
"172.16.133.24",57730,"23.20.10.203",443,18,5914,20810,0,0,9,966,9,4948,275.653166,10.24906900000002,754,3862
"172.16.133.24",57731,"23.20.10.203",443,18,5914,20811,0,0,9,966,9,4948,275.653319,10.249822999999992,753,3861
"172.16.133.24",57732,"107.21.174.95",443,18,5915,20812,0,0,9,967,9,4948,275.653557,10.24887000000001,754,3862
"172.16.133.24",57733,"107.21.174.95",443,18,5915,20813,0,0,9,967,9,4948,275.653658,10.248676999999986,754,3862
"172.16.133.24",57734,"23.22.135.102",443,18,5913,20814,0,0,9,965,9,4948,275.653899,10.246797999999956,753,3863
"172.16.133.24",57735,"23.22.135.102",443,18,5913,20815,0,0,9,965,9,4948,275.654114,10.24801500000001,753,3862
"172.16.133.24",57736,"23.20.26.196",443,18,5913,20816,0,0,9,965,9,4948,275.654232,10.248568000000034,753,3862
"172.16.133.24",57737,"23.20.26.196",443,18,5913,20817,0,0,9,965,9,4948,275.654396,10.248532999999952,753,3862
"172.16.133.24",57738,"23.20.26.196",443,18,5913,20818,0,0,9,965,9,4948,275.654512,10.248739,753,3862
"172.16.133.24",57739,"23.20.26.196",443,18,5913,20819,0,0,9,965,9,4948,275.654605,10.24810100000002,753,3862
"172.16.133.56",61678,"172.16.139.250",5440,10,1022,20820,0,0,10,1022,0,0,275.670432,0.009389999999996235,870713,0
"172.16.133.41",53383,"172.16.139.250",5440,10,1022,20821,0,0,10,1022,0,0,275.725218,0.005529000000024098,1478748,0
"172.16.133.24",57740,"64.208.138.113",443,28,14034,20822,0,0,14,6089,14,7945,275.775151,20.124247000000025,2420,3158
"172.16.133.43",57999,"172.16.139.250",5440,12,1142,20823,0,0,12,1142,0,0,275.795325,0.015621000000010099,584853,0
"172.16.133.24",57741,"204.246.169.142",443,20,8731,20824,0,0,10,1618,10,7113,275.812351,0.5591130000000248,23150,101775
"172.16.133.13",53293,"172.16.139.250",5440,10,1022,20825,0,0,10,1022,0,0,275.815719,0.01567499999998745,521594,0
"172.16.133.85",52509,"172.16.139.250",5440,10,1022,20826,0,0,10,1022,0,0,275.821391,0.015237000000013268,536588,0
"172.16.133.42",57342,"172.16.139.250",5440,12,1142,20827,0,0,12,1142,0,0,275.856339,0.00941699999998491,970160,0
"172.16.133.20",62693,"172.16.139.250",5440,12,1142,20828,0,0,12,1142,0,0,275.865753,0.005436000000031527,1680647,0
"172.16.133.24",57742,"204.232.201.76",443,20,7602,20829,0,0,9,1973,11,5629,275.86681,10.079348000000039,1565,4467
"172.16.133.28",49437,"172.16.139.250",5440,12,1142,20830,0,0,12,1142,0,0,275.894887,0.006185000000016316,1477122,0
"172.16.133.24",57743,"204.232.201.76",443,7,432,20831,0,0,4,246,3,186,275.900737,12.477784999999983,157,119
"172.16.133.24",57744,"107.22.33.210",443,26,11128,20832,0,0,14,4905,12,6223,275.912253,9.98966999999999,3928,4983
"172.16.133.99",56283,"172.16.139.250",5440,12,1142,20833,0,0,12,1142,0,0,275.923551,0.02009600000002365,454617,0
"172.16.133.75",51197,"172.16.139.250",5440,10,1022,20834,0,0,10,1022,0,0,275.929111,0.010476000000039676,780450,0
"172.16.133.87",60489,"172.16.139.250",5440,10,1022,20835,0,0,10,1022,0,0,275.949334,0.005659999999977572,1444522,0
"172.16.133.116",54063,"172.16.139.250",5440,10,1022,20836,0,0,10,1022,0,0,275.95879,0.005410999999980959,1510996,0
"172.16.133.35",50192,"172.16.139.250",5440,12,1142,20837,0,0,12,1142,0,0,275.962115,0.029171000000019376,313187,0
"172.16.133.116",54064,"172.16.139.250",5440,10,1022,20838,0,0,10,1022,0,0,275.965111,0.005234000000029937,1562094,0
"172.16.133.116",54065,"172.16.139.250",5440,12,1142,20839,0,0,12,1142,0,0,275.971153,0.008082000000001699,1130413,0
"172.16.133.84",59037,"172.16.139.250",5440,12,1142,20840,0,0,12,1142,0,0,275.981084,0.006344000000012784,1440100,0
"172.16.133.96",53456,"98.137.80.33",80,130,121075,20841,0,0,48,9754,82,111321,275.983375,2.0082559999999603,38855,443453
"172.16.133.96",53457,"98.137.80.33",80,45,34051,20842,0,0,20,4707,25,29344,275.984002,2.007628000000011,18756,116930
"172.16.133.96",53458,"98.137.80.33",80,48,37506,20843,0,0,20,3833,28,33673,275.984438,2.0053689999999733,15290,134331
"172.16.133.73",60930,"68.64.5.249",443,6,366,20844,0,0,4,246,2,120,276.005721,0.11884900000001153,16558,8077
"172.16.133.73",60931,"68.64.25.250",443,6,366,20845,0,0,4,246,2,120,276.027901,0.1292060000000106,15231,7429
"172.16.133.49",56012,"172.16.139.250",5440,12,1142,20846,0,0,12,1142,0,0,276.057452,0.016444999999976062,555548,0
"172.16.133.87",60490,"157.56.240.102",443,25,13084,20847,0,0,11,2745,14,10339,276.094625,0.7719730000000027,28446,107143
"172.16.133.95",57234,"172.16.139.250",5440,12,1142,20848,0,0,12,1142,0,0,276.101251,0.015403999999989537,593092,0
"172.16.133.96",53459,"209.234.234.12",80,29,19475,20849,0,0,15,6549,14,12926,276.113873,1.9177139999999895,27320,53922
"172.16.133.92",57900,"172.16.139.250",5440,12,1142,20850,0,0,12,1142,0,0,276.124185,0.007009999999979755,1303281,0
"172.16.133.29",61234,"172.16.139.250",5440,12,1142,20851,0,0,12,1142,0,0,276.144587,0.0061059999999883985,1496233,0
"172.16.133.44",65061,"172.16.139.250",5440,10,1022,20852,0,0,10,1022,0,0,276.149392,0.005374000000017531,1521399,0
"172.16.133.207",56168,"172.16.139.250",5440,12,1142,20853,0,0,12,1142,0,0,276.174842,0.018564999999966858,492108,0
"172.16.133.83",57335,"172.16.139.250",5440,12,1142,20854,0,0,12,1142,0,0,276.184819,0.00463799999999992,"",""
"172.16.133.73",60932,"216.115.209.254",443,6,366,20855,0,0,4,246,2,120,276.193755,0.23600299999998242,8338,4067
"172.16.133.96",53460,"192.221.110.126",80,58,52639,20856,0,0,20,2103,38,50536,276.196721,1.8025159999999687,9333,224290
"172.16.133.93",61119,"172.16.139.250",5440,12,1142,20857,0,0,12,1142,0,0,276.200157,0.004917000000034477,"",""
"172.16.133.96",53461,"23.67.243.35",80,29,17101,20858,0,0,15,2059,14,15042,276.200515,1.793356000000017,9185,67101
"172.16.133.11",55397,"172.16.139.250",5440,12,1142,20859,0,0,12,1142,0,0,276.21921,0.006731000000002041,1357302,0
"172.16.133.55",57855,"172.16.139.250",5440,12,1142,20860,0,0,12,1142,0,0,276.223447,0.006499999999959982,1405538,0
"172.16.133.96",53462,"98.137.80.33",80,24,16037,20861,0,0,11,1447,13,14590,276.243164,1.7468400000000202,6626,66817
"172.16.133.96",53463,"209.234.234.12",80,22,12105,20862,0,0,12,4384,10,7721,276.243965,1.7871549999999843,19624,34562
"172.16.133.96",53464,"98.137.80.33",80,11,3330,20863,0,0,6,750,5,2580,276.244859,1.7444899999999848,3439,11831
"172.16.133.73",60933,"172.16.139.250",5440,12,1142,20864,0,0,12,1142,0,0,276.245158,0.014910999999983687,612702,0
"172.16.133.53",54336,"172.16.139.250",5440,10,1022,20865,0,0,10,1022,0,0,276.247474,0.01719700000001012,475431,0
"172.16.133.21",53410,"172.16.139.250",5440,10,1022,20866,0,0,10,1022,0,0,276.250554,0.01787899999999354,457296,0
"172.16.133.96",53465,"173.194.43.60",80,10,1508,20867,0,0,6,782,4,726,276.252381,1.739247999999975,3596,3339
"172.16.133.96",53466,"173.194.43.60",80,10,1495,20868,0,0,6,769,4,726,276.253507,1.7368079999999964,3542,3344
"172.16.133.96",53467,"98.137.80.33",80,10,1753,20869,0,0,6,754,4,999,276.254018,1.736295000000041,3474,4602
"172.16.133.30",62908,"172.16.139.250",5440,12,1142,20870,0,0,12,1142,0,0,276.255571,0.02059100000002445,443688,0
"172.16.133.25",63712,"172.16.139.250",5440,12,1142,20871,0,0,12,1142,0,0,276.261443,0.010037000000011176,910232,0
"172.16.133.68",61025,"208.117.46.102",80,9,1098,20872,0,0,5,597,4,501,276.262678,0.5819549999999936,8206,6887
"172.16.133.34",50701,"172.16.139.250",5440,12,1142,20873,0,0,12,1142,0,0,276.271094,0.008262999999999465,1105651,0
"172.16.133.73",60934,"78.108.119.250",443,6,366,20874,0,0,4,246,2,120,276.271778,0.24656800000002477,7981,3893
"172.16.133.96",53468,"76.13.116.133",80,10,1935,20875,0,0,6,896,4,1039,276.274233,0.08875299999999697,80763,93653
"172.16.133.96",53469,"76.13.116.133",80,12,2000,20876,0,0,7,966,5,1034,276.274601,0.08897799999999734,86852,92966
"172.16.133.96",53470,"76.13.116.133",80,12,2010,20877,0,0,7,965,5,1045,276.275307,0.08962600000000975,86135,93276
"172.16.133.96",53471,"76.13.116.133",80,9,1828,20878,0,0,5,830,4,998,276.27591,0.09454299999998739,70232,84448
"172.16.133.96",53472,"76.13.116.133",80,12,2034,20879,0,0,7,961,5,1073,276.275911,0.09267099999999573,82960,92628
"172.16.133.96",53473,"206.190.56.190",80,11,3393,20880,0,0,6,711,5,2682,276.275912,1.7210610000000202,3304,12466
"172.16.133.96",53474,"76.13.116.133",80,9,1787,20881,0,0,5,829,4,958,276.275913,0.10003899999998112,66294,76610
"172.16.133.96",53475,"23.67.242.10",80,13,5292,20882,0,0,7,829,6,4463,276.279038,1.7043909999999869,3891,20948
"172.16.133.96",53476,"23.67.242.10",80,11,2720,20883,0,0,6,763,5,1957,276.279039,1.703187000000014,3583,9192
"172.16.133.96",53477,"76.13.116.133",80,12,5779,20884,0,0,5,873,7,4906,276.279539,0.11636900000002015,60015,337271
"172.16.133.96",53478,"23.67.242.10",80,13,6607,20885,0,0,6,763,7,5844,276.279543,1.705268999999987,3579,27416
"172.16.133.97",59617,"172.16.139.250",5440,10,1022,20886,0,0,10,1022,0,0,276.280438,0.014780999999970845,553142,0
"172.16.133.96",53479,"98.137.80.33",80,11,3037,20887,0,0,6,758,5,2279,276.297522,1.691034000000002,3585,10781
"172.16.133.96",53480,"98.137.80.33",80,10,1957,20888,0,0,6,760,4,1197,276.297849,1.6908180000000357,3595,5663
"172.16.133.96",53481,"98.137.80.33",80,11,2652,20889,0,0,6,760,5,1892,276.298362,1.6916439999999966,3594,8947
"172.16.133.96",53482,"98.137.80.33",80,10,1908,20890,0,0,6,760,4,1148,276.298682,1.6830400000000054,3612,5456
"172.16.133.69",59825,"172.16.128.169",8014,10,4630,20891,0,0,5,1930,5,2700,276.302506,2.21457700000002,6971,9753
"172.16.133.33",58120,"172.16.139.250",5440,10,1022,20892,0,0,10,1022,0,0,276.350588,0.00675499999999829,1210362,0
"172.16.133.96",53483,"76.13.116.133",80,12,2019,20893,0,0,7,966,5,1053,276.352818,0.09350000000000591,82652,90096
"172.16.133.96",53484,"173.194.43.59",80,10,1362,20894,0,0,6,730,4,632,276.355982,1.6341340000000173,3573,3093
"172.16.133.96",53485,"173.194.43.59",80,10,2127,20895,0,0,6,730,4,1397,276.356385,1.6352430000000027,3571,6834
"172.16.133.96",53486,"209.247.230.167",80,11,2135,20896,0,0,6,839,5,1296,276.371293,0.11512300000003961,58302,90060
"172.16.133.68",61026,"172.16.139.250",5440,10,1022,20897,0,0,10,1022,0,0,276.386673,0.005580000000009022,1465232,0
"172.16.133.12",60019,"172.16.139.250",5440,10,1022,20898,0,0,10,1022,0,0,276.400057,0.0058490000000119835,1397845,0
"172.16.133.63",54225,"172.16.139.250",5440,10,1022,20899,0,0,10,1022,0,0,276.412998,0.005561000000000149,1470239,0
"172.16.133.66",54440,"172.16.139.250",5440,10,1022,20900,0,0,10,1022,0,0,276.42279,0.014558999999962907,561577,0
"172.16.133.82",61666,"172.16.139.250",5440,10,1022,20901,0,0,10,1022,0,0,276.437653,0.005542999999988751,1475013,0
"172.16.133.37",60890,"172.16.139.250",5440,10,1022,20902,0,0,10,1022,0,0,276.450214,0.014414999999985412,567186,0
"172.16.133.96",53487,"23.21.62.111",80,13,4201,20903,0,0,7,882,6,3319,276.462209,1.5240210000000047,4629,17422
"172.16.133.96",53488,"209.234.235.129",80,13,3747,20904,0,0,7,1824,6,1923,276.462883,0.22551600000002736,64704,68216
"172.16.133.96",53489,"208.47.254.83",80,13,2814,20905,0,0,8,1485,5,1329,276.479372,1.5130790000000047,7851,7026
"172.16.133.78",59486,"172.16.139.250",5440,12,1142,20906,0,0,12,1142,0,0,276.60712,0.015544999999974607,587713,0
"172.16.133.96",53490,"23.67.242.42",80,10,2219,20907,0,0,6,852,4,1367,276.615001,1.3614689999999996,5006,8032
"172.16.133.67",56230,"172.16.139.250",5440,10,1022,20908,0,0,10,1022,0,0,276.662136,0.0055650000000468935,1469182,0
"172.16.133.56",61679,"172.16.139.250",5440,10,1022,20909,0,0,10,1022,0,0,276.685875,0.004844999999988886,"",""
"172.16.133.41",53384,"172.16.139.250",5440,10,1022,20910,0,0,10,1022,0,0,276.740075,0.00550900000001775,1484116,0
"172.16.133.96",53491,"98.139.200.238",80,12,1859,20911,0,0,7,910,5,949,276.74822,0.10372699999999213,70184,73192
"172.16.133.96",53492,"23.67.242.10",80,20,11402,20912,0,0,10,1319,10,10083,276.792026,1.2021719999999618,8777,67098
"172.16.133.96",53493,"174.35.22.75",80,29,12294,20913,0,0,14,4830,15,7464,276.802912,1.1856420000000298,32589,50362
"172.16.133.43",58000,"172.16.139.250",5440,12,1142,20914,0,0,12,1142,0,0,276.808773,0.006191000000001168,1475690,0
"172.16.133.13",53294,"172.16.139.250",5440,12,1142,20915,0,0,12,1142,0,0,276.829682,0.006231000000013864,1466217,0
"172.16.133.85",52510,"172.16.139.250",5440,10,1022,20916,0,0,10,1022,0,0,276.83529,0.005489000000011401,1489524,0
"172.16.133.96",53494,"98.139.50.175",80,12,2529,20917,0,0,7,1731,5,798,276.847701,0.09790200000003324,141447,65208
"172.16.133.96",53495,"98.139.240.23",80,9,2266,20918,0,0,5,1648,4,618,276.848093,0.10740499999997155,122750,46031
"172.16.133.96",53496,"98.139.200.238",80,11,1579,20919,0,0,6,838,5,741,276.848393,0.10813200000001189,61998,54821
"172.16.133.96",53497,"174.35.22.75",80,88,74637,20920,0,0,33,4764,55,69873,276.860307,1.1297010000000114,33736,494807
"172.16.133.96",53498,"174.35.22.75",80,14,3728,20921,0,0,8,1864,6,1864,276.861565,1.1268489999999929,13233,13233
"172.16.133.42",57343,"172.16.139.250",5440,12,1142,20922,0,0,12,1142,0,0,276.86532,0.02244500000000471,407039,0
"172.16.133.20",62694,"172.16.139.250",5440,10,1022,20923,0,0,10,1022,0,0,276.880451,0.007166999999981272,1140784,0
"172.16.133.96",53499,"76.13.234.33",80,16,4947,20924,0,0,9,2919,7,2028,276.892526,1.293202000000008,18057,12545
"172.16.133.28",49438,"172.16.139.250",5440,12,1142,20925,0,0,12,1142,0,0,276.907658,0.006206999999960772,1471886,0
"172.16.133.99",56284,"172.16.139.250",5440,12,1142,20926,0,0,12,1142,0,0,276.93772,0.0054599999999709325,1673260,0
"172.16.133.75",51198,"172.16.139.250",5440,12,1142,20927,0,0,12,1142,0,0,276.942845,0.006194000000050437,1474975,0
"172.16.133.87",60491,"172.16.139.250",5440,10,1022,20928,0,0,10,1022,0,0,276.962875,0.005469000000005053,1494971,0
"172.16.133.35",50193,"172.16.139.250",5440,12,1142,20929,0,0,12,1142,0,0,276.964753,0.02093600000000606,436377,0
"172.16.133.116",54066,"172.16.139.250",5440,10,1022,20930,0,0,10,1022,0,0,276.972759,0.005334000000004835,1532808,0
"172.16.133.116",54067,"172.16.139.250",5440,10,1022,20931,0,0,10,1022,0,0,276.979017,0.007595999999978176,1076355,0
"172.16.133.116",54068,"172.16.139.250",5440,10,1022,20932,0,0,10,1022,0,0,276.9876,0.005559000000005199,1470768,0
"172.16.133.96",53500,"50.116.194.23",80,10,2295,20933,0,0,6,1594,4,701,276.990046,1.011353999999983,12608,5545
"172.16.133.84",59038,"172.16.139.250",5440,10,1022,20934,0,0,10,1022,0,0,276.994932,0.005358000000001084,1525942,0
"172.16.133.96",53501,"23.67.243.35",80,14,6156,20935,0,0,7,775,7,5381,277.014489,0.978256999999985,6337,44004
"172.16.133.49",56013,"172.16.139.250",5440,12,1142,20936,0,0,12,1142,0,0,277.071552,0.006370000000003984,1434222,0
"172.16.133.95",57235,"172.16.139.250",5440,10,1022,20937,0,0,10,1022,0,0,277.115649,0.015056999999956133,543003,0
"172.16.133.92",57901,"172.16.139.250",5440,10,1022,20938,0,0,10,1022,0,0,277.139258,0.005489000000011401,1489524,0
"172.16.133.29",61235,"172.16.139.250",5440,10,1022,20939,0,0,10,1022,0,0,277.158158,0.005636999999978798,1450416,0
"172.16.133.44",65062,"172.16.139.250",5440,12,1142,20940,0,0,12,1142,0,0,277.164716,0.01592900000002828,573545,0
"172.16.133.96",53502,"50.58.197.194",80,14,4720,20941,0,0,9,3978,5,742,277.170514,1.5003679999999804,21210,3956
"172.16.133.207",56169,"172.16.139.250",5440,12,1142,20942,0,0,12,1142,0,0,277.18892,0.004924000000016804,"",""
"172.16.133.83",57336,"172.16.139.250",5440,12,1142,20943,0,0,12,1142,0,0,277.199046,0.014676000000008571,622512,0
"172.16.133.93",61120,"172.16.139.250",5440,12,1142,20944,0,0,12,1142,0,0,277.214813,0.004979999999989104,"",""
"172.16.133.11",55398,"172.16.139.250",5440,10,1022,20945,0,0,10,1022,0,0,277.232645,0.005557000000010248,1471297,0
"172.16.133.55",57856,"172.16.139.250",5440,10,1022,20946,0,0,10,1022,0,0,277.237665,0.014769000000001142,553591,0
"172.16.133.73",60935,"172.16.139.250",5440,10,1022,20947,0,0,10,1022,0,0,277.258491,0.005923999999993157,1380148,0
"172.16.133.53",54337,"172.16.139.250",5440,12,1142,20948,0,0,12,1142,0,0,277.26111,0.008289000000047508,1102183,0
"172.16.133.21",53411,"172.16.139.250",5440,10,1022,20949,0,0,10,1022,0,0,277.264557,0.01493199999998751,547548,0
"172.16.133.30",62909,"172.16.139.250",5440,10,1022,20950,0,0,10,1022,0,0,277.268378,0.005118000000038592,1597499,0
"172.16.133.25",63713,"172.16.139.250",5440,10,1022,20951,0,0,10,1022,0,0,277.275398,0.007658999999989646,1067502,0
"172.16.133.34",50702,"172.16.139.250",5440,10,1022,20952,0,0,10,1022,0,0,277.285257,0.008029000000021824,1018308,0
"172.16.133.97",59618,"172.16.139.250",5440,10,1022,20953,0,0,10,1022,0,0,277.29464,0.0054179999999632855,1509043,0
"172.16.133.40",50292,"184.73.247.227",80,10,1473,20954,0,0,5,988,5,485,277.358622,0.17814499999997224,44368,21780
"172.16.133.33",58121,"172.16.139.250",5440,12,1142,20955,0,0,12,1142,0,0,277.364613,0.02190699999999879,417035,0
"172.16.133.68",61027,"172.16.139.250",5440,10,1022,20956,0,0,10,1022,0,0,277.401001,0.015265999999996893,535569,0
"172.16.133.12",60020,"172.16.139.250",5440,10,1022,20957,0,0,10,1022,0,0,277.416068,0.005763000000001739,1418705,0
"172.16.133.63",54226,"172.16.139.250",5440,12,1142,20958,0,0,12,1142,0,0,277.426359,0.015111999999987802,604552,0
"172.16.133.66",54441,"172.16.139.250",5440,10,1022,20959,0,0,10,1022,0,0,277.43682,0.008537999999987278,957601,0
"172.16.133.33",58122,"157.56.245.198",443,22,9463,20960,0,0,10,2088,12,7375,277.44523,3.2499900000000252,5139,18153
"172.16.133.82",61667,"172.16.139.250",5440,10,1022,20961,0,0,10,1022,0,0,277.453189,0.005523999999979878,1480086,0
"172.16.133.37",60891,"172.16.139.250",5440,10,1022,20962,0,0,10,1022,0,0,277.465637,0.005412999999975909,1510437,0
"172.16.133.96",53503,"157.56.134.97",80,15,7973,20963,0,0,8,3078,7,4895,277.534875,0.4132099999999923,59591,94770
"172.16.133.96",53504,"108.170.193.78",80,10,3655,20964,0,0,5,1644,5,2011,277.558401,0.1790070000000128,73471,89873
"172.16.133.96",53505,"108.170.193.78",80,10,3639,20965,0,0,5,1720,5,1919,277.558926,0.19404000000002952,70913,79117
"172.16.133.78",59487,"172.16.139.250",5440,12,1142,20966,0,0,12,1142,0,0,277.621443,0.016459999999995034,555042,0
"172.16.133.67",56231,"172.16.139.250",5440,12,1142,20967,0,0,12,1142,0,0,277.677293,0.006034999999997126,1513835,0
"172.16.133.96",53506,"184.173.190.13",80,11,1635,20968,0,0,7,918,4,717,277.680779,0.3148570000000177,23324,18217
"172.16.133.56",61680,"172.16.139.250",5440,10,1022,20969,0,0,10,1022,0,0,277.698701,0.004966999999965083,"",""
"172.16.133.96",53507,"173.194.43.58",80,13,3797,20970,0,0,8,2257,5,1540,277.73457,0.2557419999999979,70602,48173
"172.16.133.41",53385,"172.16.139.250",5440,10,1022,20971,0,0,10,1022,0,0,277.754189,0.00547599999998738,1493060,0
"172.16.133.96",53508,"108.170.193.78",80,9,2239,20972,0,0,5,755,4,1484,277.770287,0.15444300000001476,39108,76869
"172.16.133.43",58001,"172.16.139.250",5440,12,1142,20973,0,0,12,1142,0,0,277.822588,0.016415999999992437,556530,0
"172.16.133.13",53295,"172.16.139.250",5440,12,1142,20974,0,0,12,1142,0,0,277.844931,0.006411000000014155,1425050,0
"172.16.133.96",53509,"108.170.198.160",80,9,2846,20975,0,0,5,1585,4,1261,277.845362,0.15786799999995083,80320,63901
"172.16.133.85",52511,"172.16.139.250",5440,12,1142,20976,0,0,12,1142,0,0,277.849139,0.005538000000001375,1649693,0
"172.16.133.42",57344,"172.16.139.250",5440,12,1142,20977,0,0,12,1142,0,0,277.884974,0.034587999999985186,264137,0
"172.16.133.20",62695,"172.16.139.250",5440,10,1022,20978,0,0,10,1022,0,0,277.89422,0.005468000000007578,1495245,0
"172.16.133.96",53510,"23.21.62.111",443,33,13393,20979,0,0,18,3385,15,10008,277.920721,0.19772199999999884,136959,404932
"172.16.133.28",49439,"172.16.139.250",5440,10,1022,20980,0,0,10,1022,0,0,277.922791,0.0053759999999556385,1520833,0
"172.16.133.96",53511,"23.0.52.46",80,17,7700,20981,0,0,9,2371,8,5329,277.92286,0.11178100000000768,169688,381388
"172.16.133.99",56285,"172.16.139.250",5440,10,1022,20982,0,0,10,1022,0,0,277.951907,0.01569200000000137,521029,0
"172.16.133.75",51199,"172.16.139.250",5440,10,1022,20983,0,0,10,1022,0,0,277.956902,0.015463000000011107,528746,0
"172.16.133.96",53512,"108.170.198.160",80,9,1963,20984,0,0,5,702,4,1261,277.963546,0.24074899999999388,23327,41902
"172.16.133.87",60492,"172.16.139.250",5440,10,1022,20985,0,0,10,1022,0,0,277.97738,0.018527000000005955,441301,0
"172.16.133.35",50194,"172.16.139.250",5440,12,1142,20986,0,0,12,1142,0,0,277.978866,0.02311400000002095,395258,0
"172.16.133.96",53513,"65.54.81.18",80,59,50415,20987,0,0,23,5785,36,44630,277.981,0.4659470000000283,99324,766267
"172.16.133.116",54069,"172.16.139.250",5440,10,1022,20988,0,0,10,1022,0,0,277.988741,0.010411999999973887,785247,0
"172.16.133.116",54070,"172.16.139.250",5440,10,1022,20989,0,0,10,1022,0,0,278.000327,0.00576899999998659,1417230,0
"172.16.133.95",57236,"184.168.192.63",80,20,10903,20990,0,0,9,1006,11,9897,278.006181,8.169587999999976,985,9691
"172.16.133.116",54071,"172.16.139.250",5440,10,1022,20991,0,0,10,1022,0,0,278.00706,0.007986999999957334,1023663,0
"172.16.133.84",59039,"172.16.139.250",5440,10,1022,20992,0,0,10,1022,0,0,278.009942,0.014385000000004311,568369,0
"172.16.133.96",53514,"204.154.111.33",80,14,4733,20993,0,0,8,4147,6,586,278.060939,0.37915799999996125,87499,12364
"172.16.133.49",56014,"172.16.139.250",5440,10,1022,20994,0,0,10,1022,0,0,278.085253,0.005521999999984928,1480622,0
"172.16.133.95",57237,"172.16.139.250",5440,10,1022,20995,0,0,10,1022,0,0,278.129393,0.006196999999986019,1319348,0
"172.16.133.92",57902,"172.16.139.250",5440,10,1022,20996,0,0,10,1022,0,0,278.153396,0.005478000000039174,1492515,0
"172.16.133.29",61236,"172.16.139.250",5440,10,1022,20997,0,0,10,1022,0,0,278.170956,0.006683000000009542,1223402,0
"172.16.133.44",65063,"172.16.139.250",5440,10,1022,20998,0,0,10,1022,0,0,278.177939,0.0150520000000256,543183,0
"172.16.133.207",56170,"172.16.139.250",5440,12,1142,20999,0,0,12,1142,0,0,278.202647,0.004843999999991411,"",""
"172.16.133.83",57337,"172.16.139.250",5440,12,1142,21000,0,0,12,1142,0,0,278.213928,0.008577999999999975,1065050,0
"172.16.133.93",61121,"172.16.139.250",5440,12,1142,21001,0,0,12,1142,0,0,278.228664,0.014754000000039014,619221,0
"172.16.133.11",55399,"172.16.139.250",5440,10,1022,21002,0,0,10,1022,0,0,278.246065,0.005613000000039392,1456618,0
"172.16.133.55",57857,"172.16.139.250",5440,12,1142,21003,0,0,12,1142,0,0,278.249658,0.01624799999996185,562284,0
"172.16.133.73",60936,"172.16.139.250",5440,12,1142,21004,0,0,12,1142,0,0,278.272519,0.01687000000003991,541553,0
"172.16.133.53",54338,"172.16.139.250",5440,10,1022,21005,0,0,10,1022,0,0,278.275128,0.005453999999986081,1499083,0
"172.16.133.21",53412,"172.16.139.250",5440,10,1022,21006,0,0,10,1022,0,0,278.278984,0.005750000000034561,1421913,0
"172.16.133.30",62910,"172.16.139.250",5440,10,1022,21007,0,0,10,1022,0,0,278.283921,0.00947999999999638,862447,0
"172.16.133.25",63714,"172.16.139.250",5440,10,1022,21008,0,0,10,1022,0,0,278.289745,0.006674000000032265,1225052,0
"172.16.133.34",50703,"172.16.139.250",5440,10,1022,21009,0,0,10,1022,0,0,278.299031,0.004995000000008076,"",""
"172.16.133.97",59619,"172.16.139.250",5440,12,1142,21010,0,0,12,1142,0,0,278.308919,0.0063279999999963366,1443742,0
"172.16.133.33",58123,"172.16.139.250",5440,10,1022,21011,0,0,10,1022,0,0,278.379862,0.005471000000000004,1494425,0
"172.16.133.68",61028,"172.16.139.250",5440,10,1022,21012,0,0,10,1022,0,0,278.415834,0.006688999999994394,1222305,0
"172.16.133.12",60021,"172.16.139.250",5440,10,1022,21013,0,0,10,1022,0,0,278.43013,0.0054179999999632855,1509043,0
"172.16.133.63",54227,"172.16.139.250",5440,10,1022,21014,0,0,10,1022,0,0,278.439594,0.014946000000009008,547035,0
"172.16.133.66",54442,"172.16.139.250",5440,10,1022,21015,0,0,10,1022,0,0,278.450895,0.007353000000023258,1111927,0
"172.16.133.82",61668,"172.16.139.250",5440,10,1022,21016,0,0,10,1022,0,0,278.466777,0.005727000000035787,1427623,0
"172.16.133.37",60892,"172.16.139.250",5440,12,1142,21017,0,0,12,1142,0,0,278.479232,0.016648999999972602,548741,0
"172.16.133.96",53515,"98.137.80.33",80,75,61400,21018,0,0,31,5549,44,55851,278.48179,1.9551270000000045,22705,228531
"172.16.133.96",53516,"98.137.80.33",80,92,78509,21019,0,0,38,7232,54,71277,278.482769,21.256523999999956,2721,26825
"172.16.133.33",58124,"157.56.245.198",443,24,12999,21020,0,0,10,2710,14,10289,278.494686,0.8126980000000117,26676,101282
"172.16.133.78",59488,"172.16.139.250",5440,12,1142,21021,0,0,12,1142,0,0,278.635475,0.0069510000000150285,1314343,0
"172.16.133.67",56232,"172.16.139.250",5440,10,1022,21022,0,0,10,1022,0,0,278.690318,0.005502000000035423,1486005,0
"172.16.133.56",61681,"172.16.139.250",5440,10,1022,21023,0,0,10,1022,0,0,278.713477,0.00477899999998499,"",""
"172.16.133.41",53386,"172.16.139.250",5440,10,1022,21024,0,0,10,1022,0,0,278.768322,0.005645000000015443,1448361,0
"172.16.133.43",58002,"172.16.139.250",5440,10,1022,21025,0,0,10,1022,0,0,278.836792,0.00538899999997966,1517164,0
"172.16.133.13",53296,"172.16.139.250",5440,10,1022,21026,0,0,10,1022,0,0,278.859146,0.005343999999979587,1529940,0
"172.16.133.85",52512,"172.16.139.250",5440,10,1022,21027,0,0,10,1022,0,0,278.863224,0.01535999999998694,532291,0
"172.16.133.42",57345,"172.16.139.250",5440,12,1142,21028,0,0,12,1142,0,0,278.897228,0.013609000000030846,671320,0
"172.16.133.20",62696,"172.16.139.250",5440,12,1142,21029,0,0,12,1142,0,0,278.908363,0.005064000000004398,1804107,0
"172.16.133.55",57859,"67.217.64.244",443,6,366,21030,0,0,4,246,2,120,278.922481,0.06358499999998912,30950,15097
"172.16.133.55",57858,"216.219.113.250",443,6,366,21031,0,0,4,246,2,120,278.922483,0.1981349999999793,9932,4845
"172.16.133.55",57860,"216.115.223.200",443,6,366,21032,0,0,4,246,2,120,278.922766,0.08789600000000064,22390,10921
"172.16.133.55",57861,"66.151.150.190",443,6,366,21033,0,0,4,246,2,120,278.924208,0.18972599999995055,10372,5059
"172.16.133.28",49440,"172.16.139.250",5440,10,1022,21034,0,0,10,1022,0,0,278.936978,0.0053719999999657375,1521965,0
"172.16.133.99",56286,"172.16.139.250",5440,10,1022,21035,0,0,10,1022,0,0,278.9656,0.004859000000010383,"",""
"172.16.133.75",51200,"172.16.139.250",5440,12,1142,21036,0,0,12,1142,0,0,278.969488,0.015701999999976124,581836,0
"172.16.133.87",60493,"172.16.139.250",5440,10,1022,21037,0,0,10,1022,0,0,278.991078,0.005734999999958745,1425632,0
"172.16.133.35",50195,"172.16.139.250",5440,12,1142,21038,0,0,12,1142,0,0,278.992619,0.009601000000031945,951567,0
"172.16.133.116",54072,"172.16.139.250",5440,12,1142,21039,0,0,12,1142,0,0,279.003609,0.007515000000012151,1215701,0
"172.16.133.116",54073,"172.16.139.250",5440,10,1022,21040,0,0,10,1022,0,0,279.011623,0.006298000000015236,1298189,0
"172.16.133.116",54074,"172.16.139.250",5440,10,1022,21041,0,0,10,1022,0,0,279.020375,0.005700999999987744,1434134,0
"172.16.133.84",59040,"172.16.139.250",5440,10,1022,21042,0,0,10,1022,0,0,279.023421,0.00670100000002094,1220116,0
"172.16.133.49",56015,"172.16.139.250",5440,12,1142,21043,0,0,12,1142,0,0,279.099402,0.006254000000012638,1460825,0
"172.16.133.95",57238,"172.16.139.250",5440,12,1142,21044,0,0,12,1142,0,0,279.142502,0.006097000000011121,1498441,0
"172.16.133.92",57903,"172.16.139.250",5440,10,1022,21045,0,0,10,1022,0,0,279.16619,0.005179000000055112,1578683,0
"172.16.133.29",61237,"172.16.139.250",5440,10,1022,21046,0,0,10,1022,0,0,279.186155,0.005315999999993437,1537998,0
"172.16.133.44",65064,"172.16.139.250",5440,12,1142,21047,0,0,12,1142,0,0,279.191623,0.015429999999980737,592093,0
"172.16.133.207",56171,"172.16.139.250",5440,10,1022,21048,0,0,10,1022,0,0,279.2172,0.014397000000030857,567896,0
"172.16.133.83",57338,"172.16.139.250",5440,12,1142,21049,0,0,12,1142,0,0,279.226927,0.013896999999985837,657408,0
"172.16.133.93",61122,"172.16.139.250",5440,12,1142,21050,0,0,12,1142,0,0,279.241803,0.014314000000013039,638256,0
"172.16.133.116",54075,"173.194.43.60",80,34,34499,21051,0,0,9,1391,25,33108,279.260121,0.08208799999999883,135561,3226586
"172.16.133.11",55400,"172.16.139.250",5440,10,1022,21052,0,0,10,1022,0,0,279.260542,0.005834999999990487,1401199,0
"172.16.133.55",57862,"172.16.139.250",5440,10,1022,21053,0,0,10,1022,0,0,279.26358,0.006700000000023465,1220298,0
"172.16.133.73",60937,"172.16.139.250",5440,10,1022,21054,0,0,10,1022,0,0,279.28668,0.01886899999999514,433303,0
"172.16.133.53",54339,"172.16.139.250",5440,10,1022,21055,0,0,10,1022,0,0,279.290624,0.005682000000035714,1438929,0
"172.16.133.21",53413,"172.16.139.250",5440,10,1022,21056,0,0,10,1022,0,0,279.292922,0.01693500000004633,482787,0
"172.16.133.30",62911,"172.16.139.250",5440,10,1022,21057,0,0,10,1022,0,0,279.296375,0.005166999999971722,1582349,0
"172.16.133.25",63715,"172.16.139.250",5440,12,1142,21058,0,0,12,1142,0,0,279.303043,0.010530000000017026,867616,0
"172.16.133.34",50704,"172.16.139.250",5440,10,1022,21059,0,0,10,1022,0,0,279.313398,0.00513100000000577,1593451,0
"172.16.133.97",59620,"172.16.139.250",5440,10,1022,21060,0,0,10,1022,0,0,279.322729,0.014562000000012176,561461,0
"172.16.133.33",58125,"172.16.139.250",5440,12,1142,21061,0,0,12,1142,0,0,279.392604,0.0062479999999709435,1462227,0
"172.16.133.68",61029,"172.16.139.250",5440,10,1022,21062,0,0,10,1022,0,0,279.428938,0.005599999999958527,1460000,0
"172.16.133.12",60022,"172.16.139.250",5440,10,1022,21063,0,0,10,1022,0,0,279.4422,0.005657999999982621,1445033,0
"172.16.133.35",50196,"216.115.223.200",443,6,366,21064,0,0,4,246,2,120,279.451237,0.10758500000002869,18292,8923
"172.16.133.35",50197,"66.151.150.190",443,6,366,21065,0,0,4,246,2,120,279.451978,0.21357799999998406,9214,4494
"172.16.133.63",54228,"172.16.139.250",5440,10,1022,21066,0,0,10,1022,0,0,279.453837,0.005435999999974683,1504047,0
"172.16.133.35",50198,"216.219.113.250",443,6,366,21067,0,0,4,246,2,120,279.455341,0.21651800000000776,9089,4433
"172.16.133.35",50199,"67.217.64.244",443,6,366,21068,0,0,4,246,2,120,279.456559,0.06767399999995405,29080,14185
"172.16.133.66",54443,"172.16.139.250",5440,10,1022,21069,0,0,10,1022,0,0,279.464836,0.01551200000000108,527075,0
"172.16.133.82",61669,"172.16.139.250",5440,10,1022,21070,0,0,10,1022,0,0,279.479446,0.01525200000003224,536060,0
"172.16.133.37",60893,"172.16.139.250",5440,10,1022,21071,0,0,10,1022,0,0,279.492262,0.006238999999993666,1310466,0
"172.16.133.78",59489,"172.16.139.250",5440,12,1142,21072,0,0,12,1142,0,0,279.649335,0.015618000000017673,584966,0
"172.16.133.67",56233,"172.16.139.250",5440,12,1142,21073,0,0,12,1142,0,0,279.704276,0.01536900000002106,594443,0
"172.16.133.56",61682,"172.16.139.250",5440,12,1142,21074,0,0,12,1142,0,0,279.726685,0.004918000000031952,"",""
"172.16.133.96",53517,"98.137.201.232",80,10,3517,21075,0,0,6,1759,4,1758,279.728685,6.0543949999999995,2324,2322
"172.16.128.233",50956,"172.16.133.233",22,198,22216,21076,0,0,50,4258,148,17958,279.738051,8.001904000000025,4256,17953
"172.16.133.41",53387,"172.16.139.250",5440,10,1022,21077,0,0,10,1022,0,0,279.781416,0.00539600000001883,1515196,0
"172.16.133.16",59372,"8.18.45.80",443,24,12761,21078,0,0,12,6595,12,6166,279.795213,19.90892100000002,2650,2477
"172.16.133.43",58003,"172.16.139.250",5440,10,1022,21079,0,0,10,1022,0,0,279.850601,0.005722999999989042,1428621,0
"172.16.133.13",53297,"172.16.139.250",5440,10,1022,21080,0,0,10,1022,0,0,279.871927,0.005730999999968844,1426627,0
"172.16.133.85",52513,"172.16.139.250",5440,10,1022,21081,0,0,10,1022,0,0,279.876853,0.014823000000035336,551575,0
"172.16.133.42",57346,"172.16.139.250",5440,12,1142,21082,0,0,12,1142,0,0,279.90764,0.009490999999968608,962596,0
"172.16.133.20",62697,"172.16.139.250",5440,10,1022,21083,0,0,10,1022,0,0,279.922767,0.014308999999968819,571388,0
"172.16.133.42",57347,"67.217.95.254",443,6,366,21084,0,0,4,246,2,120,279.922935,0.05965800000001309,32988,16091
"172.16.133.42",57348,"202.173.25.200",443,6,366,21085,0,0,4,246,2,120,279.933025,0.5316850000000386,3701,1805
"172.16.133.42",57349,"216.219.117.244",443,6,366,21086,0,0,4,246,2,120,279.933594,0.20434499999998934,9630,4697
"172.16.133.42",57350,"78.108.117.250",443,6,366,21087,0,0,4,246,2,120,279.933596,0.20545599999996966,9578,4672
"172.16.133.28",49441,"172.16.139.250",5440,10,1022,21088,0,0,10,1022,0,0,279.950997,0.005873000000008233,1392133,0
"172.16.133.99",56287,"172.16.139.250",5440,10,1022,21089,0,0,10,1022,0,0,279.979352,0.014617999999984477,559310,0
"172.16.133.75",51201,"172.16.139.250",5440,10,1022,21090,0,0,10,1022,0,0,279.984875,0.014629000000013548,558889,0
"172.16.133.87",60494,"172.16.139.250",5440,10,1022,21091,0,0,10,1022,0,0,280.005282,0.018010000000003856,453970,0
"172.16.133.35",50200,"172.16.139.250",5440,12,1142,21092,0,0,12,1142,0,0,280.008163,0.01550499999996191,589229,0
"172.16.133.116",54076,"172.16.139.250",5440,12,1142,21093,0,0,12,1142,0,0,280.015677,0.015362000000038734,594714,0
"172.16.133.116",54077,"172.16.139.250",5440,10,1022,21094,0,0,10,1022,0,0,280.031936,0.02313200000003235,353449,0
"172.16.133.84",59041,"172.16.139.250",5440,10,1022,21095,0,0,10,1022,0,0,280.037855,0.0054620000000227265,1496887,0
"172.16.133.116",54078,"172.16.139.250",5440,10,1022,21096,0,0,10,1022,0,0,280.055893,0.006031999999947857,1355437,0
"172.16.133.49",56016,"172.16.139.250",5440,10,1022,21097,0,0,10,1022,0,0,280.112552,0.015471999999988384,528438,0
"172.16.133.95",57239,"172.16.139.250",5440,10,1022,21098,0,0,10,1022,0,0,280.156533,0.015567999999973381,525179,0
"172.16.133.92",57904,"172.16.139.250",5440,10,1022,21099,0,0,10,1022,0,0,280.181283,0.005555000000015298,1471827,0
"172.16.133.25",63716,"129.25.32.242",32071,3,194,21100,0,0,3,194,0,0,280.181986,9.005476999999985,172,0
"172.16.133.40",50293,"180.153.31.250",443,6,366,21101,0,0,4,246,2,120,280.182623,0.48155200000002196,4086,1993
"172.16.133.29",61238,"172.16.139.250",5440,10,1022,21102,0,0,10,1022,0,0,280.199266,0.005415999999968335,1509601,0
"172.16.133.44",65065,"172.16.139.250",5440,12,1142,21103,0,0,12,1142,0,0,280.205816,0.005867999999964013,1556918,0
"172.16.133.68",61030,"208.117.46.102",80,9,1095,21104,0,0,5,594,4,501,280.227054,0.9648689999999647,4925,4153
"172.16.133.207",56172,"172.16.139.250",5440,12,1142,21105,0,0,12,1142,0,0,280.231351,0.005502999999976055,1660185,0
"172.16.133.83",57339,"172.16.139.250",5440,12,1142,21106,0,0,12,1142,0,0,280.241986,0.004454000000009728,"",""
"172.16.133.93",61123,"172.16.139.250",5440,12,1142,21107,0,0,12,1142,0,0,280.254514,0.005494000000055621,1662904,0
"172.16.133.11",55401,"172.16.139.250",5440,10,1022,21108,0,0,10,1022,0,0,280.272873,0.014572999999984404,561037,0
"172.16.133.55",57863,"172.16.139.250",5440,10,1022,21109,0,0,10,1022,0,0,280.277667,0.005580000000009022,1465232,0
"172.16.133.73",60938,"172.16.139.250",5440,12,1142,21110,0,0,12,1142,0,0,280.300528,0.09093200000000934,100470,0
"172.16.133.53",54340,"172.16.139.250",5440,12,1142,21111,0,0,12,1142,0,0,280.303999,0.09193800000002739,99371,0
"172.16.133.21",53414,"172.16.139.250",5440,10,1022,21112,0,0,10,1022,0,0,280.307555,0.11390400000004774,71779,0
"172.16.133.30",62913,"172.16.139.250",5440,12,1142,21113,0,0,12,1142,0,0,280.311472,0.09125099999999975,100119,0
"172.16.133.25",63717,"172.16.139.250",5440,12,1142,21114,0,0,12,1142,0,0,280.317954,0.081799999999987,111687,0
"172.16.133.34",50705,"172.16.139.250",5440,12,1142,21115,0,0,12,1142,0,0,280.326368,0.08030600000000732,113764,0
"172.16.133.97",59621,"172.16.139.250",5440,10,1022,21116,0,0,10,1022,0,0,280.336678,0.08962600000000975,91223,0
"172.16.133.96",53518,"76.13.115.116",80,39,31833,21117,0,0,16,3254,23,28579,280.380243,1.2722210000000018,20461,179710
"172.16.133.33",58126,"172.16.139.250",5440,12,1142,21118,0,0,12,1142,0,0,280.406015,0.024084999999956835,379323,0
"172.16.133.68",61031,"172.16.139.250",5440,10,1022,21119,0,0,10,1022,0,0,280.444041,0.007527999999979329,1086078,0
"172.16.133.12",60023,"172.16.139.250",5440,12,1142,21120,0,0,12,1142,0,0,280.457829,0.008082000000001699,1130413,0
"172.16.133.63",54229,"172.16.139.250",5440,12,1142,21121,0,0,12,1142,0,0,280.46821,0.006116000000019994,1493786,0
"172.16.133.66",54444,"172.16.139.250",5440,10,1022,21122,0,0,10,1022,0,0,280.478531,0.005740000000002965,1424390,0
"172.16.133.82",61670,"172.16.139.250",5440,12,1142,21123,0,0,12,1142,0,0,280.494985,0.006368000000009033,1434673,0
"172.16.133.37",60894,"172.16.139.250",5440,12,1142,21124,0,0,12,1142,0,0,280.507013,0.008495000000039,1075456,0
"172.16.133.78",59490,"172.16.139.250",5440,12,1142,21125,0,0,12,1142,0,0,280.662587,0.006478000000015527,1410311,0
"172.16.133.67",56234,"172.16.139.250",5440,10,1022,21126,0,0,10,1022,0,0,280.718268,0.014885999999989963,549240,0
"172.16.133.56",61683,"172.16.139.250",5440,12,1142,21127,0,0,12,1142,0,0,280.74048,0.005029000000035921,1816663,0
"172.16.133.113",55768,"172.16.139.250",135,8,492,21128,0,0,8,492,0,0,280.772386,0.007947999999998956,495218,0
"172.16.133.113",55769,"172.16.139.250",5462,10,696,21129,0,0,10,696,0,0,280.781217,0.5603709999999751,9936,0
"172.16.133.41",53388,"172.16.139.250",5440,10,1022,21130,0,0,10,1022,0,0,280.795313,0.005556999999953405,1471297,0
"172.16.133.43",58004,"172.16.139.250",5440,12,1142,21131,0,0,12,1142,0,0,280.864667,0.006279000000006363,1455008,0
"172.16.133.13",53298,"172.16.139.250",5440,12,1142,21132,0,0,12,1142,0,0,280.885974,0.006153000000040265,1484804,0
"172.16.133.85",52514,"172.16.139.250",5440,12,1142,21133,0,0,12,1142,0,0,280.892434,0.006242000000042935,1463633,0
"172.16.133.42",57351,"172.16.139.250",5440,12,1142,21134,0,0,12,1142,0,0,280.92483,0.0084990000000289,1074949,0
"172.16.133.20",62698,"172.16.139.250",5440,12,1142,21135,0,0,12,1142,0,0,280.936415,0.015655999999978576,583546,0
"172.16.133.55",57864,"67.217.64.244",443,6,366,21136,0,0,4,246,2,120,280.96033,0.05869799999999259,33527,16354
"172.16.133.28",49442,"172.16.139.250",5440,12,1142,21137,0,0,12,1142,0,0,280.96478,0.015281999999956497,597827,0
"172.16.133.55",57865,"216.115.223.200",443,6,366,21138,0,0,4,246,2,120,280.970303,0.08929000000000542,22040,10751
"172.16.133.21",53415,"172.16.139.250",5440,10,1022,21139,0,0,10,1022,0,0,280.981054,0.005766000000051008,1417967,0
"172.16.133.84",59042,"157.56.240.137",443,6,374,21140,0,0,3,194,3,180,280.983263,1.0820860000000039,1434,1330
"172.16.133.99",56288,"172.16.139.250",5440,12,1142,21141,0,0,12,1142,0,0,280.992331,0.015126000000009299,603993,0
"172.16.133.75",51202,"172.16.139.250",5440,10,1022,21142,0,0,10,1022,0,0,280.998949,0.016113000000018474,507416,0
"172.16.133.87",60495,"172.16.139.250",5440,10,1022,21143,0,0,10,1022,0,0,281.01903,0.005180999999993219,1578073,0
"172.16.133.35",50201,"172.16.139.250",5440,12,1142,21144,0,0,12,1142,0,0,281.024213,0.011156000000028143,818931,0
"172.16.133.55",57866,"66.151.150.190",443,6,366,21145,0,0,4,246,2,120,281.026259,0.2016179999999963,9761,4761
"172.16.133.116",54079,"172.16.139.250",5440,12,1142,21146,0,0,12,1142,0,0,281.027654,0.007514000000014676,1215863,0
"172.16.133.55",57867,"216.219.113.250",443,6,366,21147,0,0,4,246,2,120,281.029287,0.19956500000000688,9861,4810
"172.16.133.116",54080,"172.16.139.250",5440,10,1022,21148,0,0,10,1022,0,0,281.035918,0.006856000000027507,1192532,0
"172.16.133.116",54081,"172.16.139.250",5440,12,1142,21149,0,0,12,1142,0,0,281.043714,0.013362999999969816,683678,0
"172.16.133.96",53519,"98.137.80.33",80,49,41806,21150,0,0,18,2437,31,39369,281.04849,18.69207399999999,1043,16849
"172.16.133.96",53520,"98.137.80.33",80,28,22892,21151,0,0,10,1504,18,21388,281.049353,14.134642999999983,851,12105
"172.16.133.96",53521,"209.234.234.12",80,22,12835,21152,0,0,11,4973,11,7862,281.049355,5.51697200000001,7211,11400
"172.16.133.96",53522,"98.137.80.33",80,17,7673,21153,0,0,9,1816,8,5857,281.049356,14.162338000000034,1025,3308
"172.16.133.96",53523,"98.137.80.33",80,87,89138,21154,0,0,27,3205,60,85933,281.049403,14.056470999999988,1824,48907
"172.16.133.84",59043,"172.16.139.250",5440,10,1022,21155,0,0,10,1022,0,0,281.052003,0.014508999999975458,563512,0
"172.16.133.49",56017,"172.16.139.250",5440,12,1142,21156,0,0,12,1142,0,0,281.126687,0.005644000000017968,1618710,0
"172.16.133.96",53524,"209.234.234.12",80,22,14057,21157,0,0,11,3865,11,10192,281.158102,5.323680000000024,5808,15315
"172.16.133.96",53525,"76.13.116.133",80,19,11923,21158,0,0,10,1192,9,10731,281.158493,0.24205100000000357,39396,354669
"172.16.133.96",53526,"209.234.234.12",80,18,10679,21159,0,0,9,3743,9,6936,281.158495,5.322814999999991,5625,10424
"172.16.133.96",53527,"209.234.234.12",80,12,6134,21160,0,0,6,1580,6,4554,281.158976,5.1399959999999965,2459,7087
"172.16.133.96",53528,"173.194.43.60",80,7,1310,21161,0,0,4,650,3,660,281.158978,0.0876920000000041,59298,60210
"172.16.133.96",53529,"208.47.254.83",80,22,9519,21162,0,0,14,5829,8,3690,281.159361,4.415418999999986,10561,6685
"172.16.133.96",53530,"98.137.80.33",80,9,1383,21163,0,0,5,676,4,707,281.159363,14.097800000000007,383,401
"172.16.133.96",53531,"167.8.226.9",80,14,3703,21164,0,0,7,1552,7,2151,281.159364,0.10001500000004171,124141,172054
"172.16.133.95",57240,"172.16.139.250",5440,10,1022,21165,0,0,10,1022,0,0,281.170443,0.014766000000008717,553704,0
"172.16.133.96",53532,"98.137.80.54",80,30,22546,21166,0,0,12,1586,18,20960,281.191853,9.627680999999995,1317,17416
"172.16.133.92",57905,"172.16.139.250",5440,10,1022,21167,0,0,10,1022,0,0,281.195028,0.015716999999995096,520201,0
"172.16.133.29",61239,"172.16.139.250",5440,10,1022,21168,0,0,10,1022,0,0,281.213466,0.015387000000032458,531357,0
"172.16.133.44",65066,"172.16.139.250",5440,10,1022,21169,0,0,10,1022,0,0,281.219958,0.017331999999953496,471728,0
"172.16.133.207",56173,"172.16.139.250",5440,12,1142,21170,0,0,12,1142,0,0,281.244763,0.006557000000043445,1393320,0
"172.16.133.83",57340,"172.16.139.250",5440,12,1142,21171,0,0,12,1142,0,0,281.255972,0.004851000000030581,"",""
"172.16.133.93",61124,"172.16.139.250",5440,10,1022,21172,0,0,10,1022,0,0,281.269653,0.014566000000002077,561307,0
"172.16.133.93",61125,"74.63.51.79",80,102,98577,21173,0,0,35,3291,67,95286,281.277029,16.24099799999999,1621,46936
"172.16.133.11",55402,"172.16.139.250",5440,10,1022,21174,0,0,10,1022,0,0,281.288315,0.015242000000000644,536412,0
"172.16.133.96",53533,"167.8.226.9",80,30,16983,21175,0,0,15,4062,15,12921,281.290727,1.395894999999996,23279,74051
"172.16.133.96",53534,"209.247.230.167",80,11,2592,21176,0,0,6,1296,5,1296,281.291275,1.1896950000000288,8714,8714
"172.16.133.55",57868,"172.16.139.250",5440,10,1022,21177,0,0,10,1022,0,0,281.291804,0.005513000000007651,1483040,0
"172.16.133.72",52252,"66.35.252.234",80,15,8183,21178,0,0,7,2291,8,5892,281.305022,1.0839129999999955,16909,43486
"172.16.133.73",60939,"172.16.139.250",5440,12,1142,21179,0,0,12,1142,0,0,281.315365,0.006379000000038104,1432199,0
"172.16.133.53",54341,"172.16.139.250",5440,12,1142,21180,0,0,12,1142,0,0,281.317056,0.008650000000045566,1056184,0
"172.16.133.21",53416,"172.16.139.250",5440,12,1142,21181,0,0,12,1142,0,0,281.320928,0.008513999999991029,1073056,0
"172.16.133.30",62914,"172.16.139.250",5440,10,1022,21182,0,0,10,1022,0,0,281.325397,0.008143000000018219,1004052,0
"172.16.133.25",63718,"172.16.139.250",5440,12,1142,21183,0,0,12,1142,0,0,281.33122,0.006106000000045242,1496233,0
"172.16.133.34",50706,"172.16.139.250",5440,10,1022,21184,0,0,10,1022,0,0,281.3403,0.0065159999999764295,1254757,0
"172.16.133.97",59622,"172.16.139.250",5440,10,1022,21185,0,0,10,1022,0,0,281.350779,0.005429999999989832,1505709,0
"172.16.133.33",58127,"172.16.139.250",5440,12,1142,21186,0,0,12,1142,0,0,281.419714,0.015445999999997184,591479,0
"172.16.133.68",61032,"172.16.139.250",5440,10,1022,21187,0,0,10,1022,0,0,281.457646,0.009033999999985554,905025,0
"172.16.133.12",60024,"172.16.139.250",5440,12,1142,21188,0,0,12,1142,0,0,281.470255,0.00686799999999721,1330227,0
"172.16.133.63",54230,"172.16.139.250",5440,12,1142,21189,0,0,12,1142,0,0,281.482098,0.005785000000003038,1579256,0
"172.16.133.35",50202,"67.217.64.244",443,6,366,21190,0,0,4,246,2,120,281.491738,0.07122299999997495,27631,13478
"172.16.133.66",54445,"172.16.139.250",5440,12,1142,21191,0,0,12,1142,0,0,281.493236,0.006142999999951826,1487221,0
"172.16.133.82",61671,"172.16.139.250",5440,10,1022,21192,0,0,10,1022,0,0,281.507856,0.007110000000011496,1149929,0
"172.16.133.35",50203,"216.115.223.200",443,6,366,21193,0,0,4,246,2,120,281.511084,0.11070100000000593,17777,8672
"172.16.133.67",56235,"173.194.68.95",80,6,372,21194,0,0,4,246,2,126,281.516377,14.537462000000005,135,69
"172.16.133.67",56236,"173.194.68.95",80,6,372,21195,0,0,4,246,2,126,281.516661,14.53717899999998,135,69
"172.16.133.67",56237,"184.73.225.104",80,16,6411,21196,0,0,9,4322,7,2089,281.516751,14.534019,2378,1149
"172.16.133.67",56238,"184.73.225.104",80,9,564,21197,0,0,5,312,4,252,281.516986,14.533881000000008,171,138
"172.16.133.67",56239,"184.73.225.104",80,9,564,21198,0,0,5,312,4,252,281.517038,14.534019999999998,171,138
"172.16.133.67",56240,"184.73.225.104",80,9,564,21199,0,0,5,312,4,252,281.517271,14.533988000000022,171,138
"172.16.133.67",56241,"184.73.225.104",80,9,564,21200,0,0,5,312,4,252,281.517272,14.528693000000032,171,138
"172.16.133.67",56242,"184.73.225.104",80,9,564,21201,0,0,5,312,4,252,281.517551,14.533406999999954,171,138
"172.16.133.37",60895,"172.16.139.250",5440,12,1142,21202,0,0,12,1142,0,0,281.521372,0.006515000000035798,1402302,0
"172.16.133.67",56243,"72.21.194.15",80,6,372,21203,0,0,4,246,2,126,281.556011,14.489692999999988,135,69
"172.16.133.67",56244,"74.125.226.201",80,6,372,21204,0,0,4,246,2,126,281.556107,14.47578900000002,135,69
"172.16.133.67",56245,"74.125.226.201",80,6,372,21205,0,0,4,246,2,126,281.556381,14.477139000000022,135,69
"172.16.133.35",50204,"66.151.150.190",443,6,366,21206,0,0,4,246,2,120,281.556466,0.20219600000001492,9733,4747
"172.16.133.67",56246,"74.125.226.201",443,15,4089,21207,0,0,8,958,7,3131,281.556467,2.51302800000002,3049,9967
"172.16.133.67",56247,"204.232.250.219",80,7,432,21208,0,0,4,246,3,186,281.562042,14.484504999999956,135,102
"172.16.133.67",56248,"204.232.250.219",80,7,432,21209,0,0,4,246,3,186,281.562126,14.484419000000003,135,102
"172.16.133.35",50205,"216.219.113.250",443,6,366,21210,0,0,4,246,2,120,281.571834,0.21800700000000006,9027,4403
"172.16.133.78",59491,"172.16.139.250",5440,10,1022,21211,0,0,10,1022,0,0,281.676273,0.0058109999999942374,1406986,0
"172.16.133.67",56249,"172.16.139.250",5440,10,1022,21212,0,0,10,1022,0,0,281.732192,0.01539700000000721,531012,0
"172.16.133.56",61684,"172.16.139.250",5440,12,1142,21213,0,0,12,1142,0,0,281.755937,0.004815000000007785,"",""
"172.16.133.113",55764,"67.217.64.244",443,6,362,21214,0,0,4,242,2,120,281.769889,0.07137900000003583,27122,13449
"172.16.133.114",55365,"67.217.65.49",443,41,6921,21215,0,0,25,2222,16,4699,281.78162,18.21250500000002,976,2064
"172.16.133.41",53389,"172.16.139.250",5440,10,1022,21216,0,0,10,1022,0,0,281.809157,0.005399999999951888,1514074,0
"172.16.133.113",55765,"216.115.223.200",443,7,422,21217,0,0,4,242,3,180,281.813126,0.12407300000000987,15603,11606
"172.16.133.43",58005,"172.16.139.250",5440,12,1142,21218,0,0,12,1142,0,0,281.879925,0.016015999999979158,570429,0
"172.16.133.6",1740,"172.16.128.201",1060,23,5411,21219,0,0,12,3216,11,2195,281.895043,6.54273900000004,3932,2683
"172.16.133.13",53299,"172.16.139.250",5440,12,1142,21220,0,0,12,1142,0,0,281.901515,0.018180999999970027,502502,0
"172.16.133.85",52515,"172.16.139.250",5440,10,1022,21221,0,0,10,1022,0,0,281.905537,0.005235000000027412,1561795,0
"172.16.133.113",55766,"66.151.150.190",443,6,362,21222,0,0,4,242,2,120,281.933486,0.2580829999999992,7501,3719
"172.16.133.113",55767,"216.219.113.250",443,6,362,21223,0,0,4,242,2,120,281.9372,0.21171199999997725,9144,4534
"172.16.133.42",57352,"172.16.139.250",5440,12,1142,21224,0,0,12,1142,0,0,281.93838,0.026310000000023592,347244,0
"172.16.133.20",62699,"172.16.139.250",5440,12,1142,21225,0,0,12,1142,0,0,281.950097,0.015545999999972082,587675,0
"172.16.133.42",57353,"67.217.95.254",443,6,366,21226,0,0,4,246,2,120,281.957387,0.0594780000000128,33087,16140
"172.16.133.28",49443,"172.16.139.250",5440,10,1022,21227,0,0,10,1022,0,0,281.978562,0.014832000000012613,551240,0
"172.16.133.114",55366,"67.217.64.49",443,41,6921,21228,0,0,25,2222,16,4699,282.003627,17.98791,988,2089
"172.16.133.99",56289,"172.16.139.250",5440,12,1142,21229,0,0,12,1142,0,0,282.006657,0.005093999999985499,1793482,0
"172.16.133.75",51203,"172.16.139.250",5440,12,1142,21230,0,0,12,1142,0,0,282.012062,0.01616999999998825,564996,0
"172.16.133.87",60496,"172.16.139.250",5440,12,1142,21231,0,0,12,1142,0,0,282.032149,0.005912000000023454,1545331,0
"172.16.133.35",50206,"172.16.139.250",5440,12,1142,21232,0,0,12,1142,0,0,282.036537,0.012366999999983364,738740,0
"172.16.133.42",57354,"216.219.117.244",443,6,366,21233,0,0,4,246,2,120,282.039382,0.2151049999999941,9149,4462
"172.16.133.42",57355,"78.108.117.250",443,6,366,21234,0,0,4,246,2,120,282.040987,0.18999000000002297,10358,5052
"172.16.133.116",54082,"172.16.139.250",5440,10,1022,21235,0,0,10,1022,0,0,282.045185,0.006791000000021086,1203946,0
"172.16.133.116",54083,"172.16.139.250",5440,10,1022,21236,0,0,10,1022,0,0,282.05358,0.009225000000014916,886287,0
"172.16.133.116",54084,"172.16.139.250",5440,10,1022,21237,0,0,10,1022,0,0,282.063728,0.005841999999972813,1399520,0
"172.16.133.84",59044,"157.56.244.217",443,6,374,21238,0,0,3,194,3,180,282.065877,1.1869249999999738,1307,1213
"172.16.133.84",59045,"172.16.139.250",5440,12,1142,21239,0,0,12,1142,0,0,282.066157,0.007872000000020307,1160569,0
"172.16.133.49",56018,"172.16.139.250",5440,12,1142,21240,0,0,12,1142,0,0,282.141383,0.015444999999999709,591518,0
"172.16.133.95",57241,"172.16.139.250",5440,10,1022,21241,0,0,10,1022,0,0,282.184686,0.005288000000007287,1546142,0
"172.16.133.92",57906,"172.16.139.250",5440,12,1142,21242,0,0,12,1142,0,0,282.208624,0.019854000000009364,460159,0
"172.16.133.42",57356,"202.173.25.200",443,6,366,21243,0,0,4,246,2,120,282.209862,0.5315730000000372,3702,1805
"172.16.133.72",52283,"173.194.68.95",443,15,4035,21244,0,0,8,1305,7,2730,282.211274,0.509789000000012,20479,42841
"172.16.133.72",52284,"72.21.91.187",80,11,3943,21245,0,0,6,1235,5,2708,282.214572,5.95224300000001,1659,3639
"172.16.133.29",61240,"172.16.139.250",5440,10,1022,21246,0,0,10,1022,0,0,282.228808,0.005312000000003536,1539156,0
"172.16.133.44",65067,"172.16.139.250",5440,10,1022,21247,0,0,10,1022,0,0,282.233648,0.00530900000001111,1540026,0
"172.16.133.72",52285,"173.194.74.82",80,7,1143,21248,0,0,4,802,3,341,282.248785,0.2884510000000091,22242,9457
"172.16.133.207",56174,"172.16.139.250",5440,12,1142,21249,0,0,12,1142,0,0,282.258967,0.004930000000001655,"",""
"172.16.133.83",57341,"172.16.139.250",5440,12,1142,21250,0,0,12,1142,0,0,282.270192,0.014756999999974596,619096,0
"172.16.133.114",55367,"67.217.66.49",443,41,6921,21251,0,0,25,2222,16,4699,282.281791,17.712332000000004,1003,2122
"172.16.133.93",61126,"172.16.139.250",5440,10,1022,21252,0,0,10,1022,0,0,282.28317,0.0055110000000127,1483578,0
"172.16.133.11",55403,"172.16.139.250",5440,10,1022,21253,0,0,10,1022,0,0,282.302125,0.015740999999991345,519407,0
"172.16.133.55",57869,"172.16.139.250",5440,10,1022,21254,0,0,10,1022,0,0,282.305864,0.00567799999998897,1439943,0
"172.16.133.96",53535,"209.234.235.129",80,18,5278,21255,0,0,10,3030,8,2248,282.31913,0.34591300000005276,70075,51989
"172.16.133.96",53536,"174.35.22.75",80,23,9395,21256,0,0,11,1934,12,7461,282.319133,6.878376000000003,2249,8677
"172.16.133.96",53537,"174.35.22.75",80,50,36102,21257,0,0,22,2678,28,33424,282.319134,6.878376000000003,3114,38874
"172.16.133.96",53538,"174.35.22.75",80,120,102689,21258,0,0,47,4981,73,97708,282.319135,6.877709999999979,5793,113651
"172.16.133.96",53539,"50.116.194.23",80,11,2310,21259,0,0,6,1549,5,761,282.319137,6.145396000000005,2016,990
"172.16.133.96",53540,"98.139.240.23",80,9,2357,21260,0,0,5,1739,4,618,282.319138,0.15755200000000968,88301,31380
"172.16.133.96",53541,"98.139.225.43",80,35,17172,21261,0,0,17,7395,18,9777,282.319139,3.8727930000000015,15275,20196
"172.16.133.96",53542,"98.139.50.175",80,10,2128,21262,0,0,5,1330,5,798,282.319185,0.1543699999999717,68925,41355
"172.16.133.73",60940,"172.16.139.250",5440,12,1142,21263,0,0,12,1142,0,0,282.328636,0.017661999999972977,517268,0
"172.16.133.53",54342,"172.16.139.250",5440,10,1022,21264,0,0,10,1022,0,0,282.331521,0.006062999999983276,1348507,0
"172.16.133.21",53417,"172.16.139.250",5440,10,1022,21265,0,0,10,1022,0,0,282.334721,0.00643600000000788,1270354,0
"172.16.133.30",62915,"172.16.139.250",5440,12,1142,21266,0,0,12,1142,0,0,282.338509,0.011721000000022741,779455,0
"172.16.133.25",63719,"172.16.139.250",5440,12,1142,21267,0,0,12,1142,0,0,282.345308,0.008257000000014614,1106455,0
"172.16.133.96",53543,"206.190.56.190",80,48,44403,21268,0,0,16,1860,32,42543,282.349691,10.218267999999966,1456,33307
"172.16.133.96",53544,"206.190.56.190",80,34,22095,21269,0,0,17,3391,17,18704,282.350085,13.393758000000048,2025,11171
"172.16.133.34",50707,"172.16.139.250",5440,12,1142,21270,0,0,12,1142,0,0,282.354177,0.0049809999999865795,"",""
"172.16.133.97",59623,"172.16.139.250",5440,12,1142,21271,0,0,12,1142,0,0,282.364678,0.015426999999988311,592208,0
"172.16.133.40",50294,"180.153.31.250",443,6,366,21272,0,0,4,246,2,120,282.429703,0.4754169999999931,4139,2019
"172.16.133.33",58128,"172.16.139.250",5440,12,1142,21273,0,0,12,1142,0,0,282.433584,0.0062360000000012406,1465041,0
"172.16.133.72",52286,"173.194.43.62",80,17,11199,21274,0,0,7,895,10,10304,282.433941,0.0928739999999948,77093,887568
"172.16.133.96",53545,"208.47.254.83",80,10,2573,21275,0,0,6,1310,4,1263,282.447891,0.08796599999999444,119136,114862
"172.16.133.68",61033,"172.16.139.250",5440,12,1142,21276,0,0,12,1142,0,0,282.471866,0.0067170000000373875,1360131,0
"172.16.133.12",60025,"172.16.139.250",5440,12,1142,21277,0,0,12,1142,0,0,282.485758,0.00646900000003825,1412273,0
"172.16.133.63",54231,"172.16.139.250",5440,10,1022,21278,0,0,10,1022,0,0,282.49625,0.005506000000025324,1484925,0
"172.16.133.96",53546,"76.13.234.33",80,14,4701,21279,0,0,7,2713,7,1988,282.500109,0.31244099999997843,69465,50902
"172.16.133.66",54446,"172.16.139.250",5440,12,1142,21280,0,0,12,1142,0,0,282.506055,0.0062479999999709435,1462227,0
"172.16.133.82",61672,"172.16.139.250",5440,12,1142,21281,0,0,12,1142,0,0,282.521931,0.01657399999999143,551224,0
"172.16.133.37",60896,"172.16.139.250",5440,10,1022,21282,0,0,10,1022,0,0,282.535016,0.0068740000000389045,1189409,0
"172.16.133.96",53547,"209.234.235.129",80,13,2523,21283,0,0,7,1629,6,894,282.542156,0.1963440000000105,66373,36425
"172.16.133.72",52287,"173.194.43.34",80,9,2510,21284,0,0,5,1766,4,744,282.597396,0.3351299999999924,42156,17760
"172.16.133.96",53548,"209.234.235.129",80,15,3318,21285,0,0,8,2121,7,1197,282.611,0.28695099999998774,59132,33371
"172.16.133.72",52288,"50.19.91.197",80,8,2418,21286,0,0,4,886,4,1532,282.618332,0.1895979999999895,37384,64642
"172.16.133.26",53117,"68.64.28.20",443,16,4808,21287,0,0,8,917,8,3891,282.628698,0.7260939999999891,10103,42870
"172.16.133.18",50328,"174.129.20.55",443,26,9590,21288,0,0,13,2336,13,7254,282.686621,10.319154000000026,1811,5623
"172.16.133.78",59492,"172.16.139.250",5440,12,1142,21289,0,0,12,1142,0,0,282.691365,0.00669199999998682,1365212,0
"172.16.133.72",52289,"173.194.43.34",80,7,1842,21290,0,0,4,1286,3,556,282.706622,0.2612930000000233,39373,17023
"172.16.133.16",59373,"23.21.132.234",80,8,1578,21291,0,0,5,985,3,593,282.717694,0.07714500000003,102145,61494
"172.16.133.26",53118,"68.64.28.20",443,16,4808,21292,0,0,8,917,8,3891,282.732397,0.8226099999999974,8917,37840
"172.16.133.72",52290,"204.93.223.146",80,7,1658,21293,0,0,4,1249,3,409,282.735142,0.29658399999999574,33690,11032
"172.16.133.67",56250,"172.16.139.250",5440,12,1142,21294,0,0,12,1142,0,0,282.745162,0.015506000000016229,589191,0
"172.16.133.16",59374,"208.92.52.90",80,12,1895,21295,0,0,7,1085,5,810,282.749915,0.9849900000000389,8812,6578
"172.16.133.56",61685,"172.16.139.250",5440,10,1022,21296,0,0,10,1022,0,0,282.770256,0.014857000000006337,550312,0
"172.16.133.41",53390,"172.16.139.250",5440,12,1142,21297,0,0,12,1142,0,0,282.824284,0.0072920000000067375,1252879,0
"172.16.133.43",58006,"172.16.139.250",5440,10,1022,21298,0,0,10,1022,0,0,282.892621,0.0055789999999547035,1465495,0
"172.16.133.78",59493,"24.184.234.182",42860,3,194,21299,0,0,3,194,0,0,282.898666,8.999937999999986,172,0
"172.16.133.13",53300,"172.16.139.250",5440,10,1022,21300,0,0,10,1022,0,0,282.913709,0.014980000000036853,545794,0
"172.16.133.85",52516,"172.16.139.250",5440,10,1022,21301,0,0,10,1022,0,0,282.919144,0.015687999999954627,521162,0
"172.16.133.42",57357,"172.16.139.250",5440,12,1142,21302,0,0,12,1142,0,0,282.953528,0.028448999999966418,321136,0
"172.16.133.20",62700,"172.16.139.250",5440,12,1142,21303,0,0,12,1142,0,0,282.963499,0.005176000000005843,1765069,0
"172.16.133.28",49444,"172.16.139.250",5440,12,1142,21304,0,0,12,1142,0,0,282.993757,0.015454999999974461,591135,0
"172.16.133.55",57870,"67.217.64.244",443,6,366,21305,0,0,4,246,2,120,282.995498,0.04957400000000689,39698,19364
"172.16.133.126",62177,"184.73.225.104",443,22,7276,21306,0,0,11,1982,11,5294,283.013676,5.356392000000028,2960,7906
"172.16.133.99",56290,"172.16.139.250",5440,12,1142,21307,0,0,12,1142,0,0,283.020466,0.015160999999977776,602598,0
"172.16.133.55",57871,"216.115.223.200",443,6,366,21308,0,0,4,246,2,120,283.021343,0.10662100000001828,18457,9003
"172.16.133.75",51204,"172.16.139.250",5440,12,1142,21309,0,0,12,1142,0,0,283.026004,0.005534000000011474,1650885,0
"172.16.133.26",53119,"68.64.28.20",443,40,9308,21310,0,0,18,3671,22,5637,283.035278,13.02365900000001,2254,3462
"172.16.133.87",60498,"172.16.139.250",5440,10,1022,21311,0,0,10,1022,0,0,283.045914,0.014720000000011169,555434,0
"172.16.133.35",50207,"172.16.139.250",5440,12,1142,21312,0,0,12,1142,0,0,283.048128,0.008122999999955027,1124707,0
"172.16.133.116",54085,"172.16.139.250",5440,10,1022,21313,0,0,10,1022,0,0,283.056346,0.015203999999982898,537753,0
"172.16.133.116",54086,"172.16.139.250",5440,12,1142,21314,0,0,12,1142,0,0,283.072524,0.006298000000015236,1450619,0
"172.16.133.116",54087,"172.16.139.250",5440,12,1142,21315,0,0,12,1142,0,0,283.079723,0.005429999999989832,1682504,0
"172.16.133.84",59046,"172.16.139.250",5440,10,1022,21316,0,0,10,1022,0,0,283.080032,0.014438999999981661,566244,0
"172.16.133.55",57872,"66.151.150.190",443,6,366,21317,0,0,4,246,2,120,283.132419,0.189254999999946,10398,5072
"172.16.133.55",57873,"216.219.113.250",443,6,366,21318,0,0,4,246,2,120,283.137294,0.20057400000001735,9811,4786
"172.16.133.49",56019,"172.16.139.250",5440,10,1022,21319,0,0,10,1022,0,0,283.1548,0.015267999999991844,535499,0
"172.16.133.95",57242,"172.16.139.250",5440,12,1142,21320,0,0,12,1142,0,0,283.198762,0.005495999999993728,1662299,0
"172.16.133.92",57907,"172.16.139.250",5440,10,1022,21321,0,0,10,1022,0,0,283.223311,0.10569999999995616,77350,0
"172.16.133.29",61241,"172.16.139.250",5440,10,1022,21322,0,0,10,1022,0,0,283.242455,0.07106499999997595,115049,0
"172.16.133.44",65068,"172.16.139.250",5440,10,1022,21323,0,0,10,1022,0,0,283.247987,0.06953299999997853,117584,0
"172.16.133.84",59047,"157.56.234.137",80,8,884,21324,0,0,5,532,3,352,283.257388,0.2250569999999925,18910,12512
"172.16.133.207",56175,"172.16.139.250",5440,12,1142,21325,0,0,12,1142,0,0,283.27232,0.04889200000002347,186860,0
"172.16.133.83",57342,"172.16.139.250",5440,12,1142,21326,0,0,12,1142,0,0,283.283198,0.04171099999996386,219030,0
"172.16.133.93",61127,"172.16.139.250",5440,12,1142,21327,0,0,12,1142,0,0,283.296828,0.03605099999998629,253418,0
"172.16.133.11",55404,"172.16.139.250",5440,10,1022,21328,0,0,10,1022,0,0,283.315126,0.021444999999971515,381254,0
"172.16.133.126",62178,"157.56.236.89",443,6,374,21329,0,0,3,194,3,180,283.319249,1.3800170000000094,1124,1043
"172.16.133.55",57874,"172.16.139.250",5440,10,1022,21330,0,0,10,1022,0,0,283.320736,0.019499999999993634,419282,0
"172.16.133.73",60941,"172.16.139.250",5440,10,1022,21331,0,0,10,1022,0,0,283.341677,0.006056999999998425,1349843,0
"172.16.133.53",54343,"172.16.139.250",5440,10,1022,21332,0,0,10,1022,0,0,283.346165,0.017136999999991076,477096,0
"172.16.133.21",53418,"172.16.139.250",5440,12,1142,21333,0,0,12,1142,0,0,283.348659,0.022382999999990716,408166,0
"172.16.133.30",62916,"172.16.139.250",5440,10,1022,21334,0,0,10,1022,0,0,283.353669,0.005190999999967971,1575033,0
"172.16.133.25",63720,"172.16.139.250",5440,12,1142,21335,0,0,12,1142,0,0,283.359122,0.007809000000008837,1169932,0
"172.16.133.34",50708,"172.16.139.250",5440,10,1022,21336,0,0,10,1022,0,0,283.368278,0.00620600000002014,1317434,0
"172.16.133.97",59624,"172.16.139.250",5440,10,1022,21337,0,0,10,1022,0,0,283.378738,0.005318999999985863,1537131,0
"172.16.133.84",59048,"157.56.237.6",443,24,9451,21338,0,0,11,2715,13,6736,283.423509,0.7795449999999846,27862,69127
"172.16.133.33",58129,"172.16.139.250",5440,12,1142,21339,0,0,12,1142,0,0,283.447721,0.00634900000000016,1438966,0
"172.16.133.26",53120,"172.16.139.250",5440,10,1022,21340,0,0,10,1022,0,0,283.484101,0.005188999999973021,1575640,0
"172.16.133.68",61034,"172.16.139.250",5440,12,1142,21341,0,0,12,1142,0,0,283.485749,0.008135999999979049,1122910,0
"172.16.133.12",60026,"172.16.139.250",5440,12,1142,21342,0,0,12,1142,0,0,283.499383,0.006084999999984575,1501396,0
"172.16.133.63",54232,"172.16.139.250",5440,12,1142,21343,0,0,12,1142,0,0,283.510101,0.006202999999970871,1472835,0
"172.16.133.26",53071,"96.43.146.176",443,2,120,21344,0,0,1,60,1,60,283.514877,4.999999998744897e-05,"",""
"172.16.133.26",53121,"96.43.146.176",443,25,7588,21345,0,0,14,3510,11,4078,283.515216,13.751852999999983,2041,2372
"172.16.133.66",54447,"172.16.139.250",5440,10,1022,21346,0,0,10,1022,0,0,283.519916,0.0061059999999883985,1339010,0
"172.16.133.82",61673,"172.16.139.250",5440,12,1142,21347,0,0,12,1142,0,0,283.536211,0.01573799999999892,580505,0
"172.16.133.35",50208,"67.217.64.244",443,6,366,21348,0,0,4,246,2,120,283.538024,0.08357200000000375,23548,11487
"172.16.133.37",60897,"172.16.139.250",5440,10,1022,21349,0,0,10,1022,0,0,283.548438,0.0072650000000180626,1125395,0
"172.16.133.26",53122,"96.43.146.176",443,20,11525,21350,0,0,10,5062,10,6463,283.575669,16.121417000000008,2511,3207
"172.16.133.35",50209,"216.115.223.200",443,6,366,21351,0,0,4,246,2,120,283.586429,0.09917100000001255,19844,9680
"172.16.133.96",53549,"209.234.235.129",80,14,4200,21352,0,0,7,2054,7,2146,283.636963,0.2943700000000149,55820,58321
"172.16.133.96",53550,"209.234.235.129",80,17,8323,21353,0,0,8,2117,9,6206,283.636965,0.2812120000000391,60225,176550
"172.16.133.96",53551,"209.234.235.129",80,14,4157,21354,0,0,7,2056,7,2101,283.636966,0.2968770000000518,55403,56616
"172.16.133.96",53552,"209.234.235.129",80,12,2546,21355,0,0,6,1613,6,933,283.636968,0.23172699999997803,55686,32210
"172.16.133.96",53553,"74.217.34.33",80,26,11814,21356,0,0,11,2947,15,8867,283.638142,0.2690189999999575,87636,263683
"172.16.133.96",53554,"23.45.65.51",80,24,18666,21357,0,0,11,1876,13,16790,283.664269,0.21325500000000375,70375,629856
"172.16.133.96",53555,"23.45.65.26",80,13,8394,21358,0,0,6,1678,7,6716,283.664807,0.16114099999998643,83305,333422
"172.16.133.96",53556,"23.45.65.26",80,35,26611,21359,0,0,16,5692,19,20919,283.664809,0.3827630000000113,118966,437220
"172.16.133.35",50210,"66.151.150.190",443,6,366,21360,0,0,4,246,2,120,283.665378,0.19957200000004605,9861,4810
"172.16.133.35",50211,"216.219.113.250",443,6,366,21361,0,0,4,246,2,120,283.686576,0.20977299999998422,9381,4576
"172.16.133.78",59494,"172.16.139.250",5440,12,1142,21362,0,0,12,1142,0,0,283.70565,0.006443999999987682,1417752,0
"172.16.133.67",56251,"172.16.139.250",5440,12,1142,21363,0,0,12,1142,0,0,283.759349,0.015329000000008364,595994,0
"172.16.133.56",61686,"172.16.139.250",5440,12,1142,21364,0,0,12,1142,0,0,283.782783,0.005742999999995391,1590806,0
"172.16.133.113",55770,"67.217.64.244",443,6,366,21365,0,0,4,246,2,120,283.821031,0.09307999999998628,21143,10313
"172.16.133.41",53391,"172.16.139.250",5440,10,1022,21366,0,0,10,1022,0,0,283.838514,0.015258000000017091,535850,0
"172.16.133.34",50709,"172.16.139.250",5440,10,1022,21367,0,0,10,1022,0,0,283.853093,0.005230999999980668,1562989,0
"172.16.133.96",53557,"74.217.34.33",80,13,3675,21368,0,0,6,1737,7,1938,283.870719,0.13317299999999932,104345,116419
"172.16.133.96",53558,"74.217.34.33",80,11,2858,21369,0,0,6,1703,5,1155,283.871096,0.1433059999999955,95069,64477
"172.16.133.36",65047,"96.43.146.22",443,2,132,21370,0,0,1,66,1,66,283.898103,8.300000001781882e-05,"",""
"172.16.133.36",65048,"96.43.146.22",443,2,132,21371,0,0,1,66,1,66,283.902569,9.999999997489795e-05,"",""
"172.16.133.36",65043,"96.43.146.48",443,2,132,21372,0,0,1,66,1,66,283.902571,0.00015299999995477265,"",""
"172.16.133.36",65045,"96.43.146.48",443,2,132,21373,0,0,1,66,1,66,283.902572,0.00015299999995477265,"",""
"172.16.133.36",65044,"96.43.146.48",443,2,132,21374,0,0,1,66,1,66,283.902574,0.0002000000000066393,"",""
"172.16.133.36",65046,"96.43.146.48",443,2,132,21375,0,0,1,66,1,66,283.902575,0.0002000000000066393,"",""
"172.16.133.36",65037,"96.43.146.48",443,2,132,21376,0,0,1,66,1,66,283.902576,0.0002479999999991378,"",""
"172.16.133.43",58007,"172.16.139.250",5440,10,1022,21377,0,0,10,1022,0,0,283.906543,0.006343000000015309,1288979,0
"172.16.133.113",55771,"216.115.223.200",443,6,366,21378,0,0,4,246,2,120,283.912888,0.10423900000000685,18879,9209
"172.16.133.13",53301,"172.16.139.250",5440,10,1022,21379,0,0,10,1022,0,0,283.927887,0.005373000000020056,1521682,0
"172.16.133.85",52517,"172.16.139.250",5440,12,1142,21380,0,0,12,1142,0,0,283.933527,0.016089999999962856,567806,0
"172.16.133.42",57358,"172.16.139.250",5440,12,1142,21381,0,0,12,1142,0,0,283.966781,0.01769399999994903,516333,0
"172.16.133.20",62701,"172.16.139.250",5440,12,1142,21382,0,0,12,1142,0,0,283.97784,0.0085809999999924,1064677,0
"172.16.133.42",57359,"67.217.95.254",443,6,366,21383,0,0,4,246,2,120,283.996649,0.05338899999998148,36861,17981
"172.16.133.28",49445,"172.16.139.250",5440,10,1022,21384,0,0,10,1022,0,0,284.005971,0.005391000000031454,1516601,0
"172.16.133.99",56291,"172.16.139.250",5440,12,1142,21385,0,0,12,1142,0,0,284.034656,0.022105000000010477,413300,0
"172.16.133.75",51205,"172.16.139.250",5440,10,1022,21386,0,0,10,1022,0,0,284.041356,0.018823999999995067,434339,0
"172.16.133.113",55772,"216.219.113.250",443,6,366,21387,0,0,4,246,2,120,284.04292,0.2103620000000319,9355,4563
"172.16.133.113",55773,"66.151.150.190",443,6,366,21388,0,0,4,246,2,120,284.055342,0.19533100000001014,10075,4914
"172.16.133.87",60499,"172.16.139.250",5440,10,1022,21389,0,0,10,1022,0,0,284.060937,0.005303999999966891,1541478,0
"172.16.133.35",50212,"172.16.139.250",5440,12,1142,21390,0,0,12,1142,0,0,284.062948,0.05251299999997627,173975,0
"172.16.133.116",54088,"172.16.139.250",5440,12,1142,21391,0,0,12,1142,0,0,284.070361,0.006302000000005137,1449698,0
"172.16.133.116",54089,"172.16.139.250",5440,10,1022,21392,0,0,10,1022,0,0,284.077494,0.014824999999973443,551500,0
"172.16.133.116",54090,"172.16.139.250",5440,10,1022,21393,0,0,10,1022,0,0,284.093529,0.005588999999986299,1462873,0
"172.16.133.84",59049,"172.16.139.250",5440,10,1022,21394,0,0,10,1022,0,0,284.094291,0.018443999999988137,443287,0
"172.16.133.42",57360,"78.108.117.250",443,6,366,21395,0,0,4,246,2,120,284.145567,0.2120029999999815,9282,4528
"172.16.133.42",57361,"216.219.117.244",443,6,366,21396,0,0,4,246,2,120,284.151848,0.2143270000000257,9182,4479
"172.16.133.49",56020,"172.16.139.250",5440,10,1022,21397,0,0,10,1022,0,0,284.168844,0.0057760000000257605,1415512,0
"172.16.133.84",59050,"157.56.242.198",443,26,15577,21398,0,0,11,1938,15,13639,284.21033,0.7625639999999976,20331,143085
"172.16.133.95",57243,"172.16.139.250",5440,10,1022,21399,0,0,10,1022,0,0,284.212647,0.005372000000022581,1521965,0
"172.16.133.92",57908,"172.16.139.250",5440,10,1022,21400,0,0,10,1022,0,0,284.237385,0.015234999999961474,536659,0
"172.16.133.29",61242,"172.16.139.250",5440,10,1022,21401,0,0,10,1022,0,0,284.25534,0.005479000000036649,1492243,0
"172.16.133.44",65069,"172.16.139.250",5440,10,1022,21402,0,0,10,1022,0,0,284.262276,0.0053660000000377295,1523667,0
"172.16.133.207",56176,"172.16.139.250",5440,12,1142,21403,0,0,12,1142,0,0,284.286178,0.005089999999995598,1794891,0
"172.16.133.83",57343,"172.16.139.250",5440,12,1142,21404,0,0,12,1142,0,0,284.297027,0.006601999999986674,1383823,0
"172.16.133.93",61128,"172.16.139.250",5440,10,1022,21405,0,0,10,1022,0,0,284.310757,0.004932999999994081,"",""
"172.16.133.11",55405,"172.16.139.250",5440,10,1022,21406,0,0,10,1022,0,0,284.329086,0.015287999999998192,534798,0
"172.16.133.55",57875,"172.16.139.250",5440,10,1022,21407,0,0,10,1022,0,0,284.333849,0.0054770000000416985,1492788,0
"172.16.133.73",60942,"172.16.139.250",5440,10,1022,21408,0,0,10,1022,0,0,284.356942,0.020105000000000928,406665,0
"172.16.133.53",54344,"172.16.139.250",5440,10,1022,21409,0,0,10,1022,0,0,284.359414,0.005625000000009095,1453511,0
"172.16.133.21",53419,"172.16.139.250",5440,12,1142,21410,0,0,12,1142,0,0,284.361934,0.007818999999983589,1168435,0
"172.16.133.30",62917,"172.16.139.250",5440,10,1022,21411,0,0,10,1022,0,0,284.366519,0.006296000000020285,1298602,0
"172.16.133.25",63721,"172.16.139.250",5440,10,1022,21412,0,0,10,1022,0,0,284.373397,0.00744299999996656,1098481,0
"172.16.133.34",50710,"172.16.139.250",5440,10,1022,21413,0,0,10,1022,0,0,284.382569,0.004974000000004253,"",""
"172.16.133.97",59625,"172.16.139.250",5440,10,1022,21414,0,0,10,1022,0,0,284.393076,0.0053679999999758365,1523099,0
"172.16.133.33",58130,"172.16.139.250",5440,10,1022,21415,0,0,10,1022,0,0,284.461764,0.00562400000001162,1453769,0
"172.16.133.42",57362,"202.173.25.200",443,6,366,21416,0,0,4,246,2,120,284.478981,0.5283440000000041,3724,1816
"172.16.133.68",61035,"172.16.139.250",5440,10,1022,21417,0,0,10,1022,0,0,284.498712,0.005790999999987889,1411845,0
"172.16.133.63",54233,"172.16.139.250",5440,12,1142,21418,0,0,12,1142,0,0,284.524142,0.008363000000031207,1092430,0
"172.16.133.12",60027,"172.16.139.250",5440,12,1142,21419,0,0,12,1142,0,0,284.527228,0.033642000000043026,271565,0
"172.16.133.66",54448,"172.16.139.250",5440,10,1022,21420,0,0,10,1022,0,0,284.534058,0.014843999999982316,550794,0
"172.16.133.82",61674,"172.16.139.250",5440,10,1022,21421,0,0,10,1022,0,0,284.54902,0.017409000000043306,469642,0
"172.16.133.93",61129,"74.63.51.79",80,309,353553,21422,0,0,75,5561,234,347992,284.552646,12.964745999999991,3431,214731
"172.16.133.37",60898,"172.16.139.250",5440,10,1022,21423,0,0,10,1022,0,0,284.563472,0.015590000000031523,524438,0
"172.16.133.93",61130,"74.63.51.79",80,93,93786,21424,0,0,29,3840,64,89946,284.563727,12.953931000000011,2371,55548
"172.16.133.93",61131,"74.63.51.79",80,127,126512,21425,0,0,42,4686,85,121826,284.564699,12.952827999999954,2894,75242
"172.16.133.93",61132,"74.63.51.79",80,49,42512,21426,0,0,18,2133,31,40379,284.565197,12.952691000000016,1317,24939
"172.16.133.93",61133,"74.63.51.79",80,108,114194,21427,0,0,31,3960,77,110234,284.565656,12.952103000000022,2445,68087
"172.16.133.93",61134,"74.63.51.79",80,200,219411,21428,0,0,53,5280,147,214131,284.57995,12.93726700000002,3264,132411
"172.16.133.233",16262,"184.73.225.104",80,75,19902,21429,0,0,42,2532,33,17370,284.621515,0.22069800000002715,91781,629638
"172.16.133.233",30150,"172.16.125.220",80,7,420,21430,0,0,4,240,3,180,284.622198,0.21109899999999016,9095,6821
"172.16.133.93",61135,"63.241.108.124",80,12,6425,21431,0,0,7,3727,5,2698,284.628202,0.1115649999999846,267252,193465
"172.16.133.40",50295,"180.153.31.250",443,6,366,21432,0,0,4,246,2,120,284.677973,0.47096799999997074,4178,2038
"172.16.133.126",62179,"157.56.240.137",443,6,374,21433,0,0,3,194,3,180,284.706106,1.0801780000000463,1436,1333
"172.16.133.93",61136,"138.108.6.20",80,10,2477,21434,0,0,5,1347,5,1130,284.71259,14.435235000000034,746,626
"172.16.133.78",59495,"172.16.139.250",5440,12,1142,21435,0,0,12,1142,0,0,284.718722,0.006468999999981406,1412273,0
"172.16.133.67",56252,"172.16.139.250",5440,10,1022,21436,0,0,10,1022,0,0,284.773127,0.014820999999983542,551649,0
"172.16.133.56",61687,"172.16.139.250",5440,12,1142,21437,0,0,12,1142,0,0,284.797637,0.00571300000001429,1599159,0
"172.16.133.93",61137,"72.21.91.121",80,15,3251,21438,0,0,8,1520,7,1731,284.815481,12.69764200000003,957,1090
"172.16.133.93",61138,"72.21.91.121",80,15,3231,21439,0,0,8,1520,7,1711,284.815611,12.696808000000033,957,1078
"172.16.133.93",61139,"72.21.91.121",80,15,3676,21440,0,0,8,1991,7,1685,284.821063,12.69194600000003,1254,1062
"172.16.133.93",61140,"72.21.91.121",80,14,4393,21441,0,0,7,1454,7,2939,284.82197,12.690173999999956,916,1852
"172.16.133.93",61141,"72.21.91.121",80,13,2722,21442,0,0,7,1504,6,1218,284.822796,12.689921000000027,948,767
"172.16.133.93",61142,"72.21.91.121",80,13,2687,21443,0,0,7,1454,6,1233,284.823499,12.68930899999998,916,777
"172.16.133.93",61143,"72.21.91.121",80,13,2695,21444,0,0,7,1454,6,1241,284.824081,12.688203000000044,916,782
"172.16.133.93",61144,"72.21.91.121",80,13,2682,21445,0,0,7,1454,6,1228,284.834124,12.67840000000001,917,774
"172.16.133.93",61145,"72.21.91.121",80,15,3251,21446,0,0,8,1520,7,1731,284.835604,12.677014999999983,959,1092
"172.16.133.93",61146,"72.21.91.121",80,15,3171,21447,0,0,8,1483,7,1688,284.836696,12.673922000000005,936,1065
"172.16.133.93",61147,"72.21.91.121",80,14,4439,21448,0,0,7,1454,7,2985,284.836932,12.675102000000038,917,1884
"172.16.133.93",61148,"72.21.91.121",80,13,2182,21449,0,0,7,946,6,1236,284.837114,12.674733000000003,597,780
"172.16.133.93",61149,"63.241.108.124",80,15,9688,21450,0,0,8,4232,7,5456,284.844635,0.14723300000002837,229948,296455
"172.16.133.41",53392,"172.16.139.250",5440,10,1022,21451,0,0,10,1022,0,0,284.851205,0.005438000000026477,1503493,0
"172.16.133.43",58008,"172.16.139.250",5440,10,1022,21452,0,0,10,1022,0,0,284.921161,0.015129000000001724,540419,0
"172.16.133.103",63447,"96.43.146.22",443,13,3904,21453,0,0,8,3187,5,717,284.923008,0.341775000000041,74598,16782
"172.16.133.13",53302,"172.16.139.250",5440,10,1022,21454,0,0,10,1022,0,0,284.942682,0.005540999999993801,1475545,0
"172.16.133.96",53559,"74.217.34.33",80,116,59350,21455,0,0,44,4306,72,55044,284.944674,0.3715379999999868,92717,1185213
"172.16.133.96",53560,"74.217.34.33",80,15,5906,21456,0,0,7,1869,8,4037,284.945138,0.13677400000000262,109319,236126
"172.16.133.85",52518,"172.16.139.250",5440,10,1022,21457,0,0,10,1022,0,0,284.9473,0.014544000000000779,562156,0
"172.16.133.93",61150,"23.67.243.56",80,6,372,21458,0,0,4,246,2,126,284.979646,12.54433499999999,156,80
"172.16.133.42",57363,"172.16.139.250",5440,12,1142,21459,0,0,12,1142,0,0,284.984397,0.010987999999997555,831452,0
"172.16.133.20",62702,"172.16.139.250",5440,10,1022,21460,0,0,10,1022,0,0,284.993487,0.004936999999983982,"",""
"172.16.133.55",57876,"67.217.64.244",443,6,366,21461,0,0,4,246,2,120,285.017558,0.05214899999998579,37738,18408
"172.16.133.28",49446,"172.16.139.250",5440,10,1022,21462,0,0,10,1022,0,0,285.020211,0.00556499999999005,1469182,0
"172.16.133.93",61151,"199.59.148.86",443,19,6739,21463,0,0,9,2047,10,4692,285.022321,0.6295690000000036,26011,59621
"172.16.133.99",56292,"172.16.139.250",5440,10,1022,21464,0,0,10,1022,0,0,285.048936,0.01808299999999008,452137,0
"172.16.133.75",51206,"172.16.139.250",5440,12,1142,21465,0,0,12,1142,0,0,285.054958,0.008778000000006614,1040783,0
"172.16.133.87",60500,"172.16.139.250",5440,12,1142,21466,0,0,12,1142,0,0,285.075398,0.0060750000000098225,1503868,0
"172.16.133.35",50213,"172.16.139.250",5440,12,1142,21467,0,0,12,1142,0,0,285.07776,0.009551999999985128,956448,0
"172.16.133.55",57877,"216.115.223.200",443,6,366,21468,0,0,4,246,2,120,285.080629,0.09543500000000904,20621,10059
"172.16.133.116",54091,"172.16.139.250",5440,10,1022,21469,0,0,10,1022,0,0,285.085455,0.0058569999999917854,1395936,0
"172.16.133.116",54092,"172.16.139.250",5440,10,1022,21470,0,0,10,1022,0,0,285.092294,0.005877999999995609,1390949,0
"172.16.133.116",54093,"172.16.139.250",5440,10,1022,21471,0,0,10,1022,0,0,285.099143,0.00559099999998125,1462350,0
"172.16.133.84",59052,"172.16.139.250",5440,10,1022,21472,0,0,10,1022,0,0,285.106168,0.005523999999979878,1480086,0
"172.16.133.96",53561,"50.116.194.24",443,24,7784,21473,0,0,13,2648,11,5136,285.126054,5.1945969999999875,4078,7909
"172.16.133.49",56021,"172.16.139.250",5440,10,1022,21474,0,0,10,1022,0,0,285.18349,0.015632999999979802,522996,0
"172.16.133.95",57244,"172.16.139.250",5440,10,1022,21475,0,0,10,1022,0,0,285.226515,0.005522999999982403,1480354,0
"172.16.133.68",61036,"71.13.48.32",80,8,1072,21476,0,0,5,602,3,470,285.228344,0.2501450000000318,19252,15031
"172.16.133.55",57878,"66.151.150.190",443,6,366,21477,0,0,4,246,2,120,285.231571,0.18702400000000807,10522,5133
"172.16.133.55",57879,"216.219.113.250",443,6,366,21478,0,0,4,246,2,120,285.240562,0.19358099999999467,10166,4959
"172.16.133.92",57909,"172.16.139.250",5440,12,1142,21479,0,0,12,1142,0,0,285.250451,0.00599699999997938,1523428,0
"172.16.133.29",61243,"172.16.139.250",5440,10,1022,21480,0,0,10,1022,0,0,285.26996,0.005432999999982258,1504877,0
"172.16.133.44",65070,"172.16.139.250",5440,10,1022,21481,0,0,10,1022,0,0,285.275775,0.014533999999969183,562543,0
"172.16.133.207",56177,"172.16.139.250",5440,12,1142,21482,0,0,12,1142,0,0,285.300331,0.01466299999998455,623064,0
"172.16.133.83",57344,"172.16.139.250",5440,12,1142,21483,0,0,12,1142,0,0,285.312121,0.014990000000011605,609472,0
"172.16.133.96",53562,"74.217.34.33",80,16,5379,21484,0,0,8,1930,8,3449,285.315386,0.15269000000000688,101119,180706
"172.16.133.93",61152,"172.16.139.250",5440,10,1022,21485,0,0,10,1022,0,0,285.325558,0.005492000000003827,1488710,0
"172.16.133.11",55406,"172.16.139.250",5440,10,1022,21486,0,0,10,1022,0,0,285.344088,0.015544999999974607,525956,0
"172.16.133.113",55774,"172.16.139.250",135,8,492,21487,0,0,8,492,0,0,285.346021,0.02034600000001774,193453,0
"172.16.133.55",57880,"172.16.139.250",5440,10,1022,21488,0,0,10,1022,0,0,285.348926,0.005497999999988679,1487086,0
"172.16.133.96",53563,"66.220.152.19",80,11,5331,21489,0,0,5,1082,6,4249,285.357011,0.33547199999998156,25802,101325
"172.16.133.73",60943,"172.16.139.250",5440,10,1022,21490,0,0,10,1022,0,0,285.370758,0.005476999999984855,1492788,0
"172.16.133.53",54345,"172.16.139.250",5440,10,1022,21491,0,0,10,1022,0,0,285.374256,0.006334999999978663,1290607,0
"172.16.133.21",53420,"172.16.139.250",5440,10,1022,21492,0,0,10,1022,0,0,285.377504,0.015108999999995376,541134,0
"172.16.133.30",62918,"172.16.139.250",5440,10,1022,21493,0,0,10,1022,0,0,285.381661,0.004661999999996169,"",""
"172.16.133.96",53564,"69.147.86.184",80,50,9173,21494,0,0,26,2589,24,6584,285.384946,14.523225999999966,1426,3626
"172.16.133.113",55775,"172.16.139.250",5462,10,696,21495,0,0,10,696,0,0,285.386931,0.5741449999999872,9697,0
"172.16.133.25",63722,"172.16.139.250",5440,12,1142,21496,0,0,12,1142,0,0,285.387175,0.018285999999989144,499617,0
"172.16.133.34",50711,"172.16.139.250",5440,10,1022,21497,0,0,10,1022,0,0,285.396584,0.005113999999991847,1598748,0
"172.16.133.97",59626,"172.16.139.250",5440,10,1022,21498,0,0,10,1022,0,0,285.405773,0.005570999999974902,1467600,0
"172.16.133.33",58131,"172.16.139.250",5440,10,1022,21499,0,0,10,1022,0,0,285.475844,0.005611999999985073,1456878,0
"172.16.133.68",61038,"172.16.139.250",5440,10,1022,21500,0,0,10,1022,0,0,285.512981,0.00555799999995088,1471032,0
"172.16.133.12",60028,"172.16.139.250",5440,10,1022,21501,0,0,10,1022,0,0,285.527616,0.03154799999998659,259160,0
"172.16.133.63",54234,"172.16.139.250",5440,10,1022,21502,0,0,10,1022,0,0,285.538496,0.005754999999965094,1420677,0
"172.16.133.66",54449,"172.16.139.250",5440,10,1022,21503,0,0,10,1022,0,0,285.547885,0.005268000000000939,1552012,0
"172.16.133.96",53565,"98.137.80.31",80,16,7970,21504,0,0,8,877,8,7093,285.556159,14.05290500000001,499,4037
"172.16.133.82",61675,"172.16.139.250",5440,10,1022,21505,0,0,10,1022,0,0,285.563841,0.014865999999983615,549979,0
"172.16.133.37",60899,"172.16.139.250",5440,10,1022,21506,0,0,10,1022,0,0,285.57625,0.014659999999992124,557708,0
"172.16.133.35",50214,"67.217.64.244",443,6,366,21507,0,0,4,246,2,120,285.593913,0.097720000000038,20139,9823
"172.16.133.35",50215,"216.115.223.200",443,6,366,21508,0,0,4,246,2,120,285.64695,0.10102799999998524,19479,9502
"172.16.133.78",59496,"172.16.139.250",5440,12,1142,21509,0,0,12,1142,0,0,285.733415,0.006535000000042146,1398010,0
"172.16.133.96",53566,"98.139.161.29",80,12,1716,21510,0,0,7,937,5,779,285.743851,0.10451299999999719,71723,59628
"172.16.133.96",53567,"66.220.152.19",443,28,10452,21511,0,0,13,2391,15,8061,285.746107,0.22514000000001033,84960,286435
"172.16.133.35",50216,"66.151.150.190",443,6,366,21512,0,0,4,246,2,120,285.771452,0.19491599999997788,10096,4925
"172.16.133.126",62182,"157.56.244.217",443,6,374,21513,0,0,3,194,3,180,285.787208,1.204416999999978,1288,1195
"172.16.133.67",56253,"172.16.139.250",5440,12,1142,21514,0,0,12,1142,0,0,285.787511,0.0061249999999972715,1491591,0
"172.16.133.35",50217,"216.219.113.250",443,6,366,21515,0,0,4,246,2,120,285.795453,0.2067480000000046,9518,4643
"172.16.133.56",61688,"172.16.139.250",5440,12,1142,21516,0,0,12,1142,0,0,285.811726,0.005020000000001801,1819920,0
"172.16.133.113",55776,"67.217.64.244",443,6,366,21517,0,0,4,246,2,120,285.851287,0.06829699999997274,28815,14056
"172.16.133.41",53393,"172.16.139.250",5440,12,1142,21518,0,0,12,1142,0,0,285.865287,0.006199999999978445,1473548,0
"172.16.133.96",53568,"98.139.51.132",80,12,3101,21519,0,0,7,1378,5,1723,285.921634,0.08443500000004178,130561,163249
"172.16.133.43",58009,"172.16.139.250",5440,10,1022,21520,0,0,10,1022,0,0,285.934588,0.005378000000007432,1520267,0
"172.16.133.13",53303,"172.16.139.250",5440,12,1142,21521,0,0,12,1142,0,0,285.956425,0.006641999999999371,1375489,0
"172.16.133.113",55777,"216.115.223.200",443,6,366,21522,0,0,4,246,2,120,285.957776,0.09777199999996355,20128,9818
"172.16.133.85",52519,"172.16.139.250",5440,10,1022,21523,0,0,10,1022,0,0,285.960165,0.00585599999999431,1396174,0
"172.16.133.42",57364,"172.16.139.250",5440,12,1142,21524,0,0,12,1142,0,0,285.998825,0.00942099999997481,969748,0
"172.16.133.20",62703,"172.16.139.250",5440,10,1022,21525,0,0,10,1022,0,0,286.005697,0.004936999999983982,"",""
"172.16.133.96",53569,"98.139.225.43",80,9,1514,21526,0,0,5,680,4,834,286.009164,0.09295600000001514,58522,71775
"172.16.133.42",57365,"67.217.95.254",443,6,366,21527,0,0,4,246,2,120,286.030701,0.09529599999996208,20651,10073
"172.16.133.28",49447,"172.16.139.250",5440,12,1142,21528,0,0,12,1142,0,0,286.03376,0.006209000000012566,1471412,0
"172.16.133.96",53570,"74.122.143.73",80,11,2969,21529,0,0,6,1157,5,1812,286.039017,0.14673699999997325,63078,98788
"172.16.133.96",53571,"208.47.254.8",443,53,43077,21530,0,0,22,2413,31,40664,286.03943,0.2052680000000464,94042,1584815
"172.16.133.99",56293,"172.16.139.250",5440,12,1142,21531,0,0,12,1142,0,0,286.06259,0.015711000000010245,581503,0
"172.16.133.75",51207,"172.16.139.250",5440,10,1022,21532,0,0,10,1022,0,0,286.068947,0.005433000000039101,1504877,0
"172.16.133.95",57245,"184.168.192.63",80,20,11980,21533,0,0,8,932,12,11048,286.082129,13.846435999999983,538,6383
"172.16.133.87",60503,"172.16.139.250",5440,10,1022,21534,0,0,10,1022,0,0,286.088635,0.018931000000009135,431884,0
"172.16.133.116",54094,"172.16.139.250",5440,10,1022,21535,0,0,10,1022,0,0,286.098181,0.005786999999997988,1412821,0
"172.16.133.35",50218,"172.16.139.250",5440,12,1142,21536,0,0,12,1142,0,0,286.104786,0.021586000000013428,423237,0
"172.16.133.116",54095,"172.16.139.250",5440,10,1022,21537,0,0,10,1022,0,0,286.105305,0.006617000000005646,1235605,0
"172.16.133.116",54096,"172.16.139.250",5440,12,1142,21538,0,0,12,1142,0,0,286.112644,0.008114000000034594,1125955,0
"172.16.133.84",59053,"172.16.139.250",5440,10,1022,21539,0,0,10,1022,0,0,286.12117,0.01681100000001834,486348,0
"172.16.133.113",55778,"216.219.113.250",443,6,366,21540,0,0,4,246,2,120,286.165866,0.23849799999999277,8251,4025
"172.16.133.113",55779,"66.151.150.190",443,6,366,21541,0,0,4,246,2,120,286.169315,0.22007800000000088,8942,4362
"172.16.133.49",56022,"172.16.139.250",5440,12,1142,21542,0,0,12,1142,0,0,286.196806,0.006535000000042146,1398010,0
"172.16.133.95",57246,"172.16.139.250",5440,10,1022,21543,0,0,10,1022,0,0,286.241809,0.006127999999989697,1334203,0
"172.16.133.42",57366,"78.108.117.250",443,6,366,21544,0,0,4,246,2,120,286.259093,0.2169890000000123,9069,4424
"172.16.133.92",57910,"172.16.139.250",5440,10,1022,21545,0,0,10,1022,0,0,286.265229,0.005613000000039392,1456618,0
"172.16.133.42",57367,"216.219.117.244",443,6,366,21546,0,0,4,246,2,120,286.265437,0.2418739999999957,8136,3969
"172.16.133.29",61244,"172.16.139.250",5440,10,1022,21547,0,0,10,1022,0,0,286.283749,0.01527099999998427,535393,0
"172.16.133.44",65071,"172.16.139.250",5440,10,1022,21548,0,0,10,1022,0,0,286.289671,0.014385000000004311,568369,0
"172.16.133.207",56178,"172.16.139.250",5440,12,1142,21549,0,0,12,1142,0,0,286.314488,0.014511000000027252,629591,0
"172.16.133.83",57345,"172.16.139.250",5440,12,1142,21550,0,0,12,1142,0,0,286.325265,0.0075390000000084,1211831,0
"172.16.133.93",61153,"172.16.139.250",5440,10,1022,21551,0,0,10,1022,0,0,286.339964,0.006809999999973115,1200587,0
"172.16.133.11",55407,"172.16.139.250",5440,10,1022,21552,0,0,10,1022,0,0,286.357617,0.0056420000000230175,1449131,0
"172.16.133.55",57881,"172.16.139.250",5440,10,1022,21553,0,0,10,1022,0,0,286.361839,0.0057150000000092405,1430621,0
"172.16.133.73",60944,"172.16.139.250",5440,10,1022,21554,0,0,10,1022,0,0,286.384092,0.005712000000016815,1431372,0
"172.16.133.53",54346,"172.16.139.250",5440,10,1022,21555,0,0,10,1022,0,0,286.388834,0.01617300000003752,505533,0
"172.16.133.21",53421,"172.16.139.250",5440,12,1142,21556,0,0,12,1142,0,0,286.390768,0.022635000000036598,403622,0
"172.16.133.30",62919,"172.16.139.250",5440,12,1142,21557,0,0,12,1142,0,0,286.395444,0.006168000000002394,1481193,0
"172.16.133.25",63723,"172.16.139.250",5440,12,1142,21558,0,0,12,1142,0,0,286.400444,0.008538999999984753,1069914,0
"172.16.133.34",50712,"172.16.139.250",5440,12,1142,21559,0,0,12,1142,0,0,286.410536,0.014464000000032229,631637,0
"172.16.133.97",59627,"172.16.139.250",5440,12,1142,21560,0,0,12,1142,0,0,286.419962,0.009348999999986063,977216,0
"172.16.133.40",52601,"172.16.139.250",5500,8,792,21561,0,0,8,792,0,0,286.469139,4.261356000000035,1486,0
"172.16.133.33",58132,"172.16.139.250",5440,12,1142,21562,0,0,12,1142,0,0,286.489638,0.006444999999985157,1417532,0
"172.16.133.68",61039,"172.16.139.250",5440,12,1142,21563,0,0,12,1142,0,0,286.526607,0.01551000000000613,589039,0
"172.16.133.12",60029,"172.16.139.250",5440,12,1142,21564,0,0,12,1142,0,0,286.542683,0.006708000000003267,1361955,0
"172.16.133.63",54235,"172.16.139.250",5440,10,1022,21565,0,0,10,1022,0,0,286.552293,0.005554999999958454,1471827,0
"172.16.133.66",54450,"172.16.139.250",5440,12,1142,21566,0,0,12,1142,0,0,286.561871,0.006475000000023101,1410965,0
"172.16.133.82",61676,"172.16.139.250",5440,10,1022,21567,0,0,10,1022,0,0,286.577418,0.0056209999999623506,1454545,0
"172.16.133.37",60900,"172.16.139.250",5440,10,1022,21568,0,0,10,1022,0,0,286.591027,0.005640000000028067,1449645,0
"172.16.133.49",55430,"193.120.199.18",12350,2,120,21569,0,0,1,60,1,60,286.667898,0.00010000000003174137,"",""
"172.16.133.78",59497,"172.16.139.250",5440,12,1142,21570,0,0,12,1142,0,0,286.746744,0.0065790000000447435,1388660,0
"172.16.133.42",57368,"202.173.25.200",443,6,366,21571,0,0,4,246,2,120,286.749833,0.5570919999999546,3532,1723
"172.16.133.67",56254,"172.16.139.250",5440,12,1142,21572,0,0,12,1142,0,0,286.801774,0.016357999999968342,558503,0
"172.16.133.56",61689,"172.16.139.250",5440,12,1142,21573,0,0,12,1142,0,0,286.824844,0.014565000000004602,627257,0
"172.16.133.41",53394,"172.16.139.250",5440,10,1022,21574,0,0,10,1022,0,0,286.880431,0.005461000000025251,1497161,0
"172.16.133.40",50296,"180.153.31.250",443,8,486,21575,0,0,5,306,3,180,286.921905,3.463551999999993,706,415
"172.16.133.43",58010,"172.16.139.250",5440,10,1022,21576,0,0,10,1022,0,0,286.948489,0.005569999999977426,1467863,0
"172.16.128.233",50960,"172.16.133.233",22,167,19584,21577,0,0,49,4120,118,15464,286.960979,9.048844999999972,3642,13671
"172.16.133.13",53304,"172.16.139.250",5440,10,1022,21578,0,0,10,1022,0,0,286.97116,0.005534000000011474,1477412,0
"172.16.133.85",52520,"172.16.139.250",5440,12,1142,21579,0,0,12,1142,0,0,286.974461,0.01608699999997043,567911,0
"172.16.133.42",57369,"172.16.139.250",5440,12,1142,21580,0,0,12,1142,0,0,287.014012,0.01872400000002017,487929,0
"172.16.133.20",62704,"172.16.139.250",5440,10,1022,21581,0,0,10,1022,0,0,287.019576,0.014640000000042619,558469,0
"172.16.133.55",57882,"67.217.64.244",443,6,366,21582,0,0,4,246,2,120,287.046553,0.07006599999999708,28087,13701
"172.16.133.28",49448,"172.16.139.250",5440,10,1022,21583,0,0,10,1022,0,0,287.048087,0.00722000000001799,1132409,0
"172.16.133.99",56294,"172.16.139.250",5440,12,1142,21584,0,0,12,1142,0,0,287.07668,0.016042999999967833,569469,0
"172.16.133.75",51208,"172.16.139.250",5440,10,1022,21585,0,0,10,1022,0,0,287.083228,0.0061019999999984975,1339888,0
"172.16.133.87",60504,"172.16.139.250",5440,10,1022,21586,0,0,10,1022,0,0,287.10261,0.005843999999967764,1399041,0
"172.16.133.35",50219,"172.16.139.250",5440,12,1142,21587,0,0,12,1142,0,0,287.105386,0.023930000000007112,381780,0
"172.16.133.116",54097,"172.16.139.250",5440,10,1022,21588,0,0,10,1022,0,0,287.113628,0.0060330000000021755,1355212,0
"172.16.133.116",54098,"172.16.139.250",5440,10,1022,21589,0,0,10,1022,0,0,287.120597,0.015676000000041768,521561,0
"172.16.133.55",57883,"216.115.223.200",443,6,366,21590,0,0,4,246,2,120,287.132436,0.09328400000003967,21096,10291
"172.16.133.84",59056,"172.16.139.250",5440,10,1022,21591,0,0,10,1022,0,0,287.134265,0.005919999999946413,1381081,0
"172.16.133.116",54099,"172.16.139.250",5440,10,1022,21592,0,0,10,1022,0,0,287.137159,0.006904000000020005,1184241,0
"172.16.133.126",62190,"157.56.234.137",443,6,374,21593,0,0,3,194,3,180,287.139671,1.277279999999962,1215,1127
"172.16.133.49",56023,"172.16.139.250",5440,12,1142,21594,0,0,12,1142,0,0,287.211149,0.015685000000019045,582467,0
"172.16.133.95",57247,"172.16.139.250",5440,10,1022,21595,0,0,10,1022,0,0,287.255809,0.005364999999983411,1523951,0
"172.16.133.92",57911,"172.16.139.250",5440,10,1022,21596,0,0,10,1022,0,0,287.279754,0.01659999999998263,492530,0
"172.16.133.29",61245,"172.16.139.250",5440,12,1142,21597,0,0,12,1142,0,0,287.297385,0.017256999999972322,529408,0
"172.16.133.44",65072,"172.16.139.250",5440,10,1022,21598,0,0,10,1022,0,0,287.304083,0.005529000000024098,1478748,0
"172.16.133.207",56179,"172.16.139.250",5440,12,1142,21599,0,0,12,1142,0,0,287.328233,0.011005000000011478,830168,0
"172.16.133.55",57884,"66.151.150.190",443,6,366,21600,0,0,4,246,2,120,287.331699,0.22035199999999122,8931,4356
"172.16.133.83",57346,"172.16.139.250",5440,10,1022,21601,0,0,10,1022,0,0,287.339236,0.013835999999969317,590922,0
"172.16.133.55",57885,"216.219.113.250",443,6,366,21602,0,0,4,246,2,120,287.344625,0.30920199999997067,6364,3104
"172.16.133.93",61154,"172.16.139.250",5440,12,1142,21603,0,0,12,1142,0,0,287.353765,0.004902000000015505,"",""
"172.16.133.11",55408,"172.16.139.250",5440,12,1142,21604,0,0,12,1142,0,0,287.371644,0.015149000000008073,603076,0
"172.16.133.55",57886,"172.16.139.250",5440,12,1142,21605,0,0,12,1142,0,0,287.376999,0.015881999999976415,575242,0
"172.16.133.73",60945,"172.16.139.250",5440,12,1142,21606,0,0,12,1142,0,0,287.397835,0.018252000000018143,500547,0
"172.16.133.53",54347,"172.16.139.250",5440,12,1142,21607,0,0,12,1142,0,0,287.401517,0.006355999999982487,1437382,0
"172.16.133.21",53422,"172.16.139.250",5440,12,1142,21608,0,0,12,1142,0,0,287.404089,0.007961000000022977,1147594,0
"172.16.133.30",62920,"172.16.139.250",5440,10,1022,21609,0,0,10,1022,0,0,287.408561,0.011168999999995322,732026,0
"172.16.133.25",63724,"172.16.139.250",5440,12,1142,21610,0,0,12,1142,0,0,287.414334,0.008735000000001492,1045907,0
"172.16.133.34",50713,"172.16.139.250",5440,12,1142,21611,0,0,12,1142,0,0,287.424658,0.014210999999988871,642882,0
"172.16.133.97",59628,"172.16.139.250",5440,12,1142,21612,0,0,12,1142,0,0,287.433925,0.015321000000028562,596305,0
"172.16.133.33",58133,"172.16.139.250",5440,10,1022,21613,0,0,10,1022,0,0,287.503792,0.005694000000005417,1435897,0
"172.16.133.68",61040,"172.16.139.250",5440,12,1142,21614,0,0,12,1142,0,0,287.53976,0.0072420000000192886,1261529,0
"172.16.133.12",60030,"172.16.139.250",5440,12,1142,21615,0,0,12,1142,0,0,287.557556,0.01885000000004311,484668,0
"172.16.133.63",54236,"172.16.139.250",5440,10,1022,21616,0,0,10,1022,0,0,287.566203,0.005677000000048338,1440197,0
"172.16.133.66",54452,"172.16.139.250",5440,12,1142,21617,0,0,12,1142,0,0,287.576354,0.005087000000003172,1795950,0
"172.16.133.82",61677,"172.16.139.250",5440,10,1022,21618,0,0,10,1022,0,0,287.59261,0.015084000000001652,542031,0
"172.16.133.37",60901,"172.16.139.250",5440,12,1142,21619,0,0,12,1142,0,0,287.605454,0.006981999999993604,1308507,0
"172.16.133.35",50220,"67.217.64.244",443,6,366,21620,0,0,4,246,2,120,287.660782,0.07985400000001164,24644,12021
"172.16.133.35",50221,"216.115.223.200",443,6,366,21621,0,0,4,246,2,120,287.708211,0.21639499999997724,9094,4436
"172.16.133.78",59498,"172.16.139.250",5440,10,1022,21622,0,0,10,1022,0,0,287.760315,0.016675000000020646,490314,0
"172.16.133.67",56255,"172.16.139.250",5440,10,1022,21623,0,0,10,1022,0,0,287.815754,0.008314999999981865,983283,0
"172.16.133.56",61690,"172.16.139.250",5440,12,1142,21624,0,0,12,1142,0,0,287.839718,0.004850999999973737,"",""
"172.16.133.63",54237,"207.171.163.152",80,7,2122,21625,0,0,4,832,3,1290,287.868461,0.30092899999999645,22118,34293
"172.16.133.41",53395,"172.16.139.250",5440,12,1142,21626,0,0,12,1142,0,0,287.893164,0.006133999999974549,1489403,0
"172.16.133.35",50222,"66.151.150.190",443,6,366,21627,0,0,4,246,2,120,287.89912,0.36795900000004167,5348,2608
"172.16.133.35",50223,"216.219.113.250",443,6,366,21628,0,0,4,246,2,120,287.927369,0.34019100000000435,5784,2821
"172.16.133.43",58011,"172.16.139.250",5440,10,1022,21629,0,0,10,1022,0,0,287.962528,0.015467999999998483,528575,0
"172.16.133.13",53305,"172.16.139.250",5440,10,1022,21630,0,0,10,1022,0,0,287.98385,0.005378000000007432,1520267,0
"172.16.133.85",52521,"172.16.139.250",5440,12,1142,21631,0,0,12,1142,0,0,287.988348,0.015619000000015149,584928,0
"172.16.133.63",51216,"93.184.215.248",80,1,60,21632,0,0,1,60,0,0,287.992343,0,"",""
"172.16.133.63",51215,"107.22.199.132",80,1,60,21633,0,0,1,60,0,0,287.992506,0,"",""
"172.16.133.63",51217,"107.22.199.132",80,1,60,21634,0,0,1,60,0,0,287.992587,0,"",""
"172.16.133.20",62705,"172.16.139.250",5440,10,1022,21635,0,0,10,1022,0,0,288.033321,0.02153299999997671,379696,0
"172.16.133.42",57370,"172.16.139.250",5440,12,1142,21636,0,0,12,1142,0,0,288.045984,0.036649000000011256,249283,0
"172.16.133.28",49449,"172.16.139.250",5440,10,1022,21637,0,0,10,1022,0,0,288.063062,0.005403999999998632,1512953,0
"172.16.133.42",57371,"67.217.95.254",443,7,426,21638,0,0,4,246,3,180,288.085456,0.0539569999999685,36473,26687
"172.16.133.99",56295,"172.16.139.250",5440,10,1022,21639,0,0,10,1022,0,0,288.090779,0.01447200000001203,564953,0
"172.16.133.75",51209,"172.16.139.250",5440,10,1022,21640,0,0,10,1022,0,0,288.09699,0.014548999999988155,561963,0
"172.16.133.87",60505,"172.16.139.250",5440,12,1142,21641,0,0,12,1142,0,0,288.117477,0.02316200000001345,394439,0
"172.16.133.35",50224,"172.16.139.250",5440,12,1142,21642,0,0,12,1142,0,0,288.118268,0.022636999999974705,403587,0
"172.16.133.116",54100,"172.16.139.250",5440,10,1022,21643,0,0,10,1022,0,0,288.128103,0.008037000000001626,1017295,0
"172.16.133.116",54101,"172.16.139.250",5440,10,1022,21644,0,0,10,1022,0,0,288.137143,0.006934999999998581,1178947,0
"172.16.133.116",54102,"172.16.139.250",5440,10,1022,21645,0,0,10,1022,0,0,288.144874,0.015411999999969339,530495,0
"172.16.133.84",59057,"172.16.139.250",5440,10,1022,21646,0,0,10,1022,0,0,288.149444,0.015205999999977848,537682,0
"172.16.133.49",56024,"172.16.139.250",5440,10,1022,21647,0,0,10,1022,0,0,288.225578,0.01621600000004264,504193,0
"172.16.133.95",57248,"172.16.139.250",5440,12,1142,21648,0,0,12,1142,0,0,288.268961,0.006769000000019787,1349682,0
"172.16.133.92",57912,"172.16.139.250",5440,10,1022,21649,0,0,10,1022,0,0,288.292502,0.0052339999999730935,1562094,0
"172.16.133.29",61246,"172.16.139.250",5440,10,1022,21650,0,0,10,1022,0,0,288.311001,0.005564000000049418,1469446,0
"172.16.133.44",65073,"172.16.139.250",5440,10,1022,21651,0,0,10,1022,0,0,288.318181,0.006480000000010477,1261728,0
"172.16.133.207",56180,"172.16.139.250",5440,10,1022,21652,0,0,10,1022,0,0,288.342293,0.005204999999989468,1570797,0
"172.16.133.83",57347,"172.16.139.250",5440,12,1142,21653,0,0,12,1142,0,0,288.354257,0.004739999999969768,"",""
"172.16.133.93",61155,"172.16.139.250",5440,10,1022,21654,0,0,10,1022,0,0,288.368067,0.004764000000022861,"",""
"172.16.133.42",57372,"78.108.117.250",443,6,366,21655,0,0,4,246,2,120,288.37022,0.19627199999996492,10026,4891
"172.16.133.42",57373,"216.219.117.244",443,6,366,21656,0,0,4,246,2,120,288.379973,0.23431599999997843,8398,4097
"172.16.133.11",55409,"172.16.139.250",5440,10,1022,21657,0,0,10,1022,0,0,288.384954,0.00557000000003427,1467863,0
"172.16.133.55",57887,"172.16.139.250",5440,12,1142,21658,0,0,12,1142,0,0,288.389878,0.005464000000017677,1672035,0
"172.16.133.73",60946,"172.16.139.250",5440,12,1142,21659,0,0,12,1142,0,0,288.411885,0.016343000000006214,559016,0
"172.16.133.53",54348,"172.16.139.250",5440,12,1142,21660,0,0,12,1142,0,0,288.416533,0.005678999999986445,1608733,0
"172.16.133.21",53423,"172.16.139.250",5440,12,1142,21661,0,0,12,1142,0,0,288.418372,0.01781200000004901,512912,0
"172.16.133.30",62921,"172.16.139.250",5440,10,1022,21662,0,0,10,1022,0,0,288.423461,0.007853000000011434,1041130,0
"172.16.133.126",62191,"157.56.236.89",80,8,884,21663,0,0,5,532,3,352,288.428112,0.2871200000000158,14823,9807
"172.16.133.25",63725,"172.16.139.250",5440,12,1142,21664,0,0,12,1142,0,0,288.428432,0.010651999999993222,857679,0
"172.16.133.34",50714,"172.16.139.250",5440,10,1022,21665,0,0,10,1022,0,0,288.438475,0.005154000000004544,1586340,0
"172.16.133.97",59629,"172.16.139.250",5440,10,1022,21666,0,0,10,1022,0,0,288.447793,0.015072000000031949,542462,0
"172.16.133.33",58134,"172.16.139.250",5440,12,1142,21667,0,0,12,1142,0,0,288.517688,0.00634700000000521,1439420,0
"172.16.133.68",61041,"172.16.139.250",5440,10,1022,21668,0,0,10,1022,0,0,288.555023,0.005613999999980024,1456359,0
"172.16.133.12",60031,"172.16.139.250",5440,10,1022,21669,0,0,10,1022,0,0,288.576242,0.006195000000047912,1319774,0
"172.16.133.63",54238,"172.16.139.250",5440,10,1022,21670,0,0,10,1022,0,0,288.580534,0.005516000000000076,1482233,0
"172.16.133.66",54453,"172.16.139.250",5440,10,1022,21671,0,0,10,1022,0,0,288.589832,0.005312000000003536,1539156,0
"172.16.133.82",61678,"172.16.139.250",5440,10,1022,21672,0,0,10,1022,0,0,288.608543,0.015205999999977848,537682,0
"172.16.133.37",60902,"172.16.139.250",5440,10,1022,21673,0,0,10,1022,0,0,288.618501,0.014460000000042328,565421,0
"172.16.133.126",62192,"157.56.236.134",443,24,9439,21674,0,0,11,2703,13,6736,288.665258,1.2411349999999857,17422,43418
"172.16.133.78",59499,"172.16.139.250",5440,10,1022,21675,0,0,10,1022,0,0,288.774572,0.006240000000047985,1310256,0
"172.16.133.67",56256,"172.16.139.250",5440,10,1022,21676,0,0,10,1022,0,0,288.8297,0.00574100000000044,1424142,0
"172.16.133.83",57348,"173.194.43.32",443,55,26153,21677,0,0,26,3614,29,22539,288.841832,0.5850590000000011,49417,308194
"172.16.133.40",50297,"96.43.146.48",443,21,6135,21678,0,0,12,2540,9,3595,288.851669,3.3928249999999593,5989,8476
"172.16.133.56",61691,"172.16.139.250",5440,12,1142,21679,0,0,12,1142,0,0,288.852828,0.00515899999999192,1770885,0
"172.16.133.41",53396,"172.16.139.250",5440,12,1142,21680,0,0,12,1142,0,0,288.907572,0.0162239999999656,563116,0
"172.16.133.43",58012,"172.16.139.250",5440,12,1142,21681,0,0,12,1142,0,0,288.975576,0.006291000000032909,1452233,0
"172.16.133.13",53306,"172.16.139.250",5440,10,1022,21682,0,0,10,1022,0,0,288.997943,0.014554999999973006,561731,0
"172.16.133.85",52522,"172.16.139.250",5440,10,1022,21683,0,0,10,1022,0,0,289.002168,0.005468000000007578,1495245,0
"172.16.133.78",59500,"216.52.242.80",443,40,27897,21684,0,0,17,8062,23,19835,289.014029,2.2946210000000065,28107,69153
"172.16.133.42",57374,"172.16.139.250",5440,12,1142,21685,0,0,12,1142,0,0,289.047268,0.023787000000027092,384075,0
"172.16.133.20",62706,"172.16.139.250",5440,12,1142,21686,0,0,12,1142,0,0,289.048491,0.00500899999997273,1823916,0
"172.16.133.42",57375,"202.173.25.200",443,6,366,21687,0,0,4,246,2,120,289.050174,0.5896919999999568,3337,1627
"172.16.133.28",49450,"172.16.139.250",5440,12,1142,21688,0,0,12,1142,0,0,289.075892,0.015222999999991771,600144,0
"172.16.133.99",56296,"172.16.139.250",5440,10,1022,21689,0,0,10,1022,0,0,289.104601,0.015265999999996893,535569,0
"172.16.133.75",51210,"172.16.139.250",5440,10,1022,21690,0,0,10,1022,0,0,289.110158,0.005355000000008658,1526797,0
"172.16.133.87",60506,"172.16.139.250",5440,12,1142,21691,0,0,12,1142,0,0,289.130646,0.006506000000001677,1404242,0
"172.16.133.35",50225,"172.16.139.250",5440,12,1142,21692,0,0,12,1142,0,0,289.132786,0.018247999999971398,500657,0
"172.16.133.116",54103,"172.16.139.250",5440,10,1022,21693,0,0,10,1022,0,0,289.14091,0.006191000000001168,1320626,0
"172.16.133.116",54104,"172.16.139.250",5440,10,1022,21694,0,0,10,1022,0,0,289.147981,0.0067039999999565225,1219570,0
"172.16.133.116",54105,"172.16.139.250",5440,10,1022,21695,0,0,10,1022,0,0,289.157991,0.015014000000007854,544558,0
"172.16.133.84",59058,"172.16.139.250",5440,10,1022,21696,0,0,10,1022,0,0,289.163319,0.005329000000017459,1534246,0
"172.16.133.40",50298,"180.153.31.250",443,7,426,21697,0,0,5,306,2,120,289.163388,1.153915999999981,2121,831
"172.16.133.49",56025,"172.16.139.250",5440,12,1142,21698,0,0,12,1142,0,0,289.242852,0.0064469999999801075,1417093,0
"172.16.133.95",57249,"172.16.139.250",5440,12,1142,21699,0,0,12,1142,0,0,289.283019,0.006268999999974767,1457329,0
"172.16.133.92",57913,"172.16.139.250",5440,10,1022,21700,0,0,10,1022,0,0,289.307471,0.005714999999952397,1430621,0
"172.16.133.29",61247,"172.16.139.250",5440,12,1142,21701,0,0,12,1142,0,0,289.324544,0.0061210000000073705,1492566,0
"172.16.133.44",65074,"172.16.139.250",5440,10,1022,21702,0,0,10,1022,0,0,289.331683,0.015039999999999054,543617,0
"172.16.133.207",56181,"172.16.139.250",5440,12,1142,21703,0,0,12,1142,0,0,289.356399,0.015420000000005984,592477,0
"172.16.133.83",57349,"172.16.139.250",5440,12,1142,21704,0,0,12,1142,0,0,289.36732,0.007501999999988129,1217808,0
"172.16.133.93",61156,"172.16.139.250",5440,12,1142,21705,0,0,12,1142,0,0,289.38093,0.0049500000000080036,"",""
"172.16.133.11",55410,"172.16.139.250",5440,10,1022,21706,0,0,10,1022,0,0,289.399361,0.015380999999990763,531564,0
"172.16.133.55",57888,"172.16.139.250",5440,10,1022,21707,0,0,10,1022,0,0,289.404014,0.0054639999999608335,1496339,0
"172.16.133.73",60947,"172.16.139.250",5440,10,1022,21708,0,0,10,1022,0,0,289.425746,0.005366999999978361,1523383,0
"172.16.133.53",54349,"172.16.139.250",5440,10,1022,21709,0,0,10,1022,0,0,289.430061,0.015191999999956352,538177,0
"172.16.133.21",53424,"172.16.139.250",5440,10,1022,21710,0,0,10,1022,0,0,289.431854,0.0056000000000153705,1459999,0
"172.16.133.30",62922,"172.16.139.250",5440,10,1022,21711,0,0,10,1022,0,0,289.437348,0.01554100000004155,526092,0
"172.16.133.25",63726,"172.16.139.250",5440,10,1022,21712,0,0,10,1022,0,0,289.442296,0.00661200000001827,1236539,0
"172.16.133.34",50715,"172.16.139.250",5440,10,1022,21713,0,0,10,1022,0,0,289.452738,0.005083000000013271,1608498,0
"172.16.133.97",59630,"172.16.139.250",5440,10,1022,21714,0,0,10,1022,0,0,289.462062,0.0054369999999721585,1503770,0
"172.16.133.33",58135,"172.16.139.250",5440,12,1142,21715,0,0,12,1142,0,0,289.531763,0.00631599999996979,1446485,0
"172.16.133.68",61043,"172.16.139.250",5440,10,1022,21716,0,0,10,1022,0,0,289.5688,0.005504999999971005,1485195,0
"172.16.133.12",60032,"172.16.139.250",5440,10,1022,21717,0,0,10,1022,0,0,289.583203,0.01585499999998774,515673,0
"172.16.133.63",54240,"172.16.139.250",5440,10,1022,21718,0,0,10,1022,0,0,289.594372,0.008680999999967298,941826,0
"172.16.133.66",54454,"172.16.139.250",5440,10,1022,21719,0,0,10,1022,0,0,289.604126,0.005393999999967036,1515758,0
"172.16.133.82",61679,"172.16.139.250",5440,12,1142,21720,0,0,12,1142,0,0,289.619397,0.006394999999997708,1428616,0
"172.16.133.37",60903,"172.16.139.250",5440,12,1142,21721,0,0,12,1142,0,0,289.632802,0.006668999999988046,1369920,0
"172.16.133.78",59501,"172.16.139.250",5440,12,1142,21722,0,0,12,1142,0,0,289.789139,0.016386000000011336,557549,0
"172.16.133.78",59502,"23.0.49.244",443,42,36614,21723,0,0,16,3531,26,33083,289.798314,0.4763939999999707,59295,555556
"172.16.133.78",59503,"23.0.49.244",443,28,19684,21724,0,0,12,3834,16,15850,289.798464,0.6791319999999814,45163,186708
"172.16.133.78",59504,"23.0.49.244",443,18,10728,21725,0,0,8,1804,10,8924,289.798743,0.23236600000001317,62108,307239
"172.16.133.78",59505,"23.0.49.244",443,22,15062,21726,0,0,9,1960,13,13102,289.798868,0.23731399999996938,66072,441676
"172.16.133.78",59506,"23.0.49.244",443,21,12622,21727,0,0,10,3586,11,9036,289.799009,0.469633999999985,61085,153924
"172.16.133.78",59507,"23.0.49.244",443,110,110579,21728,0,0,35,5145,75,105434,289.799148,0.4828350000000228,85246,1746915
"172.16.133.67",56257,"172.16.139.250",5440,12,1142,21729,0,0,12,1142,0,0,289.843595,0.016807000000028438,543583,0
"172.16.133.56",61692,"172.16.139.250",5440,10,1022,21730,0,0,10,1022,0,0,289.866917,0.006246999999973468,1308788,0
"172.16.133.41",53397,"172.16.139.250",5440,10,1022,21731,0,0,10,1022,0,0,289.921492,0.005430999999987307,1505431,0
"172.16.133.126",62193,"132.245.2.22",443,27,16463,21732,0,0,12,1990,15,14473,289.921639,1.1196899999999914,14218,103407
"172.16.133.113",55780,"172.16.139.250",135,8,492,21733,0,0,8,492,0,0,289.962884,0.004102000000045791,"",""
"172.16.133.113",55781,"172.16.139.250",5462,12,816,21734,0,0,12,816,0,0,289.969401,0.5228060000000028,12486,0
"172.16.133.84",59059,"67.217.64.244",443,7,426,21735,0,0,4,246,3,180,289.985964,0.061825999999996384,31831,23291
"172.16.133.84",59060,"216.115.223.200",443,6,366,21736,0,0,4,246,2,120,289.986596,0.09319599999997763,21116,10300
"172.16.133.84",59061,"66.151.150.190",443,6,366,21737,0,0,4,246,2,120,289.987211,0.19179600000001074,10260,5005
"172.16.133.84",59062,"216.219.113.250",443,6,366,21738,0,0,4,246,2,120,289.988708,0.1944520000000125,10120,4936
"172.16.133.43",58013,"172.16.139.250",5440,10,1022,21739,0,0,10,1022,0,0,289.99142,0.01486699999998109,549942,0
"172.16.133.13",53307,"172.16.139.250",5440,10,1022,21740,0,0,10,1022,0,0,290.012263,0.00536099999999351,1525088,0
"172.16.133.85",52523,"172.16.139.250",5440,10,1022,21741,0,0,10,1022,0,0,290.016356,0.005522000000041771,1480622,0
"172.16.133.42",57376,"172.16.139.250",5440,12,1142,21742,0,0,12,1142,0,0,290.05848,0.058128000000010616,157170,0
"172.16.133.20",62707,"172.16.139.250",5440,10,1022,21743,0,0,10,1022,0,0,290.06159,0.004833999999959815,"",""
"172.16.133.28",49451,"172.16.139.250",5440,10,1022,21744,0,0,10,1022,0,0,290.09017,0.018191000000001623,449453,0
"172.16.139.250",4228,"69.42.109.196",443,18,3159,21745,0,0,8,1862,10,1297,290.113941,0.42854699999998047,34759,24212
"172.16.133.99",56297,"172.16.139.250",5440,10,1022,21746,0,0,10,1022,0,0,290.118642,0.014801999999974669,552357,0
"172.16.133.75",51211,"172.16.139.250",5440,10,1022,21747,0,0,10,1022,0,0,290.124219,0.004798999999991338,"",""
"172.16.133.87",60511,"172.16.139.250",5440,10,1022,21748,0,0,10,1022,0,0,290.144867,0.01531500000004371,533855,0
"172.16.133.35",50226,"172.16.139.250",5440,12,1142,21749,0,0,12,1142,0,0,290.147609,0.008803000000000338,1037828,0
"172.16.133.116",54106,"172.16.139.250",5440,10,1022,21750,0,0,10,1022,0,0,290.155108,0.008760999999992691,933226,0
"172.16.133.116",54107,"172.16.139.250",5440,10,1022,21751,0,0,10,1022,0,0,290.164817,0.014699999999947977,556190,0
"172.16.133.84",59063,"172.16.139.250",5440,12,1142,21752,0,0,12,1142,0,0,290.176459,0.01594199999999546,573077,0
"172.16.133.116",54108,"172.16.139.250",5440,12,1142,21753,0,0,12,1142,0,0,290.180757,0.014824999999973443,616256,0
"172.16.133.25",63727,"65.31.30.198",23196,18,3332,21754,0,0,10,1670,8,1662,290.226244,8.843452000000013,1510,1503
"172.16.133.6",1745,"172.16.128.201",1060,19,4190,21755,0,0,11,2781,8,1409,290.237095,2.3569109999999682,9439,4782
"172.16.133.49",56026,"172.16.139.250",5440,12,1142,21756,0,0,12,1142,0,0,290.253473,0.014736000000027616,619978,0
"172.16.133.95",57250,"172.16.139.250",5440,12,1142,21757,0,0,12,1142,0,0,290.296872,0.0062859999999886895,1453388,0
"172.16.133.92",57914,"172.16.139.250",5440,10,1022,21758,0,0,10,1022,0,0,290.321086,0.01487200000002531,549757,0
"172.16.133.29",61248,"172.16.139.250",5440,10,1022,21759,0,0,10,1022,0,0,290.339683,0.00611900000001242,1336166,0
"172.16.133.78",59508,"138.108.7.20",443,18,8057,21760,0,0,9,2793,9,5264,290.343514,0.9238599999999906,24185,45582
"172.16.133.44",65075,"172.16.139.250",5440,12,1142,21761,0,0,12,1142,0,0,290.346564,0.015522999999973308,588546,0
"172.16.133.207",56182,"172.16.139.250",5440,12,1142,21762,0,0,12,1142,0,0,290.370495,0.014611999999999625,625239,0
"172.16.133.83",57350,"172.16.139.250",5440,12,1142,21763,0,0,12,1142,0,0,290.382928,0.0059830000000147265,1526993,0
"172.16.133.93",61157,"172.16.139.250",5440,12,1142,21764,0,0,12,1142,0,0,290.396081,0.004952000000002954,"",""
"172.16.133.11",55411,"172.16.139.250",5440,12,1142,21765,0,0,12,1142,0,0,290.413353,0.006462000000055923,1413803,0
"172.16.133.78",59509,"23.33.91.120",443,19,7902,21766,0,0,10,3767,9,4135,290.416444,0.3331680000000006,90452,99289
"172.16.133.55",57889,"172.16.139.250",5440,12,1142,21767,0,0,12,1142,0,0,290.418438,0.006358000000034281,1436929,0
"172.16.133.78",59510,"74.125.226.222",443,19,4224,21768,0,0,10,3085,9,1139,290.424262,0.06393500000001495,386017,142519
"172.16.133.78",59511,"74.125.226.222",443,11,1548,21769,0,0,6,990,5,558,290.43166,0.2889949999999999,27405,15446
"172.16.133.78",59512,"64.94.107.23",443,18,7383,21770,0,0,9,2995,9,4388,290.435734,0.13493599999998196,177565,260152
"172.16.133.73",60948,"172.16.139.250",5440,12,1142,21771,0,0,12,1142,0,0,290.440685,0.005750000000034561,1588869,0
"172.16.133.53",54350,"172.16.139.250",5440,12,1142,21772,0,0,12,1142,0,0,290.443359,0.0155690000000277,586807,0
"172.16.133.21",53425,"172.16.139.250",5440,10,1022,21773,0,0,10,1022,0,0,290.446034,0.01599900000002208,511031,0
"172.16.133.30",62923,"172.16.139.250",5440,10,1022,21774,0,0,10,1022,0,0,290.452444,0.014635999999995875,558622,0
"172.16.133.25",63728,"172.16.139.250",5440,12,1142,21775,0,0,12,1142,0,0,290.45613,0.01884100000000899,484899,0
"172.16.133.34",50716,"172.16.139.250",5440,10,1022,21776,0,0,10,1022,0,0,290.466957,0.015041999999994005,543544,0
"172.16.133.97",59631,"172.16.139.250",5440,12,1142,21777,0,0,12,1142,0,0,290.476184,0.016020000000025902,570287,0
"172.16.133.33",58136,"172.16.139.250",5440,12,1142,21778,0,0,12,1142,0,0,290.546124,0.009583999999961179,953255,0
"172.16.133.68",61044,"172.16.139.250",5440,10,1022,21779,0,0,10,1022,0,0,290.582122,0.005502999999976055,1485735,0
"172.16.133.12",60033,"172.16.139.250",5440,10,1022,21780,0,0,10,1022,0,0,290.595906,0.014691999999968175,556493,0
"172.16.133.63",54241,"172.16.139.250",5440,12,1142,21781,0,0,12,1142,0,0,290.608589,0.08805499999999711,103753,0
"172.16.133.66",54455,"172.16.139.250",5440,10,1022,21782,0,0,10,1022,0,0,290.617967,0.0052839999999605425,1547312,0
"172.16.133.82",61680,"172.16.139.250",5440,12,1142,21783,0,0,12,1142,0,0,290.634141,0.07546700000000328,121059,0
"172.16.133.37",60904,"172.16.139.250",5440,12,1142,21784,0,0,12,1142,0,0,290.646794,0.06650500000000648,137373,0
"172.16.133.78",59513,"172.16.139.250",5440,12,1142,21785,0,0,12,1142,0,0,290.803105,0.015883999999971365,575169,0
"172.16.133.67",56258,"172.16.139.250",5440,12,1142,21786,0,0,12,1142,0,0,290.857721,0.006305999999995038,1448778,0
"172.16.133.56",61693,"172.16.139.250",5440,12,1142,21787,0,0,12,1142,0,0,290.88077,0.005254000000036285,1738865,0
"172.16.133.41",53398,"172.16.139.250",5440,12,1142,21788,0,0,12,1142,0,0,290.936377,0.006507999999996628,1403810,0
"172.16.133.43",58014,"172.16.139.250",5440,12,1142,21789,0,0,12,1142,0,0,291.005709,0.006089999999971951,1500164,0
"172.16.133.13",53308,"172.16.139.250",5440,12,1142,21790,0,0,12,1142,0,0,291.025,0.0060330000000021755,1514337,0
"172.16.133.85",52524,"172.16.139.250",5440,10,1022,21791,0,0,10,1022,0,0,291.030904,0.005308999999954267,1540026,0
"172.16.133.36",65091,"54.243.254.190",443,15,5499,21792,0,0,8,3423,7,2076,291.036777,0.5973760000000539,45840,27801
"172.16.133.36",65092,"54.243.254.190",443,14,4297,21793,0,0,8,3423,6,874,291.06471,0.30115599999999176,90929,23217
"172.16.133.42",57377,"172.16.139.250",5440,12,1142,21794,0,0,12,1142,0,0,291.07328,0.06196599999998398,147435,0
"172.16.133.20",62708,"172.16.139.250",5440,12,1142,21795,0,0,12,1142,0,0,291.075358,0.004761000000030435,"",""
"172.16.133.28",49453,"172.16.139.250",5440,10,1022,21796,0,0,10,1022,0,0,291.103158,0.005569999999977426,1467863,0
"172.16.133.99",56298,"172.16.139.250",5440,12,1142,21797,0,0,12,1142,0,0,291.133228,0.05754100000001472,158773,0
"172.16.133.75",51212,"172.16.139.250",5440,10,1022,21798,0,0,10,1022,0,0,291.13838,0.05650100000002567,144705,0
"172.16.133.87",60512,"172.16.139.250",5440,10,1022,21799,0,0,10,1022,0,0,291.159811,0.038671000000022104,211424,0
"172.16.133.35",50227,"172.16.139.250",5440,12,1142,21800,0,0,12,1142,0,0,291.16231,0.060445000000015625,151145,0
"172.16.133.116",54109,"172.16.139.250",5440,12,1142,21801,0,0,12,1142,0,0,291.169119,0.03641299999998182,250899,0
"172.16.133.84",59067,"172.16.139.250",5440,12,1142,21802,0,0,12,1142,0,0,291.190349,0.02977499999997235,306834,0
"172.16.133.116",54110,"172.16.139.250",5440,12,1142,21803,0,0,12,1142,0,0,291.206514,0.017545999999981632,520688,0
"172.16.133.116",54111,"172.16.139.250",5440,10,1022,21804,0,0,10,1022,0,0,291.225225,0.005060999999955129,1615491,0
"172.16.133.49",56027,"172.16.139.250",5440,10,1022,21805,0,0,10,1022,0,0,291.266872,0.005561000000000149,1470239,0
"172.16.133.78",59514,"8.27.243.253",80,3,192,21806,0,0,2,126,1,66,291.30479,0.021772999999996046,46295,24250
"172.16.133.78",59515,"8.27.243.253",80,3,192,21807,0,0,2,126,1,66,291.305019,0.020046999999976833,50281,26338
"172.16.133.78",59516,"8.27.243.253",80,3,192,21808,0,0,2,126,1,66,291.305325,0.021237000000041917,47464,24862
"172.16.133.78",59517,"208.47.254.83",80,8,2670,21809,0,0,5,2242,3,428,291.305662,1.0219810000000393,17550,3350
"172.16.133.95",57251,"172.16.139.250",5440,12,1142,21810,0,0,12,1142,0,0,291.309967,0.015098000000023148,605113,0
"172.16.133.92",57915,"172.16.139.250",5440,12,1142,21811,0,0,12,1142,0,0,291.334786,0.0058720000000107575,1555858,0
"172.16.133.29",61249,"172.16.139.250",5440,10,1022,21812,0,0,10,1022,0,0,291.353876,0.015355999999997039,532430,0
"172.16.128.169",1348,"172.16.139.250",21,8,505,21813,0,0,4,242,4,263,291.357626,0.2708210000000122,7148,7768
"172.16.133.44",65076,"172.16.139.250",5440,12,1142,21814,0,0,12,1142,0,0,291.360054,0.01615300000003117,565591,0
"172.16.133.207",56183,"172.16.139.250",5440,12,1142,21815,0,0,12,1142,0,0,291.384474,0.00664000000000442,1375903,0
"172.16.133.83",57351,"172.16.139.250",5440,12,1142,21816,0,0,12,1142,0,0,291.397283,0.004568000000006123,"",""
"172.16.133.93",61158,"172.16.139.250",5440,12,1142,21817,0,0,12,1142,0,0,291.409226,0.0048390000000040345,"",""
"172.16.133.11",55412,"172.16.139.250",5440,12,1142,21818,0,0,12,1142,0,0,291.428231,0.015286000000003241,597671,0
"172.16.133.55",57890,"172.16.139.250",5440,10,1022,21819,0,0,10,1022,0,0,291.432073,0.005604000000005271,1458957,0
"172.16.133.73",60949,"172.16.139.250",5440,10,1022,21820,0,0,10,1022,0,0,291.454203,0.04485999999997148,182255,0
"172.16.133.53",54351,"172.16.139.250",5440,12,1142,21821,0,0,12,1142,0,0,291.45686,0.038843999999983225,235197,0
"172.16.133.21",53426,"172.16.139.250",5440,10,1022,21822,0,0,10,1022,0,0,291.461158,0.04601300000001629,177688,0
"172.16.133.30",62924,"172.16.139.250",5440,10,1022,21823,0,0,10,1022,0,0,291.465473,0.037175000000047476,219932,0
"172.16.133.25",63729,"172.16.139.250",5440,10,1022,21824,0,0,10,1022,0,0,291.471851,0.0388749999999618,210315,0
"172.16.133.34",50717,"172.16.139.250",5440,10,1022,21825,0,0,10,1022,0,0,291.480569,0.03415699999999333,239365,0
"172.16.133.97",59632,"172.16.139.250",5440,12,1142,21826,0,0,12,1142,0,0,291.490017,0.0282100000000014,323856,0
"172.16.133.33",58137,"172.16.139.250",5440,10,1022,21827,0,0,10,1022,0,0,291.560108,0.005392999999969561,1516039,0
"172.16.133.28",49454,"96.43.146.176",443,16,3805,21828,0,0,9,2358,7,1447,291.562065,4.168092999999999,4525,2777
"172.16.133.68",61045,"172.16.139.250",5440,10,1022,21829,0,0,10,1022,0,0,291.597328,0.005603000000007796,1459218,0
"172.16.133.12",60034,"172.16.139.250",5440,10,1022,21830,0,0,10,1022,0,0,291.609999,0.007809000000008837,1046997,0
"172.16.133.63",54242,"172.16.139.250",5440,12,1142,21831,0,0,12,1142,0,0,291.622973,0.005525999999974829,1653275,0
"172.16.133.66",54456,"172.16.139.250",5440,10,1022,21832,0,0,10,1022,0,0,291.631998,0.005566999999985001,1468654,0
"172.16.133.78",59518,"173.194.43.59",80,9,3325,21833,0,0,5,2109,4,1216,291.645472,0.39116999999998825,43132,24868
"172.16.133.82",61681,"172.16.139.250",5440,10,1022,21834,0,0,10,1022,0,0,291.647639,0.005423999999948137,1507374,0
"172.16.133.78",59519,"173.194.43.59",80,8,3040,21835,0,0,5,2113,3,927,291.659394,0.36725300000000516,46028,20193
"172.16.133.37",60905,"172.16.139.250",5440,10,1022,21836,0,0,10,1022,0,0,291.660836,0.005663999999967473,1443502,0
"172.16.133.78",59520,"172.16.139.250",5440,10,1022,21837,0,0,10,1022,0,0,291.817469,0.005332000000009884,1533383,0
"172.16.133.67",56259,"172.16.139.250",5440,10,1022,21838,0,0,10,1022,0,0,291.871801,0.0055770000000165965,1466021,0
"172.16.133.56",61694,"172.16.139.250",5440,12,1142,21839,0,0,12,1142,0,0,291.894278,0.005028000000038446,1817024,0
"172.16.133.41",53399,"172.16.139.250",5440,12,1142,21840,0,0,12,1142,0,0,291.950366,0.007040000000017699,1297727,0
"172.16.133.43",58015,"172.16.139.250",5440,12,1142,21841,0,0,12,1142,0,0,292.018627,0.015467999999998483,590638,0
"172.16.133.84",59068,"67.217.64.244",443,6,366,21842,0,0,4,246,2,120,292.021896,0.12342799999998988,15944,7777
"172.16.133.84",59069,"216.115.223.200",443,6,366,21843,0,0,4,246,2,120,292.037892,0.11265700000001289,17468,8521
"172.16.133.13",53309,"172.16.139.250",5440,10,1022,21844,0,0,10,1022,0,0,292.040219,0.0054550000000404,1498808,0
"172.16.133.85",52525,"172.16.139.250",5440,10,1022,21845,0,0,10,1022,0,0,292.044718,0.017812999999989643,458990,0
"172.16.133.78",59521,"138.108.7.20",80,9,2779,21846,0,0,5,2121,4,658,292.057001,0.49969099999998434,33956,10534
"172.16.133.78",59522,"64.94.107.23",80,11,2946,21847,0,0,6,2363,5,583,292.070796,0.09734400000002097,194197,47912
"172.16.133.42",57378,"172.16.139.250",5440,12,1142,21848,0,0,12,1142,0,0,292.085435,0.007762999999954445,1176864,0
"172.16.133.84",59070,"66.151.150.190",443,6,366,21849,0,0,4,246,2,120,292.087854,0.2075760000000173,9480,4624
"172.16.133.84",59071,"216.219.113.250",443,6,366,21850,0,0,4,246,2,120,292.090751,0.21689299999997047,9073,4426
"172.16.133.20",62709,"172.16.139.250",5440,10,1022,21851,0,0,10,1022,0,0,292.091488,0.0049429999999688334,"",""
"172.16.133.54",64898,"184.73.225.104",443,22,7276,21852,0,0,11,1982,11,5294,292.11734,5.369191999999998,2953,7887
"172.16.133.28",49456,"172.16.139.250",5440,10,1022,21853,0,0,10,1022,0,0,292.118106,0.005288000000007287,1546142,0
"172.16.133.99",56299,"172.16.139.250",5440,12,1142,21854,0,0,12,1142,0,0,292.146954,0.01576799999998002,579401,0
"172.16.133.75",51213,"172.16.139.250",5440,10,1022,21855,0,0,10,1022,0,0,292.15324,0.00536099999999351,1525088,0
"172.16.133.87",60513,"172.16.139.250",5440,12,1142,21856,0,0,12,1142,0,0,292.172705,0.016324999999994816,559632,0
"172.16.133.35",50228,"172.16.139.250",5440,12,1142,21857,0,0,12,1142,0,0,292.174491,0.011453000000017255,797694,0
"172.16.133.116",54112,"172.16.139.250",5440,10,1022,21858,0,0,10,1022,0,0,292.182433,0.014938999999969838,547292,0
"172.16.133.116",54113,"172.16.139.250",5440,10,1022,21859,0,0,10,1022,0,0,292.198389,0.005282999999963067,1547605,0
"172.16.133.116",54114,"172.16.139.250",5440,10,1022,21860,0,0,10,1022,0,0,292.204367,0.005096000000037293,1604395,0
"172.16.133.84",59072,"172.16.139.250",5440,10,1022,21861,0,0,10,1022,0,0,292.206068,0.0070929999999975735,1152685,0
"172.16.133.49",56028,"172.16.139.250",5440,12,1142,21862,0,0,12,1142,0,0,292.280854,0.0160420000000272,569505,0
"172.16.133.95",57252,"172.16.139.250",5440,10,1022,21863,0,0,10,1022,0,0,292.325339,0.006139000000018768,1331812,0
"172.16.133.92",57916,"172.16.139.250",5440,10,1022,21864,0,0,10,1022,0,0,292.349827,0.005683999999973821,1438423,0
"172.16.133.29",61250,"172.16.139.250",5440,12,1142,21865,0,0,12,1142,0,0,292.366607,0.006219999999984793,1468810,0
"172.16.133.44",65077,"172.16.139.250",5440,12,1142,21866,0,0,12,1142,0,0,292.373959,0.00623400000000629,1465511,0
"172.16.133.207",56184,"172.16.139.250",5440,12,1142,21867,0,0,12,1142,0,0,292.398583,0.0145310000000336,628724,0
"172.16.133.83",57352,"172.16.139.250",5440,12,1142,21868,0,0,12,1142,0,0,292.410546,0.006284999999991214,1453619,0
"172.16.133.93",61159,"172.16.139.250",5440,12,1142,21869,0,0,12,1142,0,0,292.423942,0.050725999999997384,180104,0
"172.16.133.11",55413,"172.16.139.250",5440,10,1022,21870,0,0,10,1022,0,0,292.441805,0.037738999999987755,216645,0
"172.16.133.55",57891,"172.16.139.250",5440,10,1022,21871,0,0,10,1022,0,0,292.445807,0.03956399999998439,206652,0
"172.16.133.73",60950,"172.16.139.250",5440,10,1022,21872,0,0,10,1022,0,0,292.468736,0.026204000000007,312013,0
"172.16.133.53",54352,"172.16.139.250",5440,10,1022,21873,0,0,10,1022,0,0,292.470786,0.033855000000016844,241500,0
"172.16.133.21",53427,"172.16.139.250",5440,10,1022,21874,0,0,10,1022,0,0,292.473921,0.034459999999967295,237260,0
"172.16.133.30",62925,"172.16.139.250",5440,10,1022,21875,0,0,10,1022,0,0,292.480265,0.02107300000000123,387984,0
"172.16.133.25",63730,"172.16.139.250",5440,10,1022,21876,0,0,10,1022,0,0,292.485256,0.027284000000008746,299662,0
"172.16.133.97",59633,"172.16.139.250",5440,10,1022,21877,0,0,10,1022,0,0,292.504103,0.01240899999999101,658876,0
"172.16.133.34",50718,"172.16.139.250",5440,10,1022,21878,0,0,10,1022,0,0,292.512174,0.008332999999993262,981159,0
"172.16.133.34",50719,"96.43.146.176",443,39,23414,21879,0,0,19,9467,20,13947,292.527614,3.402811999999983,22256,32789
"172.16.133.54",64899,"157.56.234.137",443,6,374,21880,0,0,3,194,3,180,292.548411,1.2462980000000243,1245,1155
"172.16.133.33",58139,"172.16.139.250",5440,12,1142,21881,0,0,12,1142,0,0,292.57369,0.005499999999983629,1661090,0
"172.16.133.68",61046,"172.16.139.250",5440,10,1022,21882,0,0,10,1022,0,0,292.610866,0.005482000000029075,1491426,0
"172.16.133.12",60035,"172.16.139.250",5440,12,1142,21883,0,0,12,1142,0,0,292.625106,0.0166969999999651,547164,0
"172.16.133.63",54243,"172.16.139.250",5440,12,1142,21884,0,0,12,1142,0,0,292.636463,0.00899200000003475,1016014,0
"172.16.133.66",54457,"172.16.139.250",5440,10,1022,21885,0,0,10,1022,0,0,292.646104,0.005831000000000586,1402160,0
"172.16.133.82",61682,"172.16.139.250",5440,12,1142,21886,0,0,12,1142,0,0,292.661533,0.006730000000004566,1357503,0
"172.16.133.37",60906,"172.16.139.250",5440,10,1022,21887,0,0,10,1022,0,0,292.674996,0.005910999999969135,1383183,0
"172.16.133.34",50720,"208.47.254.26",80,7,936,21888,0,0,4,525,3,411,292.775968,0.2394090000000233,17543,13733
"172.16.133.18",50329,"157.56.238.6",443,1909,2053424,21889,0,0,462,35305,1447,2018119,292.806303,7.148290999999972,39511,2258575
"172.16.133.78",59523,"172.16.139.250",5440,10,1022,21890,0,0,10,1022,0,0,292.832346,0.005932000000029802,1378287,0
"172.16.133.67",56260,"172.16.139.250",5440,12,1142,21891,0,0,12,1142,0,0,292.885925,0.016156000000023596,565486,0
"172.16.133.56",61695,"172.16.139.250",5440,10,1022,21892,0,0,10,1022,0,0,292.908881,0.006622999999990498,1234485,0
"172.16.133.41",53400,"172.16.139.250",5440,10,1022,21893,0,0,10,1022,0,0,292.962515,0.005395000000021355,1515477,0
"172.16.133.43",58016,"172.16.139.250",5440,10,1022,21894,0,0,10,1022,0,0,293.032624,0.005454999999983556,1498808,0
"172.16.133.13",53310,"172.16.139.250",5440,12,1142,21895,0,0,12,1142,0,0,293.053099,0.01087200000000621,840323,0
"172.16.133.85",52526,"172.16.139.250",5440,10,1022,21896,0,0,10,1022,0,0,293.05845,0.014563000000009652,561422,0
"172.16.133.42",57379,"172.16.139.250",5440,12,1142,21897,0,0,12,1142,0,0,293.099811,0.09318400000000793,98042,0
"172.16.133.20",62710,"172.16.139.250",5440,12,1142,21898,0,0,12,1142,0,0,293.103668,0.014687999999978274,622004,0
"172.16.133.28",49459,"172.16.139.250",5440,12,1142,21899,0,0,12,1142,0,0,293.132118,0.00606500000003507,1506347,0
"172.16.133.99",56300,"172.16.139.250",5440,10,1022,21900,0,0,10,1022,0,0,293.160654,0.015078999999957432,542211,0
"172.16.133.75",51214,"172.16.139.250",5440,12,1142,21901,0,0,12,1142,0,0,293.166356,0.006131999999979598,1489889,0
"172.16.133.87",60514,"172.16.139.250",5440,10,1022,21902,0,0,10,1022,0,0,293.186745,0.005465000000015152,1496065,0
"172.16.133.35",50229,"172.16.139.250",5440,12,1142,21903,0,0,12,1142,0,0,293.191711,0.009321999999997388,980047,0
"172.16.133.116",54115,"172.16.139.250",5440,10,1022,21904,0,0,10,1022,0,0,293.197306,0.0061399999999594,1331596,0
"172.16.133.116",54116,"172.16.139.250",5440,10,1022,21905,0,0,10,1022,0,0,293.204308,0.005361999999990985,1524804,0
"172.16.133.116",54117,"172.16.139.250",5440,12,1142,21906,0,0,12,1142,0,0,293.210998,0.006924999999966985,1319277,0
"172.16.133.84",59073,"172.16.139.250",5440,12,1142,21907,0,0,12,1142,0,0,293.219774,0.01569900000004054,581947,0
"172.16.133.49",56029,"172.16.139.250",5440,12,1142,21908,0,0,12,1142,0,0,293.29373,0.006365000000016607,1435349,0
"172.16.133.95",57253,"172.16.139.250",5440,12,1142,21909,0,0,12,1142,0,0,293.337524,0.005785000000003038,1579256,0
"172.16.133.92",57917,"172.16.139.250",5440,10,1022,21910,0,0,10,1022,0,0,293.362428,0.015404999999987012,530736,0
"172.16.133.29",61251,"172.16.139.250",5440,10,1022,21911,0,0,10,1022,0,0,293.38191,0.015287000000000717,534833,0
"172.16.133.44",65078,"172.16.139.250",5440,10,1022,21912,0,0,10,1022,0,0,293.387417,0.015173999999944954,538816,0
"172.16.133.207",56185,"172.16.139.250",5440,10,1022,21913,0,0,10,1022,0,0,293.412249,0.01475900000002639,553967,0
"172.16.133.83",57353,"172.16.139.250",5440,12,1142,21914,0,0,12,1142,0,0,293.423532,0.015586999999982254,586129,0
"172.16.133.36",65093,"216.219.113.250",443,6,378,21915,0,0,4,258,2,120,293.431127,0.19864200000000665,10390,4832
"172.16.133.36",65094,"216.115.223.200",443,6,378,21916,0,0,4,258,2,120,293.431129,0.09314200000000028,22159,10306
"172.16.133.36",65095,"67.217.64.244",443,6,378,21917,0,0,4,258,2,120,293.43113,0.06546500000001743,31528,14664
"172.16.133.36",65096,"66.151.150.190",443,6,378,21918,0,0,4,258,2,120,293.431131,0.1915520000000015,10775,5011
"172.16.133.93",61160,"172.16.139.250",5440,12,1142,21919,0,0,12,1142,0,0,293.436901,0.006563000000028296,1392046,0
"172.16.133.11",55414,"172.16.139.250",5440,10,1022,21920,0,0,10,1022,0,0,293.45664,0.015355999999997039,532430,0
"172.16.133.55",57892,"172.16.139.250",5440,12,1142,21921,0,0,12,1142,0,0,293.461078,0.006297000000017761,1450849,0
"172.16.133.73",60951,"172.16.139.250",5440,10,1022,21922,0,0,10,1022,0,0,293.481804,0.005282999999963067,1547605,0
"172.16.133.53",54353,"172.16.139.250",5440,12,1142,21923,0,0,12,1142,0,0,293.485443,0.006294000000025335,1451541,0
"172.16.133.21",53428,"172.16.139.250",5440,12,1142,21924,0,0,12,1142,0,0,293.488567,0.0077580000000239124,1177623,0
"172.16.133.30",62927,"172.16.139.250",5440,12,1142,21925,0,0,12,1142,0,0,293.493369,0.007267000000013013,1257190,0
"172.16.133.25",63731,"172.16.139.250",5440,10,1022,21926,0,0,10,1022,0,0,293.499728,0.004849999999976262,"",""
"172.16.133.34",50721,"172.16.139.250",5440,10,1022,21927,0,0,10,1022,0,0,293.508797,0.005188999999973021,1575640,0
"172.16.133.97",59634,"172.16.139.250",5440,10,1022,21928,0,0,10,1022,0,0,293.51846,0.015411999999969339,530495,0
"172.16.133.33",58140,"172.16.139.250",5440,12,1142,21929,0,0,12,1142,0,0,293.58774,0.006437000000005355,1419294,0
"172.16.133.63",54244,"54.243.89.226",80,3,192,21930,0,0,2,126,1,66,293.594371,0.028094999999950687,35878,18793
"172.16.133.63",54245,"54.243.89.226",80,3,192,21931,0,0,2,126,1,66,293.59457,0.027063999999995758,37245,19509
"172.16.133.63",54246,"23.15.129.231",80,3,192,21932,0,0,2,126,1,66,293.594784,0.03176400000000967,31734,16622
"172.16.133.63",54247,"23.15.129.231",80,3,192,21933,0,0,2,126,1,66,293.594946,0.031601000000023305,31897,16708
"172.16.133.63",54248,"23.15.129.231",80,3,192,21934,0,0,2,126,1,66,293.595108,0.030617000000006556,32922,17245
"172.16.133.63",54249,"23.15.129.231",80,3,192,21935,0,0,2,126,1,66,293.595239,0.031312000000013995,32192,16862
"172.16.133.63",54250,"23.0.52.46",80,3,192,21936,0,0,2,126,1,66,293.595459,0.03108500000001868,32427,16985
"172.16.133.63",54251,"23.0.52.46",80,3,192,21937,0,0,2,126,1,66,293.595594,0.030951000000015938,32567,17059
"172.16.133.63",54252,"184.73.187.64",80,3,186,21938,0,0,2,126,1,60,293.595741,0.028440000000045984,35443,16877
"172.16.133.63",54253,"184.73.187.64",80,3,186,21939,0,0,2,126,1,60,293.595845,0.030704000000014275,32829,15633
"172.16.133.63",54254,"173.194.43.60",80,3,192,21940,0,0,2,126,1,66,293.595988,0.024863000000038937,40542,21236
"172.16.133.63",54255,"173.194.43.60",80,3,192,21941,0,0,2,126,1,66,293.596089,0.023222999999973126,43405,22736
"172.16.133.68",61047,"172.16.139.250",5440,12,1142,21942,0,0,12,1142,0,0,293.625292,0.0062859999999886895,1453388,0
"172.16.133.12",60036,"172.16.139.250",5440,10,1022,21943,0,0,10,1022,0,0,293.638693,0.006122000000004846,1335511,0
"172.16.133.63",54256,"172.16.139.250",5440,10,1022,21944,0,0,10,1022,0,0,293.650257,0.005205999999986943,1570495,0
"172.16.133.66",54458,"172.16.139.250",5440,12,1142,21945,0,0,12,1142,0,0,293.659761,0.005808000000001812,1573002,0
"172.16.133.82",61683,"172.16.139.250",5440,10,1022,21946,0,0,10,1022,0,0,293.675121,0.005617000000029293,1455581,0
"172.16.133.37",60907,"172.16.139.250",5440,10,1022,21947,0,0,10,1022,0,0,293.688798,0.005673999999999069,1440958,0
"172.16.133.63",54257,"208.47.254.83",80,3,192,21948,0,0,2,126,1,66,293.704609,0.020695999999986725,48705,25512
"172.16.133.63",54258,"8.27.243.253",80,3,192,21949,0,0,2,126,1,66,293.705058,0.024473999999997886,41186,21573
"172.16.133.63",54259,"8.27.243.253",80,3,192,21950,0,0,2,126,1,66,293.705308,0.023351999999988493,43165,22610
"172.16.133.63",54260,"8.27.243.253",80,3,192,21951,0,0,2,126,1,66,293.705566,0.023967000000027383,42057,22030
"172.16.133.54",64900,"157.56.236.89",443,6,374,21952,0,0,3,194,3,180,293.795674,1.2855339999999842,1207,1120
"172.16.133.78",59524,"172.16.139.250",5440,10,1022,21953,0,0,10,1022,0,0,293.845741,0.005679000000043288,1439690,0
"172.16.133.36",65041,"96.43.146.22",443,2,132,21954,0,0,1,66,1,66,293.897295,0.00011100000000396903,"",""
"172.16.133.36",65049,"96.43.146.50",443,2,132,21955,0,0,1,66,1,66,293.897957,8.499999995592589e-05,"",""
"172.16.133.36",65051,"96.43.146.50",443,2,132,21956,0,0,1,66,1,66,293.897959,0.00013599999999769352,"",""
"172.16.133.36",65050,"96.43.146.50",443,2,132,21957,0,0,1,66,1,66,293.898274,7.699999997612395e-05,"",""
"172.16.133.67",56261,"172.16.139.250",5440,12,1142,21958,0,0,12,1142,0,0,293.899827,0.0062399999999911415,1464102,0
"172.16.133.56",61696,"172.16.139.250",5440,10,1022,21959,0,0,10,1022,0,0,293.923022,0.005452999999988606,1499358,0
"172.16.133.41",53401,"172.16.139.250",5440,10,1022,21960,0,0,10,1022,0,0,293.976631,0.006073000000014872,1346286,0
"172.16.133.43",58017,"172.16.139.250",5440,12,1142,21961,0,0,12,1142,0,0,294.046649,0.023798999999996795,383881,0
"172.16.133.13",53311,"172.16.139.250",5440,10,1022,21962,0,0,10,1022,0,0,294.067961,0.005409999999983484,1511275,0
"172.16.133.85",52527,"172.16.139.250",5440,12,1142,21963,0,0,12,1142,0,0,294.072273,0.0060330000000021755,1514337,0
"172.16.133.84",59074,"216.115.223.200",443,6,366,21964,0,0,4,246,2,120,294.113942,0.11311899999998332,17397,8486
"172.16.133.20",62711,"172.16.139.250",5440,12,1142,21965,0,0,12,1142,0,0,294.117738,0.004769000000010237,"",""
"172.16.133.42",57380,"172.16.139.250",5440,12,1142,21966,0,0,12,1142,0,0,294.121345,0.020883999999966818,437464,0
"172.16.133.84",59075,"67.217.64.244",443,6,366,21967,0,0,4,246,2,120,294.122783,0.10340999999999667,19031,9283
"172.16.133.28",49461,"172.16.139.250",5440,12,1142,21968,0,0,12,1142,0,0,294.146075,0.006250000000022737,1461759,0
"172.16.133.99",56301,"172.16.139.250",5440,10,1022,21969,0,0,10,1022,0,0,294.175723,0.014794999999992342,552619,0
"172.16.133.75",51215,"172.16.139.250",5440,10,1022,21970,0,0,10,1022,0,0,294.180264,0.005395999999961987,1515196,0
"172.16.133.87",60515,"172.16.139.250",5440,12,1142,21971,0,0,12,1142,0,0,294.199824,0.006450000000029377,1416434,0
"172.16.133.35",50230,"172.16.139.250",5440,12,1142,21972,0,0,12,1142,0,0,294.201795,0.07026799999999866,130016,0
"172.16.133.84",59076,"66.151.150.190",443,6,366,21973,0,0,4,246,2,120,294.207914,0.20190299999995887,9747,4754
"172.16.133.116",54118,"172.16.139.250",5440,10,1022,21974,0,0,10,1022,0,0,294.211071,0.005111999999996897,1599374,0
"172.16.133.84",59077,"216.219.113.250",443,6,366,21975,0,0,4,246,2,120,294.211782,0.2129799999999591,9240,4507
"172.16.133.116",54119,"172.16.139.250",5440,10,1022,21976,0,0,10,1022,0,0,294.217483,0.005043000000000575,1621257,0
"172.16.133.116",54120,"172.16.139.250",5440,10,1022,21977,0,0,10,1022,0,0,294.223443,0.00519200000002229,1574730,0
"172.16.133.84",59078,"172.16.139.250",5440,10,1022,21978,0,0,10,1022,0,0,294.23361,0.00533500000000231,1532521,0
"172.16.133.49",56030,"172.16.139.250",5440,10,1022,21979,0,0,10,1022,0,0,294.308472,0.0058760000000006585,1391422,0
"172.16.133.12",60037,"96.43.146.22",443,7,817,21980,0,0,4,508,3,309,294.334645,0.1224489999999605,33189,20187
"172.16.133.12",60038,"96.43.146.22",443,7,817,21981,0,0,4,508,3,309,294.334899,0.13199099999997088,30789,18728
"172.16.133.95",57254,"172.16.139.250",5440,12,1142,21982,0,0,12,1142,0,0,294.35188,0.06472300000001496,141155,0
"172.16.133.92",57918,"172.16.139.250",5440,10,1022,21983,0,0,10,1022,0,0,294.375525,0.04553600000002689,179550,0
"172.16.133.29",61252,"172.16.139.250",5440,12,1142,21984,0,0,12,1142,0,0,294.395459,0.02982299999996485,306340,0
"172.16.133.44",65079,"172.16.139.250",5440,12,1142,21985,0,0,12,1142,0,0,294.401092,0.030281000000002223,301707,0
"172.16.133.207",56186,"172.16.139.250",5440,12,1142,21986,0,0,12,1142,0,0,294.426216,0.008373000000005959,1091126,0
"172.16.133.63",54261,"23.0.49.244",80,8,3597,21987,0,0,4,1135,4,2462,294.429881,0.21388600000000224,42452,92086
"172.16.133.63",54262,"23.0.49.244",80,13,7427,21988,0,0,6,2144,7,5283,294.430198,0.32081099999999196,53464,131741
"172.16.133.63",54263,"23.0.49.244",80,13,6693,21989,0,0,6,2144,7,4549,294.430415,0.33280999999999494,51536,109347
"172.16.133.63",54264,"23.0.49.244",80,8,3904,21990,0,0,4,1135,4,2769,294.43077,0.18175500000000966,49957,121878
"172.16.133.63",54265,"23.0.49.244",80,8,3901,21991,0,0,4,1135,4,2766,294.430943,0.19343699999996034,46940,114393
"172.16.133.83",57354,"172.16.139.250",5440,12,1142,21992,0,0,12,1142,0,0,294.437562,0.00481400000001031,"",""
"172.16.133.93",61161,"172.16.139.250",5440,12,1142,21993,0,0,12,1142,0,0,294.45202,0.005014000000016949,1822098,0
"172.16.133.11",55415,"172.16.139.250",5440,12,1142,21994,0,0,12,1142,0,0,294.468648,0.0063300000000481305,1443285,0
"172.16.133.55",57893,"172.16.139.250",5440,10,1022,21995,0,0,10,1022,0,0,294.475217,0.006996000000015101,1168667,0
"172.16.133.73",60952,"172.16.139.250",5440,10,1022,21996,0,0,10,1022,0,0,294.495913,0.0060789999999997235,1344958,0
"172.16.133.53",54354,"172.16.139.250",5440,10,1022,21997,0,0,10,1022,0,0,294.49979,0.005740000000002965,1424390,0
"172.16.133.21",53429,"172.16.139.250",5440,12,1142,21998,0,0,12,1142,0,0,294.503129,0.02002399999997806,456252,0
"172.16.133.30",62928,"172.16.139.250",5440,10,1022,21999,0,0,10,1022,0,0,294.506547,0.005538000000001375,1476345,0
"172.16.133.113",55782,"172.16.139.250",135,8,492,22000,0,0,8,492,0,0,294.50899,0.023439999999993688,167918,0
"172.16.133.25",63732,"172.16.139.250",5440,12,1142,22001,0,0,12,1142,0,0,294.512869,0.005192999999962922,1759291,0
"172.16.133.34",50722,"172.16.139.250",5440,12,1142,22002,0,0,12,1142,0,0,294.522621,0.005062000000009448,1804820,0
"172.16.133.97",59635,"172.16.139.250",5440,10,1022,22003,0,0,10,1022,0,0,294.532291,0.006590000000016971,1240667,0
"172.16.133.113",55783,"172.16.139.250",5462,12,816,22004,0,0,12,816,0,0,294.532875,0.5253040000000055,12427,0
"172.16.133.63",54266,"23.0.49.244",80,3,192,22005,0,0,2,126,1,66,294.5377,0.024943000000007487,40412,21168
"172.16.133.63",54267,"23.0.49.244",80,3,192,22006,0,0,2,126,1,66,294.537866,0.02643999999997959,38124,19969
"172.16.133.33",58141,"172.16.139.250",5440,10,1022,22007,0,0,10,1022,0,0,294.601618,0.014857000000006337,550312,0
"172.16.133.68",61048,"172.16.139.250",5440,10,1022,22008,0,0,10,1022,0,0,294.637869,0.006002999999964231,1361985,0
"172.16.133.12",60039,"172.16.139.250",5440,12,1142,22009,0,0,12,1142,0,0,294.654364,0.0060980000000085965,1498196,0
"172.16.133.63",54268,"172.16.139.250",5440,12,1142,22010,0,0,12,1142,0,0,294.664346,0.015459999999961838,590944,0
"172.16.133.66",54459,"172.16.139.250",5440,10,1022,22011,0,0,10,1022,0,0,294.674084,0.00878299999999399,930889,0
"172.16.133.82",61684,"172.16.139.250",5440,10,1022,22012,0,0,10,1022,0,0,294.689061,0.014833000000010088,551203,0
"172.16.133.37",60908,"172.16.139.250",5440,10,1022,22013,0,0,10,1022,0,0,294.701469,0.00634700000000521,1288167,0
"172.16.133.63",54269,"138.108.6.20",80,11,5206,22014,0,0,7,4548,4,658,294.767109,0.9516039999999748,38234,5531
"172.16.133.63",54270,"64.94.107.54",80,10,3092,22015,0,0,6,2569,4,523,294.777293,0.15140800000000354,135739,27633
"172.16.133.78",59525,"172.16.139.250",5440,10,1022,22016,0,0,10,1022,0,0,294.858328,0.005561000000000149,1470239,0
"172.16.133.67",56262,"172.16.139.250",5440,10,1022,22017,0,0,10,1022,0,0,294.913604,0.018428999999969164,443648,0
"172.16.133.56",61697,"172.16.139.250",5440,12,1142,22018,0,0,12,1142,0,0,294.937345,0.008358999999984462,1092953,0
"172.16.133.41",53402,"172.16.139.250",5440,10,1022,22019,0,0,10,1022,0,0,294.990707,0.005387000000041553,1517727,0
"172.16.133.43",58018,"172.16.139.250",5440,12,1142,22020,0,0,12,1142,0,0,295.060758,0.015382999999985714,593902,0
"172.16.133.54",64901,"157.56.240.137",443,6,374,22021,0,0,3,194,3,180,295.082152,1.0714659999999867,1448,1343
"172.16.133.13",53312,"172.16.139.250",5440,10,1022,22022,0,0,10,1022,0,0,295.082334,0.0054369999999721585,1503770,0
"172.16.133.85",52528,"172.16.139.250",5440,10,1022,22023,0,0,10,1022,0,0,295.086307,0.005398000000013781,1514635,0
"172.16.133.42",57381,"172.16.139.250",5440,12,1142,22024,0,0,12,1142,0,0,295.126455,0.030105999999989308,303461,0
"172.16.133.20",62712,"172.16.139.250",5440,12,1142,22025,0,0,12,1142,0,0,295.131881,0.014618999999981952,624940,0
"172.16.133.28",49462,"172.16.139.250",5440,10,1022,22026,0,0,10,1022,0,0,295.16027,0.005516999999997552,1481964,0
"172.16.133.99",56302,"172.16.139.250",5440,12,1142,22027,0,0,12,1142,0,0,295.188749,0.004842000000053304,"",""
"172.16.133.75",51216,"172.16.139.250",5440,10,1022,22028,0,0,10,1022,0,0,295.194349,0.005420000000015079,1508487,0
"172.16.133.87",60516,"172.16.139.250",5440,10,1022,22029,0,0,10,1022,0,0,295.214862,0.015470999999990909,528472,0
"172.16.133.35",50231,"172.16.139.250",5440,12,1142,22030,0,0,12,1142,0,0,295.215291,0.011766000000022814,776474,0
"172.16.133.116",54121,"172.16.139.250",5440,10,1022,22031,0,0,10,1022,0,0,295.225426,0.008711999999945874,938475,0
"172.16.133.116",54122,"172.16.139.250",5440,12,1142,22032,0,0,12,1142,0,0,295.235092,0.005709999999965021,1600000,0
"172.16.133.116",54123,"172.16.139.250",5440,12,1142,22033,0,0,12,1142,0,0,295.242096,0.005718000000001666,1597761,0
"172.16.133.84",59079,"172.16.139.250",5440,12,1142,22034,0,0,12,1142,0,0,295.246661,0.015960000000006858,572431,0
"172.16.133.49",56031,"172.16.139.250",5440,10,1022,22035,0,0,10,1022,0,0,295.321887,0.005521999999984928,1480622,0
"172.16.133.95",57255,"172.16.139.250",5440,10,1022,22036,0,0,10,1022,0,0,295.366357,0.005375000000015007,1521116,0
"172.16.133.92",57919,"172.16.139.250",5440,10,1022,22037,0,0,10,1022,0,0,295.39071,0.005556000000012773,1471562,0
"172.16.133.29",61253,"172.16.139.250",5440,12,1142,22038,0,0,12,1142,0,0,295.409734,0.00602299999997058,1516852,0
"172.16.133.44",65080,"172.16.139.250",5440,12,1142,22039,0,0,12,1142,0,0,295.415027,0.006164000000012493,1482154,0
"172.16.133.207",56187,"172.16.139.250",5440,12,1142,22040,0,0,12,1142,0,0,295.440738,0.014720000000011169,620652,0
"172.16.133.83",57355,"172.16.139.250",5440,12,1142,22041,0,0,12,1142,0,0,295.451561,0.0074989999999957035,1218295,0
"172.16.133.93",61162,"172.16.139.250",5440,12,1142,22042,0,0,12,1142,0,0,295.466114,0.005132000000003245,1780202,0
"172.16.133.36",65097,"67.217.64.244",443,6,378,22043,0,0,4,258,2,120,295.471487,0.05091999999996233,40534,18853
"172.16.133.11",55416,"172.16.139.250",5440,10,1022,22044,0,0,10,1022,0,0,295.482613,0.015640999999959604,522728,0
"172.16.133.36",65098,"216.115.223.200",443,10,618,22045,0,0,6,378,4,240,295.484024,0.13416700000004766,22539,14310
"172.16.133.55",57894,"172.16.139.250",5440,12,1142,22046,0,0,12,1142,0,0,295.488409,0.006381000000033055,1431750,0
"172.16.133.73",60953,"172.16.139.250",5440,10,1022,22047,0,0,10,1022,0,0,295.509995,0.09116599999998698,89682,0
"172.16.133.53",54355,"172.16.139.250",5440,10,1022,22048,0,0,10,1022,0,0,295.512528,0.09393900000003441,87035,0
"172.16.133.21",53430,"172.16.139.250",5440,10,1022,22049,0,0,10,1022,0,0,295.51745,0.08027299999997695,101852,0
"172.16.133.30",62929,"172.16.139.250",5440,10,1022,22050,0,0,10,1022,0,0,295.521012,0.09304500000001781,87871,0
"172.16.133.25",63733,"172.16.139.250",5440,12,1142,22051,0,0,12,1142,0,0,295.528819,0.08111200000001872,112634,0
"172.16.133.36",65099,"66.151.150.190",443,6,378,22052,0,0,4,258,2,120,295.534943,0.17704099999997425,11658,5422
"172.16.133.36",65100,"216.219.113.250",443,6,378,22053,0,0,4,258,2,120,295.536028,0.19096799999999803,10808,5027
"172.16.133.34",50723,"172.16.139.250",5440,12,1142,22054,0,0,12,1142,0,0,295.537068,0.0805080000000089,113479,0
"172.16.133.97",59636,"172.16.139.250",5440,10,1022,22055,0,0,10,1022,0,0,295.546209,0.07581100000004426,107847,0
"172.16.133.42",57383,"184.73.225.104",443,16,6854,22056,0,0,8,1771,8,5083,295.54735,0.5971650000000182,23725,68095
"172.16.133.33",58142,"172.16.139.250",5440,10,1022,22057,0,0,10,1022,0,0,295.615911,0.012439000000028955,657287,0
"172.16.133.68",61049,"172.16.139.250",5440,10,1022,22058,0,0,10,1022,0,0,295.651975,0.014860999999996238,550164,0
"172.16.133.12",60040,"172.16.139.250",5440,12,1142,22059,0,0,12,1142,0,0,295.666676,0.007367999999985386,1239956,0
"172.16.133.63",54271,"172.16.139.250",5440,10,1022,22060,0,0,10,1022,0,0,295.678874,0.018331999999986692,445996,0
"172.16.133.66",54460,"172.16.139.250",5440,10,1022,22061,0,0,10,1022,0,0,295.688049,0.005466000000012627,1495792,0
"172.16.133.82",61685,"172.16.139.250",5440,10,1022,22062,0,0,10,1022,0,0,295.703835,0.005466999999953259,1495518,0
"172.16.133.37",60909,"172.16.139.250",5440,10,1022,22063,0,0,10,1022,0,0,295.715571,0.005281999999965592,1547898,0
"172.16.133.78",59526,"172.16.139.250",5440,12,1142,22064,0,0,12,1142,0,0,295.872635,0.006319000000019059,1445798,0
"172.16.133.67",56264,"172.16.139.250",5440,10,1022,22065,0,0,10,1022,0,0,295.928745,0.0067020000000184154,1219934,0
"172.16.133.56",61698,"172.16.139.250",5440,12,1142,22066,0,0,12,1142,0,0,295.949884,0.0050420000000030996,1811979,0
"172.16.133.42",57384,"157.56.240.137",443,6,374,22067,0,0,3,194,3,180,295.964088,1.0961679999999774,1415,1313
"172.16.133.41",53403,"172.16.139.250",5440,10,1022,22068,0,0,10,1022,0,0,296.004606,0.00536099999999351,1525088,0
"172.16.133.43",58019,"172.16.139.250",5440,12,1142,22069,0,0,12,1142,0,0,296.0747,0.006254000000012638,1460825,0
"172.16.133.13",53314,"172.16.139.250",5440,12,1142,22070,0,0,12,1142,0,0,296.095503,0.005939000000012129,1538306,0
"172.16.133.85",52529,"172.16.139.250",5440,10,1022,22071,0,0,10,1022,0,0,296.1006,0.005512000000010175,1483309,0
"172.16.133.96",53573,"173.194.43.32",80,36,10901,22072,0,0,20,5748,16,5153,296.100815,1.406612999999993,32691,29307
"172.16.133.20",62713,"172.16.139.250",5440,10,1022,22073,0,0,10,1022,0,0,296.14603,0.014270000000010441,572950,0
"172.16.133.42",57385,"172.16.139.250",5440,12,1142,22074,0,0,12,1142,0,0,296.147314,0.03503399999999601,260775,0
"172.16.133.54",64902,"157.56.244.217",443,6,374,22075,0,0,3,194,3,180,296.154543,1.1785340000000133,1316,1221
"172.16.133.84",59080,"67.217.64.244",443,6,366,22076,0,0,4,246,2,120,296.156891,0.05659000000002834,34776,16964
"172.16.133.84",59081,"216.115.223.200",443,6,366,22077,0,0,4,246,2,120,296.157775,0.08462800000000925,23254,11343
"172.16.133.28",49463,"172.16.139.250",5440,10,1022,22078,0,0,10,1022,0,0,296.173147,0.005351000000018757,1527938,0
"172.16.133.99",56303,"172.16.139.250",5440,10,1022,22079,0,0,10,1022,0,0,296.202817,0.014661000000046442,557670,0
"172.16.133.75",51217,"172.16.139.250",5440,10,1022,22080,0,0,10,1022,0,0,296.209367,0.01432900000003201,570591,0
"172.16.133.87",60517,"172.16.139.250",5440,10,1022,22081,0,0,10,1022,0,0,296.228857,0.005561000000000149,1470239,0
"172.16.133.35",50232,"172.16.139.250",5440,12,1142,22082,0,0,12,1142,0,0,296.231121,0.028955000000053133,315524,0
"172.16.133.116",54124,"172.16.139.250",5440,10,1022,22083,0,0,10,1022,0,0,296.238078,0.005095000000039818,1604710,0
"172.16.133.116",54125,"172.16.139.250",5440,10,1022,22084,0,0,10,1022,0,0,296.244134,0.00664000000000442,1231325,0
"172.16.133.92",57920,"216.115.222.200",443,6,366,22085,0,0,4,246,2,120,296.246942,0.1861729999999966,10570,5156
"172.16.133.92",57921,"202.173.24.200",443,6,366,22086,0,0,4,246,2,120,296.247631,0.4818030000000135,4084,1992
"172.16.133.92",57922,"216.219.112.250",443,6,366,22087,0,0,4,246,2,120,296.247836,0.257048999999995,7656,3734
"172.16.133.116",54126,"172.16.139.250",5440,10,1022,22088,0,0,10,1022,0,0,296.25161,0.014978999999982534,545830,0
"172.16.133.84",59082,"172.16.139.250",5440,10,1022,22089,0,0,10,1022,0,0,296.2613,0.008845000000007985,924364,0
"172.16.133.92",57923,"66.151.158.187",443,6,366,22090,0,0,4,246,2,120,296.274127,0.26730699999995977,7362,3591
"172.16.133.84",59083,"66.151.150.190",443,6,366,22091,0,0,4,246,2,120,296.319855,0.2125209999999811,9260,4517
"172.16.133.84",59084,"216.219.113.250",443,6,366,22092,0,0,4,246,2,120,296.330921,0.21445599999998421,9176,4476
"172.16.133.49",56032,"172.16.139.250",5440,10,1022,22093,0,0,10,1022,0,0,296.336608,0.005926999999985583,1379449,0
"172.16.133.95",57256,"172.16.139.250",5440,10,1022,22094,0,0,10,1022,0,0,296.37993,0.014771999999993568,553479,0
"172.16.133.26",53123,"96.43.146.176",443,25,15060,22095,0,0,13,6076,12,8984,296.387196,2.7048689999999738,17970,26571
"172.16.133.92",57924,"172.16.139.250",5440,10,1022,22096,0,0,10,1022,0,0,296.404535,0.015253999999970347,535990,0
"172.16.133.29",61256,"172.16.139.250",5440,10,1022,22097,0,0,10,1022,0,0,296.42284,0.0056230000000141445,1454028,0
"172.16.133.44",65081,"172.16.139.250",5440,10,1022,22098,0,0,10,1022,0,0,296.429271,0.015514999999993506,526973,0
"172.16.133.207",56188,"172.16.139.250",5440,12,1142,22099,0,0,12,1142,0,0,296.454637,0.06522300000000314,140073,0
"172.16.133.83",57356,"172.16.139.250",5440,12,1142,22100,0,0,12,1142,0,0,296.465607,0.05748700000003737,158922,0
"172.16.133.93",61163,"172.16.139.250",5440,10,1022,22101,0,0,10,1022,0,0,296.479314,0.04742900000002237,172383,0
"172.16.133.11",55417,"172.16.139.250",5440,10,1022,22102,0,0,10,1022,0,0,296.496437,0.03407199999998056,239962,0
"172.16.133.55",57895,"172.16.139.250",5440,10,1022,22103,0,0,10,1022,0,0,296.502936,0.031249000000002525,261640,0
"172.16.133.73",60954,"172.16.139.250",5440,10,1022,22104,0,0,10,1022,0,0,296.523931,0.01455199999998058,561847,0
"172.16.133.53",54356,"172.16.139.250",5440,10,1022,22105,0,0,10,1022,0,0,296.527707,0.015418999999951666,530254,0
"172.16.133.21",53431,"172.16.139.250",5440,10,1022,22106,0,0,10,1022,0,0,296.530167,0.02145899999999301,381005,0
"172.16.133.30",62930,"172.16.139.250",5440,10,1022,22107,0,0,10,1022,0,0,296.535425,0.012469000000010055,655706,0
"172.16.133.25",63734,"172.16.139.250",5440,10,1022,22108,0,0,10,1022,0,0,296.5407,0.014648999999963053,558126,0
"172.16.133.34",50724,"172.16.139.250",5440,10,1022,22109,0,0,10,1022,0,0,296.550857,0.008526000000017575,958949,0
"172.16.133.97",59637,"172.16.139.250",5440,10,1022,22110,0,0,10,1022,0,0,296.560183,0.0053470000000288564,1529081,0
"172.16.133.33",58143,"172.16.139.250",5440,12,1142,22111,0,0,12,1142,0,0,296.629845,0.006566000000020722,1391410,0
"172.16.133.95",57257,"23.0.49.244",80,3,192,22112,0,0,2,126,1,66,296.656607,0.023579999999981283,42748,22391
"172.16.133.95",57258,"23.0.49.244",80,3,192,22113,0,0,2,126,1,66,296.656741,0.024989000000005035,40337,21129
"172.16.133.68",61050,"172.16.139.250",5440,12,1142,22114,0,0,12,1142,0,0,296.667277,0.007104999999967276,1285855,0
"172.16.133.12",60041,"172.16.139.250",5440,12,1142,22115,0,0,12,1142,0,0,296.682078,0.006348000000002685,1439193,0
"172.16.133.63",54272,"172.16.139.250",5440,12,1142,22116,0,0,12,1142,0,0,296.69204,0.005450999999993655,1676022,0
"172.16.133.66",54461,"172.16.139.250",5440,10,1022,22117,0,0,10,1022,0,0,296.701853,0.00518699999997807,1576248,0
"172.16.133.82",61686,"172.16.139.250",5440,12,1142,22118,0,0,12,1142,0,0,296.718248,0.015842999999961194,576658,0
"172.16.133.37",60910,"172.16.139.250",5440,12,1142,22119,0,0,12,1142,0,0,296.730749,0.052346000000000004,174531,0
"172.16.133.21",51653,"172.16.139.250",5500,8,8844,22120,0,0,8,8844,0,0,296.744249,0.005608999999992648,12614013,0
"172.16.133.95",57259,"216.52.242.80",80,18,9338,22121,0,0,8,2332,10,7006,296.88425,0.7175799999999981,25998,78106
"172.16.133.78",59527,"172.16.139.250",5440,10,1022,22122,0,0,10,1022,0,0,296.886788,0.006619000000000597,1235231,0
"172.16.133.67",56265,"172.16.139.250",5440,12,1142,22123,0,0,12,1142,0,0,296.941512,0.006270000000029086,1457097,0
"172.16.133.56",61699,"172.16.139.250",5440,10,1022,22124,0,0,10,1022,0,0,296.964198,0.006093999999961852,1341647,0
"172.16.133.41",53404,"172.16.139.250",5440,10,1022,22125,0,0,10,1022,0,0,297.019636,0.00559099999998125,1462350,0
"172.16.133.42",57386,"157.56.244.217",443,6,374,22126,0,0,3,194,3,180,297.062327,1.1847989999999982,1309,1215
"172.16.133.43",58020,"172.16.139.250",5440,12,1142,22127,0,0,12,1142,0,0,297.088204,0.005898000000001957,1548999,0
"172.16.133.25",63735,"74.125.170.42",80,1692,1885595,22128,0,0,461,29714,1231,1855881,297.098474,2.1232519999999795,111956,6992598
"172.16.133.95",57260,"138.108.7.20",80,7,2196,22129,0,0,4,1598,3,598,297.104508,0.41976099999999406,30455,11396
"172.16.133.13",53315,"172.16.139.250",5440,12,1142,22130,0,0,12,1142,0,0,297.109107,0.006131999999979598,1489889,0
"172.16.133.85",52530,"172.16.139.250",5440,10,1022,22131,0,0,10,1022,0,0,297.114457,0.005224999999995816,1564784,0
"172.16.133.95",57261,"64.94.107.18",80,11,2413,22132,0,0,6,1830,5,583,297.122785,0.06172999999995454,237161,75554
"172.16.133.42",57387,"172.16.139.250",5440,12,1142,22133,0,0,12,1142,0,0,297.158636,0.01740100000000666,525027,0
"172.16.133.20",62714,"172.16.139.250",5440,12,1142,22134,0,0,12,1142,0,0,297.159008,0.005102000000022144,1790670,0
"172.16.133.28",49467,"172.16.139.250",5440,12,1142,22135,0,0,12,1142,0,0,297.187226,0.016245999999966898,562353,0
"172.16.133.99",56304,"172.16.139.250",5440,10,1022,22136,0,0,10,1022,0,0,297.21733,0.016645999999980177,491169,0
"172.16.133.75",51218,"172.16.139.250",5440,10,1022,22137,0,0,10,1022,0,0,297.224538,0.0061709999999948195,1324906,0
"172.16.133.87",60518,"172.16.139.250",5440,10,1022,22138,0,0,10,1022,0,0,297.243586,0.018675000000030195,437804,0
"172.16.133.35",50233,"172.16.139.250",5440,12,1142,22139,0,0,12,1142,0,0,297.246196,0.026967000000013286,338784,0
"172.16.133.116",54127,"172.16.139.250",5440,12,1142,22140,0,0,12,1142,0,0,297.252775,0.006274000000018987,1456168,0
"172.16.133.116",54128,"172.16.139.250",5440,10,1022,22141,0,0,10,1022,0,0,297.260023,0.014454999999998108,565617,0
"172.16.133.84",59085,"172.16.139.250",5440,12,1142,22142,0,0,12,1142,0,0,297.274475,0.0160900000000197,567806,0
"172.16.133.116",54129,"172.16.139.250",5440,10,1022,22143,0,0,10,1022,0,0,297.275348,0.005974999999978081,1368368,0
"172.16.133.54",64903,"157.56.234.137",80,8,884,22144,0,0,5,532,3,352,297.343263,0.23343099999999595,18232,12063
"172.16.133.49",56033,"172.16.139.250",5440,12,1142,22145,0,0,12,1142,0,0,297.350754,0.005789999999990414,1577892,0
"172.16.133.95",57262,"172.16.139.250",5440,12,1142,22146,0,0,12,1142,0,0,297.394911,0.006163000000015018,1482394,0
"172.16.133.92",57925,"172.16.139.250",5440,12,1142,22147,0,0,12,1142,0,0,297.417162,0.015629999999987376,584516,0
"172.16.133.96",53574,"173.194.43.32",80,10,1736,22148,0,0,6,954,4,782,297.43705,0.15508999999997286,49210,40337
"172.16.133.29",61258,"172.16.139.250",5440,10,1022,22149,0,0,10,1022,0,0,297.437102,0.005391000000031454,1516601,0
"172.16.133.44",65082,"172.16.139.250",5440,10,1022,22150,0,0,10,1022,0,0,297.443073,0.014673999999956777,557175,0
"172.16.133.207",56189,"172.16.139.250",5440,10,1022,22151,0,0,10,1022,0,0,297.468409,0.004733999999984917,"",""
"172.16.133.83",57357,"172.16.139.250",5440,10,1022,22152,0,0,10,1022,0,0,297.478742,0.01475199999998722,554229,0
"172.16.133.93",61164,"172.16.139.250",5440,10,1022,22153,0,0,10,1022,0,0,297.493246,0.00472500000000764,"",""
"172.16.133.36",65101,"67.217.64.244",443,6,378,22154,0,0,4,258,2,120,297.495098,0.06141100000002098,33609,15632
"172.16.133.20",62715,"216.219.112.250",443,6,366,22155,0,0,4,246,2,120,297.495636,0.22065800000001445,8918,4350
"172.16.133.11",55418,"172.16.139.250",5440,10,1022,22156,0,0,10,1022,0,0,297.510461,0.015602999999998701,524001,0
"172.16.133.55",57896,"172.16.139.250",5440,10,1022,22157,0,0,10,1022,0,0,297.516327,0.0186469999999872,438461,0
"172.16.133.20",62716,"216.115.222.200",443,6,366,22158,0,0,4,246,2,120,297.517758,0.09503100000000586,20709,10101
"172.16.133.20",62717,"66.151.158.187",443,6,366,22159,0,0,4,246,2,120,297.518991,0.20007799999996223,9836,4798
"172.16.133.20",62718,"202.173.24.200",443,6,366,22160,0,0,4,246,2,120,297.519368,0.4925709999999981,3995,1948
"172.16.133.36",65102,"216.115.223.200",443,10,618,22161,0,0,6,378,4,240,297.531302,0.13656300000002375,22143,14059
"172.16.133.73",60955,"172.16.139.250",5440,10,1022,22162,0,0,10,1022,0,0,297.538185,0.015288999999995667,534763,0
"172.16.133.53",54357,"172.16.139.250",5440,10,1022,22163,0,0,10,1022,0,0,297.542087,0.01951200000002018,419024,0
"172.16.133.21",53432,"172.16.139.250",5440,12,1142,22164,0,0,12,1142,0,0,297.544741,0.0212139999999863,430658,0
"172.16.133.30",62931,"172.16.139.250",5440,10,1022,22165,0,0,10,1022,0,0,297.549087,0.00846599999999853,965745,0
"172.16.133.25",63736,"172.16.139.250",5440,10,1022,22166,0,0,10,1022,0,0,297.554576,0.014176000000020395,576749,0
"172.16.133.96",53575,"173.194.43.32",80,29,8059,22167,0,0,16,4425,13,3634,297.563273,1.2580300000000193,28139,23109
"172.16.133.34",50725,"172.16.139.250",5440,12,1142,22168,0,0,12,1142,0,0,297.564798,0.014839999999992415,615633,0
"172.16.133.97",59638,"172.16.139.250",5440,12,1142,22169,0,0,12,1142,0,0,297.574436,0.009986000000026252,914880,0
"172.16.133.36",65103,"66.151.150.190",443,6,378,22170,0,0,4,258,2,120,297.622426,0.18850899999995363,10949,5092
"172.16.133.36",65104,"216.219.113.250",443,6,378,22171,0,0,4,258,2,120,297.632307,0.1908499999999549,10814,5030
"172.16.133.33",58144,"172.16.139.250",5440,12,1142,22172,0,0,12,1142,0,0,297.643764,0.006561000000033346,1392470,0
"172.16.133.68",61051,"172.16.139.250",5440,12,1142,22173,0,0,12,1142,0,0,297.681166,0.014897999999959666,613236,0
"172.16.133.54",64904,"157.56.234.6",443,25,9966,22174,0,0,12,3075,13,6891,297.690206,1.7869269999999915,13766,30850
"172.16.133.12",60042,"172.16.139.250",5440,12,1142,22175,0,0,12,1142,0,0,297.693413,0.016417999999987387,556462,0
"172.16.133.63",54273,"172.16.139.250",5440,10,1022,22176,0,0,10,1022,0,0,297.705921,0.007784000000015112,1050359,0
"172.16.133.66",54462,"172.16.139.250",5440,10,1022,22177,0,0,10,1022,0,0,297.716116,0.00539600000001883,1515196,0
"172.16.133.82",61687,"172.16.139.250",5440,10,1022,22178,0,0,10,1022,0,0,297.731496,0.005520999999987453,1480891,0
"172.16.133.37",60911,"172.16.139.250",5440,10,1022,22179,0,0,10,1022,0,0,297.743557,0.006964999999979682,1173869,0
"172.16.133.78",59528,"172.16.139.250",5440,10,1022,22180,0,0,10,1022,0,0,297.900561,0.005310000000008586,1539736,0
"172.16.133.67",56266,"172.16.139.250",5440,10,1022,22181,0,0,10,1022,0,0,297.955603,0.005544999999983702,1474481,0
"172.16.133.103",63448,"202.173.28.250",443,6,366,22182,0,0,4,246,2,120,297.955958,0.4965859999999793,3963,1933
"172.16.133.103",63449,"64.74.80.187",443,6,366,22183,0,0,4,246,2,120,297.956189,0.04820000000000846,40829,19917
"172.16.133.103",63450,"67.217.65.244",443,6,366,22184,0,0,4,246,2,120,297.956712,0.07161800000000085,27479,13404
"172.16.133.103",63451,"216.115.212.254",443,6,366,22185,0,0,4,246,2,120,297.958258,0.2366129999999771,8317,4057
"172.16.133.56",61700,"172.16.139.250",5440,12,1142,22186,0,0,12,1142,0,0,297.978991,0.0052759999999807405,1731614,0
"172.16.133.41",53405,"172.16.139.250",5440,10,1022,22187,0,0,10,1022,0,0,298.032508,0.005383999999992284,1518573,0
"172.16.133.43",58021,"172.16.139.250",5440,12,1142,22188,0,0,12,1142,0,0,298.102021,0.006361000000026706,1436252,0
"172.16.133.120",53434,"172.16.128.169",8014,2,120,22189,0,0,1,60,1,60,298.120517,0.09002499999996871,5331,5331
"172.16.133.13",53316,"172.16.139.250",5440,10,1022,22190,0,0,10,1022,0,0,298.123957,0.014856000000008862,550350,0
"172.16.133.85",52531,"172.16.139.250",5440,10,1022,22191,0,0,10,1022,0,0,298.128618,0.014545999999995729,562078,0
"172.16.133.20",62719,"172.16.139.250",5440,12,1142,22192,0,0,12,1142,0,0,298.173951,0.005288000000007287,1727685,0
"172.16.133.42",57388,"172.16.139.250",5440,12,1142,22193,0,0,12,1142,0,0,298.174055,0.02289300000001049,399073,0
"172.16.133.84",59086,"67.217.64.244",443,6,366,22194,0,0,4,246,2,120,298.192083,0.06642499999998108,29627,14452
"172.16.133.28",49468,"172.16.139.250",5440,10,1022,22195,0,0,10,1022,0,0,298.201395,0.005349000000023807,1528510,0
"172.16.133.84",59087,"216.115.223.200",443,6,366,22196,0,0,4,246,2,120,298.204873,0.09144599999996217,21520,10497
"172.16.133.99",56305,"172.16.139.250",5440,10,1022,22197,0,0,10,1022,0,0,298.230925,0.014744000000007418,554530,0
"172.16.133.75",51219,"172.16.139.250",5440,10,1022,22198,0,0,10,1022,0,0,298.236429,0.005433000000039101,1504877,0
"172.16.133.42",57389,"157.56.234.137",443,6,374,22199,0,0,3,194,3,180,298.248962,1.242830999999967,1248,1158
"172.16.133.87",60519,"172.16.139.250",5440,12,1142,22200,0,0,12,1142,0,0,298.255968,0.006184000000018841,1477360,0
"172.16.133.35",50234,"172.16.139.250",5440,12,1142,22201,0,0,12,1142,0,0,298.262022,0.016547000000002754,552124,0
"172.16.133.116",54130,"172.16.139.250",5440,12,1142,22202,0,0,12,1142,0,0,298.266154,0.014530000000036125,628768,0
"172.16.133.116",54131,"172.16.139.250",5440,12,1142,22203,0,0,12,1142,0,0,298.282234,0.0065119999999865286,1402948,0
"172.16.133.84",59088,"172.16.139.250",5440,10,1022,22204,0,0,10,1022,0,0,298.288574,0.005367000000035205,1523383,0
"172.16.133.116",54132,"172.16.139.250",5440,10,1022,22205,0,0,10,1022,0,0,298.289419,0.008251999999970394,990790,0
"172.16.133.92",57926,"216.115.222.200",443,6,366,22206,0,0,4,246,2,120,298.348926,0.0917079999999828,21459,10468
"172.16.133.49",56034,"172.16.139.250",5440,10,1022,22207,0,0,10,1022,0,0,298.36479,0.005572999999969852,1467073,0
"172.16.133.92",57927,"216.219.112.250",443,6,366,22208,0,0,4,246,2,120,298.392951,0.2225300000000061,8843,4314
"172.16.133.95",57263,"172.16.139.250",5440,12,1142,22209,0,0,12,1142,0,0,298.408816,0.01557100000002265,586731,0
"172.16.133.92",57928,"172.16.139.250",5440,10,1022,22210,0,0,10,1022,0,0,298.432737,0.015251000000034765,536095,0
"172.16.133.84",59089,"66.151.150.190",443,6,366,22211,0,0,4,246,2,120,298.434066,0.19244100000003073,10226,4988
"172.16.133.84",59090,"216.219.113.250",443,6,366,22212,0,0,4,246,2,120,298.441877,0.19875500000000557,9901,4830
"172.16.133.92",57929,"66.151.158.187",443,6,366,22213,0,0,4,246,2,120,298.444112,0.19102599999996528,10302,5025
"172.16.133.29",61259,"172.16.139.250",5440,12,1142,22214,0,0,12,1142,0,0,298.451837,0.006279000000006363,1455008,0
"172.16.133.44",65083,"172.16.139.250",5440,10,1022,22215,0,0,10,1022,0,0,298.457214,0.01547299999998586,528404,0
"172.16.133.207",56190,"172.16.139.250",5440,10,1022,22216,0,0,10,1022,0,0,298.483083,0.005056999999965228,1616768,0
"172.16.133.83",57358,"172.16.139.250",5440,12,1142,22217,0,0,12,1142,0,0,298.493617,0.013698000000033517,666958,0
"172.16.133.92",57930,"202.173.24.200",443,6,366,22218,0,0,4,246,2,120,298.495922,0.4913429999999721,4005,1953
"172.16.133.63",54274,"208.111.161.254",80,33,19325,22219,0,0,13,4121,20,15204,298.497148,1.1408020000000079,28898,106619
"172.16.133.93",61165,"172.16.139.250",5440,12,1142,22220,0,0,12,1142,0,0,298.507045,0.004987999999968906,"",""
"172.16.133.11",55419,"172.16.139.250",5440,12,1142,22221,0,0,12,1142,0,0,298.524754,0.10986400000001595,83157,0
"172.16.133.55",57897,"172.16.139.250",5440,10,1022,22222,0,0,10,1022,0,0,298.534781,0.10303599999997459,79350,0
"172.16.133.73",60956,"172.16.139.250",5440,12,1142,22223,0,0,12,1142,0,0,298.551052,0.09106599999995524,100322,0
"172.16.133.53",54358,"172.16.139.250",5440,12,1142,22224,0,0,12,1142,0,0,298.555666,0.08988100000004806,101645,0
"172.16.133.21",53433,"172.16.139.250",5440,12,1142,22225,0,0,12,1142,0,0,298.558373,0.0907699999999636,100649,0
"172.16.133.30",62932,"172.16.139.250",5440,10,1022,22226,0,0,10,1022,0,0,298.562231,0.09080399999999145,90040,0
"172.16.133.25",63737,"172.16.139.250",5440,12,1142,22227,0,0,12,1142,0,0,298.569815,0.10207400000001599,89503,0
"172.16.133.34",50726,"172.16.139.250",5440,12,1142,22228,0,0,12,1142,0,0,298.578633,0.09680499999996073,94375,0
"172.16.133.97",59639,"172.16.139.250",5440,12,1142,22229,0,0,12,1142,0,0,298.588093,0.09162900000001173,99706,0
"172.16.133.33",58145,"172.16.139.250",5440,10,1022,22230,0,0,10,1022,0,0,298.657667,0.02535499999999047,322461,0
"172.16.133.68",61053,"172.16.139.250",5440,10,1022,22231,0,0,10,1022,0,0,298.694188,0.0058220000000233085,1404328,0
"172.16.133.12",60043,"172.16.139.250",5440,12,1142,22232,0,0,12,1142,0,0,298.70852,0.006268999999974767,1457329,0
"172.16.133.63",54275,"172.16.139.250",5440,12,1142,22233,0,0,12,1142,0,0,298.720422,0.015829999999994016,577132,0
"172.16.133.66",54463,"172.16.139.250",5440,10,1022,22234,0,0,10,1022,0,0,298.730833,0.009026000000005752,905827,0
"172.16.133.23",55061,"216.219.112.250",443,6,366,22235,0,0,4,246,2,120,298.734889,0.21110199999998258,9322,4547
"172.16.133.23",55062,"202.173.24.200",443,6,366,22236,0,0,4,246,2,120,298.735029,0.47838500000000295,4113,2006
"172.16.133.23",55063,"216.115.222.200",443,6,366,22237,0,0,4,246,2,120,298.735833,0.10548399999998992,18656,9100
"172.16.133.82",61689,"172.16.139.250",5440,10,1022,22238,0,0,10,1022,0,0,298.745595,0.015961000000004333,512248,0
"172.16.133.96",53576,"173.194.43.32",80,18,4151,22239,0,0,10,2358,8,1793,298.754987,0.5757059999999683,32766,24915
"172.16.133.37",60912,"172.16.139.250",5440,10,1022,22240,0,0,10,1022,0,0,298.758383,0.015732000000014068,519705,0
"172.16.133.23",55064,"66.151.158.187",443,6,366,22241,0,0,4,246,2,120,298.771116,0.18372899999997117,10711,5225
"172.16.133.109",60043,"23.33.81.213",443,51,27023,22242,0,0,22,3433,29,23590,298.840817,0.7910049999999842,34720,238582
"172.16.133.78",59529,"172.16.139.250",5440,10,1022,22243,0,0,10,1022,0,0,298.914667,0.005725999999981468,1427872,0
"172.16.133.41",53406,"157.56.236.102",443,23,9729,22244,0,0,10,1978,13,7751,298.920682,0.4958050000000185,31915,125065
"172.16.133.67",56267,"172.16.139.250",5440,10,1022,22245,0,0,10,1022,0,0,298.969919,0.005265000000008513,1552896,0
"172.16.133.56",61701,"172.16.139.250",5440,12,1142,22246,0,0,12,1142,0,0,298.991965,0.005873000000008233,1555593,0
"172.16.133.109",60044,"23.33.81.213",443,30,14819,22247,0,0,15,2081,15,12738,299.005592,0.6251640000000407,26629,163003
"172.16.133.41",53407,"172.16.139.250",5440,10,1022,22248,0,0,10,1022,0,0,299.047812,0.01228499999996302,665527,0
"172.16.133.113",55785,"172.16.139.250",135,8,492,22249,0,0,8,492,0,0,299.06622,0.0100360000000137,392188,0
"172.16.133.113",55786,"172.16.139.250",5462,10,696,22250,0,0,10,696,0,0,299.085093,0.5153930000000173,10803,0
"172.16.133.43",58022,"172.16.139.250",5440,10,1022,22251,0,0,10,1022,0,0,299.116923,0.006238999999993666,1310466,0
"172.16.133.13",53317,"172.16.139.250",5440,12,1142,22252,0,0,12,1142,0,0,299.138465,0.006114000000025044,1494275,0
"172.16.133.85",52532,"172.16.139.250",5440,10,1022,22253,0,0,10,1022,0,0,299.142586,0.01562300000000505,523330,0
"172.16.133.20",62720,"172.16.139.250",5440,12,1142,22254,0,0,12,1142,0,0,299.187979,0.01435500000002321,636433,0
"172.16.133.28",49469,"172.16.139.250",5440,12,1142,22255,0,0,12,1142,0,0,299.216161,0.0060839999999871,1501643,0
"172.16.133.42",57390,"172.16.139.250",5440,12,1142,22256,0,0,12,1142,0,0,299.232695,0.18029900000004773,50671,0
"172.16.133.99",56306,"172.16.139.250",5440,12,1142,22257,0,0,12,1142,0,0,299.244901,0.004914999999982683,"",""
"172.16.133.75",51220,"172.16.139.250",5440,10,1022,22258,0,0,10,1022,0,0,299.249499,0.005343999999979587,1529940,0
"172.16.133.87",60520,"172.16.139.250",5440,10,1022,22259,0,0,10,1022,0,0,299.271175,0.01789799999994557,456810,0
"172.16.133.116",54133,"172.16.139.250",5440,10,1022,22260,0,0,10,1022,0,0,299.279749,0.00533300000000736,1533095,0
"172.16.133.116",54134,"172.16.139.250",5440,10,1022,22261,0,0,10,1022,0,0,299.285709,0.007145999999977448,1144136,0
"172.16.133.116",54135,"172.16.139.250",5440,10,1022,22262,0,0,10,1022,0,0,299.293455,0.015049000000033175,543291,0
"172.16.133.84",59091,"172.16.139.250",5440,10,1022,22263,0,0,10,1022,0,0,299.303476,0.014451000000008207,565773,0
"172.16.133.35",50236,"172.16.139.250",5440,12,1142,22264,0,0,12,1142,0,0,299.311902,0.20924300000001494,43662,0
"172.16.133.96",53577,"173.194.43.32",80,11,2726,22265,0,0,6,1545,5,1181,299.317122,0.4038439999999923,30605,23395
"172.16.133.49",56035,"172.16.139.250",5440,10,1022,22266,0,0,10,1022,0,0,299.377528,0.00550900000001775,1484116,0
"172.16.133.95",57264,"172.16.139.250",5440,12,1142,22267,0,0,12,1142,0,0,299.422302,0.006194999999991069,1474737,0
"172.16.133.92",57931,"172.16.139.250",5440,10,1022,22268,0,0,10,1022,0,0,299.44687,0.005645000000015443,1448361,0
"172.16.133.29",61260,"172.16.139.250",5440,10,1022,22269,0,0,10,1022,0,0,299.46497,0.017548000000033426,465922,0
"172.16.133.44",65084,"172.16.139.250",5440,10,1022,22270,0,0,10,1022,0,0,299.473388,0.005472999999994954,1493879,0
"172.16.133.207",56191,"172.16.139.250",5440,12,1142,22271,0,0,12,1142,0,0,299.496612,0.014774999999985994,618341,0
"172.16.133.83",57359,"172.16.139.250",5440,12,1142,22272,0,0,12,1142,0,0,299.507656,0.007556000000022323,1209105,0
"172.16.133.42",57391,"157.56.236.89",443,2,126,22273,0,0,1,66,1,60,299.5106,0.09669700000000603,5460,4963
"172.16.133.93",61166,"172.16.139.250",5440,12,1142,22274,0,0,12,1142,0,0,299.52003,0.005234999999970569,1745176,0
"172.16.133.36",65105,"67.217.64.244",443,6,378,22275,0,0,4,258,2,120,299.533467,0.10545300000001134,19572,9103
"172.16.133.11",55420,"172.16.139.250",5440,10,1022,22276,0,0,10,1022,0,0,299.538832,0.0058070000000043365,1407955,0
"172.16.133.63",54276,"208.111.161.254",80,25,13931,22277,0,0,9,4959,16,8972,299.542447,0.4524900000000116,87674,158624
"172.16.133.55",57898,"172.16.139.250",5440,10,1022,22278,0,0,10,1022,0,0,299.543047,0.01512800000000425,540454,0
"172.16.133.63",54277,"208.111.161.254",80,28,17506,22279,0,0,11,7308,17,10198,299.543199,0.44140099999998483,132450,184829
"172.16.133.63",54278,"208.111.161.254",80,27,14491,22280,0,0,10,6141,17,8350,299.543739,0.4524629999999661,108579,147636
"172.16.133.63",54279,"208.111.161.254",80,14,5982,22281,0,0,6,2580,8,3402,299.54426,0.42978399999998373,48024,63324
"172.16.133.63",54280,"208.111.161.254",80,28,19564,22282,0,0,11,7308,17,12256,299.544806,0.45359600000000455,128890,216157
"172.16.133.73",60957,"172.16.139.250",5440,12,1142,22283,0,0,12,1142,0,0,299.564909,0.006163000000015018,1482394,0
"172.16.133.53",54359,"172.16.139.250",5440,10,1022,22284,0,0,10,1022,0,0,299.568695,0.0056690000000116925,1442229,0
"172.16.133.21",53434,"172.16.139.250",5440,10,1022,22285,0,0,10,1022,0,0,299.572441,0.005841999999972813,1399520,0
"172.16.133.20",62721,"216.115.222.200",443,6,366,22286,0,0,4,246,2,120,299.574461,0.11094900000000507,17737,8652
"172.16.133.30",62933,"172.16.139.250",5440,12,1142,22287,0,0,12,1142,0,0,299.577552,0.005443999999954485,1678177,0
"172.16.133.36",65106,"216.115.223.200",443,10,618,22288,0,0,6,378,4,240,299.578958,0.14456200000000763,20918,13281
"172.16.133.25",63738,"172.16.139.250",5440,10,1022,22289,0,0,10,1022,0,0,299.582538,0.004719000000022788,"",""
"172.16.133.34",50727,"172.16.139.250",5440,10,1022,22290,0,0,10,1022,0,0,299.592922,0.0050229999999942265,1627712,0
"172.16.133.97",59640,"172.16.139.250",5440,10,1022,22291,0,0,10,1022,0,0,299.602358,0.00562600000000657,1453252,0
"172.16.133.20",62722,"216.219.112.250",443,6,366,22292,0,0,4,246,2,120,299.613456,0.21967599999999265,8958,4370
"172.16.133.55",57899,"96.43.146.22",443,7,817,22293,0,0,4,508,3,309,299.630952,0.1319119999999998,30808,18739
"172.16.133.55",57900,"96.43.146.22",443,7,817,22294,0,0,4,508,3,309,299.631201,0.13048300000002655,31145,18944
"172.16.133.20",62723,"66.151.158.187",443,6,366,22295,0,0,4,246,2,120,299.631331,0.19063299999999117,10323,5035
"172.16.133.54",64906,"132.245.1.150",443,17,7595,22296,0,0,8,1754,9,5841,299.644396,0.1227500000000532,114313,380676
"172.16.133.33",58146,"172.16.139.250",5440,10,1022,22297,0,0,10,1022,0,0,299.672189,0.013360999999974865,611930,0
"172.16.133.109",60045,"23.33.81.213",443,7,478,22298,0,0,4,272,3,206,299.680808,0.04051199999997834,53712,40679
"172.16.133.68",61054,"172.16.139.250",5440,10,1022,22299,0,0,10,1022,0,0,299.709901,0.005576000000019121,1466284,0
"172.16.133.36",65107,"66.151.150.190",443,6,378,22300,0,0,4,258,2,120,299.718332,0.1896160000000009,10885,5062
"172.16.133.12",60044,"172.16.139.250",5440,12,1142,22301,0,0,12,1142,0,0,299.724433,0.007137000000000171,1280089,0
"172.16.133.36",65108,"216.219.113.250",443,6,378,22302,0,0,4,258,2,120,299.728199,0.19687099999998736,10484,4876
"172.16.133.63",54281,"172.16.139.250",5440,12,1142,22303,0,0,12,1142,0,0,299.733498,0.016089000000022224,567841,0
"172.16.133.66",54464,"172.16.139.250",5440,10,1022,22304,0,0,10,1022,0,0,299.744149,0.008365000000026157,977405,0
"172.16.133.63",54282,"8.27.243.253",80,3,192,22305,0,0,2,126,1,66,299.746534,0.02186299999999619,46105,24150
"172.16.133.63",54283,"8.27.243.253",80,3,192,22306,0,0,2,126,1,66,299.746683,0.022595999999964533,44609,23366
"172.16.133.63",54284,"8.27.243.253",80,3,192,22307,0,0,2,126,1,66,299.746794,0.022482999999965614,44833,23484
"172.16.133.63",54285,"216.52.242.80",80,3,192,22308,0,0,2,126,1,66,299.74701,0.09300000000001774,10838,5677
"172.16.133.82",61690,"172.16.139.250",5440,10,1022,22309,0,0,10,1022,0,0,299.759475,0.015575000000012551,524943,0
"172.16.133.37",60913,"172.16.139.250",5440,10,1022,22310,0,0,10,1022,0,0,299.773461,0.015641000000016447,522728,0
"172.16.133.20",62724,"202.173.24.200",443,1,66,22311,0,0,1,66,0,0,299.777553,0,"",""
"172.16.133.16",59375,"31.13.74.10",443,60,40399,22312,0,0,23,3083,37,37316,299.782109,0.18222000000002936,135352,1638283
"172.16.133.16",59376,"31.13.73.26",443,12,5518,22313,0,0,6,901,6,4617,299.806835,0.12898400000000265,55882,286361
"172.16.133.96",53578,"74.125.228.112",80,50,47266,22314,0,0,17,1789,33,45477,299.812909,0.16118399999999156,88792,2257147
"172.16.133.16",59377,"31.13.73.26",443,4,443,22315,0,0,3,377,1,66,299.89163,0.06857099999996308,43983,7700
"172.16.133.16",59378,"31.13.73.26",443,4,443,22316,0,0,3,377,1,66,299.89194,0.07449600000001055,40485,7087
"172.16.133.16",59379,"31.13.73.26",443,4,443,22317,0,0,3,377,1,66,299.892533,0.0786319999999705,38355,6714
"172.16.133.16",59380,"31.13.73.26",443,4,443,22318,0,0,3,377,1,66,299.892901,0.07759500000003072,38868,6804
"172.16.133.16",59381,"23.67.243.26",443,9,2563,22319,0,0,5,1254,4,1309,299.893206,0.08970699999997578,111830,116735
"172.16.133.16",59382,"23.67.243.26",443,9,2499,22320,0,0,5,1190,4,1309,299.894478,0.08548200000001316,111368,122505
"172.16.133.16",59383,"23.67.243.26",443,9,2499,22321,0,0,5,1190,4,1309,299.89489,0.08251900000004753,115367,126904
"172.16.133.16",59384,"23.67.243.26",443,9,2499,22322,0,0,5,1190,4,1309,299.895166,0.08975099999997838,106071,116678
"172.16.133.16",59385,"23.67.243.26",443,9,2499,22323,0,0,5,1190,4,1309,299.89544,0.09094999999996389,104672,115140
"172.16.133.16",59386,"23.67.243.26",443,9,2515,22324,0,0,5,1206,4,1309,299.895709,0.0908420000000092,106206,115277
"172.16.133.45",61248,"91.190.218.55",12350,2,120,22325,0,0,1,60,1,60,299.927968,9.699999998247222e-05,"",""
"172.16.133.78",59530,"172.16.139.250",5440,10,1022,22326,0,0,10,1022,0,0,299.928155,0.005489000000011401,1489524,0
"172.16.133.67",56268,"172.16.139.250",5440,10,1022,22327,0,0,10,1022,0,0,299.983625,0.006451999999967484,1267203,0
"172.16.133.103",63452,"64.74.80.187",443,1,66,22328,0,0,1,66,0,0,299.984679,0,"",""
"172.16.133.103",63453,"67.217.65.244",443,1,66,22329,0,0,1,66,0,0,299.991693,0,"",""
